date,line,station,geton,getoff,update,sum
20200101,1,종각,20427,16301,20200104,36728
20200101,1,시청,12126,10516,20200104,22642
20200101,1,서울역,36470,29895,20200104,66365
20200101,1,동묘앞,7580,7998,20200104,15578
20200101,1,청량리,13878,13997,20200104,27875
20200101,1,제기동,9791,9852,20200104,19643
20200101,1,신설동,6820,6589,20200104,13409
20200101,1,동대문,8822,9558,20200104,18380
20200101,1,종로5가,12672,11939,20200104,24611
20200101,1,종로3가,17061,15108,20200104,32169
20200102,1,서울역,59502,53548,20200105,113050
20200102,1,시청,27953,28347,20200105,56300
20200102,1,종각,48855,47433,20200105,96288
20200102,1,종로3가,35903,34261,20200105,70164
20200102,1,종로5가,28447,28619,20200105,57066
20200102,1,동대문,12057,13486,20200105,25543
20200102,1,신설동,16140,15858,20200105,31998
20200102,1,제기동,20556,21151,20200105,41707
20200102,1,청량리,24593,24717,20200105,49310
20200102,1,동묘앞,8797,9305,20200105,18102
20200103,1,서울역,66013,60775,20200106,126788
20200103,1,시청,30288,30898,20200106,61186
20200103,1,종각,53006,52135,20200106,105141
20200103,1,종로3가,39369,37568,20200106,76937
20200103,1,종로5가,30778,30873,20200106,61651
20200103,1,동대문,13288,14731,20200106,28019
20200103,1,신설동,17199,16573,20200106,33772
20200103,1,제기동,21868,22412,20200106,44280
20200103,1,청량리,26167,26603,20200106,52770
20200103,1,동묘앞,9841,10175,20200106,20016
20200104,1,서울역,48376,46823,20200107,95199
20200104,1,시청,22370,23449,20200107,45819
20200104,1,종각,35345,33183,20200107,68528
20200104,1,종로3가,34613,33921,20200107,68534
20200104,1,종로5가,26307,26355,20200107,52662
20200104,1,동대문,13392,15219,20200107,28611
20200104,1,신설동,12452,11889,20200107,24341
20200104,1,제기동,19719,20500,20200107,40219
20200104,1,청량리,24388,24906,20200107,49294
20200104,1,동묘앞,13077,13909,20200107,26986
20200105,1,서울역,38247,34335,20200108,72582
20200105,1,시청,12128,11878,20200108,24006
20200105,1,종각,20424,17508,20200108,37932
20200105,1,종로5가,12773,12485,20200108,25258
20200105,1,동대문,12340,14602,20200108,26942
20200105,1,신설동,9598,9353,20200108,18951
20200105,1,제기동,13623,14098,20200108,27721
20200105,1,청량리,18178,18398,20200108,36576
20200105,1,동묘앞,13871,14382,20200108,28253
20200105,1,종로3가,21119,19316,20200108,40435
20200106,1,서울역,58509,54106,20200109,112615
20200106,1,시청,27431,27926,20200109,55357
20200106,1,종각,49955,47854,20200109,97809
20200106,1,종로3가,35447,34264,20200109,69711
20200106,1,종로5가,28342,27852,20200109,56194
20200106,1,동대문,13409,14525,20200109,27934
20200106,1,신설동,16605,16430,20200109,33035
20200106,1,제기동,20697,20949,20200109,41646
20200106,1,청량리,23856,24206,20200109,48062
20200106,1,동묘앞,7107,7716,20200109,14823
20200107,1,서울역,56932,52709,20200110,109641
20200107,1,시청,28129,28050,20200110,56179
20200107,1,종각,49608,47621,20200110,97229
20200107,1,종로3가,32831,31628,20200110,64459
20200107,1,종로5가,28447,27705,20200110,56152
20200107,1,동대문,12450,12843,20200110,25293
20200107,1,신설동,15945,15650,20200110,31595
20200107,1,제기동,17678,17677,20200110,35355
20200107,1,청량리,21460,21728,20200110,43188
20200107,1,동묘앞,6090,6291,20200110,12381
20200108,1,서울역,58754,53792,20200111,112546
20200108,1,시청,27996,28663,20200111,56659
20200108,1,종각,49926,48608,20200111,98534
20200108,1,종로3가,37405,35497,20200111,72902
20200108,1,종로5가,29338,29116,20200111,58454
20200108,1,동대문,13898,14616,20200111,28514
20200108,1,신설동,16920,16576,20200111,33496
20200108,1,제기동,21352,21776,20200111,43128
20200108,1,청량리,24999,25517,20200111,50516
20200108,1,동묘앞,8080,8321,20200111,16401
20200109,1,서울역,60442,56118,20200112,116560
20200109,1,시청,29495,30356,20200112,59851
20200109,1,종각,52172,50502,20200112,102674
20200109,1,종로3가,38204,36550,20200112,74754
20200109,1,종로5가,30457,30412,20200112,60869
20200109,1,동대문,14278,15133,20200112,29411
20200109,1,신설동,17253,16807,20200112,34060
20200109,1,제기동,23311,23946,20200112,47257
20200109,1,청량리,26227,26293,20200112,52520
20200109,1,동묘앞,9238,9535,20200112,18773
20200110,1,시청,30140,30776,20200113,60916
20200110,1,종각,53635,53341,20200113,106976
20200110,1,종로3가,39544,38798,20200113,78342
20200110,1,종로5가,31091,31475,20200113,62566
20200110,1,동대문,14807,15757,20200113,30564
20200110,1,신설동,17908,17295,20200113,35203
20200110,1,제기동,23450,23977,20200113,47427
20200110,1,청량리,27291,27721,20200113,55012
20200110,1,동묘앞,9564,10021,20200113,19585
20200110,1,서울역,69054,62678,20200113,131732
20200111,1,서울역,54012,52192,20200114,106204
20200111,1,시청,25804,26923,20200114,52727
20200111,1,종각,41463,38990,20200114,80453
20200111,1,종로3가,38158,37276,20200114,75434
20200111,1,종로5가,28902,29001,20200114,57903
20200111,1,동대문,15147,16499,20200114,31646
20200111,1,신설동,12925,12255,20200114,25180
20200111,1,제기동,21594,22831,20200114,44425
20200111,1,청량리,26093,27141,20200114,53234
20200111,1,동묘앞,13608,14238,20200114,27846
20200112,1,서울역,38946,35440,20200115,74386
20200112,1,시청,13014,12314,20200115,25328
20200112,1,종각,21757,18592,20200115,40349
20200112,1,종로3가,22212,20294,20200115,42506
20200112,1,종로5가,14817,14417,20200115,29234
20200112,1,동대문,12999,15254,20200115,28253
20200112,1,신설동,9769,9501,20200115,19270
20200112,1,제기동,14840,15493,20200115,30333
20200112,1,청량리,19632,19825,20200115,39457
20200112,1,동묘앞,14051,14145,20200115,28196
20200113,1,서울역,59613,55643,20200116,115256
20200113,1,시청,28368,28837,20200116,57205
20200113,1,종각,49906,48307,20200116,98213
20200113,1,종로3가,36794,35017,20200116,71811
20200113,1,종로5가,29045,29040,20200116,58085
20200113,1,동대문,13851,14657,20200116,28508
20200113,1,신설동,16980,16566,20200116,33546
20200113,1,제기동,23018,23928,20200116,46946
20200113,1,청량리,25868,26216,20200116,52084
20200113,1,동묘앞,8692,9021,20200116,17713
20200114,1,동묘앞,9024,9353,20200117,18377
20200114,1,청량리,26113,26331,20200117,52444
20200114,1,제기동,23532,24464,20200117,47996
20200114,1,신설동,17122,16861,20200117,33983
20200114,1,동대문,14171,15080,20200117,29251
20200114,1,종로5가,30118,29802,20200117,59920
20200114,1,종로3가,37302,35523,20200117,72825
20200114,1,종각,50716,48868,20200117,99584
20200114,1,시청,29889,30536,20200117,60425
20200114,1,서울역,59632,55374,20200117,115006
20200115,1,시청,30341,31020,20200118,61361
20200115,1,종각,51872,49782,20200118,101654
20200115,1,종로3가,37833,35616,20200118,73449
20200115,1,종로5가,30355,30291,20200118,60646
20200115,1,동대문,14137,14908,20200118,29045
20200115,1,신설동,17636,17247,20200118,34883
20200115,1,제기동,23786,24715,20200118,48501
20200115,1,청량리,26313,26934,20200118,53247
20200115,1,동묘앞,8973,9360,20200118,18333
20200115,1,서울역,59961,55706,20200118,115667
20200116,1,동묘앞,9265,9418,20200119,18683
20200116,1,청량리,27234,27667,20200119,54901
20200116,1,제기동,24914,25742,20200119,50656
20200116,1,신설동,17365,17021,20200119,34386
20200116,1,동대문,13817,14750,20200119,28567
20200116,1,종로5가,30579,30412,20200119,60991
20200116,1,종로3가,38135,36283,20200119,74418
20200116,1,종각,51784,49954,20200119,101738
20200116,1,시청,29450,30459,20200119,59909
20200116,1,서울역,61843,56697,20200119,118540
20200117,1,서울역,69208,62321,20200120,131529
20200117,1,시청,29843,30839,20200120,60682
20200117,1,종각,54143,52979,20200120,107122
20200117,1,종로3가,40148,38933,20200120,79081
20200117,1,종로5가,31073,31155,20200120,62228
20200117,1,동대문,15115,16040,20200120,31155
20200117,1,신설동,18173,17718,20200120,35891
20200117,1,제기동,25092,26107,20200120,51199
20200117,1,청량리,28040,28611,20200120,56651
20200117,1,동묘앞,9547,10002,20200120,19549
20200118,1,시청,22674,24104,20200121,46778
20200118,1,서울역,51651,48048,20200121,99699
20200118,1,종로3가,37082,36219,20200121,73301
20200118,1,제기동,23474,25076,20200121,48550
20200118,1,청량리,27218,28031,20200121,55249
20200118,1,동묘앞,13602,14622,20200121,28224
20200118,1,종로5가,29273,29285,20200121,58558
20200118,1,동대문,15434,16390,20200121,31824
20200118,1,신설동,13140,12459,20200121,25599
20200118,1,종각,38426,36961,20200121,75387
20200119,1,서울역,38294,36289,20200122,74583
20200119,1,시청,11948,11622,20200122,23570
20200119,1,종각,19870,17466,20200122,37336
20200119,1,종로3가,20992,18846,20200122,39838
20200119,1,종로5가,14808,14512,20200122,29320
20200119,1,동대문,11555,13839,20200122,25394
20200119,1,신설동,9709,9377,20200122,19086
20200119,1,제기동,15518,16217,20200122,31735
20200119,1,청량리,19192,19430,20200122,38622
20200119,1,동묘앞,11881,12225,20200122,24106
20200120,1,동묘앞,9643,10003,20200123,19646
20200120,1,청량리,28511,28718,20200123,57229
20200120,1,제기동,26028,27528,20200123,53556
20200120,1,신설동,17551,17009,20200123,34560
20200120,1,동대문,14205,14998,20200123,29203
20200120,1,종로3가,37088,35184,20200123,72272
20200120,1,서울역,59190,57147,20200123,116337
20200120,1,종로5가,29781,29723,20200123,59504
20200120,1,시청,29222,29948,20200123,59170
20200120,1,종각,50459,48925,20200123,99384
20200121,1,서울역,58638,57038,20200124,115676
20200121,1,시청,30292,30877,20200124,61169
20200121,1,종각,50284,48660,20200124,98944
20200121,1,종로3가,37018,34317,20200124,71335
20200121,1,종로5가,29819,29677,20200124,59496
20200121,1,동대문,14093,15018,20200124,29111
20200121,1,신설동,17589,17137,20200124,34726
20200121,1,제기동,25466,26993,20200124,52459
20200121,1,청량리,28602,29145,20200124,57747
20200121,1,동묘앞,9487,10018,20200124,19505
20200122,1,서울역,56692,59402,20200125,116094
20200122,1,시청,28988,29425,20200125,58413
20200122,1,종각,49781,47764,20200125,97545
20200122,1,종로3가,36456,34103,20200125,70559
20200122,1,종로5가,29414,29519,20200125,58933
20200122,1,동대문,14193,14686,20200125,28879
20200122,1,신설동,17773,17195,20200125,34968
20200122,1,제기동,25125,26174,20200125,51299
20200122,1,청량리,28768,29097,20200125,57865
20200122,1,동묘앞,9475,9925,20200125,19400
20200123,1,서울역,55247,62901,20200126,118148
20200123,1,시청,25281,25228,20200126,50509
20200123,1,종각,43189,41813,20200126,85002
20200123,1,종로3가,34280,32722,20200126,67002
20200123,1,종로5가,28648,28369,20200126,57017
20200123,1,동대문,13354,13267,20200126,26621
20200123,1,신설동,16412,15043,20200126,31455
20200123,1,제기동,22580,23488,20200126,46068
20200123,1,청량리,28187,28919,20200126,57106
20200123,1,동묘앞,9669,10055,20200126,19724
20200124,1,동묘앞,8834,9023,20200127,17857
20200124,1,청량리,15928,16992,20200127,32920
20200124,1,제기동,10845,10938,20200127,21783
20200124,1,신설동,7092,5539,20200127,12631
20200124,1,동대문,10558,12783,20200127,23341
20200124,1,종로5가,11506,11171,20200127,22677
20200124,1,종로3가,14965,13948,20200127,28913
20200124,1,종각,13023,11963,20200127,24986
20200124,1,시청,8255,7863,20200127,16118
20200124,1,서울역,32248,39786,20200127,72034
20200125,1,서울역,35849,34423,20200128,70272
20200125,1,시청,10644,10954,20200128,21598
20200125,1,종각,14456,12697,20200128,27153
20200125,1,종로3가,12256,11879,20200128,24135
20200125,1,종로5가,6833,6645,20200128,13478
20200125,1,동대문,12447,14923,20200128,27370
20200125,1,신설동,5721,5365,20200128,11086
20200125,1,제기동,5654,5548,20200128,11202
20200125,1,청량리,11870,12012,20200128,23882
20200125,1,동묘앞,5905,6505,20200128,12410
20200126,1,종각,17929,16042,20200129,33971
20200126,1,종로3가,18802,17174,20200129,35976
20200126,1,종로5가,10166,10070,20200129,20236
20200126,1,동대문,14340,14521,20200129,28861
20200126,1,신설동,7058,7121,20200129,14179
20200126,1,제기동,7967,8300,20200129,16267
20200126,1,청량리,14219,14301,20200129,28520
20200126,1,동묘앞,10612,11478,20200129,22090
20200126,1,서울역,40076,28841,20200129,68917
20200126,1,시청,10949,10753,20200129,21702
20200127,1,시청,9937,9034,20200130,18971
20200127,1,종각,17928,15687,20200130,33615
20200127,1,종로3가,19884,18898,20200130,38782
20200127,1,종로5가,11658,11590,20200130,23248
20200127,1,동대문,8972,9545,20200130,18517
20200127,1,신설동,6855,7338,20200130,14193
20200127,1,제기동,10692,11135,20200130,21827
20200127,1,청량리,14681,14934,20200130,29615
20200127,1,동묘앞,7867,8487,20200130,16354
20200127,1,서울역,41239,31184,20200130,72423
20200128,1,시청,25219,25612,20200131,50831
20200128,1,종각,42924,42121,20200131,85045
20200128,1,종로3가,32153,30514,20200131,62667
20200128,1,종로5가,25332,25474,20200131,50806
20200128,1,동대문,10994,12288,20200131,23282
20200128,1,신설동,15044,15002,20200131,30046
20200128,1,제기동,17874,18278,20200131,36152
20200128,1,청량리,21816,21695,20200131,43511
20200128,1,동묘앞,8537,8969,20200131,17506
20200128,1,서울역,55784,46389,20200131,102173
20200129,1,시청,27966,28269,20200201,56235
20200129,1,종각,46825,45634,20200201,92459
20200129,1,종로3가,33412,31775,20200201,65187
20200129,1,종로5가,27703,27608,20200201,55311
20200129,1,동대문,13132,13691,20200201,26823
20200129,1,신설동,16299,15985,20200201,32284
20200129,1,제기동,18541,18830,20200201,37371
20200129,1,청량리,22482,22852,20200201,45334
20200129,1,동묘앞,8708,9273,20200201,17981
20200129,1,서울역,56226,50057,20200201,106283
20200130,1,동묘앞,8752,9278,20200202,18030
20200130,1,청량리,22802,23015,20200202,45817
20200130,1,제기동,19193,19619,20200202,38812
20200130,1,신설동,16550,16213,20200202,32763
20200130,1,동대문,12990,13435,20200202,26425
20200130,1,종로5가,27302,27269,20200202,54571
20200130,1,종로3가,33718,31632,20200202,65350
20200130,1,종각,46979,45632,20200202,92611
20200130,1,시청,27164,27820,20200202,54984
20200130,1,서울역,55339,50836,20200202,106175
20200131,1,서울역,58277,54060,20200203,112337
20200131,1,시청,27160,27510,20200203,54670
20200131,1,종각,47725,47091,20200203,94816
20200131,1,종로3가,33192,31611,20200203,64803
20200131,1,종로5가,26700,26910,20200203,53610
20200131,1,동대문,13235,13429,20200203,26664
20200131,1,신설동,16736,16598,20200203,33334
20200131,1,제기동,18648,18745,20200203,37393
20200131,1,청량리,22820,23182,20200203,46002
20200131,1,동묘앞,8721,9025,20200203,17746
20200201,1,시청,13966,14315,20200204,28281
20200201,1,종각,24014,23628,20200204,47642
20200201,1,종로3가,25613,24969,20200204,50582
20200201,1,종로5가,19922,19765,20200204,39687
20200201,1,동대문,11346,11210,20200204,22556
20200201,1,신설동,10517,10085,20200204,20602
20200201,1,제기동,14752,14975,20200204,29727
20200201,1,청량리,18700,19210,20200204,37910
20200201,1,동묘앞,10003,10716,20200204,20719
20200201,1,서울역,34375,33070,20200204,67445
20200202,1,서울역,27746,25860,20200205,53606
20200202,1,시청,9085,8150,20200205,17235
20200202,1,종각,14933,13299,20200205,28232
20200202,1,종로3가,14895,13381,20200205,28276
20200202,1,종로5가,9349,9429,20200205,18778
20200202,1,동대문,8774,10184,20200205,18958
20200202,1,신설동,7845,7587,20200205,15432
20200202,1,제기동,9257,9457,20200205,18714
20200202,1,청량리,13367,13360,20200205,26727
20200202,1,동묘앞,9633,9780,20200205,19413
20200203,1,서울역,48307,46039,20200206,94346
20200203,1,시청,25019,25472,20200206,50491
20200203,1,종각,43754,42847,20200206,86601
20200203,1,종로3가,29601,28159,20200206,57760
20200203,1,종로5가,24251,24394,20200206,48645
20200203,1,동대문,11981,12001,20200206,23982
20200203,1,신설동,15527,15344,20200206,30871
20200203,1,제기동,17710,18167,20200206,35877
20200203,1,청량리,21459,21065,20200206,42524
20200203,1,동묘앞,7572,7863,20200206,15435
20200204,1,서울역,48476,45855,20200207,94331
20200204,1,시청,26051,26010,20200207,52061
20200204,1,종각,45340,43607,20200207,88947
20200204,1,종로3가,29523,28059,20200207,57582
20200204,1,종로5가,24859,24243,20200207,49102
20200204,1,동대문,11866,12054,20200207,23920
20200204,1,신설동,15629,15484,20200207,31113
20200204,1,제기동,17424,17861,20200207,35285
20200204,1,청량리,21179,21383,20200207,42562
20200204,1,동묘앞,7680,8062,20200207,15742
20200205,1,서울역,46922,44674,20200208,91596
20200205,1,시청,25340,25517,20200208,50857
20200205,1,종각,44730,43016,20200208,87746
20200205,1,종로3가,28444,26886,20200208,55330
20200205,1,종로5가,22864,22545,20200208,45409
20200205,1,동대문,11320,11372,20200208,22692
20200205,1,신설동,15472,15080,20200208,30552
20200205,1,제기동,15467,15527,20200208,30994
20200205,1,청량리,19423,19408,20200208,38831
20200205,1,동묘앞,6729,7089,20200208,13818
20200206,1,서울역,47433,44662,20200209,92095
20200206,1,시청,25157,25360,20200209,50517
20200206,1,종각,43934,42848,20200209,86782
20200206,1,종로3가,28680,26964,20200209,55644
20200206,1,종로5가,23317,23327,20200209,46644
20200206,1,동대문,11213,11191,20200209,22404
20200206,1,신설동,15191,14692,20200209,29883
20200206,1,제기동,16066,16089,20200209,32155
20200206,1,청량리,19729,19822,20200209,39551
20200206,1,동묘앞,6987,7295,20200209,14282
20200207,1,서울역,53092,49805,20200210,102897
20200207,1,시청,25082,25495,20200210,50577
20200207,1,종각,44763,44435,20200210,89198
20200207,1,종로3가,30582,29590,20200210,60172
20200207,1,종로5가,23830,24042,20200210,47872
20200207,1,동대문,11932,11959,20200210,23891
20200207,1,신설동,16072,15634,20200210,31706
20200207,1,제기동,16903,17115,20200210,34018
20200207,1,청량리,21547,21146,20200210,42693
20200207,1,동묘앞,7882,8277,20200210,16159
20200208,1,시청,12410,12281,20200211,24691
20200208,1,종각,22883,22186,20200211,45069
20200208,1,종로3가,23123,22850,20200211,45973
20200208,1,종로5가,17235,17251,20200211,34486
20200208,1,동대문,10447,10254,20200211,20701
20200208,1,신설동,10083,9531,20200211,19614
20200208,1,제기동,13086,13344,20200211,26430
20200208,1,청량리,17175,17130,20200211,34305
20200208,1,동묘앞,9302,9632,20200211,18934
20200208,1,서울역,31425,32139,20200211,63564
20200209,1,서울역,25067,23190,20200212,48257
20200209,1,시청,7438,7253,20200212,14691
20200209,1,종각,13770,12374,20200212,26144
20200209,1,종로3가,14035,13216,20200212,27251
20200209,1,종로5가,8144,8068,20200212,16212
20200209,1,동대문,8458,9916,20200212,18374
20200209,1,신설동,7867,7645,20200212,15512
20200209,1,제기동,8920,9143,20200212,18063
20200209,1,청량리,12648,12573,20200212,25221
20200209,1,동묘앞,9535,9457,20200212,18992
20200210,1,서울역,48317,46088,20200213,94405
20200210,1,시청,24689,24924,20200213,49613
20200210,1,종각,43699,42901,20200213,86600
20200210,1,종로3가,31777,30038,20200213,61815
20200210,1,종로5가,24525,24814,20200213,49339
20200210,1,동대문,11944,12317,20200213,24261
20200210,1,신설동,15952,15585,20200213,31537
20200210,1,제기동,17889,18265,20200213,36154
20200210,1,청량리,21229,21161,20200213,42390
20200210,1,동묘앞,7928,8457,20200213,16385
20200211,1,서울역,48277,46129,20200214,94406
20200211,1,시청,25706,25969,20200214,51675
20200211,1,종각,44569,43273,20200214,87842
20200211,1,종로3가,32111,30295,20200214,62406
20200211,1,종로5가,25224,25285,20200214,50509
20200211,1,동대문,12293,12765,20200214,25058
20200211,1,신설동,15987,15525,20200214,31512
20200211,1,제기동,18574,18825,20200214,37399
20200211,1,청량리,21715,21855,20200214,43570
20200211,1,동묘앞,8551,9113,20200214,17664
20200212,1,서울역,47850,45385,20200215,93235
20200212,1,시청,25337,25724,20200215,51061
20200212,1,종각,44627,43224,20200215,87851
20200212,1,종로3가,29768,28431,20200215,58199
20200212,1,종로5가,24136,23904,20200215,48040
20200212,1,동대문,11616,11735,20200215,23351
20200212,1,신설동,15580,15115,20200215,30695
20200212,1,제기동,15777,15788,20200215,31565
20200212,1,청량리,19543,19525,20200215,39068
20200212,1,동묘앞,6145,6642,20200215,12787
20200213,1,서울역,50232,47437,20200216,97669
20200213,1,시청,25810,26143,20200216,51953
20200213,1,종각,44999,44090,20200216,89089
20200213,1,종로3가,33141,31031,20200216,64172
20200213,1,종로5가,25748,25916,20200216,51664
20200213,1,동대문,12519,12873,20200216,25392
20200213,1,신설동,15855,15721,20200216,31576
20200213,1,제기동,18834,19274,20200216,38108
20200213,1,청량리,22284,22224,20200216,44508
20200213,1,동묘앞,8152,8570,20200216,16722
20200214,1,서울역,56171,52470,20200217,108641
20200214,1,시청,25988,25448,20200217,51436
20200214,1,종각,46386,45456,20200217,91842
20200214,1,종로3가,35237,33489,20200217,68726
20200214,1,종로5가,26295,26379,20200217,52674
20200214,1,동대문,12954,13199,20200217,26153
20200214,1,신설동,16632,16139,20200217,32771
20200214,1,제기동,19942,19982,20200217,39924
20200214,1,청량리,23546,23776,20200217,47322
20200214,1,동묘앞,9258,9578,20200217,18836
20200215,1,서울역,36339,36476,20200218,72815
20200215,1,시청,15242,15130,20200218,30372
20200215,1,종각,26300,24914,20200218,51214
20200215,1,종로3가,27714,27547,20200218,55261
20200215,1,종로5가,20011,19887,20200218,39898
20200215,1,동대문,11989,12249,20200218,24238
20200215,1,신설동,11230,10637,20200218,21867
20200215,1,제기동,16301,16830,20200218,33131
20200215,1,청량리,20036,20232,20200218,40268
20200215,1,동묘앞,11111,11867,20200218,22978
20200216,1,서울역,29311,25874,20200219,55185
20200216,1,시청,8247,7813,20200219,16060
20200216,1,종각,14493,13353,20200219,27846
20200216,1,종로3가,14797,13843,20200219,28640
20200216,1,종로5가,9278,8943,20200219,18221
20200216,1,동대문,8301,9442,20200219,17743
20200216,1,신설동,7387,7050,20200219,14437
20200216,1,제기동,9106,9212,20200219,18318
20200216,1,청량리,13381,13390,20200219,26771
20200216,1,동묘앞,7086,7270,20200219,14356
20200217,1,서울역,50340,47562,20200220,97902
20200217,1,시청,24569,25173,20200220,49742
20200217,1,종각,44449,43389,20200220,87838
20200217,1,종로3가,29512,28064,20200220,57576
20200217,1,종로5가,23320,23487,20200220,46807
20200217,1,동대문,11447,11891,20200220,23338
20200217,1,신설동,15136,14821,20200220,29957
20200217,1,제기동,16416,16542,20200220,32958
20200217,1,청량리,20042,20128,20200220,40170
20200217,1,동묘앞,6593,6909,20200220,13502
20200218,1,서울역,49301,46801,20200221,96102
20200218,1,시청,25668,26030,20200221,51698
20200218,1,종각,44161,42658,20200221,86819
20200218,1,종로3가,29392,27716,20200221,57108
20200218,1,종로5가,23942,23979,20200221,47921
20200218,1,동대문,11550,12012,20200221,23562
20200218,1,신설동,15097,14857,20200221,29954
20200218,1,제기동,17120,17212,20200221,34332
20200218,1,청량리,20876,21081,20200221,41957
20200218,1,동묘앞,7299,7731,20200221,15030
20200219,1,서울역,49978,47110,20200222,97088
20200219,1,시청,25593,26316,20200222,51909
20200219,1,종각,45284,43442,20200222,88726
20200219,1,종로3가,31323,29278,20200222,60601
20200219,1,종로5가,24509,24657,20200222,49166
20200219,1,동대문,11737,12261,20200222,23998
20200219,1,신설동,15436,15142,20200222,30578
20200219,1,제기동,17882,18090,20200222,35972
20200219,1,청량리,21549,21620,20200222,43169
20200219,1,동묘앞,7604,7985,20200222,15589
20200220,1,서울역,49555,46719,20200223,96274
20200220,1,시청,25186,25901,20200223,51087
20200220,1,종각,43159,42330,20200223,85489
20200220,1,종로3가,30321,28576,20200223,58897
20200220,1,종로5가,24250,24579,20200223,48829
20200220,1,동대문,11536,11951,20200223,23487
20200220,1,신설동,15135,15043,20200223,30178
20200220,1,제기동,17355,17593,20200223,34948
20200220,1,청량리,21272,21308,20200223,42580
20200220,1,동묘앞,7503,7898,20200223,15401
20200221,1,서울역,51060,47574,20200224,98634
20200221,1,시청,24372,24543,20200224,48915
20200221,1,종각,41685,40299,20200224,81984
20200221,1,종로3가,26948,25726,20200224,52674
20200221,1,종로5가,22785,22519,20200224,45304
20200221,1,동대문,11291,11289,20200224,22580
20200221,1,신설동,15104,14418,20200224,29522
20200221,1,제기동,15882,16093,20200224,31975
20200221,1,청량리,22198,21113,20200224,43311
20200221,1,동묘앞,6895,7247,20200224,14142
20200222,1,서울역,25308,23887,20200225,49195
20200222,1,시청,10464,10499,20200225,20963
20200222,1,종각,16464,16077,20200225,32541
20200222,1,종로3가,16577,16260,20200225,32837
20200222,1,종로5가,14262,14243,20200225,28505
20200222,1,동대문,8585,8264,20200225,16849
20200222,1,신설동,8939,8247,20200225,17186
20200222,1,제기동,11273,11464,20200225,22737
20200222,1,청량리,14740,14684,20200225,29424
20200222,1,동묘앞,7038,7414,20200225,14452
20200223,1,서울역,18234,16791,20200226,35025
20200223,1,시청,6495,6447,20200226,12942
20200223,1,종각,9812,8703,20200226,18515
20200223,1,종로3가,9510,8651,20200226,18161
20200223,1,종로5가,6156,6138,20200226,12294
20200223,1,동대문,6005,7242,20200226,13247
20200223,1,신설동,5890,5809,20200226,11699
20200223,1,제기동,6860,7086,20200226,13946
20200223,1,청량리,10324,10101,20200226,20425
20200223,1,동묘앞,7409,7373,20200226,14782
20200224,1,서울역,38888,37484,20200227,76372
20200224,1,시청,21653,21750,20200227,43403
20200224,1,종각,36538,35661,20200227,72199
20200224,1,종로3가,23039,21654,20200227,44693
20200224,1,종로5가,19564,19541,20200227,39105
20200224,1,동대문,9637,9643,20200227,19280
20200224,1,신설동,13384,13114,20200227,26498
20200224,1,제기동,14146,14251,20200227,28397
20200224,1,청량리,17658,17156,20200227,34814
20200224,1,동묘앞,6020,6282,20200227,12302
20200225,1,서울역,35126,33231,20200228,68357
20200225,1,시청,21008,21299,20200228,42307
20200225,1,종각,34529,33901,20200228,68430
20200225,1,종로3가,20639,19482,20200228,40121
20200225,1,종로5가,18323,18467,20200228,36790
20200225,1,동대문,9029,8732,20200228,17761
20200225,1,신설동,12487,12038,20200228,24525
20200225,1,제기동,11836,11705,20200228,23541
20200225,1,청량리,15105,15124,20200228,30229
20200225,1,동묘앞,4559,4918,20200228,9477
20200226,1,서울역,33906,32297,20200229,66203
20200226,1,시청,20508,20773,20200229,41281
20200226,1,종각,32774,31817,20200229,64591
20200226,1,종로3가,21713,20446,20200229,42159
20200226,1,종로5가,19070,19104,20200229,38174
20200226,1,동대문,9431,9227,20200229,18658
20200226,1,신설동,12800,12522,20200229,25322
20200226,1,제기동,13535,13634,20200229,27169
20200226,1,청량리,16826,16898,20200229,33724
20200226,1,동묘앞,6060,6296,20200229,12356
20200227,1,서울역,32598,30785,20200301,63383
20200227,1,시청,19600,19689,20200301,39289
20200227,1,종각,31681,30947,20200301,62628
20200227,1,종로3가,20793,19478,20200301,40271
20200227,1,종로5가,18526,18700,20200301,37226
20200227,1,동대문,9104,8754,20200301,17858
20200227,1,신설동,12606,12320,20200301,24926
20200227,1,제기동,13277,13374,20200301,26651
20200227,1,청량리,16287,16385,20200301,32672
20200227,1,동묘앞,5999,6250,20200301,12249
20200228,1,서울역,32454,30638,20200302,63092
20200228,1,시청,18813,19104,20200302,37917
20200228,1,종각,30695,29840,20200302,60535
20200228,1,종로3가,19599,18968,20200302,38567
20200228,1,종로5가,17857,17849,20200302,35706
20200228,1,동대문,8737,8328,20200302,17065
20200228,1,신설동,11971,11637,20200302,23608
20200228,1,제기동,11725,11634,20200302,23359
20200228,1,청량리,15246,15298,20200302,30544
20200228,1,동묘앞,4880,4976,20200302,9856
20200229,1,시청,5990,5962,20200303,11952
20200229,1,종각,10605,10334,20200303,20939
20200229,1,종로3가,12134,11830,20200303,23964
20200229,1,종로5가,10105,10133,20200303,20238
20200229,1,동대문,6836,6149,20200303,12985
20200229,1,신설동,6663,6277,20200303,12940
20200229,1,제기동,9391,9720,20200303,19111
20200229,1,청량리,12115,12303,20200303,24418
20200229,1,동묘앞,6537,6691,20200303,13228
20200229,1,서울역,14546,13815,20200303,28361
20200301,1,서울역,10457,10389,20200304,20846
20200301,1,시청,3980,3937,20200304,7917
20200301,1,종각,6357,5849,20200304,12206
20200301,1,종로3가,6818,6361,20200304,13179
20200301,1,종로5가,3942,4019,20200304,7961
20200301,1,동대문,4304,5054,20200304,9358
20200301,1,신설동,4440,4297,20200304,8737
20200301,1,제기동,5161,5324,20200304,10485
20200301,1,청량리,7727,7722,20200304,15449
20200301,1,동묘앞,5954,6020,20200304,11974
20200302,1,서울역,30750,29308,20200305,60058
20200302,1,시청,17804,18180,20200305,35984
20200302,1,종각,28844,28043,20200305,56887
20200302,1,종로3가,18431,17189,20200305,35620
20200302,1,종로5가,18055,18268,20200305,36323
20200302,1,동대문,8780,8767,20200305,17547
20200302,1,신설동,11925,11750,20200305,23675
20200302,1,제기동,12871,13130,20200305,26001
20200302,1,청량리,16116,16087,20200305,32203
20200302,1,동묘앞,5846,6042,20200305,11888
20200303,1,시청,18050,18227,20200306,36277
20200303,1,서울역,30631,28834,20200306,59465
20200303,1,종각,28707,28018,20200306,56725
20200303,1,동묘앞,5898,6172,20200306,12070
20200303,1,청량리,15856,15697,20200306,31553
20200303,1,제기동,13075,13295,20200306,26370
20200303,1,신설동,11771,11538,20200306,23309
20200303,1,동대문,8829,8516,20200306,17345
20200303,1,종로5가,17617,17846,20200306,35463
20200303,1,종로3가,18327,17068,20200306,35395
20200304,1,서울역,30043,28180,20200307,58223
20200304,1,시청,18111,18309,20200307,36420
20200304,1,종각,29157,28204,20200307,57361
20200304,1,종로3가,17855,16635,20200307,34490
20200304,1,종로5가,17585,17555,20200307,35140
20200304,1,동대문,8433,8349,20200307,16782
20200304,1,신설동,11521,11379,20200307,22900
20200304,1,제기동,12476,12705,20200307,25181
20200304,1,청량리,15345,15235,20200307,30580
20200304,1,동묘앞,5525,5761,20200307,11286
20200305,1,서울역,30249,28384,20200308,58633
20200305,1,시청,17939,18402,20200308,36341
20200305,1,종각,29046,28264,20200308,57310
20200305,1,종로3가,18404,17177,20200308,35581
20200305,1,종로5가,17303,17621,20200308,34924
20200305,1,동대문,8724,8336,20200308,17060
20200305,1,신설동,11524,11411,20200308,22935
20200305,1,제기동,12629,12887,20200308,25516
20200305,1,청량리,15528,15085,20200308,30613
20200305,1,동묘앞,5778,6067,20200308,11845
20200306,1,서울역,32461,30457,20200309,62918
20200306,1,시청,17700,18255,20200309,35955
20200306,1,종각,29225,29111,20200309,58336
20200306,1,종로3가,19334,18278,20200309,37612
20200306,1,종로5가,17771,18031,20200309,35802
20200306,1,동대문,8956,8724,20200309,17680
20200306,1,신설동,11971,11758,20200309,23729
20200306,1,제기동,13547,13840,20200309,27387
20200306,1,청량리,16404,16346,20200309,32750
20200306,1,동묘앞,6160,6470,20200309,12630
20200307,1,서울역,14773,14238,20200310,29011
20200307,1,시청,5638,5538,20200310,11176
20200307,1,종각,10869,10437,20200310,21306
20200307,1,종로3가,12960,12567,20200310,25527
20200307,1,종로5가,10921,11069,20200310,21990
20200307,1,동대문,7080,6395,20200310,13475
20200307,1,신설동,6836,6361,20200310,13197
20200307,1,제기동,9913,10094,20200310,20007
20200307,1,청량리,12296,12296,20200310,24592
20200307,1,동묘앞,7046,7251,20200310,14297
20200308,1,서울역,11143,11045,20200311,22188
20200308,1,시청,3941,3774,20200311,7715
20200308,1,종각,7102,6615,20200311,13717
20200308,1,종로3가,8320,7600,20200311,15920
20200308,1,종로5가,4621,4777,20200311,9398
20200308,1,동대문,5087,5797,20200311,10884
20200308,1,신설동,4928,4813,20200311,9741
20200308,1,제기동,6161,6379,20200311,12540
20200308,1,청량리,8894,8874,20200311,17768
20200308,1,동묘앞,7406,7398,20200311,14804
20200309,1,시청,18250,18619,20200312,36869
20200309,1,동묘앞,6091,6422,20200312,12513
20200309,1,청량리,16299,16339,20200312,32638
20200309,1,제기동,13391,13592,20200312,26983
20200309,1,신설동,12278,12133,20200312,24411
20200309,1,동대문,9016,8917,20200312,17933
20200309,1,종로5가,18286,18555,20200312,36841
20200309,1,종로3가,21624,20538,20200312,42162
20200309,1,종각,30876,30309,20200312,61185
20200309,1,서울역,31832,30133,20200312,61965
20200310,1,서울역,30495,28745,20200313,59240
20200310,1,시청,17925,18091,20200313,36016
20200310,1,종각,29858,29614,20200313,59472
20200310,1,종로3가,19249,18427,20200313,37676
20200310,1,종로5가,17644,17624,20200313,35268
20200310,1,동대문,8290,7960,20200313,16250
20200310,1,신설동,11475,11175,20200313,22650
20200310,1,제기동,11265,11385,20200313,22650
20200310,1,청량리,14327,14133,20200313,28460
20200310,1,동묘앞,4487,4773,20200313,9260
20200311,1,서울역,30849,29167,20200314,60016
20200311,1,시청,17691,18188,20200314,35879
20200311,1,종각,30293,29929,20200314,60222
20200311,1,종로3가,21158,19992,20200314,41150
20200311,1,종로5가,18048,18136,20200314,36184
20200311,1,동대문,8887,8623,20200314,17510
20200311,1,신설동,12218,11858,20200314,24076
20200311,1,제기동,12618,12952,20200314,25570
20200311,1,청량리,15747,15633,20200314,31380
20200311,1,동묘앞,6064,6396,20200314,12460
20200312,1,서울역,30762,28918,20200315,59680
20200312,1,시청,17706,18040,20200315,35746
20200312,1,종각,29253,28817,20200315,58070
20200312,1,종로3가,20562,19404,20200315,39966
20200312,1,종로5가,17374,17454,20200315,34828
20200312,1,동대문,8732,8523,20200315,17255
20200312,1,신설동,11900,11535,20200315,23435
20200312,1,제기동,12570,12721,20200315,25291
20200312,1,청량리,15289,15042,20200315,30331
20200312,1,동묘앞,5854,6231,20200315,12085
20200313,1,서울역,31673,30183,20200316,61856
20200313,1,시청,17593,18015,20200316,35608
20200313,1,종각,29030,29099,20200316,58129
20200313,1,종로3가,21043,20299,20200316,41342
20200313,1,종로5가,17359,17711,20200316,35070
20200313,1,동대문,8933,8697,20200316,17630
20200313,1,신설동,11621,11441,20200316,23062
20200313,1,제기동,12758,13090,20200316,25848
20200313,1,청량리,15907,15850,20200316,31757
20200313,1,동묘앞,6014,6257,20200316,12271
20200314,1,서울역,15358,14932,20200317,30290
20200314,1,시청,5676,5697,20200317,11373
20200314,1,종각,11692,11286,20200317,22978
20200314,1,종로3가,13543,13417,20200317,26960
20200314,1,종로5가,11034,11018,20200317,22052
20200314,1,동대문,7124,6380,20200317,13504
20200314,1,신설동,6750,6288,20200317,13038
20200314,1,제기동,9817,10223,20200317,20040
20200314,1,청량리,12559,12597,20200317,25156
20200314,1,동묘앞,7220,7454,20200317,14674
20200315,1,서울역,12189,12077,20200318,24266
20200315,1,시청,3751,3622,20200318,7373
20200315,1,종각,7629,6936,20200318,14565
20200315,1,종로3가,8284,7624,20200318,15908
20200315,1,종로5가,4607,4616,20200318,9223
20200315,1,동대문,4793,5537,20200318,10330
20200315,1,신설동,4690,4622,20200318,9312
20200315,1,제기동,5513,5748,20200318,11261
20200315,1,청량리,8381,8405,20200318,16786
20200315,1,동묘앞,6968,7244,20200318,14212
20200316,1,서울역,31332,29557,20200319,60889
20200316,1,시청,17807,18209,20200319,36016
20200316,1,종각,30113,29453,20200319,59566
20200316,1,종로3가,21423,20065,20200319,41488
20200316,1,종로5가,18062,18140,20200319,36202
20200316,1,동대문,8806,8783,20200319,17589
20200316,1,신설동,12007,11820,20200319,23827
20200316,1,제기동,13158,13507,20200319,26665
20200316,1,청량리,16347,16055,20200319,32402
20200316,1,동묘앞,6020,6267,20200319,12287
20200317,1,시청,17816,18070,20200320,35886
20200317,1,종각,29973,29339,20200320,59312
20200317,1,종로3가,20607,19406,20200320,40013
20200317,1,종로5가,17519,17889,20200320,35408
20200317,1,동대문,8813,8575,20200320,17388
20200317,1,신설동,11698,11371,20200320,23069
20200317,1,제기동,12700,12901,20200320,25601
20200317,1,청량리,15772,15815,20200320,31587
20200317,1,동묘앞,5659,6001,20200320,11660
20200317,1,서울역,30397,28800,20200320,59197
20200318,1,서울역,31201,29331,20200321,60532
20200318,1,시청,18004,18365,20200321,36369
20200318,1,종각,30664,30410,20200321,61074
20200318,1,종로3가,22137,20729,20200321,42866
20200318,1,종로5가,18531,18596,20200321,37127
20200318,1,동대문,9142,8949,20200321,18091
20200318,1,신설동,12167,11792,20200321,23959
20200318,1,제기동,13759,14064,20200321,27823
20200318,1,청량리,16729,16507,20200321,33236
20200318,1,동묘앞,6486,6894,20200321,13380
20200319,1,서울역,30841,29065,20200322,59906
20200319,1,시청,17655,18012,20200322,35667
20200319,1,종각,29728,29257,20200322,58985
20200319,1,종로3가,19848,18801,20200322,38649
20200319,1,종로5가,17194,17270,20200322,34464
20200319,1,동대문,8422,8175,20200322,16597
20200319,1,신설동,11604,11520,20200322,23124
20200319,1,제기동,11967,12112,20200322,24079
20200319,1,청량리,14939,14869,20200322,29808
20200319,1,동묘앞,5367,5692,20200322,11059
20200320,1,서울역,34045,32448,20200323,66493
20200320,1,시청,18028,18381,20200323,36409
20200320,1,종각,31269,31054,20200323,62323
20200320,1,종로3가,22904,22060,20200323,44964
20200320,1,종로5가,18956,19112,20200323,38068
20200320,1,동대문,9735,9398,20200323,19133
20200320,1,신설동,12254,12146,20200323,24400
20200320,1,제기동,14454,14845,20200323,29299
20200320,1,청량리,17951,17744,20200323,35695
20200320,1,동묘앞,6873,7301,20200323,14174
20200321,1,서울역,16715,16436,20200324,33151
20200321,1,시청,6083,5843,20200324,11926
20200321,1,종각,12243,11882,20200324,24125
20200321,1,종로3가,15429,14926,20200324,30355
20200321,1,종로5가,11764,11926,20200324,23690
20200321,1,동대문,7648,7030,20200324,14678
20200321,1,신설동,7156,6604,20200324,13760
20200321,1,제기동,10357,10937,20200324,21294
20200321,1,청량리,13236,13254,20200324,26490
20200321,1,동묘앞,7925,8324,20200324,16249
20200322,1,서울역,12816,12436,20200325,25252
20200322,1,시청,4133,3980,20200325,8113
20200322,1,종각,7742,7087,20200325,14829
20200322,1,종로3가,9215,8521,20200325,17736
20200322,1,종로5가,5148,5126,20200325,10274
20200322,1,동대문,5393,6200,20200325,11593
20200322,1,신설동,5066,5049,20200325,10115
20200322,1,제기동,6403,6370,20200325,12773
20200322,1,청량리,9276,9274,20200325,18550
20200322,1,동묘앞,8350,8460,20200325,16810
20200323,1,서울역,31943,30458,20200326,62401
20200323,1,시청,17987,18344,20200326,36331
20200323,1,종각,30544,29944,20200326,60488
20200323,1,종로3가,21716,20177,20200326,41893
20200323,1,종로5가,18407,18643,20200326,37050
20200323,1,동대문,9219,9265,20200326,18484
20200323,1,신설동,12018,11767,20200326,23785
20200323,1,제기동,13883,14230,20200326,28113
20200323,1,청량리,16749,16668,20200326,33417
20200323,1,동묘앞,6321,6657,20200326,12978
20200324,1,서울역,31333,29473,20200327,60806
20200324,1,시청,18309,18480,20200327,36789
20200324,1,종각,30475,29929,20200327,60404
20200324,1,종로3가,21435,20322,20200327,41757
20200324,1,종로5가,18576,18931,20200327,37507
20200324,1,동대문,9307,9073,20200327,18380
20200324,1,신설동,11881,11672,20200327,23553
20200324,1,제기동,13691,14004,20200327,27695
20200324,1,청량리,16569,16490,20200327,33059
20200324,1,동묘앞,6386,6531,20200327,12917
20200325,1,시청,18123,18564,20200328,36687
20200325,1,종각,31046,30298,20200328,61344
20200325,1,종로3가,22535,21114,20200328,43649
20200325,1,종로5가,19164,19422,20200328,38586
20200325,1,동대문,9506,9322,20200328,18828
20200325,1,신설동,12250,12103,20200328,24353
20200325,1,제기동,13943,14332,20200328,28275
20200325,1,청량리,17388,17373,20200328,34761
20200325,1,동묘앞,6596,6980,20200328,13576
20200325,1,서울역,31682,29740,20200328,61422
20200326,1,동묘앞,6275,6664,20200329,12939
20200326,1,청량리,16672,16710,20200329,33382
20200326,1,제기동,13536,14040,20200329,27576
20200326,1,신설동,12127,11778,20200329,23905
20200326,1,동대문,9264,9023,20200329,18287
20200326,1,종로5가,18883,18816,20200329,37699
20200326,1,종로3가,21300,20355,20200329,41655
20200326,1,종각,30964,30260,20200329,61224
20200326,1,시청,17835,18075,20200329,35910
20200326,1,서울역,31431,29886,20200329,61317
20200327,1,서울역,33978,32817,20200330,66795
20200327,1,시청,17645,17954,20200330,35599
20200327,1,종각,31000,30744,20200330,61744
20200327,1,종로3가,22492,21854,20200330,44346
20200327,1,종로5가,18678,19076,20200330,37754
20200327,1,동대문,9545,9485,20200330,19030
20200327,1,신설동,12117,11939,20200330,24056
20200327,1,제기동,14018,14271,20200330,28289
20200327,1,청량리,17676,17289,20200330,34965
20200327,1,동묘앞,6842,7188,20200330,14030
20200328,1,서울역,16953,16705,20200331,33658
20200328,1,시청,6320,6327,20200331,12647
20200328,1,종각,12532,12130,20200331,24662
20200328,1,종로3가,15272,15052,20200331,30324
20200328,1,종로5가,12154,12254,20200331,24408
20200328,1,동대문,7826,7259,20200331,15085
20200328,1,신설동,7158,6731,20200331,13889
20200328,1,제기동,11216,11564,20200331,22780
20200328,1,청량리,14068,13907,20200331,27975
20200328,1,동묘앞,8064,8471,20200331,16535
20200329,1,서울역,13397,12987,20200401,26384
20200329,1,시청,4083,3953,20200401,8036
20200329,1,종각,7859,7185,20200401,15044
20200329,1,종로3가,9601,8871,20200401,18472
20200329,1,종로5가,5218,5379,20200401,10597
20200329,1,동대문,5557,6316,20200401,11873
20200329,1,신설동,5181,5043,20200401,10224
20200329,1,제기동,6543,6711,20200401,13254
20200329,1,청량리,9554,9321,20200401,18875
20200329,1,동묘앞,8523,8843,20200401,17366
20200330,1,서울역,32494,30740,20200402,63234
20200330,1,시청,17949,18197,20200402,36146
20200330,1,종각,30125,29445,20200402,59570
20200330,1,종로3가,21962,20707,20200402,42669
20200330,1,종로5가,19080,19143,20200402,38223
20200330,1,동대문,9337,9407,20200402,18744
20200330,1,신설동,12143,12125,20200402,24268
20200330,1,제기동,14306,14619,20200402,28925
20200330,1,청량리,17292,17123,20200402,34415
20200330,1,동묘앞,6592,6887,20200402,13479
20200331,1,서울역,31671,30434,20200403,62105
20200331,1,시청,18292,18572,20200403,36864
20200331,1,종각,30181,29607,20200403,59788
20200331,1,종로3가,21663,20290,20200403,41953
20200331,1,종로5가,18869,18913,20200403,37782
20200331,1,동대문,9591,9431,20200403,19022
20200331,1,신설동,12084,11881,20200403,23965
20200331,1,제기동,14349,14687,20200403,29036
20200331,1,청량리,17344,17098,20200403,34442
20200331,1,동묘앞,6665,7058,20200403,13723
20200401,1,종각,31105,30397,20200404,61502
20200401,1,종로3가,21991,20842,20200404,42833
20200401,1,종로5가,18925,19126,20200404,38051
20200401,1,동대문,9482,9373,20200404,18855
20200401,1,신설동,12191,12140,20200404,24331
20200401,1,제기동,13816,14067,20200404,27883
20200401,1,청량리,16949,16794,20200404,33743
20200401,1,동묘앞,6535,7013,20200404,13548
20200401,1,서울역,31908,30546,20200404,62454
20200401,1,시청,17943,17941,20200404,35884
20200402,1,서울역,32391,30764,20200405,63155
20200402,1,시청,17671,18052,20200405,35723
20200402,1,종각,30806,30102,20200405,60908
20200402,1,종로3가,21896,20514,20200405,42410
20200402,1,종로5가,18895,19078,20200405,37973
20200402,1,동대문,9362,9294,20200405,18656
20200402,1,신설동,12250,11992,20200405,24242
20200402,1,제기동,14319,14747,20200405,29066
20200402,1,청량리,17434,17314,20200405,34748
20200402,1,동묘앞,6771,7121,20200405,13892
20200403,1,서울역,35193,33968,20200406,69161
20200403,1,시청,17460,17661,20200406,35121
20200403,1,종각,31736,31406,20200406,63142
20200403,1,종로3가,22831,22032,20200406,44863
20200403,1,종로5가,19220,19203,20200406,38423
20200403,1,동대문,10043,9871,20200406,19914
20200403,1,신설동,12650,12386,20200406,25036
20200403,1,제기동,14608,14911,20200406,29519
20200403,1,청량리,18028,17808,20200406,35836
20200403,1,동묘앞,6902,7326,20200406,14228
20200404,1,서울역,17222,16881,20200407,34103
20200404,1,시청,5902,5917,20200407,11819
20200404,1,종각,12544,12050,20200407,24594
20200404,1,종로3가,15384,15291,20200407,30675
20200404,1,종로5가,12221,12077,20200407,24298
20200404,1,동대문,8208,7575,20200407,15783
20200404,1,신설동,7380,6793,20200407,14173
20200404,1,제기동,11122,11319,20200407,22441
20200404,1,청량리,14264,13918,20200407,28182
20200404,1,동묘앞,8146,8705,20200407,16851
20200405,1,서울역,14192,13388,20200408,27580
20200405,1,시청,3989,4010,20200408,7999
20200405,1,종각,7771,6847,20200408,14618
20200405,1,종로3가,9326,8778,20200408,18104
20200405,1,종로5가,5013,5100,20200408,10113
20200405,1,동대문,5747,6715,20200408,12462
20200405,1,신설동,5219,5251,20200408,10470
20200405,1,제기동,6681,6795,20200408,13476
20200405,1,청량리,9463,9489,20200408,18952
20200405,1,동묘앞,8668,8979,20200408,17647
20200406,1,서울역,34875,32917,20200409,67792
20200406,1,시청,18156,18462,20200409,36618
20200406,1,종각,32519,31986,20200409,64505
20200406,1,종로3가,22331,21053,20200409,43384
20200406,1,종로5가,19297,19533,20200409,38830
20200406,1,동대문,9644,9801,20200409,19445
20200406,1,신설동,12722,12536,20200409,25258
20200406,1,제기동,14621,14822,20200409,29443
20200406,1,청량리,17755,17491,20200409,35246
20200406,1,동묘앞,6603,6900,20200409,13503
20200407,1,서울역,33973,32286,20200410,66259
20200407,1,시청,18315,18653,20200410,36968
20200407,1,종각,32435,31698,20200410,64133
20200407,1,종로3가,22220,21089,20200410,43309
20200407,1,종로5가,19590,19647,20200410,39237
20200407,1,동대문,9774,9675,20200410,19449
20200407,1,신설동,12685,12412,20200410,25097
20200407,1,제기동,14566,14895,20200410,29461
20200407,1,청량리,17776,17401,20200410,35177
20200407,1,동묘앞,7122,7350,20200410,14472
20200408,1,서울역,33925,31959,20200411,65884
20200408,1,시청,18568,18841,20200411,37409
20200408,1,종각,32984,32151,20200411,65135
20200408,1,종로3가,22625,21413,20200411,44038
20200408,1,종로5가,19273,19341,20200411,38614
20200408,1,동대문,9931,9523,20200411,19454
20200408,1,신설동,12666,12612,20200411,25278
20200408,1,제기동,14466,14780,20200411,29246
20200408,1,청량리,17788,17699,20200411,35487
20200408,1,동묘앞,7052,7568,20200411,14620
20200409,1,서울역,34555,32908,20200412,67463
20200409,1,시청,18413,18700,20200412,37113
20200409,1,종각,32610,32053,20200412,64663
20200409,1,종로3가,22572,21193,20200412,43765
20200409,1,종로5가,19294,19477,20200412,38771
20200409,1,동대문,9866,9522,20200412,19388
20200409,1,신설동,12783,12588,20200412,25371
20200409,1,제기동,14615,14826,20200412,29441
20200409,1,청량리,17994,17767,20200412,35761
20200409,1,동묘앞,6904,7385,20200412,14289
20200410,1,동묘앞,6984,7477,20200413,14461
20200410,1,청량리,18634,18563,20200413,37197
20200410,1,제기동,14969,15304,20200413,30273
20200410,1,신설동,12943,12781,20200413,25724
20200410,1,동대문,10190,9930,20200413,20120
20200410,1,종로5가,19732,19753,20200413,39485
20200410,1,종로3가,23480,22586,20200413,46066
20200410,1,종각,33309,33248,20200413,66557
20200410,1,시청,18253,18642,20200413,36895
20200410,1,서울역,37476,36130,20200413,73606
20200411,1,서울역,18999,18675,20200414,37674
20200411,1,시청,6234,6248,20200414,12482
20200411,1,종각,13400,12814,20200414,26214
20200411,1,종로3가,16001,15979,20200414,31980
20200411,1,종로5가,12806,12943,20200414,25749
20200411,1,동대문,8726,8389,20200414,17115
20200411,1,신설동,7722,7233,20200414,14955
20200411,1,제기동,11911,12123,20200414,24034
20200411,1,청량리,14807,14982,20200414,29789
20200411,1,동묘앞,9049,9347,20200414,18396
20200412,1,시청,4083,4027,20200415,8110
20200412,1,종각,8688,7610,20200415,16298
20200412,1,종로3가,10037,9306,20200415,19343
20200412,1,종로5가,5764,5861,20200415,11625
20200412,1,동대문,6230,7262,20200415,13492
20200412,1,신설동,5549,5547,20200415,11096
20200412,1,제기동,7219,7478,20200415,14697
20200412,1,청량리,10368,10228,20200415,20596
20200412,1,동묘앞,9244,9554,20200415,18798
20200412,1,서울역,14850,13910,20200415,28760
20200413,1,서울역,35559,33780,20200416,69339
20200413,1,시청,18616,18788,20200416,37404
20200413,1,종각,33296,32742,20200416,66038
20200413,1,종로3가,23843,22366,20200416,46209
20200413,1,종로5가,20026,20199,20200416,40225
20200413,1,동대문,9996,10199,20200416,20195
20200413,1,신설동,12873,12723,20200416,25596
20200413,1,제기동,15714,16078,20200416,31792
20200413,1,청량리,18446,18184,20200416,36630
20200413,1,동묘앞,7086,7503,20200416,14589
20200414,1,서울역,35326,31057,20200417,66383
20200414,1,시청,17958,14549,20200417,32507
20200414,1,종각,31479,25221,20200417,56700
20200414,1,종로3가,24319,21991,20200417,46310
20200414,1,종로5가,18947,18776,20200417,37723
20200414,1,동대문,10097,11663,20200417,21760
20200414,1,신설동,12651,13220,20200417,25871
20200414,1,제기동,14849,14911,20200417,29760
20200414,1,청량리,17411,17809,20200417,35220
20200414,1,동묘앞,6907,8586,20200417,15493
20200415,1,서울역,15883,15392,20200418,31275
20200415,1,시청,5552,5528,20200418,11080
20200415,1,종각,11523,10517,20200418,22040
20200415,1,종로3가,15935,15039,20200418,30974
20200415,1,종로5가,12564,12677,20200418,25241
20200415,1,동대문,8164,8555,20200418,16719
20200415,1,신설동,6883,6472,20200418,13355
20200415,1,제기동,10535,10898,20200418,21433
20200415,1,청량리,12744,12774,20200418,25518
20200415,1,동묘앞,7305,7794,20200418,15099
20200416,1,시청,18629,18763,20200419,37392
20200416,1,종각,33052,32580,20200419,65632
20200416,1,종로3가,23911,22167,20200419,46078
20200416,1,종로5가,20563,20657,20200419,41220
20200416,1,동대문,10337,10163,20200419,20500
20200416,1,신설동,13088,12738,20200419,25826
20200416,1,제기동,15279,15768,20200419,31047
20200416,1,청량리,18740,18384,20200419,37124
20200416,1,동묘앞,7150,7567,20200419,14717
20200416,1,서울역,35605,34109,20200419,69714
20200417,1,서울역,37747,36293,20200420,74040
20200417,1,시청,18309,18472,20200420,36781
20200417,1,종각,33292,33373,20200420,66665
20200417,1,종로3가,22859,21948,20200420,44807
20200417,1,종로5가,19495,19752,20200420,39247
20200417,1,동대문,9851,9621,20200420,19472
20200417,1,신설동,12718,12277,20200420,24995
20200417,1,제기동,13560,13461,20200420,27021
20200417,1,청량리,17105,16972,20200420,34077
20200417,1,동묘앞,5473,5742,20200420,11215
20200418,1,서울역,20347,20007,20200421,40354
20200418,1,시청,6899,6707,20200421,13606
20200418,1,종각,14928,14294,20200421,29222
20200418,1,종로3가,18747,18311,20200421,37058
20200418,1,종로5가,14503,14837,20200421,29340
20200418,1,동대문,9279,9155,20200421,18434
20200418,1,신설동,8051,7588,20200421,15639
20200418,1,제기동,13286,13812,20200421,27098
20200418,1,청량리,16233,16232,20200421,32465
20200418,1,동묘앞,10164,10494,20200421,20658
20200419,1,서울역,16073,15162,20200422,31235
20200419,1,시청,4289,4141,20200422,8430
20200419,1,종각,8978,7976,20200422,16954
20200419,1,종로3가,9733,9034,20200422,18767
20200419,1,종로5가,6414,6177,20200422,12591
20200419,1,동대문,6102,6933,20200422,13035
20200419,1,신설동,5304,5480,20200422,10784
20200419,1,제기동,7057,7557,20200422,14614
20200419,1,청량리,10126,10070,20200422,20196
20200419,1,동묘앞,8571,8605,20200422,17176
20200420,1,서울역,37589,35472,20200423,73061
20200420,1,시청,19070,19466,20200423,38536
20200420,1,종각,34892,34114,20200423,69006
20200420,1,종로3가,23489,22444,20200423,45933
20200420,1,종로5가,21039,20833,20200423,41872
20200420,1,동대문,10140,10348,20200423,20488
20200420,1,신설동,13614,13619,20200423,27233
20200420,1,제기동,15384,15664,20200423,31048
20200420,1,청량리,18708,18493,20200423,37201
20200420,1,동묘앞,6433,6776,20200423,13209
20200421,1,서울역,37052,35001,20200424,72053
20200421,1,시청,19403,19591,20200424,38994
20200421,1,종각,35173,34511,20200424,69684
20200421,1,종로3가,23780,22726,20200424,46506
20200421,1,종로5가,21510,21136,20200424,42646
20200421,1,동대문,10384,10391,20200424,20775
20200421,1,신설동,13364,13406,20200424,26770
20200421,1,제기동,16452,16675,20200424,33127
20200421,1,청량리,19162,19222,20200424,38384
20200421,1,동묘앞,7211,7631,20200424,14842
20200422,1,서울역,36994,34911,20200425,71905
20200422,1,시청,19521,19736,20200425,39257
20200422,1,종각,35358,34479,20200425,69837
20200422,1,종로3가,23508,22413,20200425,45921
20200422,1,종로5가,20869,20665,20200425,41534
20200422,1,동대문,9972,10056,20200425,20028
20200422,1,신설동,13374,13272,20200425,26646
20200422,1,제기동,15263,15669,20200425,30932
20200422,1,청량리,18444,18444,20200425,36888
20200422,1,동묘앞,6957,7401,20200425,14358
20200423,1,서울역,37835,35886,20200426,73721
20200423,1,시청,19648,19915,20200426,39563
20200423,1,종각,36110,35100,20200426,71210
20200423,1,종로3가,24219,22839,20200426,47058
20200423,1,종로5가,21295,21297,20200426,42592
20200423,1,동대문,10446,10385,20200426,20831
20200423,1,신설동,13685,13570,20200426,27255
20200423,1,제기동,16314,16829,20200426,33143
20200423,1,청량리,19407,19121,20200426,38528
20200423,1,동묘앞,7605,7929,20200426,15534
20200424,1,시청,19650,19979,20200427,39629
20200424,1,종각,36630,36677,20200427,73307
20200424,1,종로3가,26096,25366,20200427,51462
20200424,1,종로5가,22007,22158,20200427,44165
20200424,1,동대문,10937,10933,20200427,21870
20200424,1,신설동,14305,13942,20200427,28247
20200424,1,제기동,17428,17741,20200427,35169
20200424,1,청량리,20545,20502,20200427,41047
20200424,1,동묘앞,7858,8191,20200427,16049
20200424,1,서울역,42256,39856,20200427,82112
20200425,1,서울역,23149,22675,20200428,45824
20200425,1,시청,7572,7489,20200428,15061
20200425,1,종각,17108,16119,20200428,33227
20200425,1,종로3가,19873,19604,20200428,39477
20200425,1,종로5가,15512,16021,20200428,31533
20200425,1,동대문,9770,9577,20200428,19347
20200425,1,신설동,8417,7776,20200428,16193
20200425,1,제기동,14223,14862,20200428,29085
20200425,1,청량리,17050,17003,20200428,34053
20200425,1,동묘앞,10479,11164,20200428,21643
20200426,1,서울역,17690,16629,20200429,34319
20200426,1,시청,5304,5080,20200429,10384
20200426,1,종각,11098,9666,20200429,20764
20200426,1,종로3가,12800,11769,20200429,24569
20200426,1,종로5가,7470,7393,20200429,14863
20200426,1,동대문,7969,9075,20200429,17044
20200426,1,신설동,6473,6419,20200429,12892
20200426,1,제기동,9555,9797,20200429,19352
20200426,1,청량리,12412,12295,20200429,24707
20200426,1,동묘앞,11892,12314,20200429,24206
20200427,1,서울역,39504,37592,20200430,77096
20200427,1,시청,20048,20358,20200430,40406
20200427,1,종각,35956,35448,20200430,71404
20200427,1,종로3가,25763,24041,20200430,49804
20200427,1,종로5가,22177,22377,20200430,44554
20200427,1,동대문,10986,11265,20200430,22251
20200427,1,신설동,13963,13849,20200430,27812
20200427,1,제기동,17785,18403,20200430,36188
20200427,1,청량리,20171,20278,20200430,40449
20200427,1,동묘앞,7681,8241,20200430,15922
20200428,1,서울역,40217,38527,20200501,78744
20200428,1,시청,20583,21010,20200501,41593
20200428,1,종각,37145,36283,20200501,73428
20200428,1,종로3가,25543,23869,20200501,49412
20200428,1,종로5가,22960,22991,20200501,45951
20200428,1,동대문,11310,11429,20200501,22739
20200428,1,신설동,13880,13811,20200501,27691
20200428,1,제기동,18233,18922,20200501,37155
20200428,1,청량리,20648,20476,20200501,41124
20200428,1,동묘앞,8056,8453,20200501,16509
20200429,1,서울역,44067,44758,20200502,88825
20200429,1,시청,21030,21234,20200502,42264
20200429,1,종각,38352,38096,20200502,76448
20200429,1,종로3가,27336,25752,20200502,53088
20200429,1,종로5가,23655,24109,20200502,47764
20200429,1,동대문,11660,11739,20200502,23399
20200429,1,신설동,14587,14327,20200502,28914
20200429,1,제기동,18245,18740,20200502,36985
20200429,1,청량리,21048,21010,20200502,42058
20200429,1,동묘앞,8213,8693,20200502,16906
20200430,1,시청,7208,6993,20200503,14201
20200430,1,종각,18589,18361,20200503,36950
20200430,1,종로3가,18218,17090,20200503,35308
20200430,1,종로5가,15193,15394,20200503,30587
20200430,1,동대문,10201,11086,20200503,21287
20200430,1,신설동,7604,7085,20200503,14689
20200430,1,제기동,13445,13874,20200503,27319
20200430,1,청량리,15733,15836,20200503,31569
20200430,1,동묘앞,9524,10064,20200503,19588
20200430,1,서울역,23002,27445,20200503,50447
20200501,1,동묘앞,8772,9589,20200504,18361
20200501,1,청량리,17059,17496,20200504,34555
20200501,1,제기동,14743,15200,20200504,29943
20200501,1,신설동,8901,8472,20200504,17373
20200501,1,동대문,11003,11647,20200504,22650
20200501,1,종로5가,18099,18160,20200504,36259
20200501,1,종로3가,20442,20029,20200504,40471
20200501,1,종각,18057,17459,20200504,35516
20200501,1,시청,8763,8287,20200504,17050
20200501,1,서울역,25838,26496,20200504,52334
20200502,1,서울역,25496,23653,20200505,49149
20200502,1,시청,7179,6895,20200505,14074
20200502,1,종각,15088,14638,20200505,29726
20200502,1,종로3가,18601,17832,20200505,36433
20200502,1,종로5가,14737,14964,20200505,29701
20200502,1,동대문,10189,10335,20200505,20524
20200502,1,신설동,8163,7819,20200505,15982
20200502,1,제기동,13118,13607,20200505,26725
20200502,1,청량리,16216,16016,20200505,32232
20200502,1,동묘앞,10281,10987,20200505,21268
20200503,1,종각,10987,9900,20200506,20887
20200503,1,서울역,24008,19192,20200506,43200
20200503,1,동묘앞,11274,11500,20200506,22774
20200503,1,청량리,12325,12361,20200506,24686
20200503,1,제기동,8686,9230,20200506,17916
20200503,1,신설동,6189,6475,20200506,12664
20200503,1,동대문,8619,9958,20200506,18577
20200503,1,종로5가,7578,7751,20200506,15329
20200503,1,종로3가,13107,11933,20200506,25040
20200503,1,시청,5310,5076,20200506,10386
20200504,1,서울역,36295,32641,20200507,68936
20200504,1,시청,16066,16227,20200507,32293
20200504,1,종각,28972,28827,20200507,57799
20200504,1,종로3가,25708,24861,20200507,50569
20200504,1,종로5가,21289,21855,20200507,43144
20200504,1,동대문,11861,12485,20200507,24346
20200504,1,신설동,12416,12460,20200507,24876
20200504,1,제기동,16763,17211,20200507,33974
20200504,1,청량리,19641,19336,20200507,38977
20200504,1,동묘앞,7960,8466,20200507,16426
20200505,1,서울역,21939,18331,20200508,40270
20200505,1,시청,6019,5812,20200508,11831
20200505,1,종각,13089,11803,20200508,24892
20200505,1,종로3가,15373,14093,20200508,29466
20200505,1,종로5가,13086,13430,20200508,26516
20200505,1,동대문,9821,10686,20200508,20507
20200505,1,신설동,6776,6550,20200508,13326
20200505,1,제기동,11701,12320,20200508,24021
20200505,1,청량리,13909,14154,20200508,28063
20200505,1,동묘앞,8360,8856,20200508,17216
20200506,1,동묘앞,8230,8753,20200509,16983
20200506,1,청량리,20838,20599,20200509,41437
20200506,1,제기동,17892,18512,20200509,36404
20200506,1,신설동,14561,14673,20200509,29234
20200506,1,동대문,11805,12213,20200509,24018
20200506,1,종로5가,23802,23508,20200509,47310
20200506,1,종로3가,27916,26078,20200509,53994
20200506,1,종각,37886,36946,20200509,74832
20200506,1,시청,20933,21433,20200509,42366
20200506,1,서울역,42266,39805,20200509,82071
20200507,1,서울역,43100,41078,20200510,84178
20200507,1,시청,21533,21630,20200510,43163
20200507,1,종각,38376,37759,20200510,76135
20200507,1,종로3가,28502,26564,20200510,55066
20200507,1,종로5가,23718,24031,20200510,47749
20200507,1,동대문,11900,11906,20200510,23806
20200507,1,신설동,14724,14620,20200510,29344
20200507,1,제기동,18321,18675,20200510,36996
20200507,1,청량리,21271,21105,20200510,42376
20200507,1,동묘앞,8142,8769,20200510,16911
20200508,1,서울역,49277,47873,20200511,97150
20200508,1,시청,22254,21261,20200511,43515
20200508,1,종각,39591,37368,20200511,76959
20200508,1,종로3가,27185,25429,20200511,52614
20200508,1,종로5가,23928,23279,20200511,47207
20200508,1,동대문,11886,12054,20200511,23940
20200508,1,신설동,15018,14728,20200511,29746
20200508,1,제기동,17676,18098,20200511,35774
20200508,1,청량리,21448,21915,20200511,43363
20200508,1,동묘앞,8297,8713,20200511,17010
20200509,1,서울역,25030,24042,20200512,49072
20200509,1,동묘앞,4734,4908,20200512,9642
20200509,1,청량리,13746,13908,20200512,27654
20200509,1,제기동,10598,10616,20200512,21214
20200509,1,신설동,7501,6976,20200512,14477
20200509,1,동대문,8755,8310,20200512,17065
20200509,1,종로5가,14350,14696,20200512,29046
20200509,1,종로3가,17066,16689,20200512,33755
20200509,1,종각,15364,15380,20200512,30744
20200509,1,시청,7087,7205,20200512,14292
20200510,1,서울역,22350,19383,20200513,41733
20200510,1,시청,5581,5294,20200513,10875
20200510,1,종각,11252,10025,20200513,21277
20200510,1,종로3가,12897,11965,20200513,24862
20200510,1,종로5가,7421,7758,20200513,15179
20200510,1,동대문,8235,9438,20200513,17673
20200510,1,신설동,6488,6446,20200513,12934
20200510,1,제기동,9022,9445,20200513,18467
20200510,1,청량리,13016,13067,20200513,26083
20200510,1,동묘앞,10741,11042,20200513,21783
20200511,1,서울역,41370,39268,20200514,80638
20200511,1,시청,20507,20787,20200514,41294
20200511,1,종각,37592,36372,20200514,73964
20200511,1,종로3가,26489,24861,20200514,51350
20200511,1,종로5가,22905,23001,20200514,45906
20200511,1,동대문,11437,11711,20200514,23148
20200511,1,신설동,14484,14550,20200514,29034
20200511,1,제기동,17199,17575,20200514,34774
20200511,1,청량리,20653,20391,20200514,41044
20200511,1,동묘앞,7707,8215,20200514,15922
20200512,1,서울역,39430,37614,20200515,77044
20200512,1,시청,20886,21063,20200515,41949
20200512,1,종각,36803,35893,20200515,72696
20200512,1,종로3가,26040,24254,20200515,50294
20200512,1,종로5가,22232,22390,20200515,44622
20200512,1,동대문,11286,11329,20200515,22615
20200512,1,신설동,13955,13748,20200515,27703
20200512,1,제기동,16258,16739,20200515,32997
20200512,1,청량리,19787,19645,20200515,39432
20200512,1,동묘앞,7555,8124,20200515,15679
20200513,1,서울역,39413,37208,20200516,76621
20200513,1,시청,20966,21342,20200516,42308
20200513,1,종각,37329,36498,20200516,73827
20200513,1,종로3가,26392,24524,20200516,50916
20200513,1,종로5가,22617,22659,20200516,45276
20200513,1,동대문,11323,11373,20200516,22696
20200513,1,신설동,14472,14233,20200516,28705
20200513,1,제기동,16856,17198,20200516,34054
20200513,1,청량리,20301,20185,20200516,40486
20200513,1,동묘앞,8074,8485,20200516,16559
20200514,1,동묘앞,7825,8149,20200517,15974
20200514,1,청량리,20043,19579,20200517,39622
20200514,1,제기동,16274,16879,20200517,33153
20200514,1,신설동,14221,14396,20200517,28617
20200514,1,동대문,11147,11223,20200517,22370
20200514,1,종로5가,22776,22669,20200517,45445
20200514,1,종로3가,25863,24089,20200517,49952
20200514,1,종각,36559,35919,20200517,72478
20200514,1,시청,20789,21013,20200517,41802
20200514,1,서울역,40530,38263,20200517,78793
20200515,1,동묘앞,5544,5968,20200518,11512
20200515,1,청량리,18127,18108,20200518,36235
20200515,1,제기동,14183,14119,20200518,28302
20200515,1,신설동,13604,13546,20200518,27150
20200515,1,동대문,10440,10440,20200518,20880
20200515,1,종로5가,21901,21772,20200518,43673
20200515,1,종로3가,24040,22866,20200518,46906
20200515,1,종각,37670,36572,20200518,74242
20200515,1,시청,20387,20444,20200518,40831
20200515,1,서울역,43915,41585,20200518,85500
20200516,1,종로5가,15606,15994,20200519,31600
20200516,1,동대문,9905,9651,20200519,19556
20200516,1,신설동,8609,8512,20200519,17121
20200516,1,제기동,13201,13290,20200519,26491
20200516,1,청량리,16476,16599,20200519,33075
20200516,1,동묘앞,8860,9355,20200519,18215
20200516,1,시청,7956,7980,20200519,15936
20200516,1,서울역,23775,23464,20200519,47239
20200516,1,종각,15885,15704,20200519,31589
20200516,1,종로3가,19205,18212,20200519,37417
20200517,1,동묘앞,11262,11709,20200520,22971
20200517,1,청량리,12456,12492,20200520,24948
20200517,1,제기동,8559,8904,20200520,17463
20200517,1,신설동,6657,6642,20200520,13299
20200517,1,동대문,8081,9076,20200520,17157
20200517,1,종로5가,7404,7679,20200520,15083
20200517,1,종로3가,12276,11214,20200520,23490
20200517,1,종각,10506,9625,20200520,20131
20200517,1,시청,5501,5326,20200520,10827
20200517,1,서울역,20277,18612,20200520,38889
20200518,1,동묘앞,6465,6808,20200521,13273
20200518,1,청량리,18942,18821,20200521,37763
20200518,1,제기동,15530,15858,20200521,31388
20200518,1,신설동,13691,13934,20200521,27625
20200518,1,동대문,10585,10858,20200521,21443
20200518,1,종로5가,22452,21937,20200521,44389
20200518,1,종로3가,24218,22841,20200521,47059
20200518,1,종각,37285,35494,20200521,72779
20200518,1,시청,20192,20151,20200521,40343
20200518,1,서울역,39190,36958,20200521,76148
20200519,1,시청,20687,20858,20200522,41545
20200519,1,종각,36898,36245,20200522,73143
20200519,1,종로3가,25095,23466,20200522,48561
20200519,1,종로5가,21662,22028,20200522,43690
20200519,1,동대문,10801,10654,20200522,21455
20200519,1,신설동,13912,13584,20200522,27496
20200519,1,제기동,15048,15180,20200522,30228
20200519,1,청량리,18553,18439,20200522,36992
20200519,1,동묘앞,6449,6761,20200522,13210
20200519,1,서울역,38820,36762,20200522,75582
20200520,1,동묘앞,8543,8941,20200523,17484
20200520,1,청량리,21239,21180,20200523,42419
20200520,1,제기동,17674,18272,20200523,35946
20200520,1,신설동,14894,14811,20200523,29705
20200520,1,동대문,11821,11924,20200523,23745
20200520,1,종로5가,23819,23953,20200523,47772
20200520,1,종로3가,27419,25744,20200523,53163
20200520,1,종각,38362,37547,20200523,75909
20200520,1,시청,21381,21659,20200523,43040
20200520,1,서울역,40860,38438,20200523,79298
20200521,1,동묘앞,8583,9057,20200524,17640
20200521,1,청량리,21118,21014,20200524,42132
20200521,1,제기동,17342,17923,20200524,35265
20200521,1,신설동,14699,14582,20200524,29281
20200521,1,동대문,11521,11949,20200524,23470
20200521,1,종로5가,23925,23827,20200524,47752
20200521,1,종로3가,27638,25508,20200524,53146
20200521,1,종각,37482,37261,20200524,74743
20200521,1,시청,21269,21685,20200524,42954
20200521,1,서울역,42564,39660,20200524,82224
20200522,1,서울역,46242,44092,20200525,90334
20200522,1,시청,21313,21718,20200525,43031
20200522,1,종각,38474,38002,20200525,76476
20200522,1,종로3가,27683,26125,20200525,53808
20200522,1,종로5가,24004,24205,20200525,48209
20200522,1,동대문,11753,12081,20200525,23834
20200522,1,신설동,15248,15270,20200525,30518
20200522,1,제기동,17369,17873,20200525,35242
20200522,1,청량리,21906,21864,20200525,43770
20200522,1,동묘앞,8475,8827,20200525,17302
20200523,1,서울역,27017,27040,20200526,54057
20200523,1,시청,8901,8728,20200526,17629
20200523,1,종각,19284,18237,20200526,37521
20200523,1,종로3가,22048,21394,20200526,43442
20200523,1,종로5가,17789,18203,20200526,35992
20200523,1,동대문,10998,11013,20200526,22011
20200523,1,신설동,9893,9633,20200526,19526
20200523,1,제기동,14790,15307,20200526,30097
20200523,1,청량리,18602,18732,20200526,37334
20200523,1,동묘앞,11278,11921,20200526,23199
20200524,1,동묘앞,9470,9753,20200527,19223
20200524,1,청량리,12324,12144,20200527,24468
20200524,1,제기동,7958,8198,20200527,16156
20200524,1,신설동,6397,6412,20200527,12809
20200524,1,동대문,7455,8628,20200527,16083
20200524,1,종로5가,7306,7634,20200527,14940
20200524,1,종로3가,12493,11569,20200527,24062
20200524,1,종각,11006,10013,20200527,21019
20200524,1,시청,5517,5497,20200527,11014
20200524,1,서울역,20504,18477,20200527,38981
20200525,1,서울역,43040,40236,20200528,83276
20200525,1,시청,20946,21123,20200528,42069
20200525,1,종각,38459,37669,20200528,76128
20200525,1,종로3가,27175,25227,20200528,52402
20200525,1,종로5가,23631,23914,20200528,47545
20200525,1,동대문,11672,12037,20200528,23709
20200525,1,신설동,14939,14959,20200528,29898
20200525,1,제기동,17572,17990,20200528,35562
20200525,1,청량리,21408,21401,20200528,42809
20200525,1,동묘앞,8080,8492,20200528,16572
20200526,1,동묘앞,8017,8332,20200529,16349
20200526,1,청량리,20899,20851,20200529,41750
20200526,1,제기동,17099,17419,20200529,34518
20200526,1,신설동,14541,14480,20200529,29021
20200526,1,동대문,11331,11834,20200529,23165
20200526,1,종로5가,24115,23733,20200529,47848
20200526,1,종로3가,26110,24711,20200529,50821
20200526,1,종각,38510,37555,20200529,76065
20200526,1,시청,21915,21883,20200529,43798
20200526,1,서울역,41694,40649,20200529,82343
20200527,1,서울역,42475,40455,20200530,82930
20200527,1,동묘앞,8952,9351,20200530,18303
20200527,1,청량리,21374,21237,20200530,42611
20200527,1,제기동,17380,17729,20200530,35109
20200527,1,신설동,15130,15140,20200530,30270
20200527,1,동대문,11787,12026,20200530,23813
20200527,1,종로5가,23809,23957,20200530,47766
20200527,1,종로3가,27286,25544,20200530,52830
20200527,1,종각,39220,38311,20200530,77531
20200527,1,시청,21926,22165,20200530,44091
20200528,1,동묘앞,8419,8881,20200531,17300
20200528,1,청량리,20942,20601,20200531,41543
20200528,1,제기동,16721,17275,20200531,33996
20200528,1,신설동,15046,14848,20200531,29894
20200528,1,동대문,11472,11596,20200531,23068
20200528,1,종로5가,23269,23234,20200531,46503
20200528,1,종로3가,26998,24788,20200531,51786
20200528,1,종각,37818,37738,20200531,75556
20200528,1,시청,21903,22011,20200531,43914
20200528,1,서울역,42935,40484,20200531,83419
20200529,1,서울역,46528,44965,20200601,91493
20200529,1,시청,21280,21503,20200601,42783
20200529,1,종각,38871,38902,20200601,77773
20200529,1,종로3가,27430,25671,20200601,53101
20200529,1,종로5가,23590,23565,20200601,47155
20200529,1,동대문,11925,12261,20200601,24186
20200529,1,신설동,15252,15071,20200601,30323
20200529,1,제기동,16695,16930,20200601,33625
20200529,1,청량리,21249,21166,20200601,42415
20200529,1,동묘앞,8540,8902,20200601,17442
20200530,1,서울역,24739,25452,20200602,50191
20200530,1,시청,7978,7916,20200602,15894
20200530,1,종각,18527,18225,20200602,36752
20200530,1,종로3가,20409,19684,20200602,40093
20200530,1,종로5가,16686,16865,20200602,33551
20200530,1,동대문,10379,10212,20200602,20591
20200530,1,신설동,9056,8645,20200602,17701
20200530,1,제기동,13527,13866,20200602,27393
20200530,1,청량리,16930,17063,20200602,33993
20200530,1,동묘앞,10485,10908,20200602,21393
20200531,1,서울역,20520,18555,20200603,39075
20200531,1,시청,5187,5064,20200603,10251
20200531,1,종각,10737,9817,20200603,20554
20200531,1,종로3가,12150,10944,20200603,23094
20200531,1,종로5가,7140,7672,20200603,14812
20200531,1,동대문,8259,9366,20200603,17625
20200531,1,신설동,6634,6785,20200603,13419
20200531,1,제기동,8212,8659,20200603,16871
20200531,1,청량리,12035,12083,20200603,24118
20200531,1,동묘앞,11228,11336,20200603,22564
20200101,2,용두,1130,1156,20200104,2286
20200101,2,신정네거리,4384,4549,20200104,8933
20200101,2,양천구청,2766,2916,20200104,5682
20200101,2,도림천,347,380,20200104,727
20200101,2,신설동,2161,1988,20200104,4149
20200101,2,신답,605,710,20200104,1315
20200101,2,용답,1548,1643,20200104,3191
20200101,2,충정로,3886,3739,20200104,7625
20200101,2,아현,4475,4575,20200104,9050
20200101,2,이대,8803,9724,20200104,18527
20200101,2,신촌,25420,23862,20200104,49282
20200101,2,홍대입구,69202,61962,20200104,131164
20200101,2,합정,16947,16707,20200104,33654
20200101,2,당산,7613,8759,20200104,16372
20200101,2,영등포구청,6594,6644,20200104,13238
20200101,2,문래,5998,6303,20200104,12301
20200101,2,신도림,26096,26716,20200104,52812
20200101,2,대림,16429,17443,20200104,33872
20200101,2,구로디지털단지,25130,25859,20200104,50989
20200101,2,신대방,14808,14965,20200104,29773
20200101,2,신림,36826,37845,20200104,74671
20200101,2,봉천,11289,11536,20200104,22825
20200101,2,서울대입구,23793,25781,20200104,49574
20200101,2,낙성대,13222,14468,20200104,27690
20200101,2,사당,18983,20297,20200104,39280
20200101,2,방배,5397,5875,20200104,11272
20200101,2,서초,4819,4304,20200104,9123
20200101,2,교대,9262,10245,20200104,19507
20200101,2,강남,39231,36768,20200104,75999
20200101,2,역삼,10755,10997,20200104,21752
20200101,2,선릉,11749,9965,20200104,21714
20200101,2,삼성,25168,23880,20200104,49048
20200101,2,종합운동장,4585,4599,20200104,9184
20200101,2,잠실새내,11199,11150,20200104,22349
20200101,2,잠실,53799,48425,20200104,102224
20200101,2,잠실나루,5165,5247,20200104,10412
20200101,2,강변,26220,25509,20200104,51729
20200101,2,구의,10741,10802,20200104,21543
20200101,2,건대입구,29289,29008,20200104,58297
20200101,2,성수,9037,9685,20200104,18722
20200101,2,뚝섬,5904,6277,20200104,12181
20200101,2,한양대,2367,2567,20200104,4934
20200101,2,왕십리,9553,8463,20200104,18016
20200101,2,상왕십리,5947,6058,20200104,12005
20200101,2,신당,7007,7796,20200104,14803
20200101,2,동대문역사문화공원,12705,13550,20200104,26255
20200101,2,을지로4가,4055,4033,20200104,8088
20200101,2,을지로3가,8612,8672,20200104,17284
20200101,2,을지로입구,29241,27367,20200104,56608
20200101,2,시청,8725,5943,20200104,14668
20200102,2,시청,30321,28535,20200105,58856
20200102,2,을지로입구,57339,57431,20200105,114770
20200102,2,을지로3가,26307,26176,20200105,52483
20200102,2,을지로4가,15313,15329,20200105,30642
20200102,2,동대문역사문화공원,18148,21538,20200105,39686
20200102,2,신당,15257,16169,20200105,31426
20200102,2,상왕십리,15605,15076,20200105,30681
20200102,2,왕십리,18767,16132,20200105,34899
20200102,2,한양대,9559,10642,20200105,20201
20200102,2,뚝섬,21438,22905,20200105,44343
20200102,2,성수,34838,37434,20200105,72272
20200102,2,건대입구,42864,46534,20200105,89398
20200102,2,구의,26471,25974,20200105,52445
20200102,2,강변,43710,40991,20200105,84701
20200102,2,잠실나루,17760,17256,20200105,35016
20200102,2,잠실,88601,86659,20200105,175260
20200102,2,잠실새내,25556,25618,20200105,51174
20200102,2,종합운동장,8808,9665,20200105,18473
20200102,2,삼성,63899,65186,20200105,129085
20200102,2,선릉,63911,57187,20200105,121098
20200102,2,역삼,57076,63435,20200105,120511
20200102,2,강남,115263,116820,20200105,232083
20200102,2,교대,40243,45591,20200105,85834
20200102,2,서초,23609,23790,20200105,47399
20200102,2,방배,19816,20496,20200105,40312
20200102,2,사당,41886,46697,20200105,88583
20200102,2,낙성대,30496,30124,20200105,60620
20200102,2,서울대입구,53566,53026,20200105,106592
20200102,2,봉천,26795,25145,20200105,51940
20200102,2,신림,72865,71278,20200105,144143
20200102,2,신대방,30009,28633,20200105,58642
20200102,2,구로디지털단지,71079,70880,20200105,141959
20200102,2,대림,29634,30196,20200105,59830
20200102,2,신도림,59576,58568,20200105,118144
20200102,2,문래,23549,23762,20200105,47311
20200102,2,영등포구청,25302,25568,20200105,50870
20200102,2,당산,21800,24982,20200105,46782
20200102,2,합정,34624,35979,20200105,70603
20200102,2,홍대입구,79840,85293,20200105,165133
20200102,2,신촌,47377,49261,20200105,96638
20200102,2,이대,17063,18422,20200105,35485
20200102,2,아현,10928,10658,20200105,21586
20200102,2,충정로,11844,12320,20200105,24164
20200102,2,용답,2730,2689,20200105,5419
20200102,2,신답,1696,1932,20200105,3628
20200102,2,신설동,3845,3804,20200105,7649
20200102,2,도림천,1323,1523,20200105,2846
20200102,2,양천구청,7866,8200,20200105,16066
20200102,2,신정네거리,10580,10827,20200105,21407
20200102,2,용두,2551,2673,20200105,5224
20200103,2,시청,31852,30071,20200106,61923
20200103,2,을지로입구,60498,60824,20200106,121322
20200103,2,을지로3가,27164,27684,20200106,54848
20200103,2,을지로4가,16303,16133,20200106,32436
20200103,2,동대문역사문화공원,19438,22961,20200106,42399
20200103,2,신당,16262,16803,20200106,33065
20200103,2,상왕십리,16551,15716,20200106,32267
20200103,2,왕십리,21008,18171,20200106,39179
20200103,2,한양대,10065,10801,20200106,20866
20200103,2,뚝섬,22462,23637,20200106,46099
20200103,2,성수,36162,39585,20200106,75747
20200103,2,건대입구,47496,54406,20200106,101902
20200103,2,구의,27871,26827,20200106,54698
20200103,2,강변,47485,46480,20200106,93965
20200103,2,잠실나루,18754,17947,20200106,36701
20200103,2,잠실,95193,92634,20200106,187827
20200103,2,잠실새내,27882,28393,20200106,56275
20200103,2,종합운동장,9904,10994,20200106,20898
20200103,2,삼성,71064,71867,20200106,142931
20200103,2,선릉,66502,59573,20200106,126075
20200103,2,역삼,59087,66668,20200106,125755
20200103,2,강남,126036,132511,20200106,258547
20200103,2,교대,41435,47168,20200106,88603
20200103,2,서초,24409,24276,20200106,48685
20200103,2,방배,20889,21244,20200106,42133
20200103,2,사당,48252,53045,20200106,101297
20200103,2,낙성대,32861,30836,20200106,63697
20200103,2,서울대입구,58647,55953,20200106,114600
20200103,2,봉천,28360,25802,20200106,54162
20200103,2,신림,76792,74880,20200106,151672
20200103,2,신대방,31384,29424,20200106,60808
20200103,2,구로디지털단지,73974,74596,20200106,148570
20200103,2,대림,31028,31363,20200106,62391
20200103,2,신도림,62801,62386,20200106,125187
20200103,2,문래,24430,24936,20200106,49366
20200103,2,영등포구청,26703,27070,20200106,53773
20200103,2,당산,23616,26876,20200106,50492
20200103,2,합정,38511,41981,20200106,80492
20200103,2,홍대입구,89087,99670,20200106,188757
20200103,2,신촌,51847,53776,20200106,105623
20200103,2,이대,18750,19345,20200106,38095
20200103,2,아현,12051,11359,20200106,23410
20200103,2,충정로,12217,12779,20200106,24996
20200103,2,용답,2996,2968,20200106,5964
20200103,2,신답,1859,2068,20200106,3927
20200103,2,신설동,4585,4589,20200106,9174
20200103,2,도림천,1376,1452,20200106,2828
20200103,2,양천구청,8245,8577,20200106,16822
20200103,2,신정네거리,10915,11318,20200106,22233
20200103,2,용두,2710,2803,20200106,5513
20200104,2,시청,13824,11463,20200107,25287
20200104,2,을지로입구,39435,38072,20200107,77507
20200104,2,을지로3가,13929,13706,20200107,27635
20200104,2,을지로4가,10390,10581,20200107,20971
20200104,2,동대문역사문화공원,15562,17194,20200107,32756
20200104,2,신당,12282,13130,20200107,25412
20200104,2,상왕십리,10909,10135,20200107,21044
20200104,2,왕십리,16356,14475,20200107,30831
20200104,2,한양대,5302,5392,20200107,10694
20200104,2,뚝섬,12705,12880,20200107,25585
20200104,2,성수,16731,18223,20200107,34954
20200104,2,건대입구,43701,49696,20200107,93397
20200104,2,구의,18989,17942,20200107,36931
20200104,2,강변,41804,40949,20200107,82753
20200104,2,잠실나루,9862,9510,20200107,19372
20200104,2,잠실,81999,77313,20200107,159312
20200104,2,잠실새내,20706,21959,20200107,42665
20200104,2,종합운동장,8787,9524,20200107,18311
20200104,2,삼성,45421,45965,20200107,91386
20200104,2,선릉,30318,27003,20200107,57321
20200104,2,역삼,22999,24662,20200107,47661
20200104,2,강남,87333,93257,20200107,180590
20200104,2,교대,22148,25326,20200107,47474
20200104,2,서초,13931,12945,20200107,26876
20200104,2,방배,12266,12551,20200107,24817
20200104,2,사당,39197,42750,20200107,81947
20200104,2,낙성대,24473,22402,20200107,46875
20200104,2,서울대입구,43847,42868,20200107,86715
20200104,2,봉천,20304,18491,20200107,38795
20200104,2,신림,60576,58649,20200107,119225
20200104,2,신대방,22971,21815,20200107,44786
20200104,2,구로디지털단지,44203,43499,20200107,87702
20200104,2,대림,23421,24746,20200107,48167
20200104,2,신도림,54259,54953,20200107,109212
20200104,2,문래,12699,13012,20200107,25711
20200104,2,영등포구청,14544,14770,20200107,29314
20200104,2,당산,15038,16330,20200107,31368
20200104,2,합정,31544,34922,20200107,66466
20200104,2,홍대입구,90634,102811,20200107,193445
20200104,2,신촌,44931,46748,20200107,91679
20200104,2,이대,14489,14887,20200107,29376
20200104,2,아현,8452,7894,20200107,16346
20200104,2,충정로,7232,7460,20200107,14692
20200104,2,용답,2251,2108,20200107,4359
20200104,2,신답,1201,1237,20200107,2438
20200104,2,신설동,4569,4221,20200107,8790
20200104,2,도림천,888,913,20200107,1801
20200104,2,양천구청,5414,5292,20200107,10706
20200104,2,신정네거리,8245,8304,20200107,16549
20200104,2,용두,1987,1996,20200107,3983
20200105,2,시청,8651,7108,20200108,15759
20200105,2,을지로입구,29442,27887,20200108,57329
20200105,2,을지로3가,10926,10811,20200108,21737
20200105,2,을지로4가,4583,4497,20200108,9080
20200105,2,동대문역사문화공원,12109,14645,20200108,26754
20200105,2,신당,9440,10098,20200108,19538
20200105,2,상왕십리,7662,7476,20200108,15138
20200105,2,왕십리,11529,10287,20200108,21816
20200105,2,한양대,3074,3483,20200108,6557
20200105,2,뚝섬,9804,9852,20200108,19656
20200105,2,성수,11150,11912,20200108,23062
20200105,2,건대입구,33806,35508,20200108,69314
20200105,2,구의,13278,13009,20200108,26287
20200105,2,강변,31835,32681,20200108,64516
20200105,2,잠실나루,7041,7200,20200108,14241
20200105,2,잠실,59763,55702,20200108,115465
20200105,2,잠실새내,13524,14285,20200108,27809
20200105,2,종합운동장,7404,8002,20200108,15406
20200105,2,삼성,31830,31633,20200108,63463
20200105,2,선릉,15439,13520,20200108,28959
20200105,2,역삼,13941,14846,20200108,28787
20200105,2,강남,52620,51683,20200108,104303
20200105,2,교대,13379,14819,20200108,28198
20200105,2,서초,15678,14749,20200108,30427
20200105,2,방배,8666,9059,20200108,17725
20200105,2,사당,26437,28988,20200108,55425
20200105,2,낙성대,17759,18341,20200108,36100
20200105,2,서울대입구,31948,32777,20200108,64725
20200105,2,봉천,14416,13872,20200108,28288
20200105,2,신림,45798,45068,20200108,90866
20200105,2,신대방,18559,17978,20200108,36537
20200105,2,구로디지털단지,31980,31694,20200108,63674
20200105,2,대림,21292,21602,20200108,42894
20200105,2,신도림,37315,37526,20200108,74841
20200105,2,문래,8454,8563,20200108,17017
20200105,2,영등포구청,9278,9467,20200108,18745
20200105,2,당산,10306,11193,20200108,21499
20200105,2,합정,23597,24079,20200108,47676
20200105,2,홍대입구,70489,70084,20200108,140573
20200105,2,신촌,31549,30672,20200108,62221
20200105,2,이대,10211,10841,20200108,21052
20200105,2,아현,5879,5932,20200108,11811
20200105,2,충정로,4646,4678,20200108,9324
20200105,2,용답,1916,1919,20200108,3835
20200105,2,신답,806,898,20200108,1704
20200105,2,신설동,4066,3845,20200108,7911
20200105,2,도림천,496,501,20200108,997
20200105,2,양천구청,3870,4076,20200108,7946
20200105,2,신정네거리,5642,5707,20200108,11349
20200105,2,용두,1267,1284,20200108,2551
20200106,2,시청,30576,29093,20200109,59669
20200106,2,을지로입구,56171,56874,20200109,113045
20200106,2,을지로3가,27132,26820,20200109,53952
20200106,2,을지로4가,15634,15179,20200109,30813
20200106,2,동대문역사문화공원,16842,19284,20200109,36126
20200106,2,신당,15536,16263,20200109,31799
20200106,2,상왕십리,16003,15544,20200109,31547
20200106,2,왕십리,19616,16235,20200109,35851
20200106,2,한양대,10065,10798,20200109,20863
20200106,2,뚝섬,21682,23225,20200109,44907
20200106,2,성수,36425,38817,20200109,75242
20200106,2,건대입구,42349,45455,20200109,87804
20200106,2,구의,27220,26736,20200109,53956
20200106,2,강변,43269,41583,20200109,84852
20200106,2,잠실나루,18425,18365,20200109,36790
20200106,2,잠실,85090,83547,20200109,168637
20200106,2,잠실새내,26034,25805,20200109,51839
20200106,2,종합운동장,8675,10637,20200109,19312
20200106,2,삼성,64505,65417,20200109,129922
20200106,2,선릉,69055,61369,20200109,130424
20200106,2,역삼,62638,68667,20200109,131305
20200106,2,강남,117522,118454,20200109,235976
20200106,2,교대,41450,47500,20200109,88950
20200106,2,서초,25838,25414,20200109,51252
20200106,2,방배,20893,21671,20200109,42564
20200106,2,사당,43383,48242,20200109,91625
20200106,2,낙성대,31248,30857,20200109,62105
20200106,2,서울대입구,56410,54788,20200109,111198
20200106,2,봉천,27731,25937,20200109,53668
20200106,2,신림,72858,71297,20200109,144155
20200106,2,신대방,30745,29434,20200109,60179
20200106,2,구로디지털단지,72750,72692,20200109,145442
20200106,2,대림,30341,31058,20200109,61399
20200106,2,신도림,61303,59841,20200109,121144
20200106,2,문래,24396,24678,20200109,49074
20200106,2,영등포구청,26545,26581,20200109,53126
20200106,2,당산,22038,25545,20200109,47583
20200106,2,합정,34051,35234,20200109,69285
20200106,2,홍대입구,71697,75177,20200109,146874
20200106,2,신촌,47260,48524,20200109,95784
20200106,2,이대,17573,18640,20200109,36213
20200106,2,아현,11015,10871,20200109,21886
20200106,2,충정로,12189,13038,20200109,25227
20200106,2,용답,2810,2900,20200109,5710
20200106,2,신답,1792,2025,20200109,3817
20200106,2,신설동,4116,4012,20200109,8128
20200106,2,도림천,1406,1558,20200109,2964
20200106,2,양천구청,8096,8688,20200109,16784
20200106,2,신정네거리,10739,11084,20200109,21823
20200106,2,용두,2670,2895,20200109,5565
20200107,2,시청,30647,29322,20200110,59969
20200107,2,을지로입구,56020,56195,20200110,112215
20200107,2,을지로3가,26809,25979,20200110,52788
20200107,2,을지로4가,14987,14441,20200110,29428
20200107,2,동대문역사문화공원,16222,18829,20200110,35051
20200107,2,신당,15025,15754,20200110,30779
20200107,2,상왕십리,15752,15295,20200110,31047
20200107,2,왕십리,19087,15781,20200110,34868
20200107,2,한양대,10179,10770,20200110,20949
20200107,2,뚝섬,21862,23035,20200110,44897
20200107,2,성수,35634,38346,20200110,73980
20200107,2,건대입구,40892,44346,20200110,85238
20200107,2,구의,26649,26102,20200110,52751
20200107,2,강변,39683,38522,20200110,78205
20200107,2,잠실나루,18317,17846,20200110,36163
20200107,2,잠실,83156,82477,20200110,165633
20200107,2,잠실새내,25645,25573,20200110,51218
20200107,2,종합운동장,9012,9665,20200110,18677
20200107,2,삼성,67197,67710,20200110,134907
20200107,2,선릉,68443,60518,20200110,128961
20200107,2,역삼,63812,69366,20200110,133178
20200107,2,강남,115832,116538,20200110,232370
20200107,2,교대,41769,47369,20200110,89138
20200107,2,서초,25573,25010,20200110,50583
20200107,2,방배,20211,20977,20200110,41188
20200107,2,사당,44077,47887,20200110,91964
20200107,2,낙성대,31169,30458,20200110,61627
20200107,2,서울대입구,54754,52963,20200110,107717
20200107,2,봉천,27393,25583,20200110,52976
20200107,2,신림,71503,70124,20200110,141627
20200107,2,신대방,29871,28533,20200110,58404
20200107,2,구로디지털단지,71028,71465,20200110,142493
20200107,2,대림,28769,29191,20200110,57960
20200107,2,신도림,59593,58223,20200110,117816
20200107,2,문래,24430,24600,20200110,49030
20200107,2,영등포구청,26070,25971,20200110,52041
20200107,2,당산,21565,25128,20200110,46693
20200107,2,합정,33994,35248,20200110,69242
20200107,2,홍대입구,68312,71304,20200110,139616
20200107,2,신촌,46154,47407,20200110,93561
20200107,2,이대,16961,17714,20200110,34675
20200107,2,아현,11175,10835,20200110,22010
20200107,2,충정로,12230,12849,20200110,25079
20200107,2,용답,2767,2768,20200110,5535
20200107,2,신답,1749,2025,20200110,3774
20200107,2,신설동,3937,3948,20200110,7885
20200107,2,도림천,1458,1558,20200110,3016
20200107,2,양천구청,7936,8446,20200110,16382
20200107,2,신정네거리,10433,10843,20200110,21276
20200107,2,용두,2500,2609,20200110,5109
20200108,2,시청,31018,29845,20200111,60863
20200108,2,을지로입구,57372,57951,20200111,115323
20200108,2,을지로3가,27740,27798,20200111,55538
20200108,2,을지로4가,15828,15605,20200111,31433
20200108,2,동대문역사문화공원,18134,20887,20200111,39021
20200108,2,신당,16208,16917,20200111,33125
20200108,2,상왕십리,16479,15859,20200111,32338
20200108,2,왕십리,20477,17177,20200111,37654
20200108,2,한양대,10782,11422,20200111,22204
20200108,2,뚝섬,22611,24126,20200111,46737
20200108,2,성수,36917,40124,20200111,77041
20200108,2,건대입구,44207,47911,20200111,92118
20200108,2,구의,27753,26896,20200111,54649
20200108,2,강변,42435,40528,20200111,82963
20200108,2,잠실나루,19115,18587,20200111,37702
20200108,2,잠실,89594,88027,20200111,177621
20200108,2,잠실새내,26634,26645,20200111,53279
20200108,2,종합운동장,13090,14323,20200111,27413
20200108,2,삼성,66976,68480,20200111,135456
20200108,2,선릉,69980,61984,20200111,131964
20200108,2,역삼,62807,70038,20200111,132845
20200108,2,강남,120178,120962,20200111,241140
20200108,2,교대,43609,49690,20200111,93299
20200108,2,서초,26565,27016,20200111,53581
20200108,2,방배,20840,21417,20200111,42257
20200108,2,사당,46619,50787,20200111,97406
20200108,2,낙성대,32286,31326,20200111,63612
20200108,2,서울대입구,57495,55701,20200111,113196
20200108,2,봉천,27951,25837,20200111,53788
20200108,2,신림,75033,72856,20200111,147889
20200108,2,신대방,31088,29867,20200111,60955
20200108,2,구로디지털단지,73576,73616,20200111,147192
20200108,2,대림,30502,31356,20200111,61858
20200108,2,신도림,61735,60597,20200111,122332
20200108,2,문래,24742,24991,20200111,49733
20200108,2,영등포구청,26640,26920,20200111,53560
20200108,2,당산,22668,26177,20200111,48845
20200108,2,합정,35639,37258,20200111,72897
20200108,2,홍대입구,74819,79883,20200111,154702
20200108,2,신촌,48042,49254,20200111,97296
20200108,2,이대,17154,18299,20200111,35453
20200108,2,아현,11166,10679,20200111,21845
20200108,2,충정로,12406,13188,20200111,25594
20200108,2,용답,2870,2913,20200111,5783
20200108,2,신답,1837,2108,20200111,3945
20200108,2,신설동,4098,4028,20200111,8126
20200108,2,도림천,1383,1446,20200111,2829
20200108,2,양천구청,8333,8759,20200111,17092
20200108,2,신정네거리,10903,11216,20200111,22119
20200108,2,용두,2752,2901,20200111,5653
20200109,2,시청,31589,30628,20200112,62217
20200109,2,을지로입구,58484,58937,20200112,117421
20200109,2,을지로3가,27948,27815,20200112,55763
20200109,2,을지로4가,15823,15865,20200112,31688
20200109,2,동대문역사문화공원,17785,20386,20200112,38171
20200109,2,신당,16310,16835,20200112,33145
20200109,2,상왕십리,16334,15916,20200112,32250
20200109,2,왕십리,20789,17081,20200112,37870
20200109,2,한양대,10716,11331,20200112,22047
20200109,2,뚝섬,22796,24258,20200112,47054
20200109,2,성수,37067,40438,20200112,77505
20200109,2,건대입구,45379,48977,20200112,94356
20200109,2,구의,28044,27362,20200112,55406
20200109,2,강변,43484,42152,20200112,85636
20200109,2,잠실나루,19233,18738,20200112,37971
20200109,2,잠실,93980,91824,20200112,185804
20200109,2,잠실새내,26759,26628,20200112,53387
20200109,2,종합운동장,9493,10260,20200112,19753
20200109,2,삼성,66574,68156,20200112,134730
20200109,2,선릉,70061,62554,20200112,132615
20200109,2,역삼,62826,70001,20200112,132827
20200109,2,강남,122108,122689,20200112,244797
20200109,2,교대,44432,50549,20200112,94981
20200109,2,서초,26646,26719,20200112,53365
20200109,2,방배,21153,21895,20200112,43048
20200109,2,사당,48175,52514,20200112,100689
20200109,2,낙성대,33057,32117,20200112,65174
20200109,2,서울대입구,58465,56650,20200112,115115
20200109,2,봉천,28276,26465,20200112,54741
20200109,2,신림,75995,73872,20200112,149867
20200109,2,신대방,31710,30115,20200112,61825
20200109,2,구로디지털단지,74410,74750,20200112,149160
20200109,2,대림,30541,30980,20200112,61521
20200109,2,신도림,63232,62383,20200112,125615
20200109,2,문래,25201,25291,20200112,50492
20200109,2,영등포구청,27046,27281,20200112,54327
20200109,2,당산,23201,26573,20200112,49774
20200109,2,합정,36666,38678,20200112,75344
20200109,2,홍대입구,77947,82743,20200112,160690
20200109,2,신촌,48589,49992,20200112,98581
20200109,2,이대,17525,18520,20200112,36045
20200109,2,아현,11480,11053,20200112,22533
20200109,2,충정로,12595,13286,20200112,25881
20200109,2,용답,2893,2940,20200112,5833
20200109,2,신답,1847,2046,20200112,3893
20200109,2,신설동,4173,4194,20200112,8367
20200109,2,도림천,1394,1533,20200112,2927
20200109,2,양천구청,8346,8838,20200112,17184
20200109,2,신정네거리,11015,11377,20200112,22392
20200109,2,용두,2761,2923,20200112,5684
20200110,2,시청,32103,30978,20200113,63081
20200110,2,을지로입구,60403,60896,20200113,121299
20200110,2,을지로3가,28317,28297,20200113,56614
20200110,2,을지로4가,16313,16254,20200113,32567
20200110,2,동대문역사문화공원,18253,21559,20200113,39812
20200110,2,신당,16962,17731,20200113,34693
20200110,2,상왕십리,17116,15988,20200113,33104
20200110,2,왕십리,21799,18757,20200113,40556
20200110,2,한양대,11160,11630,20200113,22790
20200110,2,뚝섬,23416,24835,20200113,48251
20200110,2,성수,37822,40983,20200113,78805
20200110,2,건대입구,48335,55832,20200113,104167
20200110,2,구의,28773,27956,20200113,56729
20200110,2,강변,48874,47726,20200113,96600
20200110,2,잠실나루,19290,18254,20200113,37544
20200110,2,잠실,96532,92917,20200113,189449
20200110,2,잠실새내,28008,29164,20200113,57172
20200110,2,종합운동장,11358,12773,20200113,24131
20200110,2,삼성,70726,71802,20200113,142528
20200110,2,선릉,70116,62468,20200113,132584
20200110,2,역삼,62739,70673,20200113,133412
20200110,2,강남,127610,134985,20200113,262595
20200110,2,교대,45534,52120,20200113,97654
20200110,2,서초,25948,25861,20200113,51809
20200110,2,방배,21755,22132,20200113,43887
20200110,2,사당,52177,57311,20200113,109488
20200110,2,낙성대,34283,32143,20200113,66426
20200110,2,서울대입구,61977,58717,20200113,120694
20200110,2,봉천,29459,26425,20200113,55884
20200110,2,신림,79361,77355,20200113,156716
20200110,2,신대방,32288,30166,20200113,62454
20200110,2,구로디지털단지,76485,76975,20200113,153460
20200110,2,대림,31368,32173,20200113,63541
20200110,2,신도림,65596,65659,20200113,131255
20200110,2,문래,25387,25694,20200113,51081
20200110,2,영등포구청,27635,27953,20200113,55588
20200110,2,당산,24242,27880,20200113,52122
20200110,2,합정,39399,43210,20200113,82609
20200110,2,홍대입구,83173,95550,20200113,178723
20200110,2,신촌,51438,53370,20200113,104808
20200110,2,이대,18813,19295,20200113,38108
20200110,2,아현,11894,11121,20200113,23015
20200110,2,충정로,12589,13402,20200113,25991
20200110,2,용답,3122,3017,20200113,6139
20200110,2,신답,2000,2146,20200113,4146
20200110,2,신설동,4735,4723,20200113,9458
20200110,2,도림천,1400,1493,20200113,2893
20200110,2,양천구청,8471,8831,20200113,17302
20200110,2,신정네거리,11532,11846,20200113,23378
20200110,2,용두,2874,3005,20200113,5879
20200111,2,시청,15889,13622,20200114,29511
20200111,2,을지로입구,40781,39414,20200114,80195
20200111,2,을지로3가,14764,14787,20200114,29551
20200111,2,을지로4가,11175,11484,20200114,22659
20200111,2,동대문역사문화공원,16344,17981,20200114,34325
20200111,2,신당,13267,13976,20200114,27243
20200111,2,상왕십리,11570,10630,20200114,22200
20200111,2,왕십리,17651,15342,20200114,32993
20200111,2,한양대,5980,6190,20200114,12170
20200111,2,뚝섬,14010,14199,20200114,28209
20200111,2,성수,19475,21146,20200114,40621
20200111,2,건대입구,46269,53119,20200114,99388
20200111,2,구의,19845,18743,20200114,38588
20200111,2,강변,46959,45441,20200114,92400
20200111,2,잠실나루,10546,10165,20200114,20711
20200111,2,잠실,87689,83099,20200114,170788
20200111,2,잠실새내,21725,23103,20200114,44828
20200111,2,종합운동장,8737,9729,20200114,18466
20200111,2,삼성,46376,46343,20200114,92719
20200111,2,선릉,33407,29629,20200114,63036
20200111,2,역삼,25448,27248,20200114,52696
20200111,2,강남,94848,101571,20200114,196419
20200111,2,교대,24811,28396,20200114,53207
20200111,2,서초,16208,14850,20200114,31058
20200111,2,방배,13226,13210,20200114,26436
20200111,2,사당,44579,48835,20200114,93414
20200111,2,낙성대,26629,24226,20200114,50855
20200111,2,서울대입구,47810,46468,20200114,94278
20200111,2,봉천,21211,19164,20200114,40375
20200111,2,신림,64764,62501,20200114,127265
20200111,2,신대방,24438,22952,20200114,47390
20200111,2,구로디지털단지,46475,46346,20200114,92821
20200111,2,대림,24347,25853,20200114,50200
20200111,2,신도림,59891,60232,20200114,120123
20200111,2,문래,14702,15105,20200114,29807
20200111,2,영등포구청,15624,16018,20200114,31642
20200111,2,당산,16469,18218,20200114,34687
20200111,2,합정,35127,38848,20200114,73975
20200111,2,홍대입구,95907,110791,20200114,206698
20200111,2,신촌,49492,50930,20200114,100422
20200111,2,이대,15772,16250,20200114,32022
20200111,2,아현,9066,8587,20200114,17653
20200111,2,충정로,7962,8311,20200114,16273
20200111,2,용답,2450,2311,20200114,4761
20200111,2,신답,1194,1279,20200114,2473
20200111,2,신설동,4923,4576,20200114,9499
20200111,2,도림천,944,907,20200114,1851
20200111,2,양천구청,5500,5568,20200114,11068
20200111,2,신정네거리,8631,8753,20200114,17384
20200111,2,용두,2108,2159,20200114,4267
20200112,2,시청,9587,7517,20200115,17104
20200112,2,을지로입구,32020,30360,20200115,62380
20200112,2,을지로3가,12134,11768,20200115,23902
20200112,2,을지로4가,5574,5322,20200115,10896
20200112,2,동대문역사문화공원,13740,16412,20200115,30152
20200112,2,신당,9760,10658,20200115,20418
20200112,2,상왕십리,8158,7988,20200115,16146
20200112,2,왕십리,12688,11081,20200115,23769
20200112,2,한양대,9161,9000,20200115,18161
20200112,2,뚝섬,9549,9777,20200115,19326
20200112,2,성수,12296,12969,20200115,25265
20200112,2,건대입구,36028,37821,20200115,73849
20200112,2,구의,13882,13507,20200115,27389
20200112,2,강변,34137,35795,20200115,69932
20200112,2,잠실나루,7295,7388,20200115,14683
20200112,2,잠실,64087,59597,20200115,123684
20200112,2,잠실새내,14985,15621,20200115,30606
20200112,2,종합운동장,8220,9061,20200115,17281
20200112,2,삼성,34702,34002,20200115,68704
20200112,2,선릉,16488,14334,20200115,30822
20200112,2,역삼,15087,15808,20200115,30895
20200112,2,강남,55787,54371,20200115,110158
20200112,2,교대,14509,16117,20200115,30626
20200112,2,서초,15761,15037,20200115,30798
20200112,2,방배,8880,9243,20200115,18123
20200112,2,사당,29634,31776,20200115,61410
20200112,2,낙성대,18724,19061,20200115,37785
20200112,2,서울대입구,33746,34062,20200115,67808
20200112,2,봉천,15072,14831,20200115,29903
20200112,2,신림,48368,47737,20200115,96105
20200112,2,신대방,18799,18154,20200115,36953
20200112,2,구로디지털단지,33445,32676,20200115,66121
20200112,2,대림,21763,22475,20200115,44238
20200112,2,신도림,38120,38394,20200115,76514
20200112,2,문래,8228,8407,20200115,16635
20200112,2,영등포구청,9314,9507,20200115,18821
20200112,2,당산,10730,12005,20200115,22735
20200112,2,합정,25066,25471,20200115,50537
20200112,2,홍대입구,77950,76314,20200115,154264
20200112,2,신촌,34239,32844,20200115,67083
20200112,2,이대,11127,11692,20200115,22819
20200112,2,아현,6158,6297,20200115,12455
20200112,2,충정로,4797,5004,20200115,9801
20200112,2,용답,1994,2006,20200115,4000
20200112,2,신답,860,942,20200115,1802
20200112,2,신설동,4183,3938,20200115,8121
20200112,2,도림천,473,505,20200115,978
20200112,2,양천구청,4037,4215,20200115,8252
20200112,2,신정네거리,5902,6169,20200115,12071
20200112,2,용두,1258,1274,20200115,2532
20200113,2,시청,30623,29450,20200116,60073
20200113,2,을지로입구,57482,58105,20200116,115587
20200113,2,을지로3가,27400,27090,20200116,54490
20200113,2,을지로4가,16135,15895,20200116,32030
20200113,2,동대문역사문화공원,17079,19527,20200116,36606
20200113,2,신당,15963,16398,20200116,32361
20200113,2,상왕십리,16076,15541,20200116,31617
20200113,2,왕십리,19662,16491,20200116,36153
20200113,2,한양대,9571,10664,20200116,20235
20200113,2,뚝섬,21536,22946,20200116,44482
20200113,2,성수,35707,38084,20200116,73791
20200113,2,건대입구,42244,45529,20200116,87773
20200113,2,구의,27312,26968,20200116,54280
20200113,2,강변,43591,42223,20200116,85814
20200113,2,잠실나루,18511,18067,20200116,36578
20200113,2,잠실,88522,86537,20200116,175059
20200113,2,잠실새내,25855,25717,20200116,51572
20200113,2,종합운동장,8636,10506,20200116,19142
20200113,2,삼성,65804,67015,20200116,132819
20200113,2,선릉,69660,62360,20200116,132020
20200113,2,역삼,63724,70280,20200116,134004
20200113,2,강남,118073,118909,20200116,236982
20200113,2,교대,43101,49525,20200116,92626
20200113,2,서초,25249,24986,20200116,50235
20200113,2,방배,21068,21732,20200116,42800
20200113,2,사당,45566,50507,20200116,96073
20200113,2,낙성대,31816,31195,20200116,63011
20200113,2,서울대입구,56969,55171,20200116,112140
20200113,2,봉천,28184,26258,20200116,54442
20200113,2,신림,74036,71808,20200116,145844
20200113,2,신대방,31059,29597,20200116,60656
20200113,2,구로디지털단지,73015,73669,20200116,146684
20200113,2,대림,31029,31431,20200116,62460
20200113,2,신도림,60409,59403,20200116,119812
20200113,2,문래,24742,25089,20200116,49831
20200113,2,영등포구청,26809,27083,20200116,53892
20200113,2,당산,22366,25691,20200116,48057
20200113,2,합정,34737,36201,20200116,70938
20200113,2,홍대입구,74146,77150,20200116,151296
20200113,2,신촌,47565,48695,20200116,96260
20200113,2,이대,17413,18563,20200116,35976
20200113,2,아현,11248,11009,20200116,22257
20200113,2,충정로,12190,12999,20200116,25189
20200113,2,용답,2860,2760,20200116,5620
20200113,2,신답,1765,2056,20200116,3821
20200113,2,신설동,4259,4182,20200116,8441
20200113,2,도림천,1454,1531,20200116,2985
20200113,2,양천구청,8198,8642,20200116,16840
20200113,2,신정네거리,10946,11465,20200116,22411
20200113,2,용두,2772,2939,20200116,5711
20200114,2,용두,2841,2998,20200117,5839
20200114,2,신정네거리,10999,11334,20200117,22333
20200114,2,양천구청,8193,8781,20200117,16974
20200114,2,도림천,1453,1539,20200117,2992
20200114,2,신설동,3946,4000,20200117,7946
20200114,2,신답,1822,2080,20200117,3902
20200114,2,용답,2900,2848,20200117,5748
20200114,2,충정로,12294,12871,20200117,25165
20200114,2,아현,11562,11225,20200117,22787
20200114,2,이대,17805,18586,20200117,36391
20200114,2,신촌,48035,49391,20200117,97426
20200114,2,홍대입구,77040,80960,20200117,158000
20200114,2,합정,36340,37928,20200117,74268
20200114,2,당산,23240,26494,20200117,49734
20200114,2,영등포구청,27249,27499,20200117,54748
20200114,2,문래,25035,25228,20200117,50263
20200114,2,신도림,60558,59215,20200117,119773
20200114,2,대림,30971,31559,20200117,62530
20200114,2,구로디지털단지,74529,74519,20200117,149048
20200114,2,신대방,31304,30074,20200117,61378
20200114,2,신림,75589,73807,20200117,149396
20200114,2,봉천,28545,26463,20200117,55008
20200114,2,서울대입구,58331,56648,20200117,114979
20200114,2,낙성대,32360,31725,20200117,64085
20200114,2,사당,47135,51475,20200117,98610
20200114,2,방배,21610,22137,20200117,43747
20200114,2,서초,25780,25926,20200117,51706
20200114,2,교대,45049,51534,20200117,96583
20200114,2,강남,120976,121733,20200117,242709
20200114,2,역삼,63875,70635,20200117,134510
20200114,2,선릉,69774,62359,20200117,132133
20200114,2,삼성,66637,68431,20200117,135068
20200114,2,종합운동장,9414,10173,20200117,19587
20200114,2,잠실새내,26526,26290,20200117,52816
20200114,2,잠실,91634,89073,20200117,180707
20200114,2,잠실나루,18666,18243,20200117,36909
20200114,2,강변,41872,40506,20200117,82378
20200114,2,구의,28091,27405,20200117,55496
20200114,2,건대입구,43676,47321,20200117,90997
20200114,2,성수,37146,40170,20200117,77316
20200114,2,뚝섬,22679,24239,20200117,46918
20200114,2,한양대,9706,10626,20200117,20332
20200114,2,왕십리,19920,16414,20200117,36334
20200114,2,상왕십리,16464,15811,20200117,32275
20200114,2,신당,16401,17177,20200117,33578
20200114,2,동대문역사문화공원,17837,20458,20200117,38295
20200114,2,을지로4가,16338,16341,20200117,32679
20200114,2,을지로3가,27438,27360,20200117,54798
20200114,2,을지로입구,58555,59584,20200117,118139
20200114,2,시청,32075,31007,20200117,63082
20200115,2,시청,32109,31294,20200118,63403
20200115,2,을지로입구,59288,59835,20200118,119123
20200115,2,을지로3가,28185,28173,20200118,56358
20200115,2,을지로4가,16544,16326,20200118,32870
20200115,2,동대문역사문화공원,17757,20523,20200118,38280
20200115,2,신당,16540,17506,20200118,34046
20200115,2,상왕십리,16477,15946,20200118,32423
20200115,2,왕십리,20751,16907,20200118,37658
20200115,2,한양대,9493,10324,20200118,19817
20200115,2,뚝섬,23369,24701,20200118,48070
20200115,2,성수,37515,40273,20200118,77788
20200115,2,건대입구,44429,48468,20200118,92897
20200115,2,구의,28277,27623,20200118,55900
20200115,2,강변,43692,41603,20200118,85295
20200115,2,잠실나루,18949,18461,20200118,37410
20200115,2,잠실,92707,89902,20200118,182609
20200115,2,잠실새내,26861,26933,20200118,53794
20200115,2,종합운동장,11008,11913,20200118,22921
20200115,2,삼성,68013,69639,20200118,137652
20200115,2,선릉,70282,62412,20200118,132694
20200115,2,역삼,64033,70587,20200118,134620
20200115,2,강남,122025,122875,20200118,244900
20200115,2,교대,44934,50993,20200118,95927
20200115,2,서초,27058,27121,20200118,54179
20200115,2,방배,20677,21511,20200118,42188
20200115,2,사당,47739,51975,20200118,99714
20200115,2,낙성대,32810,31952,20200118,64762
20200115,2,서울대입구,59065,56820,20200118,115885
20200115,2,봉천,28546,26349,20200118,54895
20200115,2,신림,76301,74509,20200118,150810
20200115,2,신대방,31476,30340,20200118,61816
20200115,2,구로디지털단지,74642,74998,20200118,149640
20200115,2,대림,31002,31709,20200118,62711
20200115,2,신도림,62706,61934,20200118,124640
20200115,2,문래,25148,25362,20200118,50510
20200115,2,영등포구청,26817,27149,20200118,53966
20200115,2,당산,23217,26620,20200118,49837
20200115,2,합정,36646,38566,20200118,75212
20200115,2,홍대입구,77801,82503,20200118,160304
20200115,2,신촌,48792,50185,20200118,98977
20200115,2,이대,18145,18926,20200118,37071
20200115,2,아현,11488,10992,20200118,22480
20200115,2,충정로,12550,13237,20200118,25787
20200115,2,용답,2940,2930,20200118,5870
20200115,2,신답,1826,2076,20200118,3902
20200115,2,신설동,4088,4195,20200118,8283
20200115,2,도림천,1427,1524,20200118,2951
20200115,2,양천구청,8278,8811,20200118,17089
20200115,2,신정네거리,11187,11459,20200118,22646
20200115,2,용두,2800,3019,20200118,5819
20200116,2,용두,2915,3079,20200119,5994
20200116,2,신정네거리,11118,11408,20200119,22526
20200116,2,양천구청,8329,8746,20200119,17075
20200116,2,도림천,1439,1533,20200119,2972
20200116,2,신설동,4149,4326,20200119,8475
20200116,2,신답,1751,1964,20200119,3715
20200116,2,용답,2899,2925,20200119,5824
20200116,2,충정로,12576,13323,20200119,25899
20200116,2,아현,11428,10945,20200119,22373
20200116,2,이대,18014,18883,20200119,36897
20200116,2,신촌,48752,49841,20200119,98593
20200116,2,홍대입구,80741,85552,20200119,166293
20200116,2,합정,37685,39747,20200119,77432
20200116,2,당산,23360,27066,20200119,50426
20200116,2,영등포구청,27102,27439,20200119,54541
20200116,2,문래,24943,25507,20200119,50450
20200116,2,신도림,63464,62514,20200119,125978
20200116,2,대림,30841,31735,20200119,62576
20200116,2,구로디지털단지,74816,75121,20200119,149937
20200116,2,신대방,31356,30250,20200119,61606
20200116,2,신림,76716,74203,20200119,150919
20200116,2,봉천,28963,26818,20200119,55781
20200116,2,서울대입구,58419,56509,20200119,114928
20200116,2,낙성대,32941,31724,20200119,64665
20200116,2,사당,48765,53008,20200119,101773
20200116,2,방배,21165,21725,20200119,42890
20200116,2,서초,26413,26477,20200119,52890
20200116,2,교대,45377,51736,20200119,97113
20200116,2,강남,123030,124343,20200119,247373
20200116,2,역삼,63477,70695,20200119,134172
20200116,2,선릉,71359,63504,20200119,134863
20200116,2,삼성,70181,72073,20200119,142254
20200116,2,종합운동장,9727,10294,20200119,20021
20200116,2,잠실새내,26537,26823,20200119,53360
20200116,2,잠실,92637,90400,20200119,183037
20200116,2,잠실나루,18740,18067,20200119,36807
20200116,2,강변,43745,41814,20200119,85559
20200116,2,구의,28562,27802,20200119,56364
20200116,2,건대입구,44787,48463,20200119,93250
20200116,2,성수,37975,41137,20200119,79112
20200116,2,뚝섬,22984,24615,20200119,47599
20200116,2,한양대,8915,9707,20200119,18622
20200116,2,왕십리,20253,16968,20200119,37221
20200116,2,상왕십리,16380,15887,20200119,32267
20200116,2,신당,16409,17378,20200119,33787
20200116,2,동대문역사문화공원,17903,20584,20200119,38487
20200116,2,을지로4가,16418,16425,20200119,32843
20200116,2,을지로3가,27747,27675,20200119,55422
20200116,2,을지로입구,59199,60063,20200119,119262
20200116,2,시청,31873,30891,20200119,62764
20200117,2,시청,31954,31113,20200120,63067
20200117,2,을지로입구,60683,60856,20200120,121539
20200117,2,을지로3가,29142,29720,20200120,58862
20200117,2,을지로4가,16648,16697,20200120,33345
20200117,2,동대문역사문화공원,18526,21524,20200120,40050
20200117,2,신당,16943,17507,20200120,34450
20200117,2,상왕십리,17084,16241,20200120,33325
20200117,2,왕십리,21631,18449,20200120,40080
20200117,2,한양대,9456,9923,20200120,19379
20200117,2,뚝섬,23274,24755,20200120,48029
20200117,2,성수,38023,41646,20200120,79669
20200117,2,건대입구,48286,54762,20200120,103048
20200117,2,구의,29091,27873,20200120,56964
20200117,2,강변,49661,47557,20200120,97218
20200117,2,잠실나루,19575,18700,20200120,38275
20200117,2,잠실,97679,94193,20200120,191872
20200117,2,잠실새내,28229,29337,20200120,57566
20200117,2,종합운동장,11241,12276,20200120,23517
20200117,2,삼성,75318,75774,20200120,151092
20200117,2,선릉,70725,63156,20200120,133881
20200117,2,역삼,63056,71153,20200120,134209
20200117,2,강남,129997,136864,20200120,266861
20200117,2,교대,46477,53730,20200120,100207
20200117,2,서초,27056,26859,20200120,53915
20200117,2,방배,21250,22010,20200120,43260
20200117,2,사당,53076,58185,20200120,111261
20200117,2,낙성대,34205,32192,20200120,66397
20200117,2,서울대입구,61707,58581,20200120,120288
20200117,2,봉천,29194,26350,20200120,55544
20200117,2,신림,79263,77090,20200120,156353
20200117,2,신대방,32562,30484,20200120,63046
20200117,2,구로디지털단지,76456,76883,20200120,153339
20200117,2,대림,31426,32305,20200120,63731
20200117,2,신도림,65063,65375,20200120,130438
20200117,2,문래,25001,25636,20200120,50637
20200117,2,영등포구청,27308,27877,20200120,55185
20200117,2,당산,24443,27534,20200120,51977
20200117,2,합정,39846,44443,20200120,84289
20200117,2,홍대입구,86314,98551,20200120,184865
20200117,2,신촌,51550,53611,20200120,105161
20200117,2,이대,19046,19852,20200120,38898
20200117,2,아현,11743,10917,20200120,22660
20200117,2,충정로,13039,13715,20200120,26754
20200117,2,용답,3102,3014,20200120,6116
20200117,2,신답,1872,2067,20200120,3939
20200117,2,신설동,4621,4714,20200120,9335
20200117,2,도림천,1457,1531,20200120,2988
20200117,2,양천구청,8663,8980,20200120,17643
20200117,2,신정네거리,11261,11797,20200120,23058
20200117,2,용두,2994,3165,20200120,6159
20200118,2,시청,15127,13011,20200121,28138
20200118,2,을지로입구,39796,38370,20200121,78166
20200118,2,을지로3가,14967,14929,20200121,29896
20200118,2,을지로4가,11300,11769,20200121,23069
20200118,2,동대문역사문화공원,17286,18491,20200121,35777
20200118,2,신당,13473,14301,20200121,27774
20200118,2,상왕십리,11389,10678,20200121,22067
20200118,2,왕십리,17264,15121,20200121,32385
20200118,2,한양대,5787,6040,20200121,11827
20200118,2,뚝섬,14567,14691,20200121,29258
20200118,2,성수,20188,22226,20200121,42414
20200118,2,건대입구,45676,51499,20200121,97175
20200118,2,구의,20047,18957,20200121,39004
20200118,2,강변,45365,43585,20200121,88950
20200118,2,잠실나루,10574,10185,20200121,20759
20200118,2,잠실,87802,83241,20200121,171043
20200118,2,잠실새내,22405,23580,20200121,45985
20200118,2,종합운동장,12003,13674,20200121,25677
20200118,2,삼성,47871,48527,20200121,96398
20200118,2,선릉,33366,29746,20200121,63112
20200118,2,역삼,25268,27876,20200121,53144
20200118,2,강남,93172,99551,20200121,192723
20200118,2,교대,24732,27984,20200121,52716
20200118,2,서초,16081,15022,20200121,31103
20200118,2,방배,12750,13012,20200121,25762
20200118,2,사당,43116,47655,20200121,90771
20200118,2,낙성대,26130,23814,20200121,49944
20200118,2,서울대입구,47829,46286,20200121,94115
20200118,2,봉천,21372,19469,20200121,40841
20200118,2,신림,63727,61293,20200121,125020
20200118,2,신대방,24363,22723,20200121,47086
20200118,2,구로디지털단지,47561,46819,20200121,94380
20200118,2,대림,24373,25974,20200121,50347
20200118,2,신도림,57251,57479,20200121,114730
20200118,2,문래,13648,13903,20200121,27551
20200118,2,영등포구청,15113,15525,20200121,30638
20200118,2,당산,16475,17850,20200121,34325
20200118,2,합정,35223,38958,20200121,74181
20200118,2,홍대입구,97173,110721,20200121,207894
20200118,2,신촌,47569,49072,20200121,96641
20200118,2,이대,16008,16447,20200121,32455
20200118,2,아현,8908,8386,20200121,17294
20200118,2,충정로,7852,8258,20200121,16110
20200118,2,용답,2415,2251,20200121,4666
20200118,2,신답,1144,1248,20200121,2392
20200118,2,신설동,4850,4446,20200121,9296
20200118,2,도림천,914,899,20200121,1813
20200118,2,양천구청,5799,5819,20200121,11618
20200118,2,신정네거리,8646,8712,20200121,17358
20200118,2,용두,2342,2402,20200121,4744
20200119,2,시청,8921,7100,20200122,16021
20200119,2,을지로입구,30083,28769,20200122,58852
20200119,2,을지로3가,11288,11168,20200122,22456
20200119,2,을지로4가,5441,5248,20200122,10689
20200119,2,동대문역사문화공원,11953,13973,20200122,25926
20200119,2,신당,9376,10066,20200122,19442
20200119,2,상왕십리,7977,7699,20200122,15676
20200119,2,왕십리,12293,10715,20200122,23008
20200119,2,한양대,3711,3975,20200122,7686
20200119,2,뚝섬,9574,9666,20200122,19240
20200119,2,성수,12405,13251,20200122,25656
20200119,2,건대입구,33893,35337,20200122,69230
20200119,2,구의,13601,13424,20200122,27025
20200119,2,강변,31783,34906,20200122,66689
20200119,2,잠실나루,7055,7089,20200122,14144
20200119,2,잠실,61657,57527,20200122,119184
20200119,2,잠실새내,14230,14617,20200122,28847
20200119,2,종합운동장,10215,11266,20200122,21481
20200119,2,삼성,33198,32681,20200122,65879
20200119,2,선릉,15927,13711,20200122,29638
20200119,2,역삼,14614,15339,20200122,29953
20200119,2,강남,54820,53801,20200122,108621
20200119,2,교대,14310,15707,20200122,30017
20200119,2,서초,15631,14774,20200122,30405
20200119,2,방배,8845,9193,20200122,18038
20200119,2,사당,27858,30662,20200122,58520
20200119,2,낙성대,18982,18903,20200122,37885
20200119,2,서울대입구,32627,32791,20200122,65418
20200119,2,봉천,15022,14451,20200122,29473
20200119,2,신림,47960,46521,20200122,94481
20200119,2,신대방,18922,18101,20200122,37023
20200119,2,구로디지털단지,33053,32822,20200122,65875
20200119,2,대림,21045,21682,20200122,42727
20200119,2,신도림,38367,37490,20200122,75857
20200119,2,문래,8746,9000,20200122,17746
20200119,2,영등포구청,10187,10315,20200122,20502
20200119,2,당산,10636,11750,20200122,22386
20200119,2,합정,25397,25941,20200122,51338
20200119,2,홍대입구,75739,74313,20200122,150052
20200119,2,신촌,33244,31552,20200122,64796
20200119,2,이대,10826,11551,20200122,22377
20200119,2,아현,6122,6041,20200122,12163
20200119,2,충정로,4716,4933,20200122,9649
20200119,2,용답,1864,1809,20200122,3673
20200119,2,신답,827,929,20200122,1756
20200119,2,신설동,3816,3486,20200122,7302
20200119,2,도림천,467,527,20200122,994
20200119,2,양천구청,3882,3985,20200122,7867
20200119,2,신정네거리,5852,5959,20200122,11811
20200119,2,용두,1521,1593,20200122,3114
20200120,2,용두,3037,3155,20200123,6192
20200120,2,신정네거리,11198,11420,20200123,22618
20200120,2,양천구청,8328,8763,20200123,17091
20200120,2,도림천,1413,1533,20200123,2946
20200120,2,신설동,4305,4172,20200123,8477
20200120,2,신답,1849,2087,20200123,3936
20200120,2,용답,3013,2877,20200123,5890
20200120,2,충정로,12620,13366,20200123,25986
20200120,2,아현,11561,11262,20200123,22823
20200120,2,이대,17267,18051,20200123,35318
20200120,2,신촌,47110,48848,20200123,95958
20200120,2,홍대입구,76767,79573,20200123,156340
20200120,2,합정,35379,36874,20200123,72253
20200120,2,당산,22483,26175,20200123,48658
20200120,2,영등포구청,27537,27746,20200123,55283
20200120,2,문래,24910,25151,20200123,50061
20200120,2,신도림,61601,60033,20200123,121634
20200120,2,대림,31054,31607,20200123,62661
20200120,2,구로디지털단지,73952,74196,20200123,148148
20200120,2,신대방,31207,29968,20200123,61175
20200120,2,신림,75441,73030,20200123,148471
20200120,2,봉천,28700,26583,20200123,55283
20200120,2,서울대입구,57765,55731,20200123,113496
20200120,2,낙성대,32466,32106,20200123,64572
20200120,2,사당,44874,49981,20200123,94855
20200120,2,방배,22694,23094,20200123,45788
20200120,2,서초,26064,25540,20200123,51604
20200120,2,교대,43875,50225,20200123,94100
20200120,2,강남,119614,120537,20200123,240151
20200120,2,역삼,63278,70535,20200123,133813
20200120,2,선릉,69857,62642,20200123,132499
20200120,2,삼성,65121,66795,20200123,131916
20200120,2,종합운동장,8814,10387,20200123,19201
20200120,2,잠실새내,26770,26596,20200123,53366
20200120,2,잠실,89741,87890,20200123,177631
20200120,2,잠실나루,19129,18663,20200123,37792
20200120,2,강변,44109,43098,20200123,87207
20200120,2,구의,27855,27094,20200123,54949
20200120,2,건대입구,42967,46512,20200123,89479
20200120,2,성수,37237,40175,20200123,77412
20200120,2,뚝섬,22391,23981,20200123,46372
20200120,2,한양대,8924,9912,20200123,18836
20200120,2,왕십리,19802,16285,20200123,36087
20200120,2,상왕십리,16414,15802,20200123,32216
20200120,2,신당,16409,16764,20200123,33173
20200120,2,동대문역사문화공원,16522,18834,20200123,35356
20200120,2,을지로4가,16382,16435,20200123,32817
20200120,2,을지로3가,27267,27381,20200123,54648
20200120,2,을지로입구,58287,59201,20200123,117488
20200120,2,시청,31270,30445,20200123,61715
20200121,2,시청,32441,31411,20200124,63852
20200121,2,을지로입구,58392,59019,20200124,117411
20200121,2,을지로3가,27153,27105,20200124,54258
20200121,2,을지로4가,16110,16273,20200124,32383
20200121,2,동대문역사문화공원,16753,18819,20200124,35572
20200121,2,신당,16654,17264,20200124,33918
20200121,2,상왕십리,16239,15629,20200124,31868
20200121,2,왕십리,20015,16410,20200124,36425
20200121,2,한양대,8674,9422,20200124,18096
20200121,2,뚝섬,23122,24723,20200124,47845
20200121,2,성수,37721,40732,20200124,78453
20200121,2,건대입구,43529,47273,20200124,90802
20200121,2,구의,28055,27210,20200124,55265
20200121,2,강변,43309,41974,20200124,85283
20200121,2,잠실나루,19180,18665,20200124,37845
20200121,2,잠실,90862,88162,20200124,179024
20200121,2,잠실새내,26836,27189,20200124,54025
20200121,2,종합운동장,10098,10681,20200124,20779
20200121,2,삼성,66754,68624,20200124,135378
20200121,2,선릉,70070,62176,20200124,132246
20200121,2,역삼,62720,69797,20200124,132517
20200121,2,강남,121647,122832,20200124,244479
20200121,2,교대,45025,50845,20200124,95870
20200121,2,서초,26902,26798,20200124,53700
20200121,2,방배,22865,23424,20200124,46289
20200121,2,사당,46180,50870,20200124,97050
20200121,2,낙성대,32766,31809,20200124,64575
20200121,2,서울대입구,57522,55469,20200124,112991
20200121,2,봉천,28444,26347,20200124,54791
20200121,2,신림,75247,73039,20200124,148286
20200121,2,신대방,31548,30074,20200124,61622
20200121,2,구로디지털단지,74974,75143,20200124,150117
20200121,2,대림,31158,31841,20200124,62999
20200121,2,신도림,61771,61071,20200124,122842
20200121,2,문래,25389,25337,20200124,50726
20200121,2,영등포구청,27385,27712,20200124,55097
20200121,2,당산,23165,26743,20200124,49908
20200121,2,합정,36137,37883,20200124,74020
20200121,2,홍대입구,76578,80179,20200124,156757
20200121,2,신촌,47163,48201,20200124,95364
20200121,2,이대,17024,17733,20200124,34757
20200121,2,아현,11578,11277,20200124,22855
20200121,2,충정로,12716,13379,20200124,26095
20200121,2,용답,2966,2853,20200124,5819
20200121,2,신답,1821,2115,20200124,3936
20200121,2,신설동,3940,4036,20200124,7976
20200121,2,도림천,1399,1531,20200124,2930
20200121,2,양천구청,8298,8777,20200124,17075
20200121,2,신정네거리,10964,11596,20200124,22560
20200121,2,용두,3044,3200,20200124,6244
20200122,2,시청,30992,30531,20200125,61523
20200122,2,을지로입구,56918,57776,20200125,114694
20200122,2,을지로3가,27263,27441,20200125,54704
20200122,2,을지로4가,15411,15446,20200125,30857
20200122,2,동대문역사문화공원,16605,18441,20200125,35046
20200122,2,신당,16869,17433,20200125,34302
20200122,2,상왕십리,16362,15517,20200125,31879
20200122,2,왕십리,20384,16912,20200125,37296
20200122,2,한양대,8481,9228,20200125,17709
20200122,2,뚝섬,22691,24427,20200125,47118
20200122,2,성수,37602,40532,20200125,78134
20200122,2,건대입구,45096,48461,20200125,93557
20200122,2,구의,28073,26803,20200125,54876
20200122,2,강변,42996,45507,20200125,88503
20200122,2,잠실나루,18999,18346,20200125,37345
20200122,2,잠실,91953,87859,20200125,179812
20200122,2,잠실새내,27197,27168,20200125,54365
20200122,2,종합운동장,10966,11525,20200125,22491
20200122,2,삼성,66795,68581,20200125,135376
20200122,2,선릉,69302,61535,20200125,130837
20200122,2,역삼,62124,69383,20200125,131507
20200122,2,강남,120553,121856,20200125,242409
20200122,2,교대,43357,49219,20200125,92576
20200122,2,서초,26338,26312,20200125,52650
20200122,2,방배,21557,22135,20200125,43692
20200122,2,사당,45931,50413,20200125,96344
20200122,2,낙성대,33184,31166,20200125,64350
20200122,2,서울대입구,58171,54787,20200125,112958
20200122,2,봉천,28526,25811,20200125,54337
20200122,2,신림,76967,72978,20200125,149945
20200122,2,신대방,31679,30023,20200125,61702
20200122,2,구로디지털단지,74560,74805,20200125,149365
20200122,2,대림,31867,33060,20200125,64927
20200122,2,신도림,63950,62732,20200125,126682
20200122,2,문래,24748,24865,20200125,49613
20200122,2,영등포구청,26499,26872,20200125,53371
20200122,2,당산,22868,26045,20200125,48913
20200122,2,합정,36827,38406,20200125,75233
20200122,2,홍대입구,77205,82290,20200125,159495
20200122,2,신촌,46957,47951,20200125,94908
20200122,2,이대,16935,17259,20200125,34194
20200122,2,아현,11800,11063,20200125,22863
20200122,2,충정로,12549,13250,20200125,25799
20200122,2,용답,3022,2811,20200125,5833
20200122,2,신답,1927,2138,20200125,4065
20200122,2,신설동,3973,4014,20200125,7987
20200122,2,도림천,1423,1547,20200125,2970
20200122,2,양천구청,8300,8676,20200125,16976
20200122,2,신정네거리,11106,11444,20200125,22550
20200122,2,용두,3108,3303,20200125,6411
20200123,2,시청,27162,26160,20200126,53322
20200123,2,을지로입구,53030,53236,20200126,106266
20200123,2,을지로3가,23686,24314,20200126,48000
20200123,2,을지로4가,13781,14122,20200126,27903
20200123,2,동대문역사문화공원,14758,16302,20200126,31060
20200123,2,신당,15835,15701,20200126,31536
20200123,2,상왕십리,15460,13806,20200126,29266
20200123,2,왕십리,19327,15382,20200126,34709
20200123,2,한양대,7513,7559,20200126,15072
20200123,2,뚝섬,21178,22063,20200126,43241
20200123,2,성수,33817,36193,20200126,70010
20200123,2,건대입구,44165,48342,20200126,92507
20200123,2,구의,26598,24368,20200126,50966
20200123,2,강변,44148,62046,20200126,106194
20200123,2,잠실나루,17619,16402,20200126,34021
20200123,2,잠실,86020,84247,20200126,170267
20200123,2,잠실새내,25563,26255,20200126,51818
20200123,2,종합운동장,8781,10618,20200126,19399
20200123,2,삼성,60350,60938,20200126,121288
20200123,2,선릉,59150,51263,20200126,110413
20200123,2,역삼,54009,59061,20200126,113070
20200123,2,강남,111812,115448,20200126,227260
20200123,2,교대,37033,41765,20200126,78798
20200123,2,서초,22100,21437,20200126,43537
20200123,2,방배,18023,18220,20200126,36243
20200123,2,사당,41163,45075,20200126,86238
20200123,2,낙성대,32201,26625,20200126,58826
20200123,2,서울대입구,56482,48318,20200126,104800
20200123,2,봉천,27403,23337,20200126,50740
20200123,2,신림,75840,67624,20200126,143464
20200123,2,신대방,30839,27415,20200126,58254
20200123,2,구로디지털단지,70445,68230,20200126,138675
20200123,2,대림,30542,31654,20200126,62196
20200123,2,신도림,60940,60137,20200126,121077
20200123,2,문래,22898,23074,20200126,45972
20200123,2,영등포구청,24676,24523,20200126,49199
20200123,2,당산,21332,23945,20200126,45277
20200123,2,합정,34801,36543,20200126,71344
20200123,2,홍대입구,75805,82758,20200126,158563
20200123,2,신촌,45373,45266,20200126,90639
20200123,2,이대,15757,15578,20200126,31335
20200123,2,아현,10726,9697,20200126,20423
20200123,2,충정로,11307,11585,20200126,22892
20200123,2,용답,2943,2601,20200126,5544
20200123,2,신답,1840,1840,20200126,3680
20200123,2,신설동,3704,3591,20200126,7295
20200123,2,도림천,1284,1346,20200126,2630
20200123,2,양천구청,7748,7972,20200126,15720
20200123,2,신정네거리,10350,10389,20200126,20739
20200123,2,용두,2939,2865,20200126,5804
20200124,2,용두,1269,1190,20200127,2459
20200124,2,신정네거리,4428,4318,20200127,8746
20200124,2,양천구청,3085,2864,20200127,5949
20200124,2,도림천,379,329,20200127,708
20200124,2,신설동,2015,1757,20200127,3772
20200124,2,신답,573,552,20200127,1125
20200124,2,용답,1594,1302,20200127,2896
20200124,2,충정로,3557,3355,20200127,6912
20200124,2,아현,4475,3825,20200127,8300
20200124,2,이대,7177,6264,20200127,13441
20200124,2,신촌,21204,18952,20200127,40156
20200124,2,홍대입구,48136,49441,20200127,97577
20200124,2,합정,15238,15209,20200127,30447
20200124,2,당산,6711,7163,20200127,13874
20200124,2,영등포구청,6410,5962,20200127,12372
20200124,2,문래,5611,5451,20200127,11062
20200124,2,신도림,24206,23706,20200127,47912
20200124,2,대림,15797,16851,20200127,32648
20200124,2,구로디지털단지,23796,20981,20200127,44777
20200124,2,신대방,14763,11963,20200127,26726
20200124,2,신림,37666,28379,20200127,66045
20200124,2,봉천,11561,8840,20200127,20401
20200124,2,서울대입구,24087,17403,20200127,41490
20200124,2,낙성대,13525,9155,20200127,22680
20200124,2,사당,16036,16502,20200127,32538
20200124,2,방배,5050,4825,20200127,9875
20200124,2,서초,4218,3971,20200127,8189
20200124,2,교대,8344,8742,20200127,17086
20200124,2,강남,33186,33251,20200127,66437
20200124,2,역삼,8445,8039,20200127,16484
20200124,2,선릉,9470,7267,20200127,16737
20200124,2,삼성,16812,16556,20200127,33368
20200124,2,종합운동장,3369,3183,20200127,6552
20200124,2,잠실새내,9771,9408,20200127,19179
20200124,2,잠실,41856,39512,20200127,81368
20200124,2,잠실나루,4862,4429,20200127,9291
20200124,2,강변,23892,41905,20200127,65797
20200124,2,구의,10469,8650,20200127,19119
20200124,2,건대입구,23344,22888,20200127,46232
20200124,2,성수,8144,8137,20200127,16281
20200124,2,뚝섬,5959,5623,20200127,11582
20200124,2,한양대,2007,1661,20200127,3668
20200124,2,왕십리,8059,6104,20200127,14163
20200124,2,상왕십리,5802,4789,20200127,10591
20200124,2,신당,7133,6734,20200127,13867
20200124,2,동대문역사문화공원,8476,9734,20200127,18210
20200124,2,을지로4가,3766,3805,20200127,7571
20200124,2,을지로3가,5699,5599,20200127,11298
20200124,2,을지로입구,16510,16300,20200127,32810
20200124,2,시청,5543,4484,20200127,10027
20200125,2,시청,6300,5091,20200128,11391
20200125,2,을지로입구,15176,13876,20200128,29052
20200125,2,을지로3가,5068,4853,20200128,9921
20200125,2,을지로4가,2787,2823,20200128,5610
20200125,2,동대문역사문화공원,7796,9295,20200128,17091
20200125,2,신당,5190,5664,20200128,10854
20200125,2,상왕십리,4630,4565,20200128,9195
20200125,2,왕십리,5777,5196,20200128,10973
20200125,2,한양대,1299,1426,20200128,2725
20200125,2,뚝섬,3936,4161,20200128,8097
20200125,2,성수,5197,5958,20200128,11155
20200125,2,건대입구,16759,19677,20200128,36436
20200125,2,구의,8186,8025,20200128,16211
20200125,2,강변,26635,22570,20200128,49205
20200125,2,잠실나루,3955,3925,20200128,7880
20200125,2,잠실,37015,34804,20200128,71819
20200125,2,잠실새내,6524,7472,20200128,13996
20200125,2,종합운동장,2916,3193,20200128,6109
20200125,2,삼성,14847,14548,20200128,29395
20200125,2,선릉,5613,5048,20200128,10661
20200125,2,역삼,5132,5576,20200128,10708
20200125,2,강남,18365,20003,20200128,38368
20200125,2,교대,4753,5286,20200128,10039
20200125,2,서초,3210,2592,20200128,5802
20200125,2,방배,3578,3696,20200128,7274
20200125,2,사당,12336,13372,20200128,25708
20200125,2,낙성대,8502,8609,20200128,17111
20200125,2,서울대입구,15055,15479,20200128,30534
20200125,2,봉천,8597,8310,20200128,16907
20200125,2,신림,27095,28289,20200128,55384
20200125,2,신대방,12914,12996,20200128,25910
20200125,2,구로디지털단지,18464,18963,20200128,37427
20200125,2,대림,13452,14589,20200128,28041
20200125,2,신도림,18073,18080,20200128,36153
20200125,2,문래,4131,4262,20200128,8393
20200125,2,영등포구청,4350,4418,20200128,8768
20200125,2,당산,5445,6005,20200128,11450
20200125,2,합정,11133,12026,20200128,23159
20200125,2,홍대입구,37373,43471,20200128,80844
20200125,2,신촌,12854,13509,20200128,26363
20200125,2,이대,5337,5918,20200128,11255
20200125,2,아현,3633,3627,20200128,7260
20200125,2,충정로,3027,2817,20200128,5844
20200125,2,용답,1249,1280,20200128,2529
20200125,2,신답,522,549,20200128,1071
20200125,2,신설동,1452,1252,20200128,2704
20200125,2,도림천,289,281,20200128,570
20200125,2,양천구청,2617,2730,20200128,5347
20200125,2,신정네거리,4017,4120,20200128,8137
20200125,2,용두,795,809,20200128,1604
20200126,2,시청,7293,5847,20200129,13140
20200126,2,을지로입구,24875,22969,20200129,47844
20200126,2,을지로3가,8967,9102,20200129,18069
20200126,2,을지로4가,3526,3595,20200129,7121
20200126,2,동대문역사문화공원,11155,12028,20200129,23183
20200126,2,신당,7565,8541,20200129,16106
20200126,2,상왕십리,6018,6140,20200129,12158
20200126,2,왕십리,8232,8112,20200129,16344
20200126,2,한양대,1830,2145,20200129,3975
20200126,2,뚝섬,6528,6949,20200129,13477
20200126,2,성수,8203,9343,20200129,17546
20200126,2,건대입구,25609,31383,20200129,56992
20200126,2,구의,10080,10590,20200129,20670
20200126,2,강변,36341,25506,20200129,61847
20200126,2,잠실나루,5081,4995,20200129,10076
20200126,2,잠실,51575,48090,20200129,99665
20200126,2,잠실새내,9978,11564,20200129,21542
20200126,2,종합운동장,4943,4866,20200129,9809
20200126,2,삼성,21992,21572,20200129,43564
20200126,2,선릉,8179,7882,20200129,16061
20200126,2,역삼,8301,9721,20200129,18022
20200126,2,강남,31769,35387,20200129,67156
20200126,2,교대,8427,9570,20200129,17997
20200126,2,서초,9941,9597,20200129,19538
20200126,2,방배,6004,6410,20200129,12414
20200126,2,사당,19091,21379,20200129,40470
20200126,2,낙성대,11574,13224,20200129,24798
20200126,2,서울대입구,20712,24475,20200129,45187
20200126,2,봉천,10602,11044,20200129,21646
20200126,2,신림,34291,39207,20200129,73498
20200126,2,신대방,14556,15225,20200129,29781
20200126,2,구로디지털단지,25232,26726,20200129,51958
20200126,2,대림,16967,18091,20200129,35058
20200126,2,신도림,26439,27467,20200129,53906
20200126,2,문래,5604,5950,20200129,11554
20200126,2,영등포구청,5934,6466,20200129,12400
20200126,2,당산,7818,8808,20200129,16626
20200126,2,합정,17705,20264,20200129,37969
20200126,2,홍대입구,56309,64972,20200129,121281
20200126,2,신촌,20629,22670,20200129,43299
20200126,2,이대,6949,8204,20200129,15153
20200126,2,아현,4479,4520,20200129,8999
20200126,2,충정로,3572,3598,20200129,7170
20200126,2,용답,1441,1573,20200129,3014
20200126,2,신답,653,724,20200129,1377
20200126,2,신설동,2342,2353,20200129,4695
20200126,2,도림천,318,376,20200129,694
20200126,2,양천구청,3323,3312,20200129,6635
20200126,2,신정네거리,4865,5034,20200129,9899
20200126,2,용두,925,968,20200129,1893
20200127,2,시청,7298,5703,20200130,13001
20200127,2,을지로입구,23375,22495,20200130,45870
20200127,2,을지로3가,6909,6827,20200130,13736
20200127,2,을지로4가,4464,4604,20200130,9068
20200127,2,동대문역사문화공원,9574,10449,20200130,20023
20200127,2,신당,7105,7954,20200130,15059
20200127,2,상왕십리,6463,6552,20200130,13015
20200127,2,왕십리,9380,8997,20200130,18377
20200127,2,한양대,2191,2749,20200130,4940
20200127,2,뚝섬,6975,7502,20200130,14477
20200127,2,성수,9931,11302,20200130,21233
20200127,2,건대입구,27305,31218,20200130,58523
20200127,2,구의,11172,11874,20200130,23046
20200127,2,강변,35203,27308,20200130,62511
20200127,2,잠실나루,5596,5779,20200130,11375
20200127,2,잠실,52788,50048,20200130,102836
20200127,2,잠실새내,12190,12946,20200130,25136
20200127,2,종합운동장,4843,5587,20200130,10430
20200127,2,삼성,22822,22573,20200130,45395
20200127,2,선릉,12699,11775,20200130,24474
20200127,2,역삼,10924,12566,20200130,23490
20200127,2,강남,42470,42586,20200130,85056
20200127,2,교대,11143,12935,20200130,24078
20200127,2,서초,5432,4965,20200130,10397
20200127,2,방배,6214,6681,20200130,12895
20200127,2,사당,21403,24603,20200130,46006
20200127,2,낙성대,13176,15803,20200130,28979
20200127,2,서울대입구,25140,29197,20200130,54337
20200127,2,봉천,11436,12173,20200130,23609
20200127,2,신림,37467,41210,20200130,78677
20200127,2,신대방,15126,15817,20200130,30943
20200127,2,구로디지털단지,26557,28015,20200130,54572
20200127,2,대림,16281,16523,20200130,32804
20200127,2,신도림,30084,30670,20200130,60754
20200127,2,문래,6966,7439,20200130,14405
20200127,2,영등포구청,7345,8043,20200130,15388
20200127,2,당산,8425,9594,20200130,18019
20200127,2,합정,18139,19500,20200130,37639
20200127,2,홍대입구,59328,62335,20200130,121663
20200127,2,신촌,25077,26023,20200130,51100
20200127,2,이대,7944,9313,20200130,17257
20200127,2,아현,4771,4989,20200130,9760
20200127,2,충정로,3931,3984,20200130,7915
20200127,2,용답,1400,1594,20200130,2994
20200127,2,신답,660,824,20200130,1484
20200127,2,신설동,1983,1980,20200130,3963
20200127,2,도림천,538,586,20200130,1124
20200127,2,양천구청,3296,3470,20200130,6766
20200127,2,신정네거리,5006,5121,20200130,10127
20200127,2,용두,1144,1333,20200130,2477
20200128,2,시청,27271,26428,20200131,53699
20200128,2,을지로입구,49274,50114,20200131,99388
20200128,2,을지로3가,24045,23873,20200131,47918
20200128,2,을지로4가,13291,13418,20200131,26709
20200128,2,동대문역사문화공원,13591,16166,20200131,29757
20200128,2,신당,14213,14839,20200131,29052
20200128,2,상왕십리,14264,14033,20200131,28297
20200128,2,왕십리,17502,14850,20200131,32352
20200128,2,한양대,7168,8152,20200131,15320
20200128,2,뚝섬,20842,22301,20200131,43143
20200128,2,성수,33940,36524,20200131,70464
20200128,2,건대입구,37256,40587,20200131,77843
20200128,2,구의,24936,24892,20200131,49828
20200128,2,강변,42902,38594,20200131,81496
20200128,2,잠실나루,16121,15850,20200131,31971
20200128,2,잠실,75376,74128,20200131,149504
20200128,2,잠실새내,23464,23246,20200131,46710
20200128,2,종합운동장,7909,8636,20200131,16545
20200128,2,삼성,56145,57298,20200131,113443
20200128,2,선릉,60221,53610,20200131,113831
20200128,2,역삼,53992,59893,20200131,113885
20200128,2,강남,99953,101282,20200131,201235
20200128,2,교대,37181,41547,20200131,78728
20200128,2,서초,22157,22085,20200131,44242
20200128,2,방배,17811,18488,20200131,36299
20200128,2,사당,39193,43472,20200131,82665
20200128,2,낙성대,28962,29202,20200131,58164
20200128,2,서울대입구,50845,51463,20200131,102308
20200128,2,봉천,25493,24125,20200131,49618
20200128,2,신림,68218,67766,20200131,135984
20200128,2,신대방,28841,27805,20200131,56646
20200128,2,구로디지털단지,66984,67108,20200131,134092
20200128,2,대림,27325,27410,20200131,54735
20200128,2,신도림,55822,54845,20200131,110667
20200128,2,문래,22464,22740,20200131,45204
20200128,2,영등포구청,24096,24617,20200131,48713
20200128,2,당산,20398,23453,20200131,43851
20200128,2,합정,31942,33381,20200131,65323
20200128,2,홍대입구,67507,72390,20200131,139897
20200128,2,신촌,40540,42636,20200131,83176
20200128,2,이대,14563,16015,20200131,30578
20200128,2,아현,10187,9670,20200131,19857
20200128,2,충정로,10942,11468,20200131,22410
20200128,2,용답,2534,2561,20200131,5095
20200128,2,신답,1680,1974,20200131,3654
20200128,2,신설동,3265,3409,20200131,6674
20200128,2,도림천,1294,1368,20200131,2662
20200128,2,양천구청,7543,7903,20200131,15446
20200128,2,신정네거리,9791,10165,20200131,19956
20200128,2,용두,2372,2481,20200131,4853
20200129,2,시청,30273,29517,20200201,59790
20200129,2,을지로입구,51858,53039,20200201,104897
20200129,2,을지로3가,26391,26249,20200201,52640
20200129,2,을지로4가,14813,14729,20200201,29542
20200129,2,동대문역사문화공원,15428,17419,20200201,32847
20200129,2,신당,15339,16102,20200201,31441
20200129,2,상왕십리,15480,14712,20200201,30192
20200129,2,왕십리,18577,15767,20200201,34344
20200129,2,한양대,7833,8767,20200201,16600
20200129,2,뚝섬,22346,24019,20200201,46365
20200129,2,성수,36534,39450,20200201,75984
20200129,2,건대입구,38156,41229,20200201,79385
20200129,2,구의,26374,25778,20200201,52152
20200129,2,강변,40166,38680,20200201,78846
20200129,2,잠실나루,17203,16864,20200201,34067
20200129,2,잠실,78801,76812,20200201,155613
20200129,2,잠실새내,24727,24461,20200201,49188
20200129,2,종합운동장,9179,10439,20200201,19618
20200129,2,삼성,60717,62321,20200201,123038
20200129,2,선릉,65259,58109,20200201,123368
20200129,2,역삼,58714,65869,20200201,124583
20200129,2,강남,106844,107871,20200201,214715
20200129,2,교대,40019,45507,20200201,85526
20200129,2,서초,25002,25207,20200201,50209
20200129,2,방배,19530,20136,20200201,39666
20200129,2,사당,42831,46851,20200201,89682
20200129,2,낙성대,30689,29917,20200201,60606
20200129,2,서울대입구,54432,53511,20200201,107943
20200129,2,봉천,27083,25023,20200201,52106
20200129,2,신림,72308,70664,20200201,142972
20200129,2,신대방,30027,28962,20200201,58989
20200129,2,구로디지털단지,70508,70993,20200201,141501
20200129,2,대림,28215,28391,20200201,56606
20200129,2,신도림,58608,57728,20200201,116336
20200129,2,문래,23708,23874,20200201,47582
20200129,2,영등포구청,25159,25437,20200201,50596
20200129,2,당산,22430,25697,20200201,48127
20200129,2,합정,34310,35965,20200201,70275
20200129,2,홍대입구,68126,72676,20200201,140802
20200129,2,신촌,42858,44234,20200201,87092
20200129,2,이대,15417,16369,20200201,31786
20200129,2,아현,10877,10381,20200201,21258
20200129,2,충정로,11917,12672,20200201,24589
20200129,2,용답,2648,2644,20200201,5292
20200129,2,신답,1797,2059,20200201,3856
20200129,2,신설동,3725,3920,20200201,7645
20200129,2,도림천,1302,1408,20200201,2710
20200129,2,양천구청,7793,8280,20200201,16073
20200129,2,신정네거리,10425,10816,20200201,21241
20200129,2,용두,2508,2703,20200201,5211
20200130,2,용두,2586,2727,20200202,5313
20200130,2,신정네거리,10207,10676,20200202,20883
20200130,2,양천구청,7763,8213,20200202,15976
20200130,2,도림천,1375,1463,20200202,2838
20200130,2,신설동,3693,3718,20200202,7411
20200130,2,신답,1786,1998,20200202,3784
20200130,2,용답,2682,2670,20200202,5352
20200130,2,충정로,11913,12544,20200202,24457
20200130,2,아현,10842,10400,20200202,21242
20200130,2,이대,15698,16818,20200202,32516
20200130,2,신촌,42385,44009,20200202,86394
20200130,2,홍대입구,70210,74396,20200202,144606
20200130,2,합정,34923,36580,20200202,71503
20200130,2,당산,22698,25889,20200202,48587
20200130,2,영등포구청,26099,26099,20200202,52198
20200130,2,문래,24033,24345,20200202,48378
20200130,2,신도림,59792,59044,20200202,118836
20200130,2,대림,28046,28232,20200202,56278
20200130,2,구로디지털단지,71306,71596,20200202,142902
20200130,2,신대방,29825,28787,20200202,58612
20200130,2,신림,72365,70256,20200202,142621
20200130,2,봉천,27492,25248,20200202,52740
20200130,2,서울대입구,54995,53253,20200202,108248
20200130,2,낙성대,30611,29996,20200202,60607
20200130,2,사당,43899,47594,20200202,91493
20200130,2,방배,19203,19858,20200202,39061
20200130,2,서초,24596,25006,20200202,49602
20200130,2,교대,40655,46004,20200202,86659
20200130,2,강남,106050,108133,20200202,214183
20200130,2,역삼,59158,66231,20200202,125389
20200130,2,선릉,67058,59576,20200202,126634
20200130,2,삼성,61735,63706,20200202,125441
20200130,2,종합운동장,8627,10237,20200202,18864
20200130,2,잠실새내,24849,24755,20200202,49604
20200130,2,잠실,80368,78540,20200202,158908
20200130,2,잠실나루,17478,17029,20200202,34507
20200130,2,강변,39785,38288,20200202,78073
20200130,2,구의,26668,25860,20200202,52528
20200130,2,건대입구,38347,41111,20200202,79458
20200130,2,성수,36372,39368,20200202,75740
20200130,2,뚝섬,22020,23753,20200202,45773
20200130,2,한양대,7738,8657,20200202,16395
20200130,2,왕십리,18970,16036,20200202,35006
20200130,2,상왕십리,15452,14879,20200202,30331
20200130,2,신당,15231,15788,20200202,31019
20200130,2,동대문역사문화공원,15775,17920,20200202,33695
20200130,2,을지로4가,14785,14713,20200202,29498
20200130,2,을지로3가,26078,26098,20200202,52176
20200130,2,을지로입구,51912,53412,20200202,105324
20200130,2,시청,29734,29519,20200202,59253
20200131,2,시청,29557,28958,20200203,58515
20200131,2,을지로입구,52192,53824,20200203,106016
20200131,2,을지로3가,26276,26825,20200203,53101
20200131,2,을지로4가,14821,14829,20200203,29650
20200131,2,동대문역사문화공원,16080,18148,20200203,34228
20200131,2,신당,15660,16051,20200203,31711
20200131,2,상왕십리,15694,15091,20200203,30785
20200131,2,왕십리,19821,17013,20200203,36834
20200131,2,한양대,7714,8361,20200203,16075
20200131,2,뚝섬,22189,23941,20200203,46130
20200131,2,성수,36658,40065,20200203,76723
20200131,2,건대입구,39627,44294,20200203,83921
20200131,2,구의,26727,25864,20200203,52591
20200131,2,강변,42625,41402,20200203,84027
20200131,2,잠실나루,17167,16294,20200203,33461
20200131,2,잠실,80783,78372,20200203,159155
20200131,2,잠실새내,25763,26625,20200203,52388
20200131,2,종합운동장,9163,9926,20200203,19089
20200131,2,삼성,61768,63385,20200203,125153
20200131,2,선릉,65582,58482,20200203,124064
20200131,2,역삼,58682,66108,20200203,124790
20200131,2,강남,108233,112821,20200203,221054
20200131,2,교대,40610,46509,20200203,87119
20200131,2,서초,24212,24146,20200203,48358
20200131,2,방배,19207,19775,20200203,38982
20200131,2,사당,46151,50496,20200203,96647
20200131,2,낙성대,31485,29802,20200203,61287
20200131,2,서울대입구,57405,55016,20200203,112421
20200131,2,봉천,27679,25208,20200203,52887
20200131,2,신림,74018,72346,20200203,146364
20200131,2,신대방,30379,28625,20200203,59004
20200131,2,구로디지털단지,71642,71634,20200203,143276
20200131,2,대림,27845,27794,20200203,55639
20200131,2,신도림,59598,59191,20200203,118789
20200131,2,문래,23691,24189,20200203,47880
20200131,2,영등포구청,25843,26143,20200203,51986
20200131,2,당산,23042,26473,20200203,49515
20200131,2,합정,36134,39863,20200203,75997
20200131,2,홍대입구,70875,79651,20200203,150526
20200131,2,신촌,44028,45863,20200203,89891
20200131,2,이대,15813,16714,20200203,32527
20200131,2,아현,11241,10591,20200203,21832
20200131,2,충정로,11879,12548,20200203,24427
20200131,2,용답,2807,2679,20200203,5486
20200131,2,신답,1795,1996,20200203,3791
20200131,2,신설동,4254,4140,20200203,8394
20200131,2,도림천,1375,1441,20200203,2816
20200131,2,양천구청,7902,8247,20200203,16149
20200131,2,신정네거리,10440,10865,20200203,21305
20200131,2,용두,2591,2738,20200203,5329
20200201,2,시청,10021,8610,20200204,18631
20200201,2,을지로입구,25872,25656,20200204,51528
20200201,2,을지로3가,10897,11014,20200204,21911
20200201,2,을지로4가,8071,8486,20200204,16557
20200201,2,동대문역사문화공원,12248,13282,20200204,25530
20200201,2,신당,10707,11429,20200204,22136
20200201,2,상왕십리,9400,8652,20200204,18052
20200201,2,왕십리,14324,12605,20200204,26929
20200201,2,한양대,4543,4740,20200204,9283
20200201,2,뚝섬,11531,11678,20200204,23209
20200201,2,성수,16175,17802,20200204,33977
20200201,2,건대입구,33033,36697,20200204,69730
20200201,2,구의,16493,15788,20200204,32281
20200201,2,강변,33163,32452,20200204,65615
20200201,2,잠실나루,7826,7319,20200204,15145
20200201,2,잠실,58011,55089,20200204,113100
20200201,2,잠실새내,17071,18062,20200204,35133
20200201,2,종합운동장,7077,7663,20200204,14740
20200201,2,삼성,30274,30754,20200204,61028
20200201,2,선릉,26026,23009,20200204,49035
20200201,2,역삼,20189,21567,20200204,41756
20200201,2,강남,65598,69156,20200204,134754
20200201,2,교대,19897,22313,20200204,42210
20200201,2,서초,12416,11975,20200204,24391
20200201,2,방배,10582,11042,20200204,21624
20200201,2,사당,34268,37016,20200204,71284
20200201,2,낙성대,21912,20012,20200204,41924
20200201,2,서울대입구,39972,38731,20200204,78703
20200201,2,봉천,17798,16459,20200204,34257
20200201,2,신림,53866,51985,20200204,105851
20200201,2,신대방,20353,19296,20200204,39649
20200201,2,구로디지털단지,37857,37681,20200204,75538
20200201,2,대림,18342,18896,20200204,37238
20200201,2,신도림,45435,46224,20200204,91659
20200201,2,문래,11128,11488,20200204,22616
20200201,2,영등포구청,12795,12965,20200204,25760
20200201,2,당산,13276,14739,20200204,28015
20200201,2,합정,27985,31750,20200204,59735
20200201,2,홍대입구,69648,78330,20200204,147978
20200201,2,신촌,37013,38104,20200204,75117
20200201,2,이대,12197,12887,20200204,25084
20200201,2,아현,7309,6968,20200204,14277
20200201,2,충정로,6514,6768,20200204,13282
20200201,2,용답,1851,1800,20200204,3651
20200201,2,신답,1056,1049,20200204,2105
20200201,2,신설동,3657,3629,20200204,7286
20200201,2,도림천,782,770,20200204,1552
20200201,2,양천구청,4291,4446,20200204,8737
20200201,2,신정네거리,6892,6997,20200204,13889
20200201,2,용두,1733,1738,20200204,3471
20200202,2,시청,6241,5087,20200205,11328
20200202,2,을지로입구,19748,19416,20200205,39164
20200202,2,을지로3가,8897,8877,20200205,17774
20200202,2,을지로4가,3639,3485,20200205,7124
20200202,2,동대문역사문화공원,8583,10224,20200205,18807
20200202,2,신당,7667,8197,20200205,15864
20200202,2,상왕십리,6480,6166,20200205,12646
20200202,2,왕십리,10190,8824,20200205,19014
20200202,2,한양대,2392,2812,20200205,5204
20200202,2,뚝섬,7833,8099,20200205,15932
20200202,2,성수,10500,11806,20200205,22306
20200202,2,건대입구,25007,25895,20200205,50902
20200202,2,구의,11286,11115,20200205,22401
20200202,2,강변,24491,25304,20200205,49795
20200202,2,잠실나루,5194,5353,20200205,10547
20200202,2,잠실,41970,38764,20200205,80734
20200202,2,잠실새내,10890,11344,20200205,22234
20200202,2,종합운동장,4849,5247,20200205,10096
20200202,2,삼성,22060,21934,20200205,43994
20200202,2,선릉,13444,11679,20200205,25123
20200202,2,역삼,11795,12757,20200205,24552
20200202,2,강남,37382,36531,20200205,73913
20200202,2,교대,11308,12432,20200205,23740
20200202,2,서초,12828,12342,20200205,25170
20200202,2,방배,7619,7929,20200205,15548
20200202,2,사당,23229,24536,20200205,47765
20200202,2,낙성대,15615,15700,20200205,31315
20200202,2,서울대입구,27731,27901,20200205,55632
20200202,2,봉천,12529,12037,20200205,24566
20200202,2,신림,40218,38819,20200205,79037
20200202,2,신대방,15513,14858,20200205,30371
20200202,2,구로디지털단지,25749,25665,20200205,51414
20200202,2,대림,14245,14282,20200205,28527
20200202,2,신도림,30744,31004,20200205,61748
20200202,2,문래,7318,7484,20200205,14802
20200202,2,영등포구청,8251,8380,20200205,16631
20200202,2,당산,8749,9543,20200205,18292
20200202,2,합정,20122,20911,20200205,41033
20200202,2,홍대입구,54803,53722,20200205,108525
20200202,2,신촌,26785,25633,20200205,52418
20200202,2,이대,8488,9083,20200205,17571
20200202,2,아현,4878,4854,20200205,9732
20200202,2,충정로,4202,4251,20200205,8453
20200202,2,용답,1510,1411,20200205,2921
20200202,2,신답,705,800,20200205,1505
20200202,2,신설동,3061,2918,20200205,5979
20200202,2,도림천,408,410,20200205,818
20200202,2,양천구청,3119,3245,20200205,6364
20200202,2,신정네거리,4558,4718,20200205,9276
20200202,2,용두,1074,1106,20200205,2180
20200203,2,시청,28052,27686,20200206,55738
20200203,2,을지로입구,48582,49895,20200206,98477
20200203,2,을지로3가,25097,25301,20200206,50398
20200203,2,을지로4가,14282,13968,20200206,28250
20200203,2,동대문역사문화공원,14237,16191,20200206,30428
20200203,2,신당,14454,14829,20200206,29283
20200203,2,상왕십리,14851,14020,20200206,28871
20200203,2,왕십리,17721,14520,20200206,32241
20200203,2,한양대,7771,8779,20200206,16550
20200203,2,뚝섬,20904,22448,20200206,43352
20200203,2,성수,34897,37443,20200206,72340
20200203,2,건대입구,35727,37728,20200206,73455
20200203,2,구의,25419,25018,20200206,50437
20200203,2,강변,36937,36063,20200206,73000
20200203,2,잠실나루,16045,15816,20200206,31861
20200203,2,잠실,72031,70736,20200206,142767
20200203,2,잠실새내,23511,23204,20200206,46715
20200203,2,종합운동장,7941,8819,20200206,16760
20200203,2,삼성,56850,58407,20200206,115257
20200203,2,선릉,63324,56654,20200206,119978
20200203,2,역삼,57870,64218,20200206,122088
20200203,2,강남,100352,101584,20200206,201936
20200203,2,교대,37720,42536,20200206,80256
20200203,2,서초,23367,23090,20200206,46457
20200203,2,방배,18409,19014,20200206,37423
20200203,2,사당,38713,42878,20200206,81591
20200203,2,낙성대,28929,28516,20200206,57445
20200203,2,서울대입구,52135,50692,20200206,102827
20200203,2,봉천,26669,24686,20200206,51355
20200203,2,신림,68681,66920,20200206,135601
20200203,2,신대방,28523,27751,20200206,56274
20200203,2,구로디지털단지,67861,68039,20200206,135900
20200203,2,대림,26499,26559,20200206,53058
20200203,2,신도림,54333,52871,20200206,107204
20200203,2,문래,22570,22789,20200206,45359
20200203,2,영등포구청,24832,25156,20200206,49988
20200203,2,당산,20824,24100,20200206,44924
20200203,2,합정,31538,32574,20200206,64112
20200203,2,홍대입구,61615,63969,20200206,125584
20200203,2,신촌,40135,41544,20200206,81679
20200203,2,이대,15090,15968,20200206,31058
20200203,2,아현,10315,9928,20200206,20243
20200203,2,충정로,11655,12536,20200206,24191
20200203,2,용답,2591,2576,20200206,5167
20200203,2,신답,1749,2015,20200206,3764
20200203,2,신설동,3774,3724,20200206,7498
20200203,2,도림천,1429,1539,20200206,2968
20200203,2,양천구청,7547,7897,20200206,15444
20200203,2,신정네거리,10087,10302,20200206,20389
20200203,2,용두,2465,2620,20200206,5085
20200204,2,시청,29085,28147,20200207,57232
20200204,2,을지로입구,48960,49980,20200207,98940
20200204,2,을지로3가,25532,25099,20200207,50631
20200204,2,을지로4가,14383,14060,20200207,28443
20200204,2,동대문역사문화공원,14719,16710,20200207,31429
20200204,2,신당,14715,15357,20200207,30072
20200204,2,상왕십리,15083,14655,20200207,29738
20200204,2,왕십리,17877,14799,20200207,32676
20200204,2,한양대,7977,8635,20200207,16612
20200204,2,뚝섬,21689,23148,20200207,44837
20200204,2,성수,35401,38039,20200207,73440
20200204,2,건대입구,36061,38602,20200207,74663
20200204,2,구의,25665,25382,20200207,51047
20200204,2,강변,35641,34430,20200207,70071
20200204,2,잠실나루,16219,15823,20200207,32042
20200204,2,잠실,73810,71859,20200207,145669
20200204,2,잠실새내,23509,23523,20200207,47032
20200204,2,종합운동장,8113,8782,20200207,16895
20200204,2,삼성,59002,59904,20200207,118906
20200204,2,선릉,64433,57180,20200207,121613
20200204,2,역삼,59672,64976,20200207,124648
20200204,2,강남,103200,103228,20200207,206428
20200204,2,교대,38208,43029,20200207,81237
20200204,2,서초,23787,23473,20200207,47260
20200204,2,방배,18772,19607,20200207,38379
20200204,2,사당,40378,43668,20200207,84046
20200204,2,낙성대,30069,29245,20200207,59314
20200204,2,서울대입구,52406,50992,20200207,103398
20200204,2,봉천,26439,24661,20200207,51100
20200204,2,신림,69572,68381,20200207,137953
20200204,2,신대방,28580,27717,20200207,56297
20200204,2,구로디지털단지,68371,68631,20200207,137002
20200204,2,대림,26212,26423,20200207,52635
20200204,2,신도림,54226,53111,20200207,107337
20200204,2,문래,22854,23078,20200207,45932
20200204,2,영등포구청,25391,25427,20200207,50818
20200204,2,당산,21170,24628,20200207,45798
20200204,2,합정,33003,33850,20200207,66853
20200204,2,홍대입구,62935,65944,20200207,128879
20200204,2,신촌,41166,42269,20200207,83435
20200204,2,이대,15379,16064,20200207,31443
20200204,2,아현,10436,10151,20200207,20587
20200204,2,충정로,11994,12589,20200207,24583
20200204,2,용답,2627,2560,20200207,5187
20200204,2,신답,1711,1969,20200207,3680
20200204,2,신설동,3824,3616,20200207,7440
20200204,2,도림천,1506,1654,20200207,3160
20200204,2,양천구청,7277,7825,20200207,15102
20200204,2,신정네거리,9937,10236,20200207,20173
20200204,2,용두,2403,2596,20200207,4999
20200205,2,시청,28767,27874,20200208,56641
20200205,2,을지로입구,48185,49208,20200208,97393
20200205,2,을지로3가,25519,25496,20200208,51015
20200205,2,을지로4가,13719,13225,20200208,26944
20200205,2,동대문역사문화공원,14567,16201,20200208,30768
20200205,2,신당,14207,14777,20200208,28984
20200205,2,상왕십리,14742,14265,20200208,29007
20200205,2,왕십리,18123,15068,20200208,33191
20200205,2,한양대,7591,8310,20200208,15901
20200205,2,뚝섬,21391,22909,20200208,44300
20200205,2,성수,35103,37778,20200208,72881
20200205,2,건대입구,35426,38057,20200208,73483
20200205,2,구의,25052,24422,20200208,49474
20200205,2,강변,34758,33625,20200208,68383
20200205,2,잠실나루,15763,15134,20200208,30897
20200205,2,잠실,72954,71788,20200208,144742
20200205,2,잠실새내,23050,23133,20200208,46183
20200205,2,종합운동장,7881,8514,20200208,16395
20200205,2,삼성,59317,60697,20200208,120014
20200205,2,선릉,63230,56110,20200208,119340
20200205,2,역삼,59289,64570,20200208,123859
20200205,2,강남,102545,103379,20200208,205924
20200205,2,교대,37863,42848,20200208,80711
20200205,2,서초,23509,23645,20200208,47154
20200205,2,방배,18450,19057,20200208,37507
20200205,2,사당,39729,42689,20200208,82418
20200205,2,낙성대,29238,28371,20200208,57609
20200205,2,서울대입구,51183,49600,20200208,100783
20200205,2,봉천,25755,23980,20200208,49735
20200205,2,신림,68551,66599,20200208,135150
20200205,2,신대방,27797,26912,20200208,54709
20200205,2,구로디지털단지,66827,67502,20200208,134329
20200205,2,대림,25195,25371,20200208,50566
20200205,2,신도림,52817,51494,20200208,104311
20200205,2,문래,22149,22335,20200208,44484
20200205,2,영등포구청,24116,24447,20200208,48563
20200205,2,당산,20767,24116,20200208,44883
20200205,2,합정,32700,34204,20200208,66904
20200205,2,홍대입구,63059,66026,20200208,129085
20200205,2,신촌,40325,41329,20200208,81654
20200205,2,이대,15148,15909,20200208,31057
20200205,2,아현,10187,9818,20200208,20005
20200205,2,충정로,11874,12625,20200208,24499
20200205,2,용답,2505,2458,20200208,4963
20200205,2,신답,1652,1969,20200208,3621
20200205,2,신설동,3677,3676,20200208,7353
20200205,2,도림천,1459,1640,20200208,3099
20200205,2,양천구청,7126,7602,20200208,14728
20200205,2,신정네거리,9624,9846,20200208,19470
20200205,2,용두,2349,2515,20200208,4864
20200206,2,시청,27971,27700,20200209,55671
20200206,2,을지로입구,47180,48644,20200209,95824
20200206,2,을지로3가,24612,24642,20200209,49254
20200206,2,을지로4가,13544,13383,20200209,26927
20200206,2,동대문역사문화공원,14056,15831,20200209,29887
20200206,2,신당,14132,14668,20200209,28800
20200206,2,상왕십리,14406,14074,20200209,28480
20200206,2,왕십리,17726,14948,20200209,32674
20200206,2,한양대,7482,8349,20200209,15831
20200206,2,뚝섬,20742,22544,20200209,43286
20200206,2,성수,34643,37260,20200209,71903
20200206,2,건대입구,35041,37799,20200209,72840
20200206,2,구의,24808,24172,20200209,48980
20200206,2,강변,34212,33363,20200209,67575
20200206,2,잠실나루,15521,14762,20200209,30283
20200206,2,잠실,71464,69150,20200209,140614
20200206,2,잠실새내,22733,22306,20200209,45039
20200206,2,종합운동장,7782,8645,20200209,16427
20200206,2,삼성,57447,59325,20200209,116772
20200206,2,선릉,62378,55752,20200209,118130
20200206,2,역삼,57805,64069,20200209,121874
20200206,2,강남,101782,102485,20200209,204267
20200206,2,교대,36971,41959,20200209,78930
20200206,2,서초,23083,23389,20200209,46472
20200206,2,방배,18119,18608,20200209,36727
20200206,2,사당,39375,42821,20200209,82196
20200206,2,낙성대,28726,27751,20200209,56477
20200206,2,서울대입구,50932,49307,20200209,100239
20200206,2,봉천,25744,23844,20200209,49588
20200206,2,신림,68172,66276,20200209,134448
20200206,2,신대방,27791,26584,20200209,54375
20200206,2,구로디지털단지,66697,67009,20200209,133706
20200206,2,대림,25046,25188,20200209,50234
20200206,2,신도림,53086,51782,20200209,104868
20200206,2,문래,21661,21915,20200209,43576
20200206,2,영등포구청,24334,24501,20200209,48835
20200206,2,당산,20663,23797,20200209,44460
20200206,2,합정,32557,34186,20200209,66743
20200206,2,홍대입구,63111,66274,20200209,129385
20200206,2,신촌,39410,40969,20200209,80379
20200206,2,이대,14692,15237,20200209,29929
20200206,2,아현,10052,9743,20200209,19795
20200206,2,충정로,11797,12297,20200209,24094
20200206,2,용답,2543,2505,20200209,5048
20200206,2,신답,1651,1875,20200209,3526
20200206,2,신설동,3500,3676,20200209,7176
20200206,2,도림천,1471,1625,20200209,3096
20200206,2,양천구청,7007,7458,20200209,14465
20200206,2,신정네거리,9467,9775,20200209,19242
20200206,2,용두,2214,2411,20200209,4625
20200207,2,시청,28242,27511,20200210,55753
20200207,2,을지로입구,46799,48657,20200210,95456
20200207,2,을지로3가,25284,25487,20200210,50771
20200207,2,을지로4가,13856,13734,20200210,27590
20200207,2,동대문역사문화공원,14882,16823,20200210,31705
20200207,2,신당,14774,15393,20200210,30167
20200207,2,상왕십리,15175,14412,20200210,29587
20200207,2,왕십리,18721,16084,20200210,34805
20200207,2,한양대,7557,8302,20200210,15859
20200207,2,뚝섬,21666,23270,20200210,44936
20200207,2,성수,35229,38668,20200210,73897
20200207,2,건대입구,38408,42965,20200210,81373
20200207,2,구의,25604,24923,20200210,50527
20200207,2,강변,38800,38375,20200210,77175
20200207,2,잠실나루,15611,14862,20200210,30473
20200207,2,잠실,74405,70983,20200210,145388
20200207,2,잠실새내,23880,24481,20200210,48361
20200207,2,종합운동장,8379,9274,20200210,17653
20200207,2,삼성,58663,59755,20200210,118418
20200207,2,선릉,63327,56242,20200210,119569
20200207,2,역삼,57659,64289,20200210,121948
20200207,2,강남,106007,110312,20200210,216319
20200207,2,교대,38486,43622,20200210,82108
20200207,2,서초,23435,23395,20200210,46830
20200207,2,방배,18637,19089,20200210,37726
20200207,2,사당,42372,46504,20200210,88876
20200207,2,낙성대,30047,27952,20200210,57999
20200207,2,서울대입구,53692,51436,20200210,105128
20200207,2,봉천,26564,24013,20200210,50577
20200207,2,신림,71326,69380,20200210,140706
20200207,2,신대방,28781,27139,20200210,55920
20200207,2,구로디지털단지,69178,69194,20200210,138372
20200207,2,대림,25776,25738,20200210,51514
20200207,2,신도림,55839,55615,20200210,111454
20200207,2,문래,21437,21647,20200210,43084
20200207,2,영등포구청,24714,24628,20200210,49342
20200207,2,당산,21576,25038,20200210,46614
20200207,2,합정,34861,38582,20200210,73443
20200207,2,홍대입구,66760,75006,20200210,141766
20200207,2,신촌,41236,42968,20200210,84204
20200207,2,이대,15025,15401,20200210,30426
20200207,2,아현,10539,9909,20200210,20448
20200207,2,충정로,11762,12366,20200210,24128
20200207,2,용답,2682,2501,20200210,5183
20200207,2,신답,1744,1917,20200210,3661
20200207,2,신설동,4056,4144,20200210,8200
20200207,2,도림천,1310,1415,20200210,2725
20200207,2,양천구청,7248,7723,20200210,14971
20200207,2,신정네거리,9946,10319,20200210,20265
20200207,2,용두,2472,2493,20200210,4965
20200208,2,시청,8918,7766,20200211,16684
20200208,2,을지로입구,17279,17205,20200211,34484
20200208,2,을지로3가,10327,10104,20200211,20431
20200208,2,을지로4가,7430,7447,20200211,14877
20200208,2,동대문역사문화공원,11417,11787,20200211,23204
20200208,2,신당,10131,10760,20200211,20891
20200208,2,상왕십리,8977,8220,20200211,17197
20200208,2,왕십리,13888,12440,20200211,26328
20200208,2,한양대,4079,4363,20200211,8442
20200208,2,뚝섬,11586,11639,20200211,23225
20200208,2,성수,15090,16756,20200211,31846
20200208,2,건대입구,32420,36233,20200211,68653
20200208,2,구의,15865,15191,20200211,31056
20200208,2,강변,31123,30843,20200211,61966
20200208,2,잠실나루,7132,6848,20200211,13980
20200208,2,잠실,54268,50172,20200211,104440
20200208,2,잠실새내,16199,17067,20200211,33266
20200208,2,종합운동장,5064,6124,20200211,11188
20200208,2,삼성,28953,29097,20200211,58050
20200208,2,선릉,27064,23749,20200211,50813
20200208,2,역삼,19668,21309,20200211,40977
20200208,2,강남,66548,69937,20200211,136485
20200208,2,교대,18797,21109,20200211,39906
20200208,2,서초,12118,11165,20200211,23283
20200208,2,방배,10610,10795,20200211,21405
20200208,2,사당,31721,35093,20200211,66814
20200208,2,낙성대,21376,19670,20200211,41046
20200208,2,서울대입구,39399,38085,20200211,77484
20200208,2,봉천,17569,16144,20200211,33713
20200208,2,신림,52486,50431,20200211,102917
20200208,2,신대방,19463,18633,20200211,38096
20200208,2,구로디지털단지,36414,36367,20200211,72781
20200208,2,대림,17677,18208,20200211,35885
20200208,2,신도림,43365,43610,20200211,86975
20200208,2,문래,11089,11441,20200211,22530
20200208,2,영등포구청,12636,12853,20200211,25489
20200208,2,당산,12678,14349,20200211,27027
20200208,2,합정,26773,29829,20200211,56602
20200208,2,홍대입구,67318,75947,20200211,143265
20200208,2,신촌,34429,35173,20200211,69602
20200208,2,이대,11590,11887,20200211,23477
20200208,2,아현,6695,6425,20200211,13120
20200208,2,충정로,6637,6898,20200211,13535
20200208,2,용답,1830,1707,20200211,3537
20200208,2,신답,977,1016,20200211,1993
20200208,2,신설동,3477,3366,20200211,6843
20200208,2,도림천,826,823,20200211,1649
20200208,2,양천구청,4176,4215,20200211,8391
20200208,2,신정네거리,6583,6701,20200211,13284
20200208,2,용두,1602,1632,20200211,3234
20200209,2,시청,6247,5231,20200212,11478
20200209,2,을지로입구,13247,12938,20200212,26185
20200209,2,을지로3가,8533,8388,20200212,16921
20200209,2,을지로4가,3421,3314,20200212,6735
20200209,2,동대문역사문화공원,8404,10301,20200212,18705
20200209,2,신당,7499,8049,20200212,15548
20200209,2,상왕십리,6352,6249,20200212,12601
20200209,2,왕십리,10266,8833,20200212,19099
20200209,2,한양대,2553,2921,20200212,5474
20200209,2,뚝섬,7879,8160,20200212,16039
20200209,2,성수,9899,10879,20200212,20778
20200209,2,건대입구,25115,26577,20200212,51692
20200209,2,구의,10872,10819,20200212,21691
20200209,2,강변,23303,24432,20200212,47735
20200209,2,잠실나루,4943,4961,20200212,9904
20200209,2,잠실,40385,37265,20200212,77650
20200209,2,잠실새내,10493,10997,20200212,21490
20200209,2,종합운동장,4775,5270,20200212,10045
20200209,2,삼성,21919,21491,20200212,43410
20200209,2,선릉,13227,11927,20200212,25154
20200209,2,역삼,12184,13189,20200212,25373
20200209,2,강남,40663,39982,20200212,80645
20200209,2,교대,11955,12840,20200212,24795
20200209,2,서초,12376,11858,20200212,24234
20200209,2,방배,7317,7641,20200212,14958
20200209,2,사당,22360,24105,20200212,46465
20200209,2,낙성대,15588,15774,20200212,31362
20200209,2,서울대입구,28200,28556,20200212,56756
20200209,2,봉천,12353,11725,20200212,24078
20200209,2,신림,39631,38692,20200212,78323
20200209,2,신대방,14905,14287,20200212,29192
20200209,2,구로디지털단지,25221,24912,20200212,50133
20200209,2,대림,13139,12833,20200212,25972
20200209,2,신도림,29359,29856,20200212,59215
20200209,2,문래,6782,6890,20200212,13672
20200209,2,영등포구청,7800,7999,20200212,15799
20200209,2,당산,8666,9393,20200212,18059
20200209,2,합정,21022,21573,20200212,42595
20200209,2,홍대입구,55518,55411,20200212,110929
20200209,2,신촌,25746,25016,20200212,50762
20200209,2,이대,8422,8960,20200212,17382
20200209,2,아현,4684,4756,20200212,9440
20200209,2,충정로,3812,3960,20200212,7772
20200209,2,용답,1423,1380,20200212,2803
20200209,2,신답,638,728,20200212,1366
20200209,2,신설동,2829,2964,20200212,5793
20200209,2,도림천,387,425,20200212,812
20200209,2,양천구청,3005,3154,20200212,6159
20200209,2,신정네거리,4463,4503,20200212,8966
20200209,2,용두,915,951,20200212,1866
20200210,2,시청,28078,27330,20200213,55408
20200210,2,을지로입구,46350,47564,20200213,93914
20200210,2,을지로3가,24887,24898,20200213,49785
20200210,2,을지로4가,14076,13911,20200213,27987
20200210,2,동대문역사문화공원,14105,15861,20200213,29966
20200210,2,신당,14458,14691,20200213,29149
20200210,2,상왕십리,14579,13992,20200213,28571
20200210,2,왕십리,17494,14952,20200213,32446
20200210,2,한양대,7437,8183,20200213,15620
20200210,2,뚝섬,20345,21968,20200213,42313
20200210,2,성수,34282,36989,20200213,71271
20200210,2,건대입구,37100,39351,20200213,76451
20200210,2,구의,25158,24699,20200213,49857
20200210,2,강변,36856,35855,20200213,72711
20200210,2,잠실나루,15519,15130,20200213,30649
20200210,2,잠실,69697,67781,20200213,137478
20200210,2,잠실새내,23183,22911,20200213,46094
20200210,2,종합운동장,7297,8181,20200213,15478
20200210,2,삼성,55490,56698,20200213,112188
20200210,2,선릉,63799,57024,20200213,120823
20200210,2,역삼,57779,64380,20200213,122159
20200210,2,강남,103591,104910,20200213,208501
20200210,2,교대,37789,42484,20200213,80273
20200210,2,서초,23092,22841,20200213,45933
20200210,2,방배,18199,18828,20200213,37027
20200210,2,사당,39054,43198,20200213,82252
20200210,2,낙성대,29099,28361,20200213,57460
20200210,2,서울대입구,51754,50980,20200213,102734
20200210,2,봉천,26109,24297,20200213,50406
20200210,2,신림,68684,66718,20200213,135402
20200210,2,신대방,28430,27101,20200213,55531
20200210,2,구로디지털단지,67547,68200,20200213,135747
20200210,2,대림,26728,26677,20200213,53405
20200210,2,신도림,52903,51940,20200213,104843
20200210,2,문래,22046,22390,20200213,44436
20200210,2,영등포구청,24566,24690,20200213,49256
20200210,2,당산,21123,24249,20200213,45372
20200210,2,합정,32302,33750,20200213,66052
20200210,2,홍대입구,64580,68102,20200213,132682
20200210,2,신촌,38295,39285,20200213,77580
20200210,2,이대,14066,14948,20200213,29014
20200210,2,아현,9955,9627,20200213,19582
20200210,2,충정로,11058,11785,20200213,22843
20200210,2,용답,2531,2544,20200213,5075
20200210,2,신답,1758,2022,20200213,3780
20200210,2,신설동,3734,3686,20200213,7420
20200210,2,도림천,1282,1333,20200213,2615
20200210,2,양천구청,7357,7710,20200213,15067
20200210,2,신정네거리,9907,10188,20200213,20095
20200210,2,용두,2365,2485,20200213,4850
20200211,2,시청,28281,28290,20200214,56571
20200211,2,을지로입구,48237,49635,20200214,97872
20200211,2,을지로3가,25405,25385,20200214,50790
20200211,2,을지로4가,14313,14152,20200214,28465
20200211,2,동대문역사문화공원,14407,16231,20200214,30638
20200211,2,신당,14841,15478,20200214,30319
20200211,2,상왕십리,14947,14312,20200214,29259
20200211,2,왕십리,18000,15090,20200214,33090
20200211,2,한양대,7320,8028,20200214,15348
20200211,2,뚝섬,21880,23483,20200214,45363
20200211,2,성수,35833,38821,20200214,74654
20200211,2,건대입구,38394,41279,20200214,79673
20200211,2,구의,25817,25155,20200214,50972
20200211,2,강변,36315,35112,20200214,71427
20200211,2,잠실나루,16100,15614,20200214,31714
20200211,2,잠실,76655,74480,20200214,151135
20200211,2,잠실새내,23571,23491,20200214,47062
20200211,2,종합운동장,7850,8509,20200214,16359
20200211,2,삼성,59244,60681,20200214,119925
20200211,2,선릉,65259,58128,20200214,123387
20200211,2,역삼,58309,65073,20200214,123382
20200211,2,강남,106091,107900,20200214,213991
20200211,2,교대,39372,43888,20200214,83260
20200211,2,서초,23924,24029,20200214,47953
20200211,2,방배,18732,19381,20200214,38113
20200211,2,사당,41263,45301,20200214,86564
20200211,2,낙성대,30673,29364,20200214,60037
20200211,2,서울대입구,54482,53162,20200214,107644
20200211,2,봉천,26935,24903,20200214,51838
20200211,2,신림,70545,68368,20200214,138913
20200211,2,신대방,28974,27835,20200214,56809
20200211,2,구로디지털단지,69538,69974,20200214,139512
20200211,2,대림,26858,26972,20200214,53830
20200211,2,신도림,54598,53409,20200214,108007
20200211,2,문래,22850,23128,20200214,45978
20200211,2,영등포구청,24906,25081,20200214,49987
20200211,2,당산,21792,25203,20200214,46995
20200211,2,합정,33873,35542,20200214,69415
20200211,2,홍대입구,66567,70247,20200214,136814
20200211,2,신촌,40610,41868,20200214,82478
20200211,2,이대,14241,15120,20200214,29361
20200211,2,아현,10439,9825,20200214,20264
20200211,2,충정로,11577,12120,20200214,23697
20200211,2,용답,2617,2580,20200214,5197
20200211,2,신답,1768,1951,20200214,3719
20200211,2,신설동,3492,3682,20200214,7174
20200211,2,도림천,1271,1383,20200214,2654
20200211,2,양천구청,7343,7807,20200214,15150
20200211,2,신정네거리,10032,10381,20200214,20413
20200211,2,용두,2485,2604,20200214,5089
20200212,2,시청,28890,28059,20200215,56949
20200212,2,을지로입구,47329,48682,20200215,96011
20200212,2,을지로3가,25411,25134,20200215,50545
20200212,2,을지로4가,14060,13818,20200215,27878
20200212,2,동대문역사문화공원,14094,15703,20200215,29797
20200212,2,신당,14314,15017,20200215,29331
20200212,2,상왕십리,14973,14473,20200215,29446
20200212,2,왕십리,17863,15096,20200215,32959
20200212,2,한양대,7242,8051,20200215,15293
20200212,2,뚝섬,21529,23118,20200215,44647
20200212,2,성수,35463,38469,20200215,73932
20200212,2,건대입구,36585,38965,20200215,75550
20200212,2,구의,25179,24805,20200215,49984
20200212,2,강변,35661,34761,20200215,70422
20200212,2,잠실나루,15870,15383,20200215,31253
20200212,2,잠실,72665,71020,20200215,143685
20200212,2,잠실새내,23174,23074,20200215,46248
20200212,2,종합운동장,7640,8168,20200215,15808
20200212,2,삼성,60306,61516,20200215,121822
20200212,2,선릉,64220,56880,20200215,121100
20200212,2,역삼,58563,64488,20200215,123051
20200212,2,강남,104164,104777,20200215,208941
20200212,2,교대,38245,43128,20200215,81373
20200212,2,서초,23684,23697,20200215,47381
20200212,2,방배,18278,19010,20200215,37288
20200212,2,사당,40280,43988,20200215,84268
20200212,2,낙성대,29524,28619,20200215,58143
20200212,2,서울대입구,51472,49935,20200215,101407
20200212,2,봉천,26001,24098,20200215,50099
20200212,2,신림,68653,67056,20200215,135709
20200212,2,신대방,28061,26915,20200215,54976
20200212,2,구로디지털단지,67205,67924,20200215,135129
20200212,2,대림,25473,25572,20200215,51045
20200212,2,신도림,54919,53304,20200215,108223
20200212,2,문래,22030,22499,20200215,44529
20200212,2,영등포구청,24215,24400,20200215,48615
20200212,2,당산,21205,24603,20200215,45808
20200212,2,합정,33205,34413,20200215,67618
20200212,2,홍대입구,62346,66542,20200215,128888
20200212,2,신촌,40142,41152,20200215,81294
20200212,2,이대,13909,14673,20200215,28582
20200212,2,아현,9978,9584,20200215,19562
20200212,2,충정로,11524,12136,20200215,23660
20200212,2,용답,2466,2473,20200215,4939
20200212,2,신답,1676,2012,20200215,3688
20200212,2,신설동,3586,3630,20200215,7216
20200212,2,도림천,1287,1356,20200215,2643
20200212,2,양천구청,7220,7703,20200215,14923
20200212,2,신정네거리,9773,10058,20200215,19831
20200212,2,용두,2306,2459,20200215,4765
20200213,2,시청,28951,28385,20200216,57336
20200213,2,을지로입구,48529,50166,20200216,98695
20200213,2,을지로3가,25432,25528,20200216,50960
20200213,2,을지로4가,14718,14693,20200216,29411
20200213,2,동대문역사문화공원,14768,16466,20200216,31234
20200213,2,신당,15179,15823,20200216,31002
20200213,2,상왕십리,15251,14621,20200216,29872
20200213,2,왕십리,18582,15809,20200216,34391
20200213,2,한양대,7492,8106,20200216,15598
20200213,2,뚝섬,22367,24087,20200216,46454
20200213,2,성수,35725,39058,20200216,74783
20200213,2,건대입구,40195,43457,20200216,83652
20200213,2,구의,26435,25531,20200216,51966
20200213,2,강변,37819,37115,20200216,74934
20200213,2,잠실나루,16510,15874,20200216,32384
20200213,2,잠실,79076,76961,20200216,156037
20200213,2,잠실새내,24321,24309,20200216,48630
20200213,2,종합운동장,8594,9092,20200216,17686
20200213,2,삼성,62617,64178,20200216,126795
20200213,2,선릉,65276,58558,20200216,123834
20200213,2,역삼,58501,65820,20200216,124321
20200213,2,강남,108592,109881,20200216,218473
20200213,2,교대,39645,44682,20200216,84327
20200213,2,서초,24434,24819,20200216,49253
20200213,2,방배,19177,19974,20200216,39151
20200213,2,사당,42287,46494,20200216,88781
20200213,2,낙성대,30453,29248,20200216,59701
20200213,2,서울대입구,53420,51842,20200216,105262
20200213,2,봉천,26959,24986,20200216,51945
20200213,2,신림,71430,69442,20200216,140872
20200213,2,신대방,29304,27910,20200216,57214
20200213,2,구로디지털단지,70270,70047,20200216,140317
20200213,2,대림,26926,26989,20200216,53915
20200213,2,신도림,56585,56235,20200216,112820
20200213,2,문래,22475,22973,20200216,45448
20200213,2,영등포구청,25217,25328,20200216,50545
20200213,2,당산,22357,25567,20200216,47924
20200213,2,합정,34867,37269,20200216,72136
20200213,2,홍대입구,70215,75160,20200216,145375
20200213,2,신촌,41552,43077,20200216,84629
20200213,2,이대,14807,15577,20200216,30384
20200213,2,아현,10283,9788,20200216,20071
20200213,2,충정로,11610,12169,20200216,23779
20200213,2,용답,2604,2578,20200216,5182
20200213,2,신답,1763,1976,20200216,3739
20200213,2,신설동,3571,3555,20200216,7126
20200213,2,도림천,1233,1308,20200216,2541
20200213,2,양천구청,7465,7791,20200216,15256
20200213,2,신정네거리,10134,10459,20200216,20593
20200213,2,용두,2480,2556,20200216,5036
20200214,2,시청,28553,28430,20200217,56983
20200214,2,을지로입구,50023,51100,20200217,101123
20200214,2,을지로3가,26370,26524,20200217,52894
20200214,2,을지로4가,14726,14755,20200217,29481
20200214,2,동대문역사문화공원,15556,17910,20200217,33466
20200214,2,신당,15690,16406,20200217,32096
20200214,2,상왕십리,15890,14873,20200217,30763
20200214,2,왕십리,19905,17390,20200217,37295
20200214,2,한양대,7439,8310,20200217,15749
20200214,2,뚝섬,22655,24206,20200217,46861
20200214,2,성수,36480,39822,20200217,76302
20200214,2,건대입구,43595,49376,20200217,92971
20200214,2,구의,27053,26008,20200217,53061
20200214,2,강변,43456,42556,20200217,86012
20200214,2,잠실나루,16794,15740,20200217,32534
20200214,2,잠실,85045,82142,20200217,167187
20200214,2,잠실새내,25605,26809,20200217,52414
20200214,2,종합운동장,8423,8840,20200217,17263
20200214,2,삼성,65217,66467,20200217,131684
20200214,2,선릉,65557,58337,20200217,123894
20200214,2,역삼,58548,65798,20200217,124346
20200214,2,강남,113614,119315,20200217,232929
20200214,2,교대,40215,45572,20200217,85787
20200214,2,서초,24583,24451,20200217,49034
20200214,2,방배,20143,20478,20200217,40621
20200214,2,사당,45905,50455,20200217,96360
20200214,2,낙성대,32147,29791,20200217,61938
20200214,2,서울대입구,57027,54789,20200217,111816
20200214,2,봉천,27960,24944,20200217,52904
20200214,2,신림,74964,73124,20200217,148088
20200214,2,신대방,30339,28270,20200217,58609
20200214,2,구로디지털단지,72247,72004,20200217,144251
20200214,2,대림,27892,27777,20200217,55669
20200214,2,신도림,61139,60335,20200217,121474
20200214,2,문래,23006,23753,20200217,46759
20200214,2,영등포구청,25754,25828,20200217,51582
20200214,2,당산,22928,26148,20200217,49076
20200214,2,합정,37703,41804,20200217,79507
20200214,2,홍대입구,76030,87780,20200217,163810
20200214,2,신촌,45346,47320,20200217,92666
20200214,2,이대,15478,15846,20200217,31324
20200214,2,아현,10760,9955,20200217,20715
20200214,2,충정로,11859,12479,20200217,24338
20200214,2,용답,2823,2684,20200217,5507
20200214,2,신답,1884,2024,20200217,3908
20200214,2,신설동,4036,4172,20200217,8208
20200214,2,도림천,1334,1350,20200217,2684
20200214,2,양천구청,7773,8023,20200217,15796
20200214,2,신정네거리,10701,10980,20200217,21681
20200214,2,용두,2651,2781,20200217,5432
20200215,2,시청,10544,9256,20200218,19800
20200215,2,을지로입구,25944,25319,20200218,51263
20200215,2,을지로3가,11118,11092,20200218,22210
20200215,2,을지로4가,8257,8439,20200218,16696
20200215,2,동대문역사문화공원,12610,13390,20200218,26000
20200215,2,신당,11391,12018,20200218,23409
20200215,2,상왕십리,9990,9120,20200218,19110
20200215,2,왕십리,15407,13342,20200218,28749
20200215,2,한양대,4518,4740,20200218,9258
20200215,2,뚝섬,12792,13394,20200218,26186
20200215,2,성수,16350,18397,20200218,34747
20200215,2,건대입구,38019,41708,20200218,79727
20200215,2,구의,17565,16560,20200218,34125
20200215,2,강변,36223,35753,20200218,71976
20200215,2,잠실나루,7997,7605,20200218,15602
20200215,2,잠실,67531,63648,20200218,131179
20200215,2,잠실새내,18208,19181,20200218,37389
20200215,2,종합운동장,5206,6029,20200218,11235
20200215,2,삼성,33112,33497,20200218,66609
20200215,2,선릉,28554,25401,20200218,53955
20200215,2,역삼,21517,23762,20200218,45279
20200215,2,강남,75772,80458,20200218,156230
20200215,2,교대,20191,22824,20200218,43015
20200215,2,서초,13833,12721,20200218,26554
20200215,2,방배,11145,11302,20200218,22447
20200215,2,사당,35184,38671,20200218,73855
20200215,2,낙성대,23477,21382,20200218,44859
20200215,2,서울대입구,42240,40429,20200218,82669
20200215,2,봉천,19063,17420,20200218,36483
20200215,2,신림,56507,54467,20200218,110974
20200215,2,신대방,21551,20102,20200218,41653
20200215,2,구로디지털단지,40829,40075,20200218,80904
20200215,2,대림,19398,20077,20200218,39475
20200215,2,신도림,48709,49796,20200218,98505
20200215,2,문래,12346,12865,20200218,25211
20200215,2,영등포구청,13759,14212,20200218,27971
20200215,2,당산,14115,15441,20200218,29556
20200215,2,합정,30646,34402,20200218,65048
20200215,2,홍대입구,77574,87171,20200218,164745
20200215,2,신촌,38402,39061,20200218,77463
20200215,2,이대,11884,12729,20200218,24613
20200215,2,아현,7603,7088,20200218,14691
20200215,2,충정로,6589,7027,20200218,13616
20200215,2,용답,2022,1901,20200218,3923
20200215,2,신답,1040,1018,20200218,2058
20200215,2,신설동,3757,3617,20200218,7374
20200215,2,도림천,776,766,20200218,1542
20200215,2,양천구청,4691,4735,20200218,9426
20200215,2,신정네거리,7342,7442,20200218,14784
20200215,2,용두,1846,1889,20200218,3735
20200216,2,시청,6408,5235,20200219,11643
20200216,2,을지로입구,18541,18372,20200219,36913
20200216,2,을지로3가,8606,8357,20200219,16963
20200216,2,을지로4가,3735,3534,20200219,7269
20200216,2,동대문역사문화공원,8491,10262,20200219,18753
20200216,2,신당,7317,8054,20200219,15371
20200216,2,상왕십리,6713,6624,20200219,13337
20200216,2,왕십리,10863,9376,20200219,20239
20200216,2,한양대,2594,2883,20200219,5477
20200216,2,뚝섬,7941,8160,20200219,16101
20200216,2,성수,10220,11161,20200219,21381
20200216,2,건대입구,26996,28440,20200219,55436
20200216,2,구의,11546,11501,20200219,23047
20200216,2,강변,26393,27667,20200219,54060
20200216,2,잠실나루,5255,5273,20200219,10528
20200216,2,잠실,47279,44438,20200219,91717
20200216,2,잠실새내,11786,12142,20200219,23928
20200216,2,종합운동장,4679,5174,20200219,9853
20200216,2,삼성,25730,25501,20200219,51231
20200216,2,선릉,14144,12323,20200219,26467
20200216,2,역삼,13289,14098,20200219,27387
20200216,2,강남,43892,43610,20200219,87502
20200216,2,교대,12065,13493,20200219,25558
20200216,2,서초,13795,13082,20200219,26877
20200216,2,방배,7596,8023,20200219,15619
20200216,2,사당,23113,24927,20200219,48040
20200216,2,낙성대,16061,16413,20200219,32474
20200216,2,서울대입구,29005,29124,20200219,58129
20200216,2,봉천,12855,12570,20200219,25425
20200216,2,신림,41356,40389,20200219,81745
20200216,2,신대방,15426,15053,20200219,30479
20200216,2,구로디지털단지,26626,26704,20200219,53330
20200216,2,대림,14085,14131,20200219,28216
20200216,2,신도림,31280,31941,20200219,63221
20200216,2,문래,7394,7518,20200219,14912
20200216,2,영등포구청,8834,9217,20200219,18051
20200216,2,당산,8651,9705,20200219,18356
20200216,2,합정,21891,22380,20200219,44271
20200216,2,홍대입구,58925,57965,20200219,116890
20200216,2,신촌,28130,27065,20200219,55195
20200216,2,이대,8442,8738,20200219,17180
20200216,2,아현,5150,5160,20200219,10310
20200216,2,충정로,4134,4353,20200219,8487
20200216,2,용답,1445,1482,20200219,2927
20200216,2,신답,685,752,20200219,1437
20200216,2,신설동,2786,2589,20200219,5375
20200216,2,도림천,411,442,20200219,853
20200216,2,양천구청,3341,3525,20200219,6866
20200216,2,신정네거리,5033,5064,20200219,10097
20200216,2,용두,1008,1099,20200219,2107
20200217,2,시청,28540,27994,20200220,56534
20200217,2,을지로입구,47360,49007,20200220,96367
20200217,2,을지로3가,24954,25254,20200220,50208
20200217,2,을지로4가,13926,13706,20200220,27632
20200217,2,동대문역사문화공원,13942,15564,20200220,29506
20200217,2,신당,14422,14972,20200220,29394
20200217,2,상왕십리,15087,14600,20200220,29687
20200217,2,왕십리,17776,14910,20200220,32686
20200217,2,한양대,7533,8401,20200220,15934
20200217,2,뚝섬,21414,23011,20200220,44425
20200217,2,성수,35700,38470,20200220,74170
20200217,2,건대입구,38246,40807,20200220,79053
20200217,2,구의,25920,25480,20200220,51400
20200217,2,강변,38461,37265,20200220,75726
20200217,2,잠실나루,15910,15753,20200220,31663
20200217,2,잠실,74923,73398,20200220,148321
20200217,2,잠실새내,24327,23868,20200220,48195
20200217,2,종합운동장,7879,8881,20200220,16760
20200217,2,삼성,60443,62102,20200220,122545
20200217,2,선릉,65325,58521,20200220,123846
20200217,2,역삼,60630,67060,20200220,127690
20200217,2,강남,106675,109029,20200220,215704
20200217,2,교대,38896,43996,20200220,82892
20200217,2,서초,24558,24275,20200220,48833
20200217,2,방배,19128,19772,20200220,38900
20200217,2,사당,39215,43691,20200220,82906
20200217,2,낙성대,29464,28843,20200220,58307
20200217,2,서울대입구,52131,50719,20200220,102850
20200217,2,봉천,26198,24265,20200220,50463
20200217,2,신림,69271,67343,20200220,136614
20200217,2,신대방,28380,27535,20200220,55915
20200217,2,구로디지털단지,68684,69483,20200220,138167
20200217,2,대림,26767,27015,20200220,53782
20200217,2,신도림,55287,54259,20200220,109546
20200217,2,문래,22755,23073,20200220,45828
20200217,2,영등포구청,25179,25414,20200220,50593
20200217,2,당산,20607,23958,20200220,44565
20200217,2,합정,32798,33997,20200220,66795
20200217,2,홍대입구,65195,68124,20200220,133319
20200217,2,신촌,41020,42390,20200220,83410
20200217,2,이대,14871,15589,20200220,30460
20200217,2,아현,10144,9854,20200220,19998
20200217,2,충정로,11512,12091,20200220,23603
20200217,2,용답,2587,2519,20200220,5106
20200217,2,신답,1706,1929,20200220,3635
20200217,2,신설동,3599,3671,20200220,7270
20200217,2,도림천,1327,1424,20200220,2751
20200217,2,양천구청,7589,7874,20200220,15463
20200217,2,신정네거리,10011,10266,20200220,20277
20200217,2,용두,2291,2395,20200220,4686
20200218,2,시청,28977,28372,20200221,57349
20200218,2,을지로입구,48892,50174,20200221,99066
20200218,2,을지로3가,25208,25124,20200221,50332
20200218,2,을지로4가,14151,14116,20200221,28267
20200218,2,동대문역사문화공원,14735,16542,20200221,31277
20200218,2,신당,14842,15621,20200221,30463
20200218,2,상왕십리,15020,14524,20200221,29544
20200218,2,왕십리,18392,15323,20200221,33715
20200218,2,한양대,7675,8380,20200221,16055
20200218,2,뚝섬,22019,23647,20200221,45666
20200218,2,성수,35651,38960,20200221,74611
20200218,2,건대입구,39498,41778,20200221,81276
20200218,2,구의,26028,25509,20200221,51537
20200218,2,강변,37127,36205,20200221,73332
20200218,2,잠실나루,16317,15717,20200221,32034
20200218,2,잠실,77833,75852,20200221,153685
20200218,2,잠실새내,23983,23721,20200221,47704
20200218,2,종합운동장,7843,8592,20200221,16435
20200218,2,삼성,61251,62961,20200221,124212
20200218,2,선릉,66348,59042,20200221,125390
20200218,2,역삼,60370,66796,20200221,127166
20200218,2,강남,109332,110513,20200221,219845
20200218,2,교대,39205,44221,20200221,83426
20200218,2,서초,24471,24277,20200221,48748
20200218,2,방배,18971,19848,20200221,38819
20200218,2,사당,41317,45301,20200221,86618
20200218,2,낙성대,29840,29210,20200221,59050
20200218,2,서울대입구,52602,50966,20200221,103568
20200218,2,봉천,26750,24996,20200221,51746
20200218,2,신림,69278,67863,20200221,137141
20200218,2,신대방,28882,27420,20200221,56302
20200218,2,구로디지털단지,69454,69654,20200221,139108
20200218,2,대림,26676,27169,20200221,53845
20200218,2,신도림,56116,54884,20200221,111000
20200218,2,문래,23240,23331,20200221,46571
20200218,2,영등포구청,25201,25509,20200221,50710
20200218,2,당산,21288,24599,20200221,45887
20200218,2,합정,34167,35817,20200221,69984
20200218,2,홍대입구,69587,73199,20200221,142786
20200218,2,신촌,41977,42957,20200221,84934
20200218,2,이대,15540,16314,20200221,31854
20200218,2,아현,10307,9887,20200221,20194
20200218,2,충정로,11663,12228,20200221,23891
20200218,2,용답,2541,2494,20200221,5035
20200218,2,신답,1692,1897,20200221,3589
20200218,2,신설동,3418,3541,20200221,6959
20200218,2,도림천,1298,1427,20200221,2725
20200218,2,양천구청,7444,7910,20200221,15354
20200218,2,신정네거리,9894,10218,20200221,20112
20200218,2,용두,2369,2504,20200221,4873
20200219,2,시청,29285,28679,20200222,57964
20200219,2,을지로입구,48988,50312,20200222,99300
20200219,2,을지로3가,25790,25945,20200222,51735
20200219,2,을지로4가,14033,14165,20200222,28198
20200219,2,동대문역사문화공원,15053,16693,20200222,31746
20200219,2,신당,14917,15737,20200222,30654
20200219,2,상왕십리,14816,14323,20200222,29139
20200219,2,왕십리,17594,14568,20200222,32162
20200219,2,한양대,7205,7796,20200222,15001
20200219,2,뚝섬,21708,23465,20200222,45173
20200219,2,성수,35883,38831,20200222,74714
20200219,2,건대입구,39665,42668,20200222,82333
20200219,2,구의,26315,25305,20200222,51620
20200219,2,강변,37712,36630,20200222,74342
20200219,2,잠실나루,16488,15785,20200222,32273
20200219,2,잠실,79734,77938,20200222,157672
20200219,2,잠실새내,24171,23980,20200222,48151
20200219,2,종합운동장,8159,8778,20200222,16937
20200219,2,삼성,61167,63186,20200222,124353
20200219,2,선릉,65909,58988,20200222,124897
20200219,2,역삼,59138,66045,20200222,125183
20200219,2,강남,109058,110042,20200222,219100
20200219,2,교대,39626,44486,20200222,84112
20200219,2,서초,25009,25138,20200222,50147
20200219,2,방배,19210,19742,20200222,38952
20200219,2,사당,42458,46496,20200222,88954
20200219,2,낙성대,30486,29384,20200222,59870
20200219,2,서울대입구,53430,51768,20200222,105198
20200219,2,봉천,26956,24991,20200222,51947
20200219,2,신림,70368,68774,20200222,139142
20200219,2,신대방,28721,27528,20200222,56249
20200219,2,구로디지털단지,69020,69630,20200222,138650
20200219,2,대림,27104,27265,20200222,54369
20200219,2,신도림,55821,55414,20200222,111235
20200219,2,문래,23130,23543,20200222,46673
20200219,2,영등포구청,25188,25289,20200222,50477
20200219,2,당산,22091,25241,20200222,47332
20200219,2,합정,34379,36185,20200222,70564
20200219,2,홍대입구,69381,73095,20200222,142476
20200219,2,신촌,42213,43811,20200222,86024
20200219,2,이대,15694,16381,20200222,32075
20200219,2,아현,10247,9820,20200222,20067
20200219,2,충정로,11703,12302,20200222,24005
20200219,2,용답,2584,2509,20200222,5093
20200219,2,신답,1695,2039,20200222,3734
20200219,2,신설동,3465,3398,20200222,6863
20200219,2,도림천,1268,1358,20200222,2626
20200219,2,양천구청,7562,7953,20200222,15515
20200219,2,신정네거리,10261,10585,20200222,20846
20200219,2,용두,2392,2514,20200222,4906
20200220,2,시청,28057,27972,20200223,56029
20200220,2,을지로입구,48450,49922,20200223,98372
20200220,2,을지로3가,25265,25041,20200223,50306
20200220,2,을지로4가,13850,13911,20200223,27761
20200220,2,동대문역사문화공원,14372,16317,20200223,30689
20200220,2,신당,14641,15259,20200223,29900
20200220,2,상왕십리,14490,13938,20200223,28428
20200220,2,왕십리,16896,13929,20200223,30825
20200220,2,한양대,7040,7595,20200223,14635
20200220,2,뚝섬,21291,22875,20200223,44166
20200220,2,성수,35151,38344,20200223,73495
20200220,2,건대입구,39128,42156,20200223,81284
20200220,2,구의,26142,25453,20200223,51595
20200220,2,강변,37172,36579,20200223,73751
20200220,2,잠실나루,16070,15327,20200223,31397
20200220,2,잠실,78178,76225,20200223,154403
20200220,2,잠실새내,23495,23204,20200223,46699
20200220,2,종합운동장,7696,8230,20200223,15926
20200220,2,삼성,59893,61709,20200223,121602
20200220,2,선릉,65123,57809,20200223,122932
20200220,2,역삼,58083,65338,20200223,123421
20200220,2,강남,107019,108655,20200223,215674
20200220,2,교대,38940,43771,20200223,82711
20200220,2,서초,24620,24712,20200223,49332
20200220,2,방배,18504,19189,20200223,37693
20200220,2,사당,41721,45747,20200223,87468
20200220,2,낙성대,29731,28670,20200223,58401
20200220,2,서울대입구,52560,50784,20200223,103344
20200220,2,봉천,26402,24379,20200223,50781
20200220,2,신림,70194,68071,20200223,138265
20200220,2,신대방,28684,27300,20200223,55984
20200220,2,구로디지털단지,68213,68507,20200223,136720
20200220,2,대림,26479,26923,20200223,53402
20200220,2,신도림,55770,54881,20200223,110651
20200220,2,문래,22844,23195,20200223,46039
20200220,2,영등포구청,24774,24962,20200223,49736
20200220,2,당산,22028,25317,20200223,47345
20200220,2,합정,34172,35777,20200223,69949
20200220,2,홍대입구,68935,73013,20200223,141948
20200220,2,신촌,40616,42125,20200223,82741
20200220,2,이대,15142,15932,20200223,31074
20200220,2,아현,10162,9691,20200223,19853
20200220,2,충정로,11694,12248,20200223,23942
20200220,2,용답,2483,2514,20200223,4997
20200220,2,신답,1686,1959,20200223,3645
20200220,2,신설동,3408,3454,20200223,6862
20200220,2,도림천,1304,1385,20200223,2689
20200220,2,양천구청,7394,7832,20200223,15226
20200220,2,신정네거리,10185,10535,20200223,20720
20200220,2,용두,2358,2484,20200223,4842
20200221,2,시청,27428,26754,20200224,54182
20200221,2,을지로입구,45593,46817,20200224,92410
20200221,2,을지로3가,24088,23674,20200224,47762
20200221,2,을지로4가,13615,13283,20200224,26898
20200221,2,동대문역사문화공원,14291,15593,20200224,29884
20200221,2,신당,14503,15121,20200224,29624
20200221,2,상왕십리,14475,13519,20200224,27994
20200221,2,왕십리,17557,14342,20200224,31899
20200221,2,한양대,6915,7142,20200224,14057
20200221,2,뚝섬,20733,22277,20200224,43010
20200221,2,성수,33882,36985,20200224,70867
20200221,2,건대입구,39655,43372,20200224,83027
20200221,2,구의,25724,24694,20200224,50418
20200221,2,강변,39538,38241,20200224,77779
20200221,2,잠실나루,15031,14227,20200224,29258
20200221,2,잠실,75652,72726,20200224,148378
20200221,2,잠실새내,23329,23787,20200224,47116
20200221,2,종합운동장,7717,8297,20200224,16014
20200221,2,삼성,58306,59610,20200224,117916
20200221,2,선릉,62229,56051,20200224,118280
20200221,2,역삼,55816,62119,20200224,117935
20200221,2,강남,105267,109084,20200224,214351
20200221,2,교대,37231,42379,20200224,79610
20200221,2,서초,23353,23156,20200224,46509
20200221,2,방배,17345,17919,20200224,35264
20200221,2,사당,41463,45212,20200224,86675
20200221,2,낙성대,29726,27918,20200224,57644
20200221,2,서울대입구,52469,49896,20200224,102365
20200221,2,봉천,26209,23851,20200224,50060
20200221,2,신림,69815,67510,20200224,137325
20200221,2,신대방,28044,26245,20200224,54289
20200221,2,구로디지털단지,66852,67348,20200224,134200
20200221,2,대림,25860,25969,20200224,51829
20200221,2,신도림,54172,53782,20200224,107954
20200221,2,문래,22010,22623,20200224,44633
20200221,2,영등포구청,23928,24123,20200224,48051
20200221,2,당산,21329,24694,20200224,46023
20200221,2,합정,34117,37801,20200224,71918
20200221,2,홍대입구,66364,74180,20200224,140544
20200221,2,신촌,41665,42815,20200224,84480
20200221,2,이대,14888,15075,20200224,29963
20200221,2,아현,10011,9443,20200224,19454
20200221,2,충정로,11158,11754,20200224,22912
20200221,2,용답,2468,2440,20200224,4908
20200221,2,신답,1762,1884,20200224,3646
20200221,2,신설동,3719,3783,20200224,7502
20200221,2,도림천,1257,1300,20200224,2557
20200221,2,양천구청,7145,7503,20200224,14648
20200221,2,신정네거리,9645,10058,20200224,19703
20200221,2,용두,2302,2393,20200224,4695
20200222,2,시청,7933,7002,20200225,14935
20200222,2,을지로입구,20493,20677,20200225,41170
20200222,2,을지로3가,8267,8300,20200225,16567
20200222,2,을지로4가,6675,6664,20200225,13339
20200222,2,동대문역사문화공원,10295,11011,20200225,21306
20200222,2,신당,9447,9858,20200225,19305
20200222,2,상왕십리,8058,7410,20200225,15468
20200222,2,왕십리,12043,10231,20200225,22274
20200222,2,한양대,3153,3329,20200225,6482
20200222,2,뚝섬,9838,10061,20200225,19899
20200222,2,성수,12992,14299,20200225,27291
20200222,2,건대입구,29513,33413,20200225,62926
20200222,2,구의,14527,13993,20200225,28520
20200222,2,강변,27135,27683,20200225,54818
20200222,2,잠실나루,6184,5956,20200225,12140
20200222,2,잠실,50965,47919,20200225,98884
20200222,2,잠실새내,14093,14970,20200225,29063
20200222,2,종합운동장,3725,4359,20200225,8084
20200222,2,삼성,26857,27110,20200225,53967
20200222,2,선릉,23452,20884,20200225,44336
20200222,2,역삼,18539,20089,20200225,38628
20200222,2,강남,60264,63003,20200225,123267
20200222,2,교대,15902,17664,20200225,33566
20200222,2,서초,10034,9485,20200225,19519
20200222,2,방배,8797,8875,20200225,17672
20200222,2,사당,26974,29714,20200225,56688
20200222,2,낙성대,19638,18143,20200225,37781
20200222,2,서울대입구,34665,33326,20200225,67991
20200222,2,봉천,16031,14659,20200225,30690
20200222,2,신림,48116,46191,20200225,94307
20200222,2,신대방,17893,16960,20200225,34853
20200222,2,구로디지털단지,32246,32225,20200225,64471
20200222,2,대림,15973,16564,20200225,32537
20200222,2,신도림,38126,38630,20200225,76756
20200222,2,문래,10979,11370,20200225,22349
20200222,2,영등포구청,11827,12045,20200225,23872
20200222,2,당산,11226,12724,20200225,23950
20200222,2,합정,23601,26277,20200225,49878
20200222,2,홍대입구,58300,64481,20200225,122781
20200222,2,신촌,30837,31273,20200225,62110
20200222,2,이대,10424,10748,20200225,21172
20200222,2,아현,6284,5986,20200225,12270
20200222,2,충정로,5504,5732,20200225,11236
20200222,2,용답,1616,1480,20200225,3096
20200222,2,신답,795,912,20200225,1707
20200222,2,신설동,2924,2782,20200225,5706
20200222,2,도림천,709,650,20200225,1359
20200222,2,양천구청,3567,3715,20200225,7282
20200222,2,신정네거리,5982,6121,20200225,12103
20200222,2,용두,1415,1453,20200225,2868
20200223,2,시청,5154,4251,20200226,9405
20200223,2,을지로입구,15612,15691,20200226,31303
20200223,2,을지로3가,6061,5794,20200226,11855
20200223,2,을지로4가,2831,2776,20200226,5607
20200223,2,동대문역사문화공원,7208,9053,20200226,16261
20200223,2,신당,6317,6996,20200226,13313
20200223,2,상왕십리,5192,5104,20200226,10296
20200223,2,왕십리,8127,6939,20200226,15066
20200223,2,한양대,3776,3625,20200226,7401
20200223,2,뚝섬,6376,6458,20200226,12834
20200223,2,성수,7919,8913,20200226,16832
20200223,2,건대입구,21201,22085,20200226,43286
20200223,2,구의,9521,9421,20200226,18942
20200223,2,강변,19238,19597,20200226,38835
20200223,2,잠실나루,4152,4035,20200226,8187
20200223,2,잠실,35062,32919,20200226,67981
20200223,2,잠실새내,8530,8832,20200226,17362
20200223,2,종합운동장,2753,3176,20200226,5929
20200223,2,삼성,17911,17623,20200226,35534
20200223,2,선릉,10997,9700,20200226,20697
20200223,2,역삼,10174,11042,20200226,21216
20200223,2,강남,32842,32141,20200226,64983
20200223,2,교대,8994,9950,20200226,18944
20200223,2,서초,8435,8067,20200226,16502
20200223,2,방배,5208,5548,20200226,10756
20200223,2,사당,17266,18992,20200226,36258
20200223,2,낙성대,12498,12739,20200226,25237
20200223,2,서울대입구,23157,23464,20200226,46621
20200223,2,봉천,10318,9958,20200226,20276
20200223,2,신림,32751,32039,20200226,64790
20200223,2,신대방,12239,11858,20200226,24097
20200223,2,구로디지털단지,20364,20118,20200226,40482
20200223,2,대림,11314,11085,20200226,22399
20200223,2,신도림,23211,23540,20200226,46751
20200223,2,문래,5617,5773,20200226,11390
20200223,2,영등포구청,6797,6971,20200226,13768
20200223,2,당산,7207,7950,20200226,15157
20200223,2,합정,16384,17069,20200226,33453
20200223,2,홍대입구,44873,43527,20200226,88400
20200223,2,신촌,21410,20754,20200226,42164
20200223,2,이대,7331,7708,20200226,15039
20200223,2,아현,3860,4007,20200226,7867
20200223,2,충정로,3320,3563,20200226,6883
20200223,2,용답,1141,1218,20200226,2359
20200223,2,신답,540,557,20200226,1097
20200223,2,신설동,1994,1943,20200226,3937
20200223,2,도림천,347,374,20200226,721
20200223,2,양천구청,2465,2571,20200226,5036
20200223,2,신정네거리,3678,3765,20200226,7443
20200223,2,용두,741,794,20200226,1535
20200224,2,시청,24703,24477,20200227,49180
20200224,2,을지로입구,40870,42269,20200227,83139
20200224,2,을지로3가,21831,21672,20200227,43503
20200224,2,을지로4가,12423,12168,20200227,24591
20200224,2,동대문역사문화공원,11519,12933,20200227,24452
20200224,2,신당,12536,12871,20200227,25407
20200224,2,상왕십리,12764,12428,20200227,25192
20200224,2,왕십리,14275,11692,20200227,25967
20200224,2,한양대,6114,6706,20200227,12820
20200224,2,뚝섬,18299,19895,20200227,38194
20200224,2,성수,31157,33855,20200227,65012
20200224,2,건대입구,30377,32361,20200227,62738
20200224,2,구의,22796,22286,20200227,45082
20200224,2,강변,29456,29270,20200227,58726
20200224,2,잠실나루,12897,12357,20200227,25254
20200224,2,잠실,59036,58552,20200227,117588
20200224,2,잠실새내,18474,18282,20200227,36756
20200224,2,종합운동장,6228,6619,20200227,12847
20200224,2,삼성,49588,51094,20200227,100682
20200224,2,선릉,55355,49338,20200227,104693
20200224,2,역삼,50459,56338,20200227,106797
20200224,2,강남,84095,85164,20200227,169259
20200224,2,교대,33012,37028,20200227,70040
20200224,2,서초,20371,20233,20200227,40604
20200224,2,방배,14762,15209,20200227,29971
20200224,2,사당,31542,35101,20200227,66643
20200224,2,낙성대,24862,24285,20200227,49147
20200224,2,서울대입구,44340,43123,20200227,87463
20200224,2,봉천,23176,21563,20200227,44739
20200224,2,신림,60585,58816,20200227,119401
20200224,2,신대방,24984,24018,20200227,49002
20200224,2,구로디지털단지,59853,60362,20200227,120215
20200224,2,대림,23705,23737,20200227,47442
20200224,2,신도림,45541,44633,20200227,90174
20200224,2,문래,19756,20197,20200227,39953
20200224,2,영등포구청,21846,22056,20200227,43902
20200224,2,당산,18247,21114,20200227,39361
20200224,2,합정,27011,28122,20200227,55133
20200224,2,홍대입구,48077,49951,20200227,98028
20200224,2,신촌,32233,33211,20200227,65444
20200224,2,이대,12160,12759,20200227,24919
20200224,2,아현,8651,8314,20200227,16965
20200224,2,충정로,10040,10540,20200227,20580
20200224,2,용답,2197,2218,20200227,4415
20200224,2,신답,1521,1731,20200227,3252
20200224,2,신설동,2924,3064,20200227,5988
20200224,2,도림천,1183,1245,20200227,2428
20200224,2,양천구청,6187,6482,20200227,12669
20200224,2,신정네거리,8590,8939,20200227,17529
20200224,2,용두,2114,2201,20200227,4315
20200225,2,시청,23813,24145,20200228,47958
20200225,2,을지로입구,37716,39186,20200228,76902
20200225,2,을지로3가,20551,20582,20200228,41133
20200225,2,을지로4가,11701,11395,20200228,23096
20200225,2,동대문역사문화공원,10730,12099,20200228,22829
20200225,2,신당,11726,12075,20200228,23801
20200225,2,상왕십리,12071,11629,20200228,23700
20200225,2,왕십리,13319,10971,20200228,24290
20200225,2,한양대,5749,6113,20200228,11862
20200225,2,뚝섬,17741,19380,20200228,37121
20200225,2,성수,30261,33108,20200228,63369
20200225,2,건대입구,27710,29330,20200228,57040
20200225,2,구의,21505,20843,20200228,42348
20200225,2,강변,25435,24894,20200228,50329
20200225,2,잠실나루,11832,11472,20200228,23304
20200225,2,잠실,54448,53819,20200228,108267
20200225,2,잠실새내,16799,16486,20200228,33285
20200225,2,종합운동장,5820,5858,20200228,11678
20200225,2,삼성,45275,46936,20200228,92211
20200225,2,선릉,52142,46577,20200228,98719
20200225,2,역삼,47215,53060,20200228,100275
20200225,2,강남,77368,78595,20200228,155963
20200225,2,교대,29227,32573,20200228,61800
20200225,2,서초,18839,18947,20200228,37786
20200225,2,방배,13657,14224,20200228,27881
20200225,2,사당,29231,31604,20200228,60835
20200225,2,낙성대,23309,22578,20200228,45887
20200225,2,서울대입구,41344,39948,20200228,81292
20200225,2,봉천,21561,20161,20200228,41722
20200225,2,신림,57541,55473,20200228,113014
20200225,2,신대방,23328,22302,20200228,45630
20200225,2,구로디지털단지,56568,56988,20200228,113556
20200225,2,대림,21169,21370,20200228,42539
20200225,2,신도림,41450,40536,20200228,81986
20200225,2,문래,18832,19175,20200228,38007
20200225,2,영등포구청,20502,20805,20200228,41307
20200225,2,당산,16746,19852,20200228,36598
20200225,2,합정,25382,26221,20200228,51603
20200225,2,홍대입구,43129,45292,20200228,88421
20200225,2,신촌,28154,28923,20200228,57077
20200225,2,이대,10738,11182,20200228,21920
20200225,2,아현,7851,7463,20200228,15314
20200225,2,충정로,9463,10026,20200228,19489
20200225,2,용답,2083,2115,20200228,4198
20200225,2,신답,1467,1665,20200228,3132
20200225,2,신설동,2685,2931,20200228,5616
20200225,2,도림천,1074,1167,20200228,2241
20200225,2,양천구청,5528,5850,20200228,11378
20200225,2,신정네거리,7841,8167,20200228,16008
20200225,2,용두,1949,2064,20200228,4013
20200226,2,시청,23510,23564,20200229,47074
20200226,2,을지로입구,36658,38029,20200229,74687
20200226,2,을지로3가,20180,20425,20200229,40605
20200226,2,을지로4가,11817,11641,20200229,23458
20200226,2,동대문역사문화공원,10905,12147,20200229,23052
20200226,2,신당,12096,12378,20200229,24474
20200226,2,상왕십리,11937,11557,20200229,23494
20200226,2,왕십리,13565,11302,20200229,24867
20200226,2,한양대,5686,6206,20200229,11892
20200226,2,뚝섬,18075,19499,20200229,37574
20200226,2,성수,30132,33139,20200229,63271
20200226,2,건대입구,28290,30330,20200229,58620
20200226,2,구의,21277,20881,20200229,42158
20200226,2,강변,26106,25803,20200229,51909
20200226,2,잠실나루,11664,11146,20200229,22810
20200226,2,잠실,54839,53863,20200229,108702
20200226,2,잠실새내,15999,15649,20200229,31648
20200226,2,종합운동장,5606,5954,20200229,11560
20200226,2,삼성,43448,44394,20200229,87842
20200226,2,선릉,51082,45595,20200229,96677
20200226,2,역삼,45407,50352,20200229,95759
20200226,2,강남,75301,75787,20200229,151088
20200226,2,교대,29143,32190,20200229,61333
20200226,2,서초,18480,18627,20200229,37107
20200226,2,방배,13804,14269,20200229,28073
20200226,2,사당,29634,32020,20200229,61654
20200226,2,낙성대,22938,22266,20200229,45204
20200226,2,서울대입구,41666,40273,20200229,81939
20200226,2,봉천,21377,19925,20200229,41302
20200226,2,신림,57191,55041,20200229,112232
20200226,2,신대방,23329,22616,20200229,45945
20200226,2,구로디지털단지,56250,56710,20200229,112960
20200226,2,대림,21608,21663,20200229,43271
20200226,2,신도림,42718,41864,20200229,84582
20200226,2,문래,18655,19145,20200229,37800
20200226,2,영등포구청,20519,20905,20200229,41424
20200226,2,당산,16937,19909,20200229,36846
20200226,2,합정,25986,27241,20200229,53227
20200226,2,홍대입구,44807,46963,20200229,91770
20200226,2,신촌,28591,29480,20200229,58071
20200226,2,이대,10896,11217,20200229,22113
20200226,2,아현,7942,7557,20200229,15499
20200226,2,충정로,9362,9870,20200229,19232
20200226,2,용답,2130,2063,20200229,4193
20200226,2,신답,1368,1654,20200229,3022
20200226,2,신설동,2763,2866,20200229,5629
20200226,2,도림천,1075,1147,20200229,2222
20200226,2,양천구청,5538,5964,20200229,11502
20200226,2,신정네거리,7903,8195,20200229,16098
20200226,2,용두,1935,2118,20200229,4053
20200227,2,시청,22532,22637,20200301,45169
20200227,2,을지로입구,34923,36009,20200301,70932
20200227,2,을지로3가,19248,19273,20200301,38521
20200227,2,을지로4가,11477,11392,20200301,22869
20200227,2,동대문역사문화공원,10309,11728,20200301,22037
20200227,2,신당,11773,12200,20200301,23973
20200227,2,상왕십리,11703,11207,20200301,22910
20200227,2,왕십리,13028,10944,20200301,23972
20200227,2,한양대,5403,5838,20200301,11241
20200227,2,뚝섬,17510,18960,20200301,36470
20200227,2,성수,29659,32380,20200301,62039
20200227,2,건대입구,27824,29544,20200301,57368
20200227,2,구의,20877,20335,20200301,41212
20200227,2,강변,25335,24900,20200301,50235
20200227,2,잠실나루,11363,10936,20200301,22299
20200227,2,잠실,52876,51822,20200301,104698
20200227,2,잠실새내,15633,15526,20200301,31159
20200227,2,종합운동장,5479,5714,20200301,11193
20200227,2,삼성,40991,42213,20200301,83204
20200227,2,선릉,49120,44036,20200301,93156
20200227,2,역삼,43054,47984,20200301,91038
20200227,2,강남,71572,72386,20200301,143958
20200227,2,교대,28785,32433,20200301,61218
20200227,2,서초,17446,17753,20200301,35199
20200227,2,방배,13320,13835,20200301,27155
20200227,2,사당,28785,31221,20200301,60006
20200227,2,낙성대,21980,21198,20200301,43178
20200227,2,서울대입구,39898,38462,20200301,78360
20200227,2,봉천,20670,19262,20200301,39932
20200227,2,신림,55779,53847,20200301,109626
20200227,2,신대방,22683,21680,20200301,44363
20200227,2,구로디지털단지,53284,53516,20200301,106800
20200227,2,대림,20774,20856,20200301,41630
20200227,2,신도림,42660,40941,20200301,83601
20200227,2,문래,17758,18123,20200301,35881
20200227,2,영등포구청,19936,20198,20200301,40134
20200227,2,당산,16630,19352,20200301,35982
20200227,2,합정,25096,26151,20200301,51247
20200227,2,홍대입구,42487,44672,20200301,87159
20200227,2,신촌,27359,28050,20200301,55409
20200227,2,이대,9819,10384,20200301,20203
20200227,2,아현,7772,7424,20200301,15196
20200227,2,충정로,9095,9600,20200301,18695
20200227,2,용답,2051,2097,20200301,4148
20200227,2,신답,1437,1607,20200301,3044
20200227,2,신설동,2710,2831,20200301,5541
20200227,2,도림천,1018,1107,20200301,2125
20200227,2,양천구청,5269,5558,20200301,10827
20200227,2,신정네거리,7574,7913,20200301,15487
20200227,2,용두,1950,2121,20200301,4071
20200228,2,시청,21480,21533,20200302,43013
20200228,2,을지로입구,33295,34381,20200302,67676
20200228,2,을지로3가,17955,18047,20200302,36002
20200228,2,을지로4가,11042,10684,20200302,21726
20200228,2,동대문역사문화공원,9352,10636,20200302,19988
20200228,2,신당,11435,11930,20200302,23365
20200228,2,상왕십리,11125,10663,20200302,21788
20200228,2,왕십리,13097,11014,20200302,24111
20200228,2,한양대,5326,5608,20200302,10934
20200228,2,뚝섬,16443,17764,20200302,34207
20200228,2,성수,28395,31058,20200302,59453
20200228,2,건대입구,26940,29460,20200302,56400
20200228,2,구의,20170,19943,20200302,40113
20200228,2,강변,25845,25598,20200302,51443
20200228,2,잠실나루,10530,10067,20200302,20597
20200228,2,잠실,51115,50232,20200302,101347
20200228,2,잠실새내,15721,15844,20200302,31565
20200228,2,종합운동장,5112,5454,20200302,10566
20200228,2,삼성,39564,40374,20200302,79938
20200228,2,선릉,46260,41395,20200302,87655
20200228,2,역삼,41880,45965,20200302,87845
20200228,2,강남,69594,71163,20200302,140757
20200228,2,교대,27250,30379,20200302,57629
20200228,2,서초,16604,16550,20200302,33154
20200228,2,방배,12724,12966,20200302,25690
20200228,2,사당,28580,30673,20200302,59253
20200228,2,낙성대,21631,20183,20200302,41814
20200228,2,서울대입구,38860,36711,20200302,75571
20200228,2,봉천,20153,18512,20200302,38665
20200228,2,신림,54600,52735,20200302,107335
20200228,2,신대방,22156,21036,20200302,43192
20200228,2,구로디지털단지,51738,52112,20200302,103850
20200228,2,대림,20054,20098,20200302,40152
20200228,2,신도림,40750,39964,20200302,80714
20200228,2,문래,17350,17703,20200302,35053
20200228,2,영등포구청,19295,19375,20200302,38670
20200228,2,당산,15972,18715,20200302,34687
20200228,2,합정,24358,26332,20200302,50690
20200228,2,홍대입구,38916,42521,20200302,81437
20200228,2,신촌,26346,27400,20200302,53746
20200228,2,이대,9038,9249,20200302,18287
20200228,2,아현,7566,7278,20200302,14844
20200228,2,충정로,8932,9340,20200302,18272
20200228,2,용답,2004,1970,20200302,3974
20200228,2,신답,1332,1557,20200302,2889
20200228,2,신설동,2708,2809,20200302,5517
20200228,2,도림천,1009,1070,20200302,2079
20200228,2,양천구청,5144,5464,20200302,10608
20200228,2,신정네거리,7422,7885,20200302,15307
20200228,2,용두,1942,1978,20200302,3920
20200229,2,시청,4923,4612,20200303,9535
20200229,2,을지로입구,12955,13334,20200303,26289
20200229,2,을지로3가,5208,5333,20200303,10541
20200229,2,을지로4가,4894,4797,20200303,9691
20200229,2,동대문역사문화공원,6187,6618,20200303,12805
20200229,2,신당,7353,7581,20200303,14934
20200229,2,상왕십리,5998,5619,20200303,11617
20200229,2,왕십리,8486,7551,20200303,16037
20200229,2,한양대,2347,2283,20200303,4630
20200229,2,뚝섬,7270,7563,20200303,14833
20200229,2,성수,10169,11464,20200303,21633
20200229,2,건대입구,19755,22248,20200303,42003
20200229,2,구의,11067,10384,20200303,21451
20200229,2,강변,16077,16593,20200303,32670
20200229,2,잠실나루,4452,4188,20200303,8640
20200229,2,잠실,33248,31490,20200303,64738
20200229,2,잠실새내,9472,9833,20200303,19305
20200229,2,종합운동장,2593,2819,20200303,5412
20200229,2,삼성,15707,15990,20200303,31697
20200229,2,선릉,14742,13005,20200303,27747
20200229,2,역삼,12692,13837,20200303,26529
20200229,2,강남,35285,37114,20200303,72399
20200229,2,교대,10351,11363,20200303,21714
20200229,2,서초,6054,5732,20200303,11786
20200229,2,방배,5980,6114,20200303,12094
20200229,2,사당,17723,18892,20200303,36615
20200229,2,낙성대,13222,12128,20200303,25350
20200229,2,서울대입구,24509,23497,20200303,48006
20200229,2,봉천,12037,10766,20200303,22803
20200229,2,신림,35245,33730,20200303,68975
20200229,2,신대방,13802,13098,20200303,26900
20200229,2,구로디지털단지,24361,24547,20200303,48908
20200229,2,대림,12528,12796,20200303,25324
20200229,2,신도림,25913,26035,20200303,51948
20200229,2,문래,6868,7304,20200303,14172
20200229,2,영등포구청,8235,8523,20200303,16758
20200229,2,당산,8115,8990,20200303,17105
20200229,2,합정,15692,17521,20200303,33213
20200229,2,홍대입구,31885,35720,20200303,67605
20200229,2,신촌,19055,19577,20200303,38632
20200229,2,이대,6392,6506,20200303,12898
20200229,2,아현,4509,4281,20200303,8790
20200229,2,충정로,3915,3954,20200303,7869
20200229,2,용답,1353,1225,20200303,2578
20200229,2,신답,696,671,20200303,1367
20200229,2,신설동,1898,1967,20200303,3865
20200229,2,도림천,583,549,20200303,1132
20200229,2,양천구청,2517,2593,20200303,5110
20200229,2,신정네거리,4398,4517,20200303,8915
20200229,2,용두,1079,1145,20200303,2224
20200301,2,시청,2605,2428,20200304,5033
20200301,2,을지로입구,9489,9376,20200304,18865
20200301,2,을지로3가,2696,2576,20200304,5272
20200301,2,을지로4가,1605,1551,20200304,3156
20200301,2,동대문역사문화공원,3874,5007,20200304,8881
20200301,2,신당,4638,4980,20200304,9618
20200301,2,상왕십리,3732,3597,20200304,7329
20200301,2,왕십리,5604,4890,20200304,10494
20200301,2,한양대,1400,1522,20200304,2922
20200301,2,뚝섬,4589,4734,20200304,9323
20200301,2,성수,6229,6863,20200304,13092
20200301,2,건대입구,14248,15128,20200304,29376
20200301,2,구의,7043,6879,20200304,13922
20200301,2,강변,11916,12013,20200304,23929
20200301,2,잠실나루,2731,2821,20200304,5552
20200301,2,잠실,23040,21563,20200304,44603
20200301,2,잠실새내,5696,5947,20200304,11643
20200301,2,종합운동장,1760,1930,20200304,3690
20200301,2,삼성,10789,10811,20200304,21600
20200301,2,선릉,7177,6250,20200304,13427
20200301,2,역삼,6621,7384,20200304,14005
20200301,2,강남,18405,18248,20200304,36653
20200301,2,교대,5715,6306,20200304,12021
20200301,2,서초,3525,3388,20200304,6913
20200301,2,방배,3479,3776,20200304,7255
20200301,2,사당,11385,12516,20200304,23901
20200301,2,낙성대,8920,8771,20200304,17691
20200301,2,서울대입구,16342,16571,20200304,32913
20200301,2,봉천,7468,7066,20200304,14534
20200301,2,신림,24142,23183,20200304,47325
20200301,2,신대방,9278,8820,20200304,18098
20200301,2,구로디지털단지,15018,14672,20200304,29690
20200301,2,대림,8153,8090,20200304,16243
20200301,2,신도림,16094,16427,20200304,32521
20200301,2,문래,4055,4150,20200304,8205
20200301,2,영등포구청,4755,4978,20200304,9733
20200301,2,당산,4878,5372,20200304,10250
20200301,2,합정,10559,10981,20200304,21540
20200301,2,홍대입구,23021,22176,20200304,45197
20200301,2,신촌,13209,12939,20200304,26148
20200301,2,이대,3808,3890,20200304,7698
20200301,2,아현,2666,2659,20200304,5325
20200301,2,충정로,2177,2223,20200304,4400
20200301,2,용답,899,894,20200304,1793
20200301,2,신답,389,468,20200304,857
20200301,2,신설동,1392,1539,20200304,2931
20200301,2,도림천,281,274,20200304,555
20200301,2,양천구청,1684,1682,20200304,3366
20200301,2,신정네거리,2572,2667,20200304,5239
20200301,2,용두,685,756,20200304,1441
20200302,2,시청,20864,21002,20200305,41866
20200302,2,을지로입구,30813,31934,20200305,62747
20200302,2,을지로3가,17617,17781,20200305,35398
20200302,2,을지로4가,10847,10759,20200305,21606
20200302,2,동대문역사문화공원,9210,10375,20200305,19585
20200302,2,신당,11049,11413,20200305,22462
20200302,2,상왕십리,11073,10803,20200305,21876
20200302,2,왕십리,12306,10361,20200305,22667
20200302,2,한양대,5333,5797,20200305,11130
20200302,2,뚝섬,16571,17834,20200305,34405
20200302,2,성수,28234,30768,20200305,59002
20200302,2,건대입구,25536,27310,20200305,52846
20200302,2,구의,19747,19451,20200305,39198
20200302,2,강변,24435,23988,20200305,48423
20200302,2,잠실나루,10866,10588,20200305,21454
20200302,2,잠실,47376,46641,20200305,94017
20200302,2,잠실새내,15312,15236,20200305,30548
20200302,2,종합운동장,5050,5465,20200305,10515
20200302,2,삼성,38406,39294,20200305,77700
20200302,2,선릉,45926,40927,20200305,86853
20200302,2,역삼,41204,45217,20200305,86421
20200302,2,강남,62556,63127,20200305,125683
20200302,2,교대,27602,30294,20200305,57896
20200302,2,서초,16488,16681,20200305,33169
20200302,2,방배,12859,13354,20200305,26213
20200302,2,사당,26881,29409,20200305,56290
20200302,2,낙성대,21026,20443,20200305,41469
20200302,2,서울대입구,37260,36231,20200305,73491
20200302,2,봉천,19757,18411,20200305,38168
20200302,2,신림,53149,51179,20200305,104328
20200302,2,신대방,21830,21073,20200305,42903
20200302,2,구로디지털단지,51243,51443,20200305,102686
20200302,2,대림,20122,20147,20200305,40269
20200302,2,신도림,39840,38870,20200305,78710
20200302,2,문래,17141,17425,20200305,34566
20200302,2,영등포구청,19264,19736,20200305,39000
20200302,2,당산,15674,18074,20200305,33748
20200302,2,합정,23211,24005,20200305,47216
20200302,2,홍대입구,35969,37361,20200305,73330
20200302,2,신촌,24535,25553,20200305,50088
20200302,2,이대,8487,8798,20200305,17285
20200302,2,아현,7421,7266,20200305,14687
20200302,2,충정로,8875,9360,20200305,18235
20200302,2,용답,1935,1932,20200305,3867
20200302,2,신답,1355,1579,20200305,2934
20200302,2,신설동,2530,2647,20200305,5177
20200302,2,도림천,1011,1087,20200305,2098
20200302,2,양천구청,5253,5508,20200305,10761
20200302,2,신정네거리,7436,7790,20200305,15226
20200302,2,용두,1842,1969,20200305,3811
20200303,2,역삼,40672,44597,20200306,85269
20200303,2,선릉,46188,41292,20200306,87480
20200303,2,삼성,37826,38627,20200306,76453
20200303,2,종합운동장,5090,5430,20200306,10520
20200303,2,잠실새내,15432,15239,20200306,30671
20200303,2,잠실,49893,49309,20200306,99202
20200303,2,잠실나루,10910,10653,20200306,21563
20200303,2,강변,23776,23414,20200306,47190
20200303,2,구의,19714,19185,20200306,38899
20200303,2,건대입구,25861,27486,20200306,53347
20200303,2,성수,28842,31401,20200306,60243
20200303,2,뚝섬,17042,18266,20200306,35308
20200303,2,한양대,5255,5578,20200306,10833
20200303,2,왕십리,12503,10442,20200306,22945
20200303,2,상왕십리,11079,10676,20200306,21755
20200303,2,신당,11237,11686,20200306,22923
20200303,2,동대문역사문화공원,9203,10268,20200306,19471
20200303,2,을지로4가,10910,10616,20200306,21526
20200303,2,을지로3가,17866,17663,20200306,35529
20200303,2,을지로입구,31135,32200,20200306,63335
20200303,2,시청,20908,21111,20200306,42019
20200303,2,강남,62742,63287,20200306,126029
20200303,2,교대,27722,30683,20200306,58405
20200303,2,서초,16598,16743,20200306,33341
20200303,2,방배,12850,13272,20200306,26122
20200303,2,사당,27680,30034,20200306,57714
20200303,2,낙성대,21253,20628,20200306,41881
20200303,2,서울대입구,37730,36454,20200306,74184
20200303,2,봉천,19634,18401,20200306,38035
20200303,2,신림,53085,51573,20200306,104658
20200303,2,신대방,21923,21011,20200306,42934
20200303,2,구로디지털단지,50953,51523,20200306,102476
20200303,2,대림,19912,19979,20200306,39891
20200303,2,신도림,39058,38536,20200306,77594
20200303,2,문래,17451,17795,20200306,35246
20200303,2,영등포구청,19702,19920,20200306,39622
20200303,2,당산,15919,18347,20200306,34266
20200303,2,합정,23805,24646,20200306,48451
20200303,2,홍대입구,36750,38561,20200306,75311
20200303,2,신촌,24634,25527,20200306,50161
20200303,2,이대,8468,8762,20200306,17230
20200303,2,아현,7398,7118,20200306,14516
20200303,2,충정로,8874,9403,20200306,18277
20200303,2,용답,1959,1966,20200306,3925
20200303,2,신답,1332,1563,20200306,2895
20200303,2,신설동,2467,2617,20200306,5084
20200303,2,도림천,1041,1126,20200306,2167
20200303,2,양천구청,5048,5470,20200306,10518
20200303,2,신정네거리,7365,7682,20200306,15047
20200303,2,용두,1878,2003,20200306,3881
20200304,2,시청,20961,20931,20200307,41892
20200304,2,을지로입구,31221,32163,20200307,63384
20200304,2,을지로3가,17864,17842,20200307,35706
20200304,2,을지로4가,10929,10692,20200307,21621
20200304,2,동대문역사문화공원,9339,10329,20200307,19668
20200304,2,신당,11052,11612,20200307,22664
20200304,2,상왕십리,11113,10757,20200307,21870
20200304,2,왕십리,12398,10310,20200307,22708
20200304,2,한양대,5200,5551,20200307,10751
20200304,2,뚝섬,16412,17939,20200307,34351
20200304,2,성수,28795,30969,20200307,59764
20200304,2,건대입구,26059,27989,20200307,54048
20200304,2,구의,19580,19289,20200307,38869
20200304,2,강변,23469,23066,20200307,46535
20200304,2,잠실나루,10808,10599,20200307,21407
20200304,2,잠실,50775,49688,20200307,100463
20200304,2,잠실새내,15286,15400,20200307,30686
20200304,2,종합운동장,4846,5303,20200307,10149
20200304,2,삼성,38250,39055,20200307,77305
20200304,2,선릉,46108,40953,20200307,87061
20200304,2,역삼,41183,44674,20200307,85857
20200304,2,강남,63166,63174,20200307,126340
20200304,2,교대,27820,31158,20200307,58978
20200304,2,서초,16886,16657,20200307,33543
20200304,2,방배,12889,13288,20200307,26177
20200304,2,사당,27855,29889,20200307,57744
20200304,2,낙성대,21100,20521,20200307,41621
20200304,2,서울대입구,37804,36603,20200307,74407
20200304,2,봉천,19598,18380,20200307,37978
20200304,2,신림,53227,51620,20200307,104847
20200304,2,신대방,21722,21025,20200307,42747
20200304,2,구로디지털단지,51292,51625,20200307,102917
20200304,2,대림,19519,19903,20200307,39422
20200304,2,신도림,39541,38554,20200307,78095
20200304,2,문래,17336,17754,20200307,35090
20200304,2,영등포구청,19410,19815,20200307,39225
20200304,2,당산,15540,18410,20200307,33950
20200304,2,합정,23934,24954,20200307,48888
20200304,2,홍대입구,37649,39431,20200307,77080
20200304,2,신촌,24935,25765,20200307,50700
20200304,2,이대,8495,8675,20200307,17170
20200304,2,아현,7368,7057,20200307,14425
20200304,2,충정로,8783,9338,20200307,18121
20200304,2,용답,1947,1958,20200307,3905
20200304,2,신답,1326,1523,20200307,2849
20200304,2,신설동,2555,2482,20200307,5037
20200304,2,도림천,1029,1062,20200307,2091
20200304,2,양천구청,5151,5440,20200307,10591
20200304,2,신정네거리,7333,7738,20200307,15071
20200304,2,용두,1818,1929,20200307,3747
20200305,2,시청,20576,20947,20200308,41523
20200305,2,을지로입구,31185,32229,20200308,63414
20200305,2,을지로3가,17794,17772,20200308,35566
20200305,2,을지로4가,10968,10753,20200308,21721
20200305,2,동대문역사문화공원,9364,10274,20200308,19638
20200305,2,신당,11088,11473,20200308,22561
20200305,2,상왕십리,11049,10636,20200308,21685
20200305,2,왕십리,12805,10845,20200308,23650
20200305,2,한양대,5277,5823,20200308,11100
20200305,2,뚝섬,16906,18168,20200308,35074
20200305,2,성수,28485,31485,20200308,59970
20200305,2,건대입구,26590,28530,20200308,55120
20200305,2,구의,19867,19303,20200308,39170
20200305,2,강변,24096,23575,20200308,47671
20200305,2,잠실나루,11084,10548,20200308,21632
20200305,2,잠실,51452,50461,20200308,101913
20200305,2,잠실새내,15692,15610,20200308,31302
20200305,2,종합운동장,4987,5377,20200308,10364
20200305,2,삼성,37861,39202,20200308,77063
20200305,2,선릉,46332,41607,20200308,87939
20200305,2,역삼,40563,44825,20200308,85388
20200305,2,강남,64350,64829,20200308,129179
20200305,2,교대,28610,31451,20200308,60061
20200305,2,서초,16697,17442,20200308,34139
20200305,2,방배,13052,13447,20200308,26499
20200305,2,사당,28424,30563,20200308,58987
20200305,2,낙성대,21505,20734,20200308,42239
20200305,2,서울대입구,37936,36540,20200308,74476
20200305,2,봉천,19664,18432,20200308,38096
20200305,2,신림,53567,51861,20200308,105428
20200305,2,신대방,21976,21167,20200308,43143
20200305,2,구로디지털단지,51163,51577,20200308,102740
20200305,2,대림,19873,20031,20200308,39904
20200305,2,신도림,40521,39409,20200308,79930
20200305,2,문래,17480,17862,20200308,35342
20200305,2,영등포구청,19486,19716,20200308,39202
20200305,2,당산,16120,18522,20200308,34642
20200305,2,합정,24407,25568,20200308,49975
20200305,2,홍대입구,38433,41080,20200308,79513
20200305,2,신촌,25421,26207,20200308,51628
20200305,2,이대,8184,8595,20200308,16779
20200305,2,아현,7446,7244,20200308,14690
20200305,2,충정로,8702,9186,20200308,17888
20200305,2,용답,1948,1934,20200308,3882
20200305,2,신답,1338,1509,20200308,2847
20200305,2,신설동,2483,2555,20200308,5038
20200305,2,도림천,987,1044,20200308,2031
20200305,2,양천구청,5134,5391,20200308,10525
20200305,2,신정네거리,7580,7956,20200308,15536
20200305,2,용두,1836,1935,20200308,3771
20200306,2,시청,20813,20838,20200309,41651
20200306,2,을지로입구,31701,32259,20200309,63960
20200306,2,을지로3가,17766,17894,20200309,35660
20200306,2,을지로4가,10971,10871,20200309,21842
20200306,2,동대문역사문화공원,9669,10799,20200309,20468
20200306,2,신당,11600,12107,20200309,23707
20200306,2,상왕십리,11329,10733,20200309,22062
20200306,2,왕십리,13286,11617,20200309,24903
20200306,2,한양대,5399,5615,20200309,11014
20200306,2,뚝섬,17023,18453,20200309,35476
20200306,2,성수,28726,31563,20200309,60289
20200306,2,건대입구,28953,32291,20200309,61244
20200306,2,구의,20322,19685,20200309,40007
20200306,2,강변,26159,26064,20200309,52223
20200306,2,잠실나루,11218,10605,20200309,21823
20200306,2,잠실,53574,52067,20200309,105641
20200306,2,잠실새내,16706,17174,20200309,33880
20200306,2,종합운동장,5163,5484,20200309,10647
20200306,2,삼성,38415,39496,20200309,77911
20200306,2,선릉,46692,41707,20200309,88399
20200306,2,역삼,39770,44148,20200309,83918
20200306,2,강남,68005,70586,20200309,138591
20200306,2,교대,28680,32032,20200309,60712
20200306,2,서초,16575,16681,20200309,33256
20200306,2,방배,13277,13645,20200309,26922
20200306,2,사당,30374,33063,20200309,63437
20200306,2,낙성대,22396,20789,20200309,43185
20200306,2,서울대입구,40400,38682,20200309,79082
20200306,2,봉천,20468,18597,20200309,39065
20200306,2,신림,55816,54271,20200309,110087
20200306,2,신대방,22503,21160,20200309,43663
20200306,2,구로디지털단지,52706,53143,20200309,105849
20200306,2,대림,20385,20382,20200309,40767
20200306,2,신도림,42024,41677,20200309,83701
20200306,2,문래,17528,18184,20200309,35712
20200306,2,영등포구청,19887,20078,20200309,39965
20200306,2,당산,16408,19261,20200309,35669
20200306,2,합정,25779,28159,20200309,53938
20200306,2,홍대입구,41529,45792,20200309,87321
20200306,2,신촌,27123,28560,20200309,55683
20200306,2,이대,8715,8893,20200309,17608
20200306,2,아현,7780,7277,20200309,15057
20200306,2,충정로,8883,9161,20200309,18044
20200306,2,용답,2072,2058,20200309,4130
20200306,2,신답,1322,1458,20200309,2780
20200306,2,신설동,2629,2788,20200309,5417
20200306,2,도림천,1032,1068,20200309,2100
20200306,2,양천구청,5214,5530,20200309,10744
20200306,2,신정네거리,7719,8115,20200309,15834
20200306,2,용두,2016,2153,20200309,4169
20200307,2,시청,4441,3956,20200310,8397
20200307,2,을지로입구,12774,13003,20200310,25777
20200307,2,을지로3가,5447,5621,20200310,11068
20200307,2,을지로4가,4874,4959,20200310,9833
20200307,2,동대문역사문화공원,6155,6279,20200310,12434
20200307,2,신당,7528,7770,20200310,15298
20200307,2,상왕십리,6398,5891,20200310,12289
20200307,2,왕십리,9256,7998,20200310,17254
20200307,2,한양대,2530,2480,20200310,5010
20200307,2,뚝섬,7832,8207,20200310,16039
20200307,2,성수,10696,12018,20200310,22714
20200307,2,건대입구,22190,24947,20200310,47137
20200307,2,구의,11795,11407,20200310,23202
20200307,2,강변,17152,17484,20200310,34636
20200307,2,잠실나루,4865,4621,20200310,9486
20200307,2,잠실,36206,34183,20200310,70389
20200307,2,잠실새내,10414,11125,20200310,21539
20200307,2,종합운동장,2770,3010,20200310,5780
20200307,2,삼성,16848,17149,20200310,33997
20200307,2,선릉,16577,14655,20200310,31232
20200307,2,역삼,12717,13905,20200310,26622
20200307,2,강남,39648,41549,20200310,81197
20200307,2,교대,11261,12393,20200310,23654
20200307,2,서초,6104,5635,20200310,11739
20200307,2,방배,6623,6652,20200310,13275
20200307,2,사당,19715,21160,20200310,40875
20200307,2,낙성대,14975,13513,20200310,28488
20200307,2,서울대입구,27265,26578,20200310,53843
20200307,2,봉천,12896,11546,20200310,24442
20200307,2,신림,37733,35957,20200310,73690
20200307,2,신대방,14544,13858,20200310,28402
20200307,2,구로디지털단지,25537,25533,20200310,51070
20200307,2,대림,12694,13156,20200310,25850
20200307,2,신도림,27600,27924,20200310,55524
20200307,2,문래,7636,7952,20200310,15588
20200307,2,영등포구청,8377,8608,20200310,16985
20200307,2,당산,8941,9680,20200310,18621
20200307,2,합정,17198,19570,20200310,36768
20200307,2,홍대입구,36602,40786,20200310,77388
20200307,2,신촌,20797,21374,20200310,42171
20200307,2,이대,5921,6106,20200310,12027
20200307,2,아현,4740,4459,20200310,9199
20200307,2,충정로,3760,3802,20200310,7562
20200307,2,용답,1390,1289,20200310,2679
20200307,2,신답,691,721,20200310,1412
20200307,2,신설동,2017,2062,20200310,4079
20200307,2,도림천,608,603,20200310,1211
20200307,2,양천구청,2747,2816,20200310,5563
20200307,2,신정네거리,4616,4715,20200310,9331
20200307,2,용두,1165,1202,20200310,2367
20200308,2,시청,2631,2398,20200311,5029
20200308,2,을지로입구,9660,9644,20200311,19304
20200308,2,을지로3가,3084,2848,20200311,5932
20200308,2,을지로4가,1780,1753,20200311,3533
20200308,2,동대문역사문화공원,4246,5372,20200311,9618
20200308,2,신당,5202,5661,20200311,10863
20200308,2,상왕십리,4210,4135,20200311,8345
20200308,2,왕십리,6226,5311,20200311,11537
20200308,2,한양대,1685,1841,20200311,3526
20200308,2,뚝섬,5658,6056,20200311,11714
20200308,2,성수,7081,7902,20200311,14983
20200308,2,건대입구,17753,18408,20200311,36161
20200308,2,구의,7880,7728,20200311,15608
20200308,2,강변,13566,13455,20200311,27021
20200308,2,잠실나루,3263,3312,20200311,6575
20200308,2,잠실,27466,25257,20200311,52723
20200308,2,잠실새내,6733,7032,20200311,13765
20200308,2,종합운동장,1887,2174,20200311,4061
20200308,2,삼성,11616,11593,20200311,23209
20200308,2,선릉,8034,7237,20200311,15271
20200308,2,역삼,7023,7611,20200311,14634
20200308,2,강남,22855,22861,20200311,45716
20200308,2,교대,6321,7222,20200311,13543
20200308,2,서초,3692,3392,20200311,7084
20200308,2,방배,4016,4217,20200311,8233
20200308,2,사당,13440,15010,20200311,28450
20200308,2,낙성대,10605,10479,20200311,21084
20200308,2,서울대입구,19096,19675,20200311,38771
20200308,2,봉천,8325,7945,20200311,16270
20200308,2,신림,26703,26028,20200311,52731
20200308,2,신대방,10283,10054,20200311,20337
20200308,2,구로디지털단지,16434,15956,20200311,32390
20200308,2,대림,9028,9034,20200311,18062
20200308,2,신도림,17599,17780,20200311,35379
20200308,2,문래,4281,4532,20200311,8813
20200308,2,영등포구청,5210,5229,20200311,10439
20200308,2,당산,6111,6621,20200311,12732
20200308,2,합정,12557,13245,20200311,25802
20200308,2,홍대입구,28285,28251,20200311,56536
20200308,2,신촌,14669,14832,20200311,29501
20200308,2,이대,3924,4076,20200311,8000
20200308,2,아현,3052,3068,20200311,6120
20200308,2,충정로,2440,2575,20200311,5015
20200308,2,용답,1008,1009,20200311,2017
20200308,2,신답,470,528,20200311,998
20200308,2,신설동,1666,1707,20200311,3373
20200308,2,도림천,297,268,20200311,565
20200308,2,양천구청,1909,1906,20200311,3815
20200308,2,신정네거리,2954,2888,20200311,5842
20200308,2,용두,733,708,20200311,1441
20200309,2,시청,21324,21601,20200312,42925
20200309,2,을지로입구,31871,32642,20200312,64513
20200309,2,을지로3가,18064,18210,20200312,36274
20200309,2,을지로4가,11207,11054,20200312,22261
20200309,2,동대문역사문화공원,9326,10484,20200312,19810
20200309,2,신당,11252,11566,20200312,22818
20200309,2,상왕십리,11343,10986,20200312,22329
20200309,2,왕십리,12801,10836,20200312,23637
20200309,2,한양대,5526,6077,20200312,11603
20200309,2,뚝섬,16856,18250,20200312,35106
20200309,2,성수,28970,31467,20200312,60437
20200309,2,건대입구,28153,30132,20200312,58285
20200309,2,구의,20421,20262,20200312,40683
20200309,2,강변,26249,25787,20200312,52036
20200309,2,잠실나루,11649,11337,20200312,22986
20200309,2,잠실,53410,52621,20200312,106031
20200309,2,잠실새내,16567,16544,20200312,33111
20200309,2,종합운동장,5386,5663,20200312,11049
20200309,2,삼성,40538,41514,20200312,82052
20200309,2,선릉,49468,44192,20200312,93660
20200309,2,역삼,43744,48663,20200312,92407
20200309,2,강남,72919,73302,20200312,146221
20200309,2,교대,29207,32292,20200312,61499
20200309,2,서초,17580,17640,20200312,35220
20200309,2,방배,13690,14228,20200312,27918
20200309,2,사당,29377,32046,20200312,61423
20200309,2,낙성대,22718,22405,20200312,45123
20200309,2,서울대입구,39931,38967,20200312,78898
20200309,2,봉천,20741,19402,20200312,40143
20200309,2,신림,55638,54039,20200312,109677
20200309,2,신대방,22740,21830,20200312,44570
20200309,2,구로디지털단지,53921,54563,20200312,108484
20200309,2,대림,21211,21250,20200312,42461
20200309,2,신도림,41780,40696,20200312,82476
20200309,2,문래,17971,18384,20200312,36355
20200309,2,영등포구청,20176,20748,20200312,40924
20200309,2,당산,16935,19384,20200312,36319
20200309,2,합정,24809,26161,20200312,50970
20200309,2,홍대입구,39336,41200,20200312,80536
20200309,2,신촌,26385,27542,20200312,53927
20200309,2,이대,8636,9002,20200312,17638
20200309,2,아현,7695,7485,20200312,15180
20200309,2,충정로,8937,9443,20200312,18380
20200309,2,용답,2079,2061,20200312,4140
20200309,2,신답,1369,1611,20200312,2980
20200309,2,신설동,2652,2779,20200312,5431
20200309,2,도림천,1109,1166,20200312,2275
20200309,2,양천구청,5444,5752,20200312,11196
20200309,2,신정네거리,7888,8167,20200312,16055
20200309,2,용두,1914,2022,20200312,3936
20200310,2,시청,21202,21369,20200313,42571
20200310,2,을지로입구,31282,32420,20200313,63702
20200310,2,을지로3가,17934,17718,20200313,35652
20200310,2,을지로4가,10929,10639,20200313,21568
20200310,2,동대문역사문화공원,8976,9938,20200313,18914
20200310,2,신당,10793,11341,20200313,22134
20200310,2,상왕십리,10955,10707,20200313,21662
20200310,2,왕십리,12691,10573,20200313,23264
20200310,2,한양대,5470,5765,20200313,11235
20200310,2,뚝섬,17062,18505,20200313,35567
20200310,2,성수,29251,31939,20200313,61190
20200310,2,건대입구,26300,28412,20200313,54712
20200310,2,구의,20190,19790,20200313,39980
20200310,2,강변,23606,23036,20200313,46642
20200310,2,잠실나루,11007,10710,20200313,21717
20200310,2,잠실,50762,50155,20200313,100917
20200310,2,잠실새내,15941,15823,20200313,31764
20200310,2,종합운동장,5018,5372,20200313,10390
20200310,2,삼성,40175,41331,20200313,81506
20200310,2,선릉,48246,43132,20200313,91378
20200310,2,역삼,43562,47681,20200313,91243
20200310,2,강남,70679,71554,20200313,142233
20200310,2,교대,28343,31544,20200313,59887
20200310,2,서초,17975,17842,20200313,35817
20200310,2,방배,13384,13727,20200313,27111
20200310,2,사당,28450,30962,20200313,59412
20200310,2,낙성대,21992,21196,20200313,43188
20200310,2,서울대입구,38332,37167,20200313,75499
20200310,2,봉천,19971,18568,20200313,38539
20200310,2,신림,53027,51313,20200313,104340
20200310,2,신대방,21546,20748,20200313,42294
20200310,2,구로디지털단지,51278,51650,20200313,102928
20200310,2,대림,19305,19535,20200313,38840
20200310,2,신도림,36401,34859,20200313,71260
20200310,2,문래,17430,17842,20200313,35272
20200310,2,영등포구청,19345,19621,20200313,38966
20200310,2,당산,15759,18438,20200313,34197
20200310,2,합정,24072,25064,20200313,49136
20200310,2,홍대입구,36872,38865,20200313,75737
20200310,2,신촌,25453,26697,20200313,52150
20200310,2,이대,8446,8651,20200313,17097
20200310,2,아현,7310,7111,20200313,14421
20200310,2,충정로,8709,9141,20200313,17850
20200310,2,용답,1952,1939,20200313,3891
20200310,2,신답,1347,1542,20200313,2889
20200310,2,신설동,2557,2781,20200313,5338
20200310,2,도림천,979,1085,20200313,2064
20200310,2,양천구청,5069,5298,20200313,10367
20200310,2,신정네거리,7228,7541,20200313,14769
20200310,2,용두,1813,1875,20200313,3688
20200311,2,시청,21287,21532,20200314,42819
20200311,2,을지로입구,31691,32829,20200314,64520
20200311,2,을지로3가,18040,18138,20200314,36178
20200311,2,을지로4가,11096,10992,20200314,22088
20200311,2,동대문역사문화공원,9625,10536,20200314,20161
20200311,2,신당,11276,11863,20200314,23139
20200311,2,상왕십리,11447,10908,20200314,22355
20200311,2,왕십리,13125,11167,20200314,24292
20200311,2,한양대,5490,5858,20200314,11348
20200311,2,뚝섬,17851,19333,20200314,37184
20200311,2,성수,29961,32742,20200314,62703
20200311,2,건대입구,28766,30880,20200314,59646
20200311,2,구의,20631,20332,20200314,40963
20200311,2,강변,25349,24762,20200314,50111
20200311,2,잠실나루,11378,11079,20200314,22457
20200311,2,잠실,55483,53890,20200314,109373
20200311,2,잠실새내,16457,16480,20200314,32937
20200311,2,종합운동장,5384,5760,20200314,11144
20200311,2,삼성,40375,41330,20200314,81705
20200311,2,선릉,49174,43960,20200314,93134
20200311,2,역삼,43467,47826,20200314,91293
20200311,2,강남,72971,73223,20200314,146194
20200311,2,교대,28786,32202,20200314,60988
20200311,2,서초,17319,17493,20200314,34812
20200311,2,방배,13657,14106,20200314,27763
20200311,2,사당,29781,32519,20200314,62300
20200311,2,낙성대,22803,21974,20200314,44777
20200311,2,서울대입구,39601,38405,20200314,78006
20200311,2,봉천,20297,18882,20200314,39179
20200311,2,신림,54902,53032,20200314,107934
20200311,2,신대방,21837,21052,20200314,42889
20200311,2,구로디지털단지,51299,51445,20200314,102744
20200311,2,대림,19730,19829,20200314,39559
20200311,2,신도림,35656,34011,20200314,69667
20200311,2,문래,17090,17397,20200314,34487
20200311,2,영등포구청,19503,19847,20200314,39350
20200311,2,당산,16397,18994,20200314,35391
20200311,2,합정,24972,26364,20200314,51336
20200311,2,홍대입구,40711,43271,20200314,83982
20200311,2,신촌,26474,27482,20200314,53956
20200311,2,이대,8661,8867,20200314,17528
20200311,2,아현,7541,7202,20200314,14743
20200311,2,충정로,8778,9286,20200314,18064
20200311,2,용답,2069,2067,20200314,4136
20200311,2,신답,1360,1537,20200314,2897
20200311,2,신설동,2659,2784,20200314,5443
20200311,2,도림천,949,1025,20200314,1974
20200311,2,양천구청,5016,5210,20200314,10226
20200311,2,신정네거리,7203,7674,20200314,14877
20200311,2,용두,1892,1953,20200314,3845
20200312,2,시청,20815,21081,20200315,41896
20200312,2,을지로입구,31494,32588,20200315,64082
20200312,2,을지로3가,17685,17658,20200315,35343
20200312,2,을지로4가,10895,10704,20200315,21599
20200312,2,동대문역사문화공원,9139,10201,20200315,19340
20200312,2,신당,11136,11552,20200315,22688
20200312,2,상왕십리,11182,10747,20200315,21929
20200312,2,왕십리,12730,10718,20200315,23448
20200312,2,한양대,5273,5550,20200315,10823
20200312,2,뚝섬,17452,19045,20200315,36497
20200312,2,성수,29362,32367,20200315,61729
20200312,2,건대입구,28521,30276,20200315,58797
20200312,2,구의,20421,19938,20200315,40359
20200312,2,강변,24986,24421,20200315,49407
20200312,2,잠실나루,11328,10985,20200315,22313
20200312,2,잠실,54495,52918,20200315,107413
20200312,2,잠실새내,16084,16072,20200315,32156
20200312,2,종합운동장,5182,5536,20200315,10718
20200312,2,삼성,39400,40533,20200315,79933
20200312,2,선릉,47992,42892,20200315,90884
20200312,2,역삼,42389,47199,20200315,89588
20200312,2,강남,71929,72725,20200315,144654
20200312,2,교대,28107,31347,20200315,59454
20200312,2,서초,17103,17124,20200315,34227
20200312,2,방배,13335,13847,20200315,27182
20200312,2,사당,29281,31519,20200315,60800
20200312,2,낙성대,22244,21411,20200315,43655
20200312,2,서울대입구,38986,37634,20200315,76620
20200312,2,봉천,19950,18494,20200315,38444
20200312,2,신림,53458,51673,20200315,105131
20200312,2,신대방,21574,20844,20200315,42418
20200312,2,구로디지털단지,49971,50299,20200315,100270
20200312,2,대림,19064,19175,20200315,38239
20200312,2,신도림,34218,33123,20200315,67341
20200312,2,문래,16894,17307,20200315,34201
20200312,2,영등포구청,19193,19471,20200315,38664
20200312,2,당산,16074,18531,20200315,34605
20200312,2,합정,24735,25912,20200315,50647
20200312,2,홍대입구,40126,42461,20200315,82587
20200312,2,신촌,25624,27081,20200315,52705
20200312,2,이대,8563,8877,20200315,17440
20200312,2,아현,7437,7108,20200315,14545
20200312,2,충정로,8660,9183,20200315,17843
20200312,2,용답,2049,2071,20200315,4120
20200312,2,신답,1365,1518,20200315,2883
20200312,2,신설동,2529,2675,20200315,5204
20200312,2,도림천,937,985,20200315,1922
20200312,2,양천구청,4821,5083,20200315,9904
20200312,2,신정네거리,7072,7409,20200315,14481
20200312,2,용두,1825,1913,20200315,3738
20200313,2,시청,20550,20600,20200316,41150
20200313,2,을지로입구,32094,32766,20200316,64860
20200313,2,을지로3가,17358,17680,20200316,35038
20200313,2,을지로4가,10763,10818,20200316,21581
20200313,2,동대문역사문화공원,9376,10350,20200316,19726
20200313,2,신당,11536,12049,20200316,23585
20200313,2,상왕십리,11555,10791,20200316,22346
20200313,2,왕십리,13503,11587,20200316,25090
20200313,2,한양대,5635,5743,20200316,11378
20200313,2,뚝섬,17495,18874,20200316,36369
20200313,2,성수,29418,32388,20200316,61806
20200313,2,건대입구,30304,34179,20200316,64483
20200313,2,구의,20810,20198,20200316,41008
20200313,2,강변,27042,27033,20200316,54075
20200313,2,잠실나루,11402,10716,20200316,22118
20200313,2,잠실,56106,54138,20200316,110244
20200313,2,잠실새내,17042,17700,20200316,34742
20200313,2,종합운동장,5254,5612,20200316,10866
20200313,2,삼성,40243,40745,20200316,80988
20200313,2,선릉,47767,42923,20200316,90690
20200313,2,역삼,42239,46519,20200316,88758
20200313,2,강남,75857,78367,20200316,154224
20200313,2,교대,28898,32382,20200316,61280
20200313,2,서초,16833,16953,20200316,33786
20200313,2,방배,13606,13823,20200316,27429
20200313,2,사당,31079,33874,20200316,64953
20200313,2,낙성대,23162,21590,20200316,44752
20200313,2,서울대입구,40964,39122,20200316,80086
20200313,2,봉천,20513,18668,20200316,39181
20200313,2,신림,55723,53669,20200316,109392
20200313,2,신대방,21879,20654,20200316,42533
20200313,2,구로디지털단지,50454,50277,20200316,100731
20200313,2,대림,19365,19438,20200316,38803
20200313,2,신도림,35633,34365,20200316,69998
20200313,2,문래,17016,17497,20200316,34513
20200313,2,영등포구청,19254,19281,20200316,38535
20200313,2,당산,16501,19248,20200316,35749
20200313,2,합정,26299,28725,20200316,55024
20200313,2,홍대입구,43264,48593,20200316,91857
20200313,2,신촌,27807,29247,20200316,57054
20200313,2,이대,9002,9192,20200316,18194
20200313,2,아현,7638,7350,20200316,14988
20200313,2,충정로,8626,9203,20200316,17829
20200313,2,용답,2139,2027,20200316,4166
20200313,2,신답,1377,1491,20200316,2868
20200313,2,신설동,2614,2646,20200316,5260
20200313,2,도림천,979,1002,20200316,1981
20200313,2,양천구청,4980,5208,20200316,10188
20200313,2,신정네거리,7206,7615,20200316,14821
20200313,2,용두,1934,1995,20200316,3929
20200314,2,시청,4591,4094,20200317,8685
20200314,2,을지로입구,13860,13780,20200317,27640
20200314,2,을지로3가,5838,5977,20200317,11815
20200314,2,을지로4가,4817,4848,20200317,9665
20200314,2,동대문역사문화공원,6324,6443,20200317,12767
20200314,2,신당,8011,8374,20200317,16385
20200314,2,상왕십리,6649,6235,20200317,12884
20200314,2,왕십리,9669,8267,20200317,17936
20200314,2,한양대,2606,2684,20200317,5290
20200314,2,뚝섬,8933,9182,20200317,18115
20200314,2,성수,11931,13180,20200317,25111
20200314,2,건대입구,24714,27494,20200317,52208
20200314,2,구의,12158,11707,20200317,23865
20200314,2,강변,18513,18697,20200317,37210
20200314,2,잠실나루,4905,4761,20200317,9666
20200314,2,잠실,40140,37668,20200317,77808
20200314,2,잠실새내,11276,11953,20200317,23229
20200314,2,종합운동장,2689,2989,20200317,5678
20200314,2,삼성,17837,18078,20200317,35915
20200314,2,선릉,17015,15057,20200317,32072
20200314,2,역삼,13397,14795,20200317,28192
20200314,2,강남,44058,46745,20200317,90803
20200314,2,교대,12072,13056,20200317,25128
20200314,2,서초,6403,5870,20200317,12273
20200314,2,방배,6986,7161,20200317,14147
20200314,2,사당,21172,22860,20200317,44032
20200314,2,낙성대,15671,14090,20200317,29761
20200314,2,서울대입구,27350,26578,20200317,53928
20200314,2,봉천,12573,11548,20200317,24121
20200314,2,신림,37870,36192,20200317,74062
20200314,2,신대방,14275,13684,20200317,27959
20200314,2,구로디지털단지,24975,24661,20200317,49636
20200314,2,대림,12039,12458,20200317,24497
20200314,2,신도림,23517,23168,20200317,46685
20200314,2,문래,7390,7698,20200317,15088
20200314,2,영등포구청,8410,8619,20200317,17029
20200314,2,당산,8777,9669,20200317,18446
20200314,2,합정,17899,20114,20200317,38013
20200314,2,홍대입구,39593,44740,20200317,84333
20200314,2,신촌,22321,22976,20200317,45297
20200314,2,이대,6436,6569,20200317,13005
20200314,2,아현,4889,4556,20200317,9445
20200314,2,충정로,4048,4131,20200317,8179
20200314,2,용답,1473,1359,20200317,2832
20200314,2,신답,746,742,20200317,1488
20200314,2,신설동,2000,2009,20200317,4009
20200314,2,도림천,556,545,20200317,1101
20200314,2,양천구청,2619,2603,20200317,5222
20200314,2,신정네거리,4407,4487,20200317,8894
20200314,2,용두,1233,1216,20200317,2449
20200315,2,시청,2787,2360,20200318,5147
20200315,2,을지로입구,9669,9617,20200318,19286
20200315,2,을지로3가,3028,2861,20200318,5889
20200315,2,을지로4가,1694,1712,20200318,3406
20200315,2,동대문역사문화공원,4145,5263,20200318,9408
20200315,2,신당,5127,5618,20200318,10745
20200315,2,상왕십리,4215,4120,20200318,8335
20200315,2,왕십리,6580,5622,20200318,12202
20200315,2,한양대,1641,1825,20200318,3466
20200315,2,뚝섬,5553,5680,20200318,11233
20200315,2,성수,7412,8178,20200318,15590
20200315,2,건대입구,18067,18945,20200318,37012
20200315,2,구의,7938,7964,20200318,15902
20200315,2,강변,14412,14280,20200318,28692
20200315,2,잠실나루,3089,3070,20200318,6159
20200315,2,잠실,27667,25807,20200318,53474
20200315,2,잠실새내,6722,7260,20200318,13982
20200315,2,종합운동장,1790,2155,20200318,3945
20200315,2,삼성,12243,11923,20200318,24166
20200315,2,선릉,8230,7213,20200318,15443
20200315,2,역삼,7467,8069,20200318,15536
20200315,2,강남,24905,24485,20200318,49390
20200315,2,교대,6720,7464,20200318,14184
20200315,2,서초,3869,3588,20200318,7457
20200315,2,방배,4128,4305,20200318,8433
20200315,2,사당,13718,15098,20200318,28816
20200315,2,낙성대,10148,10611,20200318,20759
20200315,2,서울대입구,18724,18962,20200318,37686
20200315,2,봉천,8079,7676,20200318,15755
20200315,2,신림,26136,25303,20200318,51439
20200315,2,신대방,9873,9517,20200318,19390
20200315,2,구로디지털단지,15640,15360,20200318,31000
20200315,2,대림,8173,8210,20200318,16383
20200315,2,신도림,14737,14858,20200318,29595
20200315,2,문래,4292,4469,20200318,8761
20200315,2,영등포구청,5114,5294,20200318,10408
20200315,2,당산,5526,6082,20200318,11608
20200315,2,합정,12218,12669,20200318,24887
20200315,2,홍대입구,29003,28466,20200318,57469
20200315,2,신촌,15430,15185,20200318,30615
20200315,2,이대,3974,4372,20200318,8346
20200315,2,아현,2881,3021,20200318,5902
20200315,2,충정로,2478,2588,20200318,5066
20200315,2,용답,1058,1091,20200318,2149
20200315,2,신답,451,513,20200318,964
20200315,2,신설동,1764,1695,20200318,3459
20200315,2,도림천,277,282,20200318,559
20200315,2,양천구청,1805,1869,20200318,3674
20200315,2,신정네거리,2698,2721,20200318,5419
20200315,2,용두,777,802,20200318,1579
20200316,2,시청,20918,20826,20200319,41744
20200316,2,을지로입구,31714,32542,20200319,64256
20200316,2,을지로3가,17880,17735,20200319,35615
20200316,2,을지로4가,10931,10958,20200319,21889
20200316,2,동대문역사문화공원,9160,10265,20200319,19425
20200316,2,신당,11171,11649,20200319,22820
20200316,2,상왕십리,11315,11040,20200319,22355
20200316,2,왕십리,12860,10757,20200319,23617
20200316,2,한양대,5748,6376,20200319,12124
20200316,2,뚝섬,17157,18560,20200319,35717
20200316,2,성수,29271,31861,20200319,61132
20200316,2,건대입구,27707,29514,20200319,57221
20200316,2,구의,20610,20313,20200319,40923
20200316,2,강변,25633,25108,20200319,50741
20200316,2,잠실나루,11315,11078,20200319,22393
20200316,2,잠실,52355,51191,20200319,103546
20200316,2,잠실새내,16388,16238,20200319,32626
20200316,2,종합운동장,5229,5530,20200319,10759
20200316,2,삼성,40100,41083,20200319,81183
20200316,2,선릉,49570,44456,20200319,94026
20200316,2,역삼,42804,47492,20200319,90296
20200316,2,강남,73055,71549,20200319,144604
20200316,2,교대,29240,32589,20200319,61829
20200316,2,서초,17595,17652,20200319,35247
20200316,2,방배,13625,14116,20200319,27741
20200316,2,사당,28823,31526,20200319,60349
20200316,2,낙성대,22401,22202,20200319,44603
20200316,2,서울대입구,38878,37641,20200319,76519
20200316,2,봉천,20412,19226,20200319,39638
20200316,2,신림,54006,52268,20200319,106274
20200316,2,신대방,21836,21175,20200319,43011
20200316,2,구로디지털단지,50979,51318,20200319,102297
20200316,2,대림,19888,19970,20200319,39858
20200316,2,신도림,35747,34432,20200319,70179
20200316,2,문래,17320,17873,20200319,35193
20200316,2,영등포구청,19368,19668,20200319,39036
20200316,2,당산,16178,18750,20200319,34928
20200316,2,합정,23990,24736,20200319,48726
20200316,2,홍대입구,37814,39393,20200319,77207
20200316,2,신촌,25488,26523,20200319,52011
20200316,2,이대,8787,9303,20200319,18090
20200316,2,아현,7545,7263,20200319,14808
20200316,2,충정로,8832,9307,20200319,18139
20200316,2,용답,2064,2121,20200319,4185
20200316,2,신답,1407,1592,20200319,2999
20200316,2,신설동,2684,2758,20200319,5442
20200316,2,도림천,1005,1060,20200319,2065
20200316,2,양천구청,5083,5338,20200319,10421
20200316,2,신정네거리,7295,7517,20200319,14812
20200316,2,용두,1843,1958,20200319,3801
20200317,2,시청,20915,21073,20200320,41988
20200317,2,을지로입구,31464,32706,20200320,64170
20200317,2,을지로3가,17855,17766,20200320,35621
20200317,2,을지로4가,10951,10753,20200320,21704
20200317,2,동대문역사문화공원,9396,10228,20200320,19624
20200317,2,신당,11274,11696,20200320,22970
20200317,2,상왕십리,11311,10867,20200320,22178
20200317,2,왕십리,12982,10668,20200320,23650
20200317,2,한양대,5812,6259,20200320,12071
20200317,2,뚝섬,17304,18809,20200320,36113
20200317,2,성수,29605,32204,20200320,61809
20200317,2,건대입구,27743,29311,20200320,57054
20200317,2,구의,20627,20280,20200320,40907
20200317,2,강변,24782,24054,20200320,48836
20200317,2,잠실나루,11517,11325,20200320,22842
20200317,2,잠실,53302,52258,20200320,105560
20200317,2,잠실새내,16411,16469,20200320,32880
20200317,2,종합운동장,5130,5444,20200320,10574
20200317,2,삼성,40145,40978,20200320,81123
20200317,2,선릉,49324,44314,20200320,93638
20200317,2,역삼,42789,47264,20200320,90053
20200317,2,강남,73130,73546,20200320,146676
20200317,2,교대,29070,32507,20200320,61577
20200317,2,서초,17525,17507,20200320,35032
20200317,2,방배,13733,14172,20200320,27905
20200317,2,사당,29519,32262,20200320,61781
20200317,2,낙성대,22426,21697,20200320,44123
20200317,2,서울대입구,38787,37410,20200320,76197
20200317,2,봉천,20299,18864,20200320,39163
20200317,2,신림,54055,52548,20200320,106603
20200317,2,신대방,22031,21270,20200320,43301
20200317,2,구로디지털단지,51107,51450,20200320,102557
20200317,2,대림,19878,20159,20200320,40037
20200317,2,신도림,36695,35625,20200320,72320
20200317,2,문래,17591,18015,20200320,35606
20200317,2,영등포구청,19474,19692,20200320,39166
20200317,2,당산,16354,18880,20200320,35234
20200317,2,합정,24606,25573,20200320,50179
20200317,2,홍대입구,37983,40299,20200320,78282
20200317,2,신촌,26624,27678,20200320,54302
20200317,2,이대,8680,9106,20200320,17786
20200317,2,아현,7426,7216,20200320,14642
20200317,2,충정로,8697,9147,20200320,17844
20200317,2,용답,2069,2068,20200320,4137
20200317,2,신답,1371,1550,20200320,2921
20200317,2,신설동,2515,2673,20200320,5188
20200317,2,도림천,991,1015,20200320,2006
20200317,2,양천구청,5082,5379,20200320,10461
20200317,2,신정네거리,7341,7717,20200320,15058
20200317,2,용두,1825,1922,20200320,3747
20200318,2,시청,20898,21163,20200321,42061
20200318,2,을지로입구,32075,33341,20200321,65416
20200318,2,을지로3가,18124,18348,20200321,36472
20200318,2,을지로4가,11061,11074,20200321,22135
20200318,2,동대문역사문화공원,9696,10800,20200321,20496
20200318,2,신당,11661,11824,20200321,23485
20200318,2,상왕십리,11518,11089,20200321,22607
20200318,2,왕십리,13246,11073,20200321,24319
20200318,2,한양대,5980,6487,20200321,12467
20200318,2,뚝섬,18074,19730,20200321,37804
20200318,2,성수,29717,32520,20200321,62237
20200318,2,건대입구,29409,31227,20200321,60636
20200318,2,구의,20827,20381,20200321,41208
20200318,2,강변,25446,24967,20200321,50413
20200318,2,잠실나루,11729,11398,20200321,23127
20200318,2,잠실,56426,55012,20200321,111438
20200318,2,잠실새내,16902,16788,20200321,33690
20200318,2,종합운동장,5478,5743,20200321,11221
20200318,2,삼성,40226,41414,20200321,81640
20200318,2,선릉,49963,44924,20200321,94887
20200318,2,역삼,43505,48151,20200321,91656
20200318,2,강남,74676,75073,20200321,149749
20200318,2,교대,29718,33168,20200321,62886
20200318,2,서초,17756,17753,20200321,35509
20200318,2,방배,13834,14384,20200321,28218
20200318,2,사당,30705,33191,20200321,63896
20200318,2,낙성대,22987,22328,20200321,45315
20200318,2,서울대입구,39986,38788,20200321,78774
20200318,2,봉천,20707,19224,20200321,39931
20200318,2,신림,55477,53588,20200321,109065
20200318,2,신대방,22500,21649,20200321,44149
20200318,2,구로디지털단지,52203,52288,20200321,104491
20200318,2,대림,20160,20526,20200321,40686
20200318,2,신도림,37869,36868,20200321,74737
20200318,2,문래,17741,18203,20200321,35944
20200318,2,영등포구청,19745,20005,20200321,39750
20200318,2,당산,17036,19535,20200321,36571
20200318,2,합정,25638,27074,20200321,52712
20200318,2,홍대입구,40912,43449,20200321,84361
20200318,2,신촌,27464,28766,20200321,56230
20200318,2,이대,9097,9518,20200321,18615
20200318,2,아현,7733,7446,20200321,15179
20200318,2,충정로,8733,9172,20200321,17905
20200318,2,용답,2192,2179,20200321,4371
20200318,2,신답,1446,1594,20200321,3040
20200318,2,신설동,2703,2771,20200321,5474
20200318,2,도림천,961,1038,20200321,1999
20200318,2,양천구청,5357,5474,20200321,10831
20200318,2,신정네거리,7417,7832,20200321,15249
20200318,2,용두,1970,2046,20200321,4016
20200319,2,시청,20685,20911,20200322,41596
20200319,2,을지로입구,31249,32126,20200322,63375
20200319,2,을지로3가,17705,17703,20200322,35408
20200319,2,을지로4가,10532,10538,20200322,21070
20200319,2,동대문역사문화공원,8903,9960,20200322,18863
20200319,2,신당,10987,11373,20200322,22360
20200319,2,상왕십리,11065,10837,20200322,21902
20200319,2,왕십리,13102,10821,20200322,23923
20200319,2,한양대,5619,6046,20200322,11665
20200319,2,뚝섬,16876,18553,20200322,35429
20200319,2,성수,28624,31716,20200322,60340
20200319,2,건대입구,27505,29709,20200322,57214
20200319,2,구의,20132,19734,20200322,39866
20200319,2,강변,24529,23615,20200322,48144
20200319,2,잠실나루,11137,10832,20200322,21969
20200319,2,잠실,52352,51171,20200322,103523
20200319,2,잠실새내,15901,15959,20200322,31860
20200319,2,종합운동장,5060,5440,20200322,10500
20200319,2,삼성,39649,40956,20200322,80605
20200319,2,선릉,48317,43609,20200322,91926
20200319,2,역삼,43105,47293,20200322,90398
20200319,2,강남,72021,72660,20200322,144681
20200319,2,교대,28569,31652,20200322,60221
20200319,2,서초,17045,17247,20200322,34292
20200319,2,방배,13430,13832,20200322,27262
20200319,2,사당,29170,31373,20200322,60543
20200319,2,낙성대,22122,21404,20200322,43526
20200319,2,서울대입구,38290,36601,20200322,74891
20200319,2,봉천,19840,18601,20200322,38441
20200319,2,신림,53723,51770,20200322,105493
20200319,2,신대방,21698,20977,20200322,42675
20200319,2,구로디지털단지,50764,51132,20200322,101896
20200319,2,대림,19433,19788,20200322,39221
20200319,2,신도림,36819,35541,20200322,72360
20200319,2,문래,17247,17698,20200322,34945
20200319,2,영등포구청,19291,19605,20200322,38896
20200319,2,당산,16086,18661,20200322,34747
20200319,2,합정,24517,25983,20200322,50500
20200319,2,홍대입구,38838,40825,20200322,79663
20200319,2,신촌,26122,27125,20200322,53247
20200319,2,이대,8775,9141,20200322,17916
20200319,2,아현,7418,7065,20200322,14483
20200319,2,충정로,8523,8993,20200322,17516
20200319,2,용답,2011,1990,20200322,4001
20200319,2,신답,1318,1523,20200322,2841
20200319,2,신설동,2678,2682,20200322,5360
20200319,2,도림천,938,1019,20200322,1957
20200319,2,양천구청,5011,5303,20200322,10314
20200319,2,신정네거리,7147,7458,20200322,14605
20200319,2,용두,1785,1868,20200322,3653
20200320,2,시청,20850,21033,20200323,41883
20200320,2,을지로입구,32757,33355,20200323,66112
20200320,2,을지로3가,18154,18396,20200323,36550
20200320,2,을지로4가,11205,11420,20200323,22625
20200320,2,동대문역사문화공원,9819,11065,20200323,20884
20200320,2,신당,12094,12433,20200323,24527
20200320,2,상왕십리,11839,11167,20200323,23006
20200320,2,왕십리,14405,12492,20200323,26897
20200320,2,한양대,6060,6438,20200323,12498
20200320,2,뚝섬,18098,19561,20200323,37659
20200320,2,성수,29883,33124,20200323,63007
20200320,2,건대입구,32343,36107,20200323,68450
20200320,2,구의,21534,20667,20200323,42201
20200320,2,강변,28373,28234,20200323,56607
20200320,2,잠실나루,11879,11324,20200323,23203
20200320,2,잠실,58747,56962,20200323,115709
20200320,2,잠실새내,17999,18676,20200323,36675
20200320,2,종합운동장,5610,5956,20200323,11566
20200320,2,삼성,41401,42371,20200323,83772
20200320,2,선릉,49492,44595,20200323,94087
20200320,2,역삼,42722,47447,20200323,90169
20200320,2,강남,78642,82085,20200323,160727
20200320,2,교대,29967,33629,20200323,63596
20200320,2,서초,17553,17524,20200323,35077
20200320,2,방배,14173,14437,20200323,28610
20200320,2,사당,32642,35758,20200323,68400
20200320,2,낙성대,24077,22230,20200323,46307
20200320,2,서울대입구,42899,40609,20200323,83508
20200320,2,봉천,21322,19353,20200323,40675
20200320,2,신림,57771,55854,20200323,113625
20200320,2,신대방,23231,22096,20200323,45327
20200320,2,구로디지털단지,53437,53522,20200323,106959
20200320,2,대림,20623,20684,20200323,41307
20200320,2,신도림,40589,39803,20200323,80392
20200320,2,문래,18096,18540,20200323,36636
20200320,2,영등포구청,19891,20076,20200323,39967
20200320,2,당산,17540,20228,20200323,37768
20200320,2,합정,27369,30218,20200323,57587
20200320,2,홍대입구,46052,52607,20200323,98659
20200320,2,신촌,29765,31414,20200323,61179
20200320,2,이대,9778,9996,20200323,19774
20200320,2,아현,8078,7673,20200323,15751
20200320,2,충정로,8841,9059,20200323,17900
20200320,2,용답,2214,2208,20200323,4422
20200320,2,신답,1412,1568,20200323,2980
20200320,2,신설동,2784,2859,20200323,5643
20200320,2,도림천,991,1038,20200323,2029
20200320,2,양천구청,5317,5590,20200323,10907
20200320,2,신정네거리,7699,8145,20200323,15844
20200320,2,용두,2039,2122,20200323,4161
20200321,2,시청,4811,4460,20200324,9271
20200321,2,을지로입구,13584,13622,20200324,27206
20200321,2,을지로3가,6172,6335,20200324,12507
20200321,2,을지로4가,5080,5196,20200324,10276
20200321,2,동대문역사문화공원,6630,6685,20200324,13315
20200321,2,신당,8021,8214,20200324,16235
20200321,2,상왕십리,6829,6266,20200324,13095
20200321,2,왕십리,9968,8441,20200324,18409
20200321,2,한양대,2727,2838,20200324,5565
20200321,2,뚝섬,9522,9882,20200324,19404
20200321,2,성수,12203,13761,20200324,25964
20200321,2,건대입구,25686,28794,20200324,54480
20200321,2,구의,12629,11852,20200324,24481
20200321,2,강변,19129,19686,20200324,38815
20200321,2,잠실나루,5128,4986,20200324,10114
20200321,2,잠실,40868,38166,20200324,79034
20200321,2,잠실새내,11612,12308,20200324,23920
20200321,2,종합운동장,2943,3150,20200324,6093
20200321,2,삼성,17748,18148,20200324,35896
20200321,2,선릉,17571,15638,20200324,33209
20200321,2,역삼,13558,14791,20200324,28349
20200321,2,강남,47272,49593,20200324,96865
20200321,2,교대,12509,13636,20200324,26145
20200321,2,서초,6401,5911,20200324,12312
20200321,2,방배,6896,7028,20200324,13924
20200321,2,사당,22334,24272,20200324,46606
20200321,2,낙성대,16061,14444,20200324,30505
20200321,2,서울대입구,28535,27851,20200324,56386
20200321,2,봉천,13478,11921,20200324,25399
20200321,2,신림,39608,37669,20200324,77277
20200321,2,신대방,15282,14430,20200324,29712
20200321,2,구로디지털단지,26346,25897,20200324,52243
20200321,2,대림,13049,13422,20200324,26471
20200321,2,신도림,26325,26290,20200324,52615
20200321,2,문래,7496,7906,20200324,15402
20200321,2,영등포구청,8858,8934,20200324,17792
20200321,2,당산,9686,10650,20200324,20336
20200321,2,합정,19231,21996,20200324,41227
20200321,2,홍대입구,41362,46632,20200324,87994
20200321,2,신촌,22746,23349,20200324,46095
20200321,2,이대,6629,6922,20200324,13551
20200321,2,아현,5061,4787,20200324,9848
20200321,2,충정로,3947,3959,20200324,7906
20200321,2,용답,1535,1541,20200324,3076
20200321,2,신답,796,799,20200324,1595
20200321,2,신설동,2254,2180,20200324,4434
20200321,2,도림천,637,575,20200324,1212
20200321,2,신정네거리,4747,4792,20200324,9539
20200321,2,용두,1329,1274,20200324,2603
20200321,2,양천구청,2920,2873,20200324,5793
20200322,2,시청,2844,2526,20200325,5370
20200322,2,을지로입구,10040,9797,20200325,19837
20200322,2,을지로3가,3351,3004,20200325,6355
20200322,2,을지로4가,1827,1830,20200325,3657
20200322,2,동대문역사문화공원,4469,5669,20200325,10138
20200322,2,신당,5570,5979,20200325,11549
20200322,2,상왕십리,4409,4255,20200325,8664
20200322,2,왕십리,6678,5804,20200325,12482
20200322,2,한양대,1853,2109,20200325,3962
20200322,2,뚝섬,6766,7232,20200325,13998
20200322,2,성수,7822,8621,20200325,16443
20200322,2,건대입구,20397,20432,20200325,40829
20200322,2,구의,8364,8337,20200325,16701
20200322,2,강변,15525,15431,20200325,30956
20200322,2,잠실나루,3458,3454,20200325,6912
20200322,2,잠실,30258,27873,20200325,58131
20200322,2,잠실새내,7297,7772,20200325,15069
20200322,2,종합운동장,2052,2340,20200325,4392
20200322,2,삼성,12625,12359,20200325,24984
20200322,2,선릉,8594,7540,20200325,16134
20200322,2,역삼,7630,8408,20200325,16038
20200322,2,강남,26203,25826,20200325,52029
20200322,2,교대,7034,7765,20200325,14799
20200322,2,서초,3993,3692,20200325,7685
20200322,2,방배,4274,4578,20200325,8852
20200322,2,사당,14745,16996,20200325,31741
20200322,2,낙성대,11182,11254,20200325,22436
20200322,2,서울대입구,20185,20790,20200325,40975
20200322,2,봉천,8676,8329,20200325,17005
20200322,2,신림,27598,27175,20200325,54773
20200322,2,신대방,10701,10329,20200325,21030
20200322,2,구로디지털단지,16619,16241,20200325,32860
20200322,2,대림,9346,9475,20200325,18821
20200322,2,신도림,16647,16910,20200325,33557
20200322,2,문래,4451,4657,20200325,9108
20200322,2,영등포구청,5150,5395,20200325,10545
20200322,2,당산,6700,7197,20200325,13897
20200322,2,합정,13533,14244,20200325,27777
20200322,2,홍대입구,31762,30728,20200325,62490
20200322,2,신촌,15679,15541,20200325,31220
20200322,2,이대,4175,4426,20200325,8601
20200322,2,아현,3242,3239,20200325,6481
20200322,2,충정로,2457,2618,20200325,5075
20200322,2,용답,1136,1240,20200325,2376
20200322,2,신답,534,545,20200325,1079
20200322,2,신설동,1793,1869,20200325,3662
20200322,2,도림천,291,272,20200325,563
20200322,2,양천구청,2002,2015,20200325,4017
20200322,2,신정네거리,3011,2962,20200325,5973
20200322,2,용두,751,764,20200325,1515
20200323,2,시청,20699,21142,20200326,41841
20200323,2,을지로입구,31590,32648,20200326,64238
20200323,2,을지로3가,18270,18182,20200326,36452
20200323,2,을지로4가,10584,10576,20200326,21160
20200323,2,동대문역사문화공원,9281,10468,20200326,19749
20200323,2,신당,11444,11793,20200326,23237
20200323,2,상왕십리,11576,11122,20200326,22698
20200323,2,왕십리,12932,10742,20200326,23674
20200323,2,한양대,5824,6376,20200326,12200
20200323,2,뚝섬,17200,18789,20200326,35989
20200323,2,성수,28491,31076,20200326,59567
20200323,2,건대입구,28339,29956,20200326,58295
20200323,2,구의,20570,20361,20200326,40931
20200323,2,강변,26539,25933,20200326,52472
20200323,2,잠실나루,11550,11279,20200326,22829
20200323,2,잠실,53420,52284,20200326,105704
20200323,2,잠실새내,16738,16717,20200326,33455
20200323,2,종합운동장,5508,5861,20200326,11369
20200323,2,삼성,41520,42539,20200326,84059
20200323,2,선릉,50765,45511,20200326,96276
20200323,2,역삼,44174,49167,20200326,93341
20200323,2,강남,74050,74190,20200326,148240
20200323,2,교대,29279,32803,20200326,62082
20200323,2,서초,18253,17946,20200326,36199
20200323,2,방배,13768,14300,20200326,28068
20200323,2,사당,29402,32611,20200326,62013
20200323,2,낙성대,22672,22298,20200326,44970
20200323,2,서울대입구,39445,38656,20200326,78101
20200323,2,봉천,20561,19247,20200326,39808
20200323,2,신림,55470,53776,20200326,109246
20200323,2,신대방,22800,21917,20200326,44717
20200323,2,구로디지털단지,53274,53610,20200326,106884
20200323,2,대림,20959,21099,20200326,42058
20200323,2,신도림,39097,37973,20200326,77070
20200323,2,문래,17481,18052,20200326,35533
20200323,2,영등포구청,19750,19998,20200326,39748
20200323,2,당산,16802,19390,20200326,36192
20200323,2,합정,24501,25411,20200326,49912
20200323,2,홍대입구,39383,41069,20200326,80452
20200323,2,신촌,26516,27624,20200326,54140
20200323,2,이대,9348,9915,20200326,19263
20200323,2,아현,7589,7301,20200326,14890
20200323,2,충정로,8697,9085,20200326,17782
20200323,2,용답,2133,2099,20200326,4232
20200323,2,신답,1344,1545,20200326,2889
20200323,2,신설동,2659,2738,20200326,5397
20200323,2,도림천,1010,1059,20200326,2069
20200323,2,양천구청,5349,5728,20200326,11077
20200323,2,신정네거리,7626,7882,20200326,15508
20200323,2,용두,1938,2075,20200326,4013
20200324,2,시청,20979,21254,20200327,42233
20200324,2,을지로입구,31943,33111,20200327,65054
20200324,2,을지로3가,18524,18363,20200327,36887
20200324,2,을지로4가,10868,10905,20200327,21773
20200324,2,동대문역사문화공원,9485,10456,20200327,19941
20200324,2,신당,11434,11877,20200327,23311
20200324,2,상왕십리,11624,11149,20200327,22773
20200324,2,왕십리,13206,10853,20200327,24059
20200324,2,한양대,5820,6396,20200327,12216
20200324,2,뚝섬,18326,19801,20200327,38127
20200324,2,성수,29654,32386,20200327,62040
20200324,2,건대입구,28698,30174,20200327,58872
20200324,2,구의,20952,20276,20200327,41228
20200324,2,강변,25021,24284,20200327,49305
20200324,2,잠실나루,11723,11483,20200327,23206
20200324,2,잠실,55000,53875,20200327,108875
20200324,2,잠실새내,16733,16792,20200327,33525
20200324,2,종합운동장,5391,5721,20200327,11112
20200324,2,삼성,41365,42500,20200327,83865
20200324,2,선릉,50684,45411,20200327,96095
20200324,2,역삼,43803,48913,20200327,92716
20200324,2,강남,74822,74483,20200327,149305
20200324,2,교대,29823,33461,20200327,63284
20200324,2,서초,18192,17843,20200327,36035
20200324,2,방배,14131,14591,20200327,28722
20200324,2,사당,30434,33217,20200327,63651
20200324,2,낙성대,22847,22385,20200327,45232
20200324,2,서울대입구,40058,38919,20200327,78977
20200324,2,봉천,20745,19193,20200327,39938
20200324,2,신림,55767,54061,20200327,109828
20200324,2,신대방,22819,22065,20200327,44884
20200324,2,구로디지털단지,52944,53314,20200327,106258
20200324,2,대림,20594,20965,20200327,41559
20200324,2,신도림,38365,37200,20200327,75565
20200324,2,문래,17982,18318,20200327,36300
20200324,2,영등포구청,19364,19796,20200327,39160
20200324,2,당산,16829,19436,20200327,36265
20200324,2,합정,25061,26431,20200327,51492
20200324,2,홍대입구,39830,41945,20200327,81775
20200324,2,신촌,26575,27518,20200327,54093
20200324,2,이대,8868,9246,20200327,18114
20200324,2,아현,7770,7456,20200327,15226
20200324,2,충정로,8667,9159,20200327,17826
20200324,2,용답,2130,2081,20200327,4211
20200324,2,신답,1374,1558,20200327,2932
20200324,2,신설동,2474,2586,20200327,5060
20200324,2,도림천,986,1052,20200327,2038
20200324,2,양천구청,5348,5677,20200327,11025
20200324,2,신정네거리,7627,8008,20200327,15635
20200324,2,용두,1993,2109,20200327,4102
20200325,2,시청,21053,21224,20200328,42277
20200325,2,을지로입구,32405,33373,20200328,65778
20200325,2,을지로3가,18768,18676,20200328,37444
20200325,2,을지로4가,11076,10991,20200328,22067
20200325,2,동대문역사문화공원,10020,11068,20200328,21088
20200325,2,신당,11756,12082,20200328,23838
20200325,2,상왕십리,11719,11333,20200328,23052
20200325,2,왕십리,13535,11393,20200328,24928
20200325,2,한양대,5901,6342,20200328,12243
20200325,2,뚝섬,18513,20310,20200328,38823
20200325,2,성수,29742,32426,20200328,62168
20200325,2,건대입구,29978,32019,20200328,61997
20200325,2,구의,21006,20409,20200328,41415
20200325,2,강변,26078,25631,20200328,51709
20200325,2,잠실나루,11803,11461,20200328,23264
20200325,2,잠실,56930,55768,20200328,112698
20200325,2,잠실새내,17100,17037,20200328,34137
20200325,2,종합운동장,5591,5989,20200328,11580
20200325,2,삼성,41613,43092,20200328,84705
20200325,2,선릉,50726,45574,20200328,96300
20200325,2,역삼,43767,48746,20200328,92513
20200325,2,강남,76454,76834,20200328,153288
20200325,2,교대,30252,33967,20200328,64219
20200325,2,서초,18350,18056,20200328,36406
20200325,2,방배,14151,14759,20200328,28910
20200325,2,사당,31087,33957,20200328,65044
20200325,2,낙성대,23603,22834,20200328,46437
20200325,2,서울대입구,40698,39567,20200328,80265
20200325,2,봉천,20959,19598,20200328,40557
20200325,2,신림,56386,54477,20200328,110863
20200325,2,신대방,23226,22209,20200328,45435
20200325,2,구로디지털단지,53332,53734,20200328,107066
20200325,2,대림,20854,21134,20200328,41988
20200325,2,신도림,40402,39113,20200328,79515
20200325,2,문래,18004,18495,20200328,36499
20200325,2,영등포구청,19724,20191,20200328,39915
20200325,2,당산,17459,20100,20200328,37559
20200325,2,합정,25942,27336,20200328,53278
20200325,2,홍대입구,41827,43861,20200328,85688
20200325,2,신촌,27332,28440,20200328,55772
20200325,2,이대,9065,9516,20200328,18581
20200325,2,아현,7842,7570,20200328,15412
20200325,2,충정로,8775,9192,20200328,17967
20200325,2,용답,2162,2092,20200328,4254
20200325,2,신답,1373,1567,20200328,2940
20200325,2,신설동,2684,2763,20200328,5447
20200325,2,도림천,966,1046,20200328,2012
20200325,2,양천구청,5407,5668,20200328,11075
20200325,2,신정네거리,7667,8069,20200328,15736
20200325,2,용두,2037,2138,20200328,4175
20200326,2,왕십리,13107,11100,20200329,24207
20200326,2,상왕십리,11573,11100,20200329,22673
20200326,2,신당,11412,11839,20200329,23251
20200326,2,동대문역사문화공원,9472,10456,20200329,19928
20200326,2,을지로4가,10805,10581,20200329,21386
20200326,2,을지로3가,18307,18115,20200329,36422
20200326,2,을지로입구,31524,32642,20200329,64166
20200326,2,시청,20693,20816,20200329,41509
20200326,2,한양대,5917,6256,20200329,12173
20200326,2,뚝섬,17650,19139,20200329,36789
20200326,2,성수,29457,32216,20200329,61673
20200326,2,건대입구,28385,30225,20200329,58610
20200326,2,구의,20927,20397,20200329,41324
20200326,2,강변,25440,24799,20200329,50239
20200326,2,잠실나루,11840,11459,20200329,23299
20200326,2,잠실,53888,52855,20200329,106743
20200326,2,잠실새내,16676,16496,20200329,33172
20200326,2,종합운동장,5411,5834,20200329,11245
20200326,2,삼성,41343,42745,20200329,84088
20200326,2,선릉,50244,45084,20200329,95328
20200326,2,역삼,44188,48433,20200329,92621
20200326,2,강남,74869,74954,20200329,149823
20200326,2,교대,29311,32961,20200329,62272
20200326,2,서초,17889,17708,20200329,35597
20200326,2,방배,13852,14273,20200329,28125
20200326,2,사당,30702,33112,20200329,63814
20200326,2,낙성대,22945,22310,20200329,45255
20200326,2,서울대입구,39595,38184,20200329,77779
20200326,2,봉천,20682,19177,20200329,39859
20200326,2,신림,55532,53515,20200329,109047
20200326,2,신대방,22496,21673,20200329,44169
20200326,2,구로디지털단지,52977,52996,20200329,105973
20200326,2,대림,20444,20539,20200329,40983
20200326,2,신도림,39569,38639,20200329,78208
20200326,2,문래,17764,18116,20200329,35880
20200326,2,영등포구청,19688,19887,20200329,39575
20200326,2,당산,16686,19376,20200329,36062
20200326,2,합정,24834,26546,20200329,51380
20200326,2,홍대입구,39935,42057,20200329,81992
20200326,2,신촌,26755,27682,20200329,54437
20200326,2,이대,8893,9244,20200329,18137
20200326,2,아현,7692,7412,20200329,15104
20200326,2,충정로,8713,9233,20200329,17946
20200326,2,용답,2063,2064,20200329,4127
20200326,2,신답,1397,1588,20200329,2985
20200326,2,신설동,2633,2727,20200329,5360
20200326,2,도림천,1033,1047,20200329,2080
20200326,2,양천구청,5258,5570,20200329,10828
20200326,2,신정네거리,7607,7966,20200329,15573
20200326,2,용두,1866,2020,20200329,3886
20200327,2,시청,20515,20457,20200330,40972
20200327,2,을지로입구,32270,33351,20200330,65621
20200327,2,을지로3가,18622,18757,20200330,37379
20200327,2,을지로4가,10960,11113,20200330,22073
20200327,2,동대문역사문화공원,10065,11129,20200330,21194
20200327,2,신당,11874,12249,20200330,24123
20200327,2,상왕십리,11881,11197,20200330,23078
20200327,2,왕십리,14307,12378,20200330,26685
20200327,2,한양대,6039,6348,20200330,12387
20200327,2,뚝섬,18330,19799,20200330,38129
20200327,2,성수,29871,33007,20200330,62878
20200327,2,건대입구,31695,35616,20200330,67311
20200327,2,구의,21397,20773,20200330,42170
20200327,2,강변,28142,28194,20200330,56336
20200327,2,잠실나루,11989,11434,20200330,23423
20200327,2,잠실,58589,56706,20200330,115295
20200327,2,잠실새내,17932,18417,20200330,36349
20200327,2,종합운동장,5649,5938,20200330,11587
20200327,2,삼성,42050,43069,20200330,85119
20200327,2,선릉,50107,45144,20200330,95251
20200327,2,역삼,43491,48111,20200330,91602
20200327,2,강남,80402,82183,20200330,162585
20200327,2,교대,30130,33946,20200330,64076
20200327,2,서초,18162,17860,20200330,36022
20200327,2,방배,14127,14574,20200330,28701
20200327,2,사당,33486,35854,20200330,69340
20200327,2,낙성대,24244,22522,20200330,46766
20200327,2,서울대입구,42730,40688,20200330,83418
20200327,2,봉천,21428,19375,20200330,40803
20200327,2,신림,58212,56251,20200330,114463
20200327,2,신대방,23328,22042,20200330,45370
20200327,2,구로디지털단지,54150,54262,20200330,108412
20200327,2,대림,20630,20747,20200330,41377
20200327,2,신도림,41776,41064,20200330,82840
20200327,2,문래,17979,18741,20200330,36720
20200327,2,영등포구청,20010,20297,20200330,40307
20200327,2,당산,17453,20149,20200330,37602
20200327,2,합정,27043,29927,20200330,56970
20200327,2,홍대입구,45014,50680,20200330,95694
20200327,2,신촌,29185,30592,20200330,59777
20200327,2,이대,9551,9898,20200330,19449
20200327,2,아현,7893,7589,20200330,15482
20200327,2,충정로,8857,9038,20200330,17895
20200327,2,용답,2243,2185,20200330,4428
20200327,2,신답,1413,1538,20200330,2951
20200327,2,신설동,2755,2802,20200330,5557
20200327,2,도림천,1008,1048,20200330,2056
20200327,2,양천구청,5484,5663,20200330,11147
20200327,2,신정네거리,7855,8241,20200330,16096
20200327,2,용두,2045,2090,20200330,4135
20200328,2,시청,5023,4512,20200331,9535
20200328,2,을지로입구,13629,13593,20200331,27222
20200328,2,을지로3가,6104,6390,20200331,12494
20200328,2,을지로4가,5157,5283,20200331,10440
20200328,2,동대문역사문화공원,6457,6635,20200331,13092
20200328,2,신당,8116,8353,20200331,16469
20200328,2,상왕십리,6943,6366,20200331,13309
20200328,2,왕십리,10001,8639,20200331,18640
20200328,2,한양대,2840,2999,20200331,5839
20200328,2,뚝섬,10044,10295,20200331,20339
20200328,2,성수,12107,13388,20200331,25495
20200328,2,건대입구,26845,29260,20200331,56105
20200328,2,구의,12825,12094,20200331,24919
20200328,2,강변,19024,19683,20200331,38707
20200328,2,잠실나루,5089,4873,20200331,9962
20200328,2,잠실,40565,38048,20200331,78613
20200328,2,잠실새내,11836,12568,20200331,24404
20200328,2,종합운동장,2963,3074,20200331,6037
20200328,2,삼성,17415,17414,20200331,34829
20200328,2,선릉,17493,15433,20200331,32926
20200328,2,역삼,13637,14619,20200331,28256
20200328,2,강남,46628,48851,20200331,95479
20200328,2,교대,12462,13811,20200331,26273
20200328,2,서초,6482,6008,20200331,12490
20200328,2,방배,7032,7164,20200331,14196
20200328,2,사당,21897,24245,20200331,46142
20200328,2,낙성대,16225,14518,20200331,30743
20200328,2,서울대입구,29614,28304,20200331,57918
20200328,2,봉천,13507,12444,20200331,25951
20200328,2,신림,40376,38327,20200331,78703
20200328,2,신대방,15298,14668,20200331,29966
20200328,2,구로디지털단지,26610,26234,20200331,52844
20200328,2,대림,13474,14036,20200331,27510
20200328,2,신도림,27109,27321,20200331,54430
20200328,2,문래,7574,7931,20200331,15505
20200328,2,영등포구청,8749,8941,20200331,17690
20200328,2,당산,9699,10712,20200331,20411
20200328,2,합정,19112,21680,20200331,40792
20200328,2,홍대입구,41866,45615,20200331,87481
20200328,2,신촌,23224,23680,20200331,46904
20200328,2,이대,6633,6764,20200331,13397
20200328,2,아현,4909,4786,20200331,9695
20200328,2,충정로,4023,4111,20200331,8134
20200328,2,용답,1520,1472,20200331,2992
20200328,2,신답,750,771,20200331,1521
20200328,2,신설동,2210,2262,20200331,4472
20200328,2,도림천,604,600,20200331,1204
20200328,2,양천구청,3025,3098,20200331,6123
20200328,2,신정네거리,4883,4984,20200331,9867
20200328,2,용두,1304,1307,20200331,2611
20200329,2,시청,3000,2623,20200401,5623
20200329,2,을지로입구,9904,9715,20200401,19619
20200329,2,을지로3가,3512,3312,20200401,6824
20200329,2,을지로4가,1876,1781,20200401,3657
20200329,2,동대문역사문화공원,4424,5627,20200401,10051
20200329,2,신당,5708,6141,20200401,11849
20200329,2,상왕십리,4528,4382,20200401,8910
20200329,2,왕십리,6992,6150,20200401,13142
20200329,2,한양대,1788,2047,20200401,3835
20200329,2,뚝섬,7040,7133,20200401,14173
20200329,2,성수,7764,8158,20200401,15922
20200329,2,건대입구,20400,20457,20200401,40857
20200329,2,구의,8452,8346,20200401,16798
20200329,2,강변,15385,15192,20200401,30577
20200329,2,잠실나루,3547,3657,20200401,7204
20200329,2,잠실,29072,27049,20200401,56121
20200329,2,잠실새내,7421,7739,20200401,15160
20200329,2,종합운동장,1979,2270,20200401,4249
20200329,2,삼성,11563,11613,20200401,23176
20200329,2,선릉,8792,7879,20200401,16671
20200329,2,역삼,7388,8135,20200401,15523
20200329,2,강남,25275,24989,20200401,50264
20200329,2,교대,7035,7955,20200401,14990
20200329,2,서초,4171,3838,20200401,8009
20200329,2,방배,4241,4457,20200401,8698
20200329,2,사당,14719,16333,20200401,31052
20200329,2,낙성대,11332,11514,20200401,22846
20200329,2,서울대입구,20269,20937,20200401,41206
20200329,2,봉천,8859,8412,20200401,17271
20200329,2,신림,27902,27317,20200401,55219
20200329,2,신대방,11075,10697,20200401,21772
20200329,2,구로디지털단지,16989,16766,20200401,33755
20200329,2,대림,9702,9820,20200401,19522
20200329,2,신도림,17941,18107,20200401,36048
20200329,2,문래,4804,4972,20200401,9776
20200329,2,영등포구청,5431,5679,20200401,11110
20200329,2,당산,6550,7094,20200401,13644
20200329,2,합정,13266,14091,20200401,27357
20200329,2,홍대입구,30234,29623,20200401,59857
20200329,2,신촌,15645,15548,20200401,31193
20200329,2,이대,4106,4542,20200401,8648
20200329,2,아현,3153,3180,20200401,6333
20200329,2,충정로,2573,2610,20200401,5183
20200329,2,용답,1110,1143,20200401,2253
20200329,2,신답,481,524,20200401,1005
20200329,2,신설동,1888,1944,20200401,3832
20200329,2,도림천,332,361,20200401,693
20200329,2,양천구청,2036,2040,20200401,4076
20200329,2,신정네거리,2996,2899,20200401,5895
20200329,2,용두,815,835,20200401,1650
20200330,2,시청,20486,20927,20200402,41413
20200330,2,을지로입구,31672,32674,20200402,64346
20200330,2,을지로3가,18574,18711,20200402,37285
20200330,2,을지로4가,10862,11018,20200402,21880
20200330,2,동대문역사문화공원,9510,10577,20200402,20087
20200330,2,신당,11754,12016,20200402,23770
20200330,2,상왕십리,11604,11309,20200402,22913
20200330,2,왕십리,12946,10852,20200402,23798
20200330,2,한양대,6108,6682,20200402,12790
20200330,2,뚝섬,17777,19293,20200402,37070
20200330,2,성수,29691,32317,20200402,62008
20200330,2,건대입구,28570,30006,20200402,58576
20200330,2,구의,21048,20600,20200402,41648
20200330,2,강변,26792,25965,20200402,52757
20200330,2,잠실나루,11886,11570,20200402,23456
20200330,2,잠실,53812,52952,20200402,106764
20200330,2,잠실새내,16784,16872,20200402,33656
20200330,2,종합운동장,5461,5815,20200402,11276
20200330,2,삼성,41835,42934,20200402,84769
20200330,2,선릉,51235,45871,20200402,97106
20200330,2,역삼,44046,48751,20200402,92797
20200330,2,강남,73778,74047,20200402,147825
20200330,2,교대,29481,32721,20200402,62202
20200330,2,서초,18173,18042,20200402,36215
20200330,2,방배,14036,14553,20200402,28589
20200330,2,사당,29752,32743,20200402,62495
20200330,2,낙성대,22929,22644,20200402,45573
20200330,2,서울대입구,39761,38939,20200402,78700
20200330,2,봉천,21023,19553,20200402,40576
20200330,2,신림,55922,54334,20200402,110256
20200330,2,신대방,23251,22496,20200402,45747
20200330,2,구로디지털단지,53719,54006,20200402,107725
20200330,2,대림,21201,21331,20200402,42532
20200330,2,신도림,40281,39016,20200402,79297
20200330,2,문래,17821,18335,20200402,36156
20200330,2,영등포구청,19869,20262,20200402,40131
20200330,2,당산,17261,19691,20200402,36952
20200330,2,합정,24296,25819,20200402,50115
20200330,2,홍대입구,39316,40589,20200402,79905
20200330,2,신촌,26243,27435,20200402,53678
20200330,2,이대,8966,9314,20200402,18280
20200330,2,아현,7891,7583,20200402,15474
20200330,2,충정로,8840,9322,20200402,18162
20200330,2,용답,2149,2159,20200402,4308
20200330,2,신답,1404,1622,20200402,3026
20200330,2,신설동,2661,2728,20200402,5389
20200330,2,도림천,1012,1119,20200402,2131
20200330,2,양천구청,5374,5673,20200402,11047
20200330,2,신정네거리,7822,8137,20200402,15959
20200330,2,용두,1968,1981,20200402,3949
20200331,2,시청,20991,21381,20200403,42372
20200331,2,을지로입구,32345,33606,20200403,65951
20200331,2,을지로3가,18571,18781,20200403,37352
20200331,2,을지로4가,11017,10891,20200403,21908
20200331,2,동대문역사문화공원,9397,10518,20200403,19915
20200331,2,신당,11682,11958,20200403,23640
20200331,2,상왕십리,11675,11218,20200403,22893
20200331,2,왕십리,13012,10716,20200403,23728
20200331,2,한양대,5857,6425,20200403,12282
20200331,2,뚝섬,18313,19826,20200403,38139
20200331,2,성수,29918,32793,20200403,62711
20200331,2,건대입구,28856,30767,20200403,59623
20200331,2,구의,21204,20684,20200403,41888
20200331,2,강변,25827,25136,20200403,50963
20200331,2,잠실나루,12106,11783,20200403,23889
20200331,2,잠실,55005,54239,20200403,109244
20200331,2,잠실새내,16971,17001,20200403,33972
20200331,2,종합운동장,5559,5784,20200403,11343
20200331,2,삼성,42404,43837,20200403,86241
20200331,2,선릉,51190,46025,20200403,97215
20200331,2,역삼,43029,48221,20200403,91250
20200331,2,강남,73891,74418,20200403,148309
20200331,2,교대,29873,33233,20200403,63106
20200331,2,서초,18296,18189,20200403,36485
20200331,2,방배,14201,14600,20200403,28801
20200331,2,사당,30507,33626,20200403,64133
20200331,2,낙성대,23341,22567,20200403,45908
20200331,2,서울대입구,40157,38897,20200403,79054
20200331,2,봉천,20950,19542,20200403,40492
20200331,2,신림,56325,54384,20200403,110709
20200331,2,신대방,23285,22595,20200403,45880
20200331,2,구로디지털단지,53051,53505,20200403,106556
20200331,2,대림,21204,21436,20200403,42640
20200331,2,신도림,40326,39342,20200403,79668
20200331,2,문래,17876,18192,20200403,36068
20200331,2,영등포구청,20032,20355,20200403,40387
20200331,2,당산,17484,20101,20200403,37585
20200331,2,합정,24929,26236,20200403,51165
20200331,2,홍대입구,39862,41581,20200403,81443
20200331,2,신촌,26471,27553,20200403,54024
20200331,2,이대,8833,9284,20200403,18117
20200331,2,아현,7778,7564,20200403,15342
20200331,2,충정로,8797,9264,20200403,18061
20200331,2,용답,2139,2079,20200403,4218
20200331,2,신답,1429,1606,20200403,3035
20200331,2,신설동,2603,2686,20200403,5289
20200331,2,도림천,1035,1099,20200403,2134
20200331,2,양천구청,5365,5633,20200403,10998
20200331,2,신정네거리,7744,8121,20200403,15865
20200331,2,용두,1991,2030,20200403,4021
20200401,2,시청,20706,20826,20200404,41532
20200401,2,을지로입구,32183,33482,20200404,65665
20200401,2,을지로3가,18427,18540,20200404,36967
20200401,2,을지로4가,10957,10800,20200404,21757
20200401,2,동대문역사문화공원,9648,10792,20200404,20440
20200401,2,신당,11682,12051,20200404,23733
20200401,2,상왕십리,11717,11231,20200404,22948
20200401,2,왕십리,13642,11395,20200404,25037
20200401,2,한양대,5945,6422,20200404,12367
20200401,2,뚝섬,18383,19845,20200404,38228
20200401,2,성수,30124,33060,20200404,63184
20200401,2,건대입구,29656,31576,20200404,61232
20200401,2,구의,21003,20334,20200404,41337
20200401,2,강변,25768,25177,20200404,50945
20200401,2,잠실나루,11824,11429,20200404,23253
20200401,2,잠실,54890,53727,20200404,108617
20200401,2,잠실새내,17045,17158,20200404,34203
20200401,2,종합운동장,5516,6039,20200404,11555
20200401,2,삼성,42277,43444,20200404,85721
20200401,2,선릉,50145,44709,20200404,94854
20200401,2,역삼,44367,48928,20200404,93295
20200401,2,강남,74145,74244,20200404,148389
20200401,2,교대,29774,33453,20200404,63227
20200401,2,서초,18269,18041,20200404,36310
20200401,2,방배,14071,14465,20200404,28536
20200401,2,사당,30798,33860,20200404,64658
20200401,2,낙성대,23446,22445,20200404,45891
20200401,2,서울대입구,40765,39858,20200404,80623
20200401,2,봉천,21042,19398,20200404,40440
20200401,2,신림,56523,54199,20200404,110722
20200401,2,신대방,23304,22413,20200404,45717
20200401,2,구로디지털단지,53378,53594,20200404,106972
20200401,2,대림,21141,21434,20200404,42575
20200401,2,신도림,40806,40003,20200404,80809
20200401,2,문래,18175,18507,20200404,36682
20200401,2,영등포구청,20034,20298,20200404,40332
20200401,2,당산,17432,20155,20200404,37587
20200401,2,합정,25809,27466,20200404,53275
20200401,2,홍대입구,41449,43584,20200404,85033
20200401,2,신촌,27305,28545,20200404,55850
20200401,2,이대,9201,9430,20200404,18631
20200401,2,아현,7827,7565,20200404,15392
20200401,2,충정로,8809,9341,20200404,18150
20200401,2,용답,2126,2074,20200404,4200
20200401,2,신답,1354,1580,20200404,2934
20200401,2,신설동,2663,2732,20200404,5395
20200401,2,도림천,1027,1139,20200404,2166
20200401,2,양천구청,5439,5656,20200404,11095
20200401,2,신정네거리,7799,8092,20200404,15891
20200401,2,용두,1956,2073,20200404,4029
20200402,2,시청,20643,20817,20200405,41460
20200402,2,을지로입구,31882,33076,20200405,64958
20200402,2,을지로3가,18322,18521,20200405,36843
20200402,2,을지로4가,10946,10934,20200405,21880
20200402,2,동대문역사문화공원,9604,10942,20200405,20546
20200402,2,신당,11721,11841,20200405,23562
20200402,2,상왕십리,11765,11268,20200405,23033
20200402,2,왕십리,13498,11159,20200405,24657
20200402,2,한양대,5994,6596,20200405,12590
20200402,2,뚝섬,18694,20151,20200405,38845
20200402,2,성수,29862,32857,20200405,62719
20200402,2,건대입구,29780,31298,20200405,61078
20200402,2,구의,21131,20585,20200405,41716
20200402,2,강변,25619,25075,20200405,50694
20200402,2,잠실나루,11847,11474,20200405,23321
20200402,2,잠실,55040,53810,20200405,108850
20200402,2,잠실새내,17108,17010,20200405,34118
20200402,2,종합운동장,5439,5807,20200405,11246
20200402,2,삼성,41610,43245,20200405,84855
20200402,2,선릉,50925,45759,20200405,96684
20200402,2,역삼,44081,48935,20200405,93016
20200402,2,강남,73850,74522,20200405,148372
20200402,2,교대,29775,33317,20200405,63092
20200402,2,서초,17747,17769,20200405,35516
20200402,2,방배,14301,14703,20200405,29004
20200402,2,사당,31033,33826,20200405,64859
20200402,2,낙성대,23184,22232,20200405,45416
20200402,2,서울대입구,40686,39449,20200405,80135
20200402,2,봉천,21095,19510,20200405,40605
20200402,2,신림,56209,53423,20200405,109632
20200402,2,신대방,23382,22552,20200405,45934
20200402,2,구로디지털단지,53302,53214,20200405,106516
20200402,2,대림,20951,20997,20200405,41948
20200402,2,신도림,41152,40245,20200405,81397
20200402,2,문래,17990,18394,20200405,36384
20200402,2,영등포구청,20097,20264,20200405,40361
20200402,2,당산,17463,20098,20200405,37561
20200402,2,합정,25400,27136,20200405,52536
20200402,2,홍대입구,40890,43453,20200405,84343
20200402,2,신촌,26857,27938,20200405,54795
20200402,2,이대,9060,9321,20200405,18381
20200402,2,아현,7977,7663,20200405,15640
20200402,2,충정로,8677,9087,20200405,17764
20200402,2,용답,2205,2085,20200405,4290
20200402,2,신답,1417,1541,20200405,2958
20200402,2,신설동,2718,2696,20200405,5414
20200402,2,도림천,1030,1117,20200405,2147
20200402,2,양천구청,5431,5645,20200405,11076
20200402,2,신정네거리,7690,7948,20200405,15638
20200402,2,용두,1973,2091,20200405,4064
20200403,2,시청,20331,20599,20200406,40930
20200403,2,을지로입구,32760,34140,20200406,66900
20200403,2,을지로3가,18420,18985,20200406,37405
20200403,2,을지로4가,11129,11060,20200406,22189
20200403,2,동대문역사문화공원,10136,11322,20200406,21458
20200403,2,신당,12157,12329,20200406,24486
20200403,2,상왕십리,12217,11301,20200406,23518
20200403,2,왕십리,14608,12746,20200406,27354
20200403,2,한양대,6133,6594,20200406,12727
20200403,2,뚝섬,19021,20377,20200406,39398
20200403,2,성수,30448,33568,20200406,64016
20200403,2,건대입구,32158,35982,20200406,68140
20200403,2,구의,21521,20817,20200406,42338
20200403,2,강변,28928,29106,20200406,58034
20200403,2,잠실나루,12089,11519,20200406,23608
20200403,2,잠실,58447,56819,20200406,115266
20200403,2,잠실새내,18140,18974,20200406,37114
20200403,2,종합운동장,5594,5870,20200406,11464
20200403,2,삼성,42605,43516,20200406,86121
20200403,2,선릉,50487,45173,20200406,95660
20200403,2,역삼,43272,47900,20200406,91172
20200403,2,강남,78454,81684,20200406,160138
20200403,2,교대,30231,34082,20200406,64313
20200403,2,서초,18328,17959,20200406,36287
20200403,2,방배,14512,14814,20200406,29326
20200403,2,사당,33377,36711,20200406,70088
20200403,2,낙성대,24616,22430,20200406,47046
20200403,2,서울대입구,43279,41469,20200406,84748
20200403,2,봉천,21636,19528,20200406,41164
20200403,2,신림,58773,56333,20200406,115106
20200403,2,신대방,24140,22618,20200406,46758
20200403,2,구로디지털단지,54620,53942,20200406,108562
20200403,2,대림,21333,21631,20200406,42964
20200403,2,신도림,43180,42906,20200406,86086
20200403,2,문래,18367,18944,20200406,37311
20200403,2,영등포구청,20565,20998,20200406,41563
20200403,2,당산,18129,20732,20200406,38861
20200403,2,합정,27514,30804,20200406,58318
20200403,2,홍대입구,45280,51422,20200406,96702
20200403,2,신촌,29554,30964,20200406,60518
20200403,2,이대,9731,9700,20200406,19431
20200403,2,아현,8325,7801,20200406,16126
20200403,2,충정로,8817,9183,20200406,18000
20200403,2,용답,2311,2118,20200406,4429
20200403,2,신답,1424,1546,20200406,2970
20200403,2,신설동,2787,2769,20200406,5556
20200403,2,도림천,1057,1121,20200406,2178
20200403,2,양천구청,5613,5870,20200406,11483
20200403,2,신정네거리,8095,8368,20200406,16463
20200403,2,용두,2042,2124,20200406,4166
20200404,2,시청,4620,4105,20200407,8725
20200404,2,을지로입구,14235,13746,20200407,27981
20200404,2,을지로3가,6174,6278,20200407,12452
20200404,2,을지로4가,5174,5291,20200407,10465
20200404,2,동대문역사문화공원,6749,6804,20200407,13553
20200404,2,신당,8298,8437,20200407,16735
20200404,2,상왕십리,7060,6585,20200407,13645
20200404,2,왕십리,10163,8787,20200407,18950
20200404,2,한양대,2972,3051,20200407,6023
20200404,2,뚝섬,10992,11014,20200407,22006
20200404,2,성수,12651,13632,20200407,26283
20200404,2,건대입구,27239,29606,20200407,56845
20200404,2,구의,12930,12462,20200407,25392
20200404,2,강변,19536,20197,20200407,39733
20200404,2,잠실나루,5379,5292,20200407,10671
20200404,2,잠실,39507,37111,20200407,76618
20200404,2,잠실새내,11933,12701,20200407,24634
20200404,2,종합운동장,2801,3077,20200407,5878
20200404,2,삼성,17122,16966,20200407,34088
20200404,2,선릉,17959,16127,20200407,34086
20200404,2,역삼,13099,13994,20200407,27093
20200404,2,강남,47013,48768,20200407,95781
20200404,2,교대,12329,13382,20200407,25711
20200404,2,서초,6455,5935,20200407,12390
20200404,2,방배,7137,7224,20200407,14361
20200404,2,사당,22636,24478,20200407,47114
20200404,2,낙성대,16507,15316,20200407,31823
20200404,2,서울대입구,30141,29034,20200407,59175
20200404,2,봉천,13681,12305,20200407,25986
20200404,2,신림,40526,38362,20200407,78888
20200404,2,신대방,16094,15487,20200407,31581
20200404,2,구로디지털단지,26245,25938,20200407,52183
20200404,2,대림,13443,14493,20200407,27936
20200404,2,신도림,27804,27759,20200407,55563
20200404,2,문래,7838,8215,20200407,16053
20200404,2,영등포구청,8883,8951,20200407,17834
20200404,2,당산,9940,10971,20200407,20911
20200404,2,합정,20030,22469,20200407,42499
20200404,2,홍대입구,42516,46663,20200407,89179
20200404,2,신촌,23385,23668,20200407,47053
20200404,2,이대,6605,6828,20200407,13433
20200404,2,아현,5159,4910,20200407,10069
20200404,2,충정로,4086,4243,20200407,8329
20200404,2,용답,1532,1420,20200407,2952
20200404,2,신답,743,799,20200407,1542
20200404,2,신설동,2326,2228,20200407,4554
20200404,2,도림천,690,780,20200407,1470
20200404,2,양천구청,3082,3090,20200407,6172
20200404,2,신정네거리,5027,5117,20200407,10144
20200404,2,용두,1282,1305,20200407,2587
20200405,2,시청,2842,2472,20200408,5314
20200405,2,을지로입구,10179,9833,20200408,20012
20200405,2,을지로3가,3444,3110,20200408,6554
20200405,2,을지로4가,1789,1762,20200408,3551
20200405,2,동대문역사문화공원,4408,5731,20200408,10139
20200405,2,신당,5670,5959,20200408,11629
20200405,2,상왕십리,4594,4419,20200408,9013
20200405,2,왕십리,6910,5955,20200408,12865
20200405,2,한양대,1946,2154,20200408,4100
20200405,2,뚝섬,7297,7231,20200408,14528
20200405,2,성수,8204,8746,20200408,16950
20200405,2,건대입구,20084,20220,20200408,40304
20200405,2,구의,8558,8372,20200408,16930
20200405,2,강변,15939,15396,20200408,31335
20200405,2,잠실나루,3472,3588,20200408,7060
20200405,2,잠실,27897,25964,20200408,53861
20200405,2,잠실새내,7385,7794,20200408,15179
20200405,2,종합운동장,2033,2298,20200408,4331
20200405,2,삼성,11463,11401,20200408,22864
20200405,2,선릉,9408,8184,20200408,17592
20200405,2,역삼,7312,7909,20200408,15221
20200405,2,강남,25400,25236,20200408,50636
20200405,2,교대,7190,7855,20200408,15045
20200405,2,서초,4343,4054,20200408,8397
20200405,2,방배,4246,4465,20200408,8711
20200405,2,사당,14833,16422,20200408,31255
20200405,2,낙성대,11566,11856,20200408,23422
20200405,2,서울대입구,19892,21088,20200408,40980
20200405,2,봉천,8856,8652,20200408,17508
20200405,2,신림,28380,27618,20200408,55998
20200405,2,신대방,11419,11211,20200408,22630
20200405,2,구로디지털단지,16938,16765,20200408,33703
20200405,2,대림,10025,10064,20200408,20089
20200405,2,신도림,18766,19343,20200408,38109
20200405,2,문래,4945,5127,20200408,10072
20200405,2,영등포구청,5533,5757,20200408,11290
20200405,2,당산,6721,7020,20200408,13741
20200405,2,합정,13661,14590,20200408,28251
20200405,2,홍대입구,31092,30449,20200408,61541
20200405,2,신촌,15892,15418,20200408,31310
20200405,2,이대,4334,4582,20200408,8916
20200405,2,아현,3348,3359,20200408,6707
20200405,2,충정로,2586,2700,20200408,5286
20200405,2,용답,1102,1136,20200408,2238
20200405,2,신답,515,551,20200408,1066
20200405,2,신설동,1920,2066,20200408,3986
20200405,2,도림천,390,414,20200408,804
20200405,2,양천구청,2072,2208,20200408,4280
20200405,2,신정네거리,3239,3193,20200408,6432
20200405,2,용두,830,866,20200408,1696
20200406,2,시청,21497,21757,20200409,43254
20200406,2,을지로입구,33558,34580,20200409,68138
20200406,2,을지로3가,19027,19093,20200409,38120
20200406,2,을지로4가,11615,11549,20200409,23164
20200406,2,동대문역사문화공원,9624,11112,20200409,20736
20200406,2,신당,11910,12051,20200409,23961
20200406,2,상왕십리,12040,11705,20200409,23745
20200406,2,왕십리,13121,10967,20200409,24088
20200406,2,한양대,5911,6569,20200409,12480
20200406,2,뚝섬,18189,19650,20200409,37839
20200406,2,성수,30057,32998,20200409,63055
20200406,2,건대입구,28927,30598,20200409,59525
20200406,2,구의,21085,20714,20200409,41799
20200406,2,강변,26977,26284,20200409,53261
20200406,2,잠실나루,11973,11790,20200409,23763
20200406,2,잠실,53992,52917,20200409,106909
20200406,2,잠실새내,17550,17321,20200409,34871
20200406,2,종합운동장,5538,5870,20200409,11408
20200406,2,삼성,42993,43813,20200409,86806
20200406,2,선릉,52508,47268,20200409,99776
20200406,2,역삼,46033,50798,20200409,96831
20200406,2,강남,76736,76489,20200409,153225
20200406,2,교대,30000,33504,20200409,63504
20200406,2,서초,18498,18336,20200409,36834
20200406,2,방배,14555,14913,20200409,29468
20200406,2,사당,30671,33756,20200409,64427
20200406,2,낙성대,23506,22982,20200409,46488
20200406,2,서울대입구,40712,40225,20200409,80937
20200406,2,봉천,21788,20299,20200409,42087
20200406,2,신림,56911,54927,20200409,111838
20200406,2,신대방,23929,22938,20200409,46867
20200406,2,구로디지털단지,55053,55166,20200409,110219
20200406,2,대림,22244,22405,20200409,44649
20200406,2,신도림,41817,40707,20200409,82524
20200406,2,문래,18660,19058,20200409,37718
20200406,2,영등포구청,20396,20888,20200409,41284
20200406,2,당산,17941,20531,20200409,38472
20200406,2,합정,25524,26422,20200409,51946
20200406,2,홍대입구,40521,42358,20200409,82879
20200406,2,신촌,27209,28558,20200409,55767
20200406,2,이대,9167,9658,20200409,18825
20200406,2,아현,8156,7932,20200409,16088
20200406,2,충정로,9045,9518,20200409,18563
20200406,2,용답,2168,2058,20200409,4226
20200406,2,신답,1446,1670,20200409,3116
20200406,2,신설동,2730,2711,20200409,5441
20200406,2,도림천,1073,1148,20200409,2221
20200406,2,양천구청,5634,5910,20200409,11544
20200406,2,신정네거리,8086,8470,20200409,16556
20200406,2,용두,1990,2114,20200409,4104
20200407,2,시청,21823,21933,20200410,43756
20200407,2,을지로입구,33832,35404,20200410,69236
20200407,2,을지로3가,19238,19224,20200410,38462
20200407,2,을지로4가,11642,11457,20200410,23099
20200407,2,동대문역사문화공원,9947,11161,20200410,21108
20200407,2,신당,12302,12346,20200410,24648
20200407,2,상왕십리,12136,11764,20200410,23900
20200407,2,왕십리,13618,11489,20200410,25107
20200407,2,한양대,6002,6560,20200410,12562
20200407,2,뚝섬,18540,19999,20200410,38539
20200407,2,성수,30523,33462,20200410,63985
20200407,2,건대입구,29056,31206,20200410,60262
20200407,2,구의,21642,21099,20200410,42741
20200407,2,강변,26447,25701,20200410,52148
20200407,2,잠실나루,12336,12042,20200410,24378
20200407,2,잠실,55178,54019,20200410,109197
20200407,2,잠실새내,17429,17460,20200410,34889
20200407,2,종합운동장,5610,5976,20200410,11586
20200407,2,삼성,43185,44330,20200410,87515
20200407,2,선릉,52733,47064,20200410,99797
20200407,2,역삼,46261,51143,20200410,97404
20200407,2,강남,77633,77320,20200410,154953
20200407,2,교대,30578,33937,20200410,64515
20200407,2,서초,18457,18367,20200410,36824
20200407,2,방배,14926,15260,20200410,30186
20200407,2,사당,31505,34461,20200410,65966
20200407,2,낙성대,24314,23422,20200410,47736
20200407,2,서울대입구,41487,40539,20200410,82026
20200407,2,봉천,21689,20233,20200410,41922
20200407,2,신림,57673,55328,20200410,113001
20200407,2,신대방,23731,23083,20200410,46814
20200407,2,구로디지털단지,55195,55289,20200410,110484
20200407,2,대림,21965,22243,20200410,44208
20200407,2,신도림,41878,40654,20200410,82532
20200407,2,문래,18866,19188,20200410,38054
20200407,2,영등포구청,20835,21216,20200410,42051
20200407,2,당산,17934,20572,20200410,38506
20200407,2,합정,25935,27260,20200410,53195
20200407,2,홍대입구,40731,43196,20200410,83927
20200407,2,신촌,27650,28818,20200410,56468
20200407,2,이대,9313,9715,20200410,19028
20200407,2,아현,8172,7821,20200410,15993
20200407,2,충정로,9147,9634,20200410,18781
20200407,2,용답,2218,2156,20200410,4374
20200407,2,신답,1426,1601,20200410,3027
20200407,2,신설동,2702,2721,20200410,5423
20200407,2,도림천,1045,1134,20200410,2179
20200407,2,양천구청,5677,5937,20200410,11614
20200407,2,신정네거리,7926,8399,20200410,16325
20200407,2,용두,2019,2130,20200410,4149
20200408,2,시청,22008,22132,20200411,44140
20200408,2,을지로입구,33809,35267,20200411,69076
20200408,2,을지로3가,19207,19168,20200411,38375
20200408,2,을지로4가,11540,11468,20200411,23008
20200408,2,동대문역사문화공원,10249,11226,20200411,21475
20200408,2,신당,12200,12373,20200411,24573
20200408,2,상왕십리,12129,11656,20200411,23785
20200408,2,왕십리,13806,11843,20200411,25649
20200408,2,한양대,6008,6608,20200411,12616
20200408,2,뚝섬,18897,20384,20200411,39281
20200408,2,성수,30401,33434,20200411,63835
20200408,2,건대입구,29655,31703,20200411,61358
20200408,2,구의,21669,20998,20200411,42667
20200408,2,강변,26384,25881,20200411,52265
20200408,2,잠실나루,12261,11908,20200411,24169
20200408,2,잠실,55877,54651,20200411,110528
20200408,2,잠실새내,17578,17637,20200411,35215
20200408,2,종합운동장,5636,6062,20200411,11698
20200408,2,삼성,43337,44372,20200411,87709
20200408,2,선릉,52734,46998,20200411,99732
20200408,2,역삼,46191,50510,20200411,96701
20200408,2,강남,77544,77579,20200411,155123
20200408,2,교대,31108,34809,20200411,65917
20200408,2,서초,18738,18732,20200411,37470
20200408,2,방배,14475,15004,20200411,29479
20200408,2,사당,32290,34946,20200411,67236
20200408,2,낙성대,24403,23560,20200411,47963
20200408,2,서울대입구,41715,40905,20200411,82620
20200408,2,봉천,21843,20350,20200411,42193
20200408,2,신림,57603,55623,20200411,113226
20200408,2,신대방,24043,22995,20200411,47038
20200408,2,구로디지털단지,55254,55638,20200411,110892
20200408,2,대림,21714,22166,20200411,43880
20200408,2,신도림,42452,41482,20200411,83934
20200408,2,문래,18799,19243,20200411,38042
20200408,2,영등포구청,20747,21303,20200411,42050
20200408,2,당산,18114,20686,20200411,38800
20200408,2,합정,26624,28242,20200411,54866
20200408,2,홍대입구,42385,44953,20200411,87338
20200408,2,신촌,28225,29052,20200411,57277
20200408,2,이대,9437,9687,20200411,19124
20200408,2,아현,8048,7772,20200411,15820
20200408,2,충정로,9195,9682,20200411,18877
20200408,2,용답,2184,2088,20200411,4272
20200408,2,신답,1407,1607,20200411,3014
20200408,2,신설동,2799,2892,20200411,5691
20200408,2,도림천,1037,1157,20200411,2194
20200408,2,양천구청,5706,6143,20200411,11849
20200408,2,신정네거리,8112,8363,20200411,16475
20200408,2,용두,1937,2034,20200411,3971
20200409,2,시청,21840,22016,20200412,43856
20200409,2,을지로입구,33874,35437,20200412,69311
20200409,2,을지로3가,19100,19165,20200412,38265
20200409,2,을지로4가,11803,11628,20200412,23431
20200409,2,동대문역사문화공원,9958,11013,20200412,20971
20200409,2,신당,12040,12260,20200412,24300
20200409,2,상왕십리,12233,11694,20200412,23927
20200409,2,왕십리,13768,11486,20200412,25254
20200409,2,한양대,6121,6663,20200412,12784
20200409,2,뚝섬,18431,20179,20200412,38610
20200409,2,성수,30729,33769,20200412,64498
20200409,2,건대입구,29528,31709,20200412,61237
20200409,2,구의,21672,20917,20200412,42589
20200409,2,강변,26634,25840,20200412,52474
20200409,2,잠실나루,12438,11946,20200412,24384
20200409,2,잠실,55936,54780,20200412,110716
20200409,2,잠실새내,17606,17575,20200412,35181
20200409,2,종합운동장,5557,6092,20200412,11649
20200409,2,삼성,43289,44569,20200412,87858
20200409,2,선릉,53029,47417,20200412,100446
20200409,2,역삼,45379,50407,20200412,95786
20200409,2,강남,77853,78121,20200412,155974
20200409,2,교대,30756,34549,20200412,65305
20200409,2,서초,18802,18861,20200412,37663
20200409,2,방배,14819,15363,20200412,30182
20200409,2,사당,32325,35450,20200412,67775
20200409,2,낙성대,24076,23136,20200412,47212
20200409,2,서울대입구,41880,40597,20200412,82477
20200409,2,봉천,22020,20312,20200412,42332
20200409,2,신림,58060,55526,20200412,113586
20200409,2,신대방,23868,23043,20200412,46911
20200409,2,구로디지털단지,55311,55264,20200412,110575
20200409,2,대림,21694,22279,20200412,43973
20200409,2,신도림,42295,41210,20200412,83505
20200409,2,문래,18929,19429,20200412,38358
20200409,2,영등포구청,20769,21129,20200412,41898
20200409,2,당산,18161,20826,20200412,38987
20200409,2,합정,26574,28018,20200412,54592
20200409,2,홍대입구,42689,45186,20200412,87875
20200409,2,신촌,28335,29283,20200412,57618
20200409,2,이대,9434,9715,20200412,19149
20200409,2,아현,8195,7808,20200412,16003
20200409,2,충정로,8933,9366,20200412,18299
20200409,2,용답,2162,2168,20200412,4330
20200409,2,신답,1470,1604,20200412,3074
20200409,2,신설동,2838,2930,20200412,5768
20200409,2,도림천,1067,1091,20200412,2158
20200409,2,양천구청,5602,5952,20200412,11554
20200409,2,신정네거리,8059,8396,20200412,16455
20200409,2,용두,1996,2120,20200412,4116
20200410,2,신당,12522,12577,20200413,25099
20200410,2,동대문역사문화공원,10104,11469,20200413,21573
20200410,2,을지로4가,11685,11619,20200413,23304
20200410,2,을지로3가,19238,19634,20200413,38872
20200410,2,을지로입구,34008,35353,20200413,69361
20200410,2,시청,21374,21378,20200413,42752
20200410,2,상왕십리,12452,11501,20200413,23953
20200410,2,왕십리,14775,12689,20200413,27464
20200410,2,한양대,6384,6734,20200413,13118
20200410,2,뚝섬,18823,20332,20200413,39155
20200410,2,성수,31054,34419,20200413,65473
20200410,2,건대입구,32095,36555,20200413,68650
20200410,2,구의,22112,21224,20200413,43336
20200410,2,강변,29802,29777,20200413,59579
20200410,2,잠실나루,12779,12092,20200413,24871
20200410,2,잠실,59251,57446,20200413,116697
20200410,2,잠실새내,18728,19788,20200413,38516
20200410,2,종합운동장,5772,6294,20200413,12066
20200410,2,삼성,43607,44703,20200413,88310
20200410,2,선릉,52804,47366,20200413,100170
20200410,2,역삼,44721,50005,20200413,94726
20200410,2,강남,82377,85018,20200413,167395
20200410,2,교대,31235,35551,20200413,66786
20200410,2,서초,19060,18775,20200413,37835
20200410,2,방배,15190,15434,20200413,30624
20200410,2,사당,34446,37799,20200413,72245
20200410,2,낙성대,25475,23272,20200413,48747
20200410,2,서울대입구,44477,42616,20200413,87093
20200410,2,봉천,22548,20148,20200413,42696
20200410,2,신림,60181,57472,20200413,117653
20200410,2,신대방,24430,22664,20200413,47094
20200410,2,구로디지털단지,55934,55599,20200413,111533
20200410,2,대림,22196,22355,20200413,44551
20200410,2,신도림,44866,44359,20200413,89225
20200410,2,문래,19030,19565,20200413,38595
20200410,2,영등포구청,20805,21005,20200413,41810
20200410,2,당산,18734,21254,20200413,39988
20200410,2,합정,28161,31519,20200413,59680
20200410,2,홍대입구,46598,53384,20200413,99982
20200410,2,신촌,30448,32279,20200413,62727
20200410,2,이대,9992,10226,20200413,20218
20200410,2,아현,8493,7944,20200413,16437
20200410,2,충정로,8953,9431,20200413,18384
20200410,2,용답,2283,2177,20200413,4460
20200410,2,신답,1449,1553,20200413,3002
20200410,2,신설동,2880,2918,20200413,5798
20200410,2,도림천,1019,1087,20200413,2106
20200410,2,양천구청,5875,6097,20200413,11972
20200410,2,신정네거리,8313,8653,20200413,16966
20200410,2,용두,2067,2145,20200413,4212
20200411,2,시청,5283,4618,20200414,9901
20200411,2,을지로입구,14324,13964,20200414,28288
20200411,2,을지로3가,6694,6796,20200414,13490
20200411,2,을지로4가,5278,5465,20200414,10743
20200411,2,동대문역사문화공원,7140,7308,20200414,14448
20200411,2,신당,8542,8576,20200414,17118
20200411,2,상왕십리,7241,6689,20200414,13930
20200411,2,왕십리,10524,9008,20200414,19532
20200411,2,한양대,2909,3047,20200414,5956
20200411,2,뚝섬,10335,10572,20200414,20907
20200411,2,성수,12736,14297,20200414,27033
20200411,2,건대입구,27001,29851,20200414,56852
20200411,2,구의,13614,12857,20200414,26471
20200411,2,강변,20743,21480,20200414,42223
20200411,2,잠실나루,5457,5320,20200414,10777
20200411,2,잠실,40249,38073,20200414,78322
20200411,2,잠실새내,12995,13699,20200414,26694
20200411,2,종합운동장,3170,3516,20200414,6686
20200411,2,삼성,17615,17591,20200414,35206
20200411,2,선릉,18108,16026,20200414,34134
20200411,2,역삼,13867,14888,20200414,28755
20200411,2,강남,48917,50831,20200414,99748
20200411,2,교대,13162,14211,20200414,27373
20200411,2,서초,7441,6869,20200414,14310
20200411,2,방배,7728,7671,20200414,15399
20200411,2,사당,23723,25860,20200414,49583
20200411,2,낙성대,17334,15953,20200414,33287
20200411,2,서울대입구,31014,29990,20200414,61004
20200411,2,봉천,14516,13068,20200414,27584
20200411,2,신림,41984,39884,20200414,81868
20200411,2,신대방,16380,15683,20200414,32063
20200411,2,구로디지털단지,27261,27115,20200414,54376
20200411,2,대림,14540,15229,20200414,29769
20200411,2,신도림,30034,30258,20200414,60292
20200411,2,문래,8681,9031,20200414,17712
20200411,2,영등포구청,10103,10378,20200414,20481
20200411,2,당산,10456,11558,20200414,22014
20200411,2,합정,20404,23084,20200414,43488
20200411,2,홍대입구,44105,49257,20200414,93362
20200411,2,신촌,24328,24900,20200414,49228
20200411,2,이대,7040,7149,20200414,14189
20200411,2,아현,5366,5088,20200414,10454
20200411,2,충정로,4127,4312,20200414,8439
20200411,2,용답,1562,1509,20200414,3071
20200411,2,신답,767,786,20200414,1553
20200411,2,신설동,2421,2275,20200414,4696
20200411,2,도림천,651,668,20200414,1319
20200411,2,양천구청,3186,3208,20200414,6394
20200411,2,신정네거리,5258,5300,20200414,10558
20200411,2,용두,1408,1365,20200414,2773
20200412,2,시청,3279,2822,20200415,6101
20200412,2,을지로입구,10214,10027,20200415,20241
20200412,2,을지로3가,4063,3827,20200415,7890
20200412,2,을지로4가,2113,2081,20200415,4194
20200412,2,신당,5845,6250,20200415,12095
20200412,2,상왕십리,4647,4507,20200415,9154
20200412,2,왕십리,7074,6160,20200415,13234
20200412,2,한양대,1883,2224,20200415,4107
20200412,2,뚝섬,6577,6752,20200415,13329
20200412,2,성수,8110,8824,20200415,16934
20200412,2,건대입구,20483,20719,20200415,41202
20200412,2,구의,8723,8773,20200415,17496
20200412,2,강변,16494,16253,20200415,32747
20200412,2,잠실나루,3687,3713,20200415,7400
20200412,2,잠실,28640,26298,20200415,54938
20200412,2,잠실새내,7716,8398,20200415,16114
20200412,2,종합운동장,2180,2484,20200415,4664
20200412,2,삼성,12811,12357,20200415,25168
20200412,2,선릉,9125,7878,20200415,17003
20200412,2,역삼,7694,8464,20200415,16158
20200412,2,강남,26851,26697,20200415,53548
20200412,2,교대,7287,8053,20200415,15340
20200412,2,서초,4787,4402,20200415,9189
20200412,2,방배,4458,4764,20200415,9222
20200412,2,사당,16034,17787,20200415,33821
20200412,2,낙성대,12182,12481,20200415,24663
20200412,2,서울대입구,20955,21875,20200415,42830
20200412,2,봉천,9314,9051,20200415,18365
20200412,2,신림,29147,28769,20200415,57916
20200412,2,신대방,11447,11075,20200415,22522
20200412,2,구로디지털단지,17506,17295,20200415,34801
20200412,2,대림,10442,10508,20200415,20950
20200412,2,신도림,19278,19555,20200415,38833
20200412,2,문래,4895,5055,20200415,9950
20200412,2,영등포구청,5695,5859,20200415,11554
20200412,2,당산,6660,7221,20200415,13881
20200412,2,합정,13916,14505,20200415,28421
20200412,2,홍대입구,32654,31853,20200415,64507
20200412,2,신촌,16485,16285,20200415,32770
20200412,2,이대,4347,4648,20200415,8995
20200412,2,아현,3470,3453,20200415,6923
20200412,2,충정로,2746,2825,20200415,5571
20200412,2,용답,1169,1199,20200415,2368
20200412,2,신답,519,571,20200415,1090
20200412,2,신설동,2028,2094,20200415,4122
20200412,2,도림천,365,369,20200415,734
20200412,2,양천구청,2249,2317,20200415,4566
20200412,2,신정네거리,3404,3387,20200415,6791
20200412,2,용두,800,832,20200415,1632
20200412,2,동대문역사문화공원,5064,6184,20200415,11248
20200413,2,시청,21745,21870,20200416,43615
20200413,2,을지로입구,34015,35387,20200416,69402
20200413,2,을지로3가,19100,19156,20200416,38256
20200413,2,을지로4가,11764,11820,20200416,23584
20200413,2,동대문역사문화공원,10103,11382,20200416,21485
20200413,2,신당,12275,12408,20200416,24683
20200413,2,상왕십리,12064,11600,20200416,23664
20200413,2,왕십리,13334,11099,20200416,24433
20200413,2,한양대,6262,7025,20200416,13287
20200413,2,뚝섬,17439,18961,20200416,36400
20200413,2,성수,29868,32717,20200416,62585
20200413,2,건대입구,29275,31813,20200416,61088
20200413,2,구의,21647,21263,20200416,42910
20200413,2,강변,27903,26995,20200416,54898
20200413,2,잠실나루,12740,12355,20200416,25095
20200413,2,잠실,55730,54860,20200416,110590
20200413,2,잠실새내,17844,17651,20200416,35495
20200413,2,종합운동장,5702,6166,20200416,11868
20200413,2,삼성,43462,44986,20200416,88448
20200413,2,선릉,53401,47917,20200416,101318
20200413,2,역삼,46492,51342,20200416,97834
20200413,2,강남,78506,78629,20200416,157135
20200413,2,교대,30603,34552,20200416,65155
20200413,2,서초,19205,19215,20200416,38420
20200413,2,방배,14846,15441,20200416,30287
20200413,2,사당,31596,34864,20200416,66460
20200413,2,낙성대,23991,23461,20200416,47452
20200413,2,서울대입구,41735,40839,20200416,82574
20200413,2,봉천,22010,20520,20200416,42530
20200413,2,신림,57593,55617,20200416,113210
20200413,2,신대방,24204,23162,20200416,47366
20200413,2,구로디지털단지,56016,56361,20200416,112377
20200413,2,대림,22737,22845,20200416,45582
20200413,2,신도림,42792,41928,20200416,84720
20200413,2,문래,19065,19558,20200416,38623
20200413,2,영등포구청,20901,21316,20200416,42217
20200413,2,당산,17931,20788,20200416,38719
20200413,2,합정,25747,27149,20200416,52896
20200413,2,홍대입구,40991,43291,20200416,84282
20200413,2,신촌,27557,28635,20200416,56192
20200413,2,이대,9479,9958,20200416,19437
20200413,2,아현,8264,8031,20200416,16295
20200413,2,충정로,9140,9556,20200416,18696
20200413,2,용답,2198,2101,20200416,4299
20200413,2,신답,1454,1692,20200416,3146
20200413,2,신설동,2728,2834,20200416,5562
20200413,2,도림천,1069,1128,20200416,2197
20200413,2,양천구청,5804,6054,20200416,11858
20200413,2,신정네거리,8294,8665,20200416,16959
20200413,2,용두,1970,2206,20200416,4176
20200414,2,시청,22475,24633,20200417,47108
20200414,2,을지로입구,35430,38496,20200417,73926
20200414,2,을지로3가,20089,20947,20200417,41036
20200414,2,을지로4가,12233,12707,20200417,24940
20200414,2,동대문역사문화공원,10760,12131,20200417,22891
20200414,2,신당,12767,12845,20200417,25612
20200414,2,상왕십리,12644,11841,20200417,24485
20200414,2,왕십리,14901,12586,20200417,27487
20200414,2,한양대,6503,7248,20200417,13751
20200414,2,뚝섬,18547,20232,20200417,38779
20200414,2,성수,30991,34480,20200417,65471
20200414,2,건대입구,31411,35835,20200417,67246
20200414,2,구의,22856,21900,20200417,44756
20200414,2,강변,27781,26976,20200417,54757
20200414,2,잠실나루,13248,12394,20200417,25642
20200414,2,잠실,59047,57471,20200417,116518
20200414,2,잠실새내,18986,19523,20200417,38509
20200414,2,종합운동장,5959,6390,20200417,12349
20200414,2,삼성,44581,46446,20200417,91027
20200414,2,선릉,53854,48411,20200417,102265
20200414,2,역삼,46695,52477,20200417,99172
20200414,2,강남,82146,84845,20200417,166991
20200414,2,교대,31675,35735,20200417,67410
20200414,2,서초,19517,19192,20200417,38709
20200414,2,방배,15601,15959,20200417,31560
20200414,2,사당,34555,38883,20200417,73438
20200414,2,낙성대,25502,23592,20200417,49094
20200414,2,서울대입구,44018,42440,20200417,86458
20200414,2,봉천,22796,20550,20200417,43346
20200414,2,신림,60952,58057,20200417,119009
20200414,2,신대방,24796,23240,20200417,48036
20200414,2,구로디지털단지,58098,57942,20200417,116040
20200414,2,대림,23019,23083,20200417,46102
20200414,2,신도림,48700,47020,20200417,95720
20200414,2,문래,20088,20786,20200417,40874
20200414,2,영등포구청,21433,21910,20200417,43343
20200414,2,당산,18786,21781,20200417,40567
20200414,2,합정,27858,30426,20200417,58284
20200414,2,홍대입구,44720,49627,20200417,94347
20200414,2,신촌,28969,30947,20200417,59916
20200414,2,이대,9813,9929,20200417,19742
20200414,2,아현,8614,8075,20200417,16689
20200414,2,충정로,9259,9852,20200417,19111
20200414,2,용답,2286,2112,20200417,4398
20200414,2,신답,1469,1511,20200417,2980
20200414,2,신설동,2772,2682,20200417,5454
20200414,2,도림천,1094,1094,20200417,2188
20200414,2,양천구청,5868,5926,20200417,11794
20200414,2,신정네거리,8450,8678,20200417,17128
20200414,2,용두,2049,2164,20200417,4213
20200415,2,시청,4350,3933,20200418,8283
20200415,2,을지로입구,12619,12237,20200418,24856
20200415,2,을지로3가,5743,5681,20200418,11424
20200415,2,을지로4가,5465,5510,20200418,10975
20200415,2,동대문역사문화공원,7037,7887,20200418,14924
20200415,2,신당,8000,8301,20200418,16301
20200415,2,상왕십리,6621,6447,20200418,13068
20200415,2,왕십리,8941,7511,20200418,16452
20200415,2,한양대,2607,2862,20200418,5469
20200415,2,뚝섬,9506,10033,20200418,19539
20200415,2,성수,12799,14084,20200418,26883
20200415,2,건대입구,24366,25108,20200418,49474
20200415,2,구의,12188,11688,20200418,23876
20200415,2,강변,16367,16524,20200418,32891
20200415,2,잠실나루,4691,4782,20200418,9473
20200415,2,잠실,33954,32048,20200418,66002
20200415,2,잠실새내,10475,10813,20200418,21288
20200415,2,종합운동장,2815,3057,20200418,5872
20200415,2,삼성,14518,14643,20200418,29161
20200415,2,선릉,15375,13677,20200418,29052
20200415,2,역삼,11784,13054,20200418,24838
20200415,2,강남,39820,39836,20200418,79656
20200415,2,교대,10373,11477,20200418,21850
20200415,2,서초,5568,5044,20200418,10612
20200415,2,방배,6255,6288,20200418,12543
20200415,2,사당,19882,21117,20200418,40999
20200415,2,낙성대,14856,14623,20200418,29479
20200415,2,서울대입구,26972,26691,20200418,53663
20200415,2,봉천,12707,11759,20200418,24466
20200415,2,신림,37211,35626,20200418,72837
20200415,2,신대방,14975,14417,20200418,29392
20200415,2,구로디지털단지,24356,24201,20200418,48557
20200415,2,대림,13353,13658,20200418,27011
20200415,2,신도림,25236,24812,20200418,50048
20200415,2,문래,7204,7474,20200418,14678
20200415,2,영등포구청,7920,8238,20200418,16158
20200415,2,당산,9091,9922,20200418,19013
20200415,2,합정,17153,18124,20200418,35277
20200415,2,홍대입구,37410,38412,20200418,75822
20200415,2,신촌,19421,19631,20200418,39052
20200415,2,이대,5913,6240,20200418,12153
20200415,2,아현,4736,4559,20200418,9295
20200415,2,충정로,3456,3605,20200418,7061
20200415,2,용답,1433,1421,20200418,2854
20200415,2,신답,748,772,20200418,1520
20200415,2,신설동,1854,1839,20200418,3693
20200415,2,도림천,589,610,20200418,1199
20200415,2,양천구청,2712,2815,20200418,5527
20200415,2,신정네거리,4427,4507,20200418,8934
20200415,2,용두,1261,1278,20200418,2539
20200416,2,시청,21878,22192,20200419,44070
20200416,2,을지로입구,34167,35710,20200419,69877
20200416,2,을지로3가,19513,19542,20200419,39055
20200416,2,을지로4가,12016,12057,20200419,24073
20200416,2,동대문역사문화공원,10646,11610,20200419,22256
20200416,2,신당,12447,12615,20200419,25062
20200416,2,상왕십리,12209,11785,20200419,23994
20200416,2,왕십리,14212,11891,20200419,26103
20200416,2,한양대,6451,7181,20200419,13632
20200416,2,뚝섬,18530,20145,20200419,38675
20200416,2,성수,30639,34201,20200419,64840
20200416,2,건대입구,30217,32816,20200419,63033
20200416,2,구의,21877,21294,20200419,43171
20200416,2,강변,27830,26954,20200419,54784
20200416,2,잠실나루,13065,12563,20200419,25628
20200416,2,잠실,56999,55354,20200419,112353
20200416,2,잠실새내,18094,18270,20200419,36364
20200416,2,종합운동장,5959,6363,20200419,12322
20200416,2,삼성,44590,45877,20200419,90467
20200416,2,선릉,53721,48468,20200419,102189
20200416,2,역삼,46249,51614,20200419,97863
20200416,2,강남,79588,80277,20200419,159865
20200416,2,교대,31305,35350,20200419,66655
20200416,2,서초,18747,18831,20200419,37578
20200416,2,방배,15287,15767,20200419,31054
20200416,2,사당,32709,36114,20200419,68823
20200416,2,낙성대,24314,23539,20200419,47853
20200416,2,서울대입구,42305,41378,20200419,83683
20200416,2,봉천,22249,20635,20200419,42884
20200416,2,신림,58701,56312,20200419,115013
20200416,2,신대방,24465,23308,20200419,47773
20200416,2,구로디지털단지,56909,56807,20200419,113716
20200416,2,대림,22700,22863,20200419,45563
20200416,2,신도림,43448,42454,20200419,85902
20200416,2,문래,19431,19850,20200419,39281
20200416,2,영등포구청,21380,21755,20200419,43135
20200416,2,당산,18367,21166,20200419,39533
20200416,2,합정,26808,28567,20200419,55375
20200416,2,홍대입구,43677,46627,20200419,90304
20200416,2,신촌,28797,30091,20200419,58888
20200416,2,이대,9586,9994,20200419,19580
20200416,2,아현,8449,8074,20200419,16523
20200416,2,충정로,9063,9609,20200419,18672
20200416,2,용답,2287,2234,20200419,4521
20200416,2,신답,1457,1569,20200419,3026
20200416,2,신설동,2773,2848,20200419,5621
20200416,2,도림천,1064,1116,20200419,2180
20200416,2,양천구청,5845,6124,20200419,11969
20200416,2,신정네거리,8484,8767,20200419,17251
20200416,2,용두,2102,2268,20200419,4370
20200417,2,시청,21504,21797,20200420,43301
20200417,2,을지로입구,33776,35257,20200420,69033
20200417,2,을지로3가,19116,19702,20200420,38818
20200417,2,을지로4가,11557,11730,20200420,23287
20200417,2,동대문역사문화공원,10020,11202,20200420,21222
20200417,2,신당,12186,12371,20200420,24557
20200417,2,상왕십리,12498,11672,20200420,24170
20200417,2,왕십리,14649,12673,20200420,27322
20200417,2,한양대,6433,6918,20200420,13351
20200417,2,뚝섬,17945,19570,20200420,37515
20200417,2,성수,30631,33953,20200420,64584
20200417,2,건대입구,30765,35357,20200420,66122
20200417,2,구의,22297,21082,20200420,43379
20200417,2,강변,29457,29006,20200420,58463
20200417,2,잠실나루,12787,12075,20200420,24862
20200417,2,잠실,57615,56723,20200420,114338
20200417,2,잠실새내,18686,19433,20200420,38119
20200417,2,종합운동장,5696,6186,20200420,11882
20200417,2,삼성,45205,46562,20200420,91767
20200417,2,선릉,53022,47622,20200420,100644
20200417,2,역삼,45966,51092,20200420,97058
20200417,2,강남,81657,85231,20200420,166888
20200417,2,교대,30925,34973,20200420,65898
20200417,2,서초,19199,18903,20200420,38102
20200417,2,방배,15248,15604,20200420,30852
20200417,2,사당,34200,37740,20200420,71940
20200417,2,낙성대,24797,22693,20200420,47490
20200417,2,서울대입구,43722,41764,20200420,85486
20200417,2,봉천,22306,19801,20200420,42107
20200417,2,신림,59112,56574,20200420,115686
20200417,2,신대방,24129,22828,20200420,46957
20200417,2,구로디지털단지,56267,56053,20200420,112320
20200417,2,대림,21996,21884,20200420,43880
20200417,2,신도림,44557,43913,20200420,88470
20200417,2,문래,19521,19941,20200420,39462
20200417,2,영등포구청,20968,21224,20200420,42192
20200417,2,당산,17954,20899,20200420,38853
20200417,2,합정,27801,30321,20200420,58122
20200417,2,홍대입구,43485,50115,20200420,93600
20200417,2,신촌,30474,32096,20200420,62570
20200417,2,이대,9699,9826,20200420,19525
20200417,2,아현,8514,7758,20200420,16272
20200417,2,충정로,8987,9374,20200420,18361
20200417,2,용답,2279,2164,20200420,4443
20200417,2,신답,1458,1615,20200420,3073
20200417,2,신설동,2769,2977,20200420,5746
20200417,2,도림천,1051,1112,20200420,2163
20200417,2,양천구청,5854,6063,20200420,11917
20200417,2,신정네거리,8306,8697,20200420,17003
20200417,2,용두,2044,2092,20200420,4136
20200418,2,시청,5718,5206,20200421,10924
20200418,2,을지로입구,15852,15554,20200421,31406
20200418,2,을지로3가,7509,7615,20200421,15124
20200418,2,을지로4가,5966,6303,20200421,12269
20200418,2,동대문역사문화공원,8024,8030,20200421,16054
20200418,2,신당,9289,9566,20200421,18855
20200418,2,상왕십리,7717,7161,20200421,14878
20200418,2,왕십리,11538,9826,20200421,21364
20200418,2,한양대,3625,3768,20200421,7393
20200418,2,뚝섬,11522,12117,20200421,23639
20200418,2,성수,13673,15517,20200421,29190
20200418,2,건대입구,30155,33310,20200421,63465
20200418,2,구의,13831,13312,20200421,27143
20200418,2,강변,21974,22708,20200421,44682
20200418,2,잠실나루,6258,6089,20200421,12347
20200418,2,잠실,44857,41779,20200421,86636
20200418,2,잠실새내,13162,14393,20200421,27555
20200418,2,종합운동장,3462,3753,20200421,7215
20200418,2,삼성,18705,18966,20200421,37671
20200418,2,선릉,20453,18154,20200421,38607
20200418,2,역삼,15002,16331,20200421,31333
20200418,2,강남,53203,55836,20200421,109039
20200418,2,교대,14080,15389,20200421,29469
20200418,2,서초,7872,7200,20200421,15072
20200418,2,방배,8084,8224,20200421,16308
20200418,2,사당,25688,28583,20200421,54271
20200418,2,낙성대,18159,16565,20200421,34724
20200418,2,서울대입구,33304,31787,20200421,65091
20200418,2,봉천,14990,13356,20200421,28346
20200418,2,신림,43937,41616,20200421,85553
20200418,2,신대방,17189,16173,20200421,33362
20200418,2,구로디지털단지,28972,28491,20200421,57463
20200418,2,대림,15456,16142,20200421,31598
20200418,2,신도림,32919,33344,20200421,66263
20200418,2,문래,9197,9660,20200421,18857
20200418,2,영등포구청,10255,10565,20200421,20820
20200418,2,당산,11785,12746,20200421,24531
20200418,2,합정,21916,24589,20200421,46505
20200418,2,홍대입구,47934,54196,20200421,102130
20200418,2,신촌,25757,26334,20200421,52091
20200418,2,이대,7321,7689,20200421,15010
20200418,2,아현,5859,5442,20200421,11301
20200418,2,충정로,4244,4293,20200421,8537
20200418,2,용답,1756,1543,20200421,3299
20200418,2,신답,853,815,20200421,1668
20200418,2,신설동,2773,2646,20200421,5419
20200418,2,도림천,670,640,20200421,1310
20200418,2,양천구청,3592,3584,20200421,7176
20200418,2,신정네거리,5660,5692,20200421,11352
20200418,2,용두,1533,1499,20200421,3032
20200419,2,시청,3155,2796,20200422,5951
20200419,2,을지로입구,10344,10138,20200422,20482
20200419,2,을지로3가,3977,3739,20200422,7716
20200419,2,을지로4가,2110,2042,20200422,4152
20200419,2,동대문역사문화공원,4744,5872,20200422,10616
20200419,2,신당,5824,6388,20200422,12212
20200419,2,상왕십리,4782,4807,20200422,9589
20200419,2,왕십리,7140,6123,20200422,13263
20200419,2,한양대,1991,2252,20200422,4243
20200419,2,뚝섬,6028,6272,20200422,12300
20200419,2,성수,8183,8872,20200422,17055
20200419,2,건대입구,19622,20161,20200422,39783
20200419,2,구의,8841,8807,20200422,17648
20200419,2,강변,16587,16326,20200422,32913
20200419,2,잠실나루,3584,3744,20200422,7328
20200419,2,잠실,28859,27104,20200422,55963
20200419,2,잠실새내,7826,8156,20200422,15982
20200419,2,종합운동장,2160,2467,20200422,4627
20200419,2,삼성,13038,12706,20200422,25744
20200419,2,선릉,9499,8377,20200422,17876
20200419,2,역삼,7986,8725,20200422,16711
20200419,2,강남,27795,27093,20200422,54888
20200419,2,교대,7736,8376,20200422,16112
20200419,2,서초,5135,4842,20200422,9977
20200419,2,방배,4639,4871,20200422,9510
20200419,2,사당,15722,17466,20200422,33188
20200419,2,낙성대,11969,12002,20200422,23971
20200419,2,서울대입구,20681,21190,20200422,41871
20200419,2,봉천,9116,9150,20200422,18266
20200419,2,신림,28876,28296,20200422,57172
20200419,2,신대방,11405,11025,20200422,22430
20200419,2,구로디지털단지,17560,17562,20200422,35122
20200419,2,대림,10506,10479,20200422,20985
20200419,2,신도림,19837,19795,20200422,39632
20200419,2,문래,5125,5288,20200422,10413
20200419,2,영등포구청,5858,6182,20200422,12040
20200419,2,당산,6263,6905,20200422,13168
20200419,2,합정,13583,14198,20200422,27781
20200419,2,홍대입구,31170,30653,20200422,61823
20200419,2,신촌,16832,16436,20200422,33268
20200419,2,이대,4443,4744,20200422,9187
20200419,2,아현,3488,3595,20200422,7083
20200419,2,충정로,2682,2847,20200422,5529
20200419,2,용답,1125,1190,20200422,2315
20200419,2,신답,503,541,20200422,1044
20200419,2,신설동,2228,2062,20200422,4290
20200419,2,도림천,311,339,20200422,650
20200419,2,양천구청,2232,2252,20200422,4484
20200419,2,신정네거리,3280,3398,20200422,6678
20200419,2,용두,861,929,20200422,1790
20200420,2,시청,22080,22254,20200423,44334
20200420,2,을지로입구,35395,36610,20200423,72005
20200420,2,을지로3가,19930,19779,20200423,39709
20200420,2,을지로4가,12032,11908,20200423,23940
20200420,2,동대문역사문화공원,9903,11336,20200423,21239
20200420,2,신당,12616,12857,20200423,25473
20200420,2,상왕십리,12500,12084,20200423,24584
20200420,2,왕십리,13978,11653,20200423,25631
20200420,2,한양대,6453,7109,20200423,13562
20200420,2,뚝섬,18130,19366,20200423,37496
20200420,2,성수,30959,33817,20200423,64776
20200420,2,건대입구,29323,31414,20200423,60737
20200420,2,구의,22273,21808,20200423,44081
20200420,2,강변,28665,27856,20200423,56521
20200420,2,잠실나루,13096,12719,20200423,25815
20200420,2,잠실,56147,55433,20200423,111580
20200420,2,잠실새내,18328,18268,20200423,36596
20200420,2,종합운동장,5812,6194,20200423,12006
20200420,2,삼성,46687,47789,20200423,94476
20200420,2,선릉,55302,49836,20200423,105138
20200420,2,역삼,48385,53359,20200423,101744
20200420,2,강남,79632,80189,20200423,159821
20200420,2,교대,31818,35721,20200423,67539
20200420,2,서초,19948,19601,20200423,39549
20200420,2,방배,15328,15877,20200423,31205
20200420,2,사당,32354,35964,20200423,68318
20200420,2,낙성대,24500,24047,20200423,48547
20200420,2,서울대입구,42268,41523,20200423,83791
20200420,2,봉천,22712,21031,20200423,43743
20200420,2,신림,59056,57170,20200423,116226
20200420,2,신대방,24484,23750,20200423,48234
20200420,2,구로디지털단지,58042,58238,20200423,116280
20200420,2,대림,23183,23381,20200423,46564
20200420,2,신도림,43780,42586,20200423,86366
20200420,2,문래,19420,19811,20200423,39231
20200420,2,영등포구청,21861,22232,20200423,44093
20200420,2,당산,17914,21032,20200423,38946
20200420,2,합정,26085,27346,20200423,53431
20200420,2,홍대입구,41403,43660,20200423,85063
20200420,2,신촌,28876,30078,20200423,58954
20200420,2,이대,10039,10461,20200423,20500
20200420,2,아현,8575,8200,20200423,16775
20200420,2,충정로,9386,9898,20200423,19284
20200420,2,용답,2211,2174,20200423,4385
20200420,2,신답,1477,1665,20200423,3142
20200420,2,신설동,2926,2905,20200423,5831
20200420,2,도림천,1075,1156,20200423,2231
20200420,2,양천구청,6009,6305,20200423,12314
20200420,2,신정네거리,8561,8921,20200423,17482
20200420,2,용두,2068,2142,20200423,4210
20200421,2,시청,22845,22873,20200424,45718
20200421,2,을지로입구,36452,37335,20200424,73787
20200421,2,을지로3가,20201,20251,20200424,40452
20200421,2,을지로4가,12439,12179,20200424,24618
20200421,2,동대문역사문화공원,10537,11692,20200424,22229
20200421,2,신당,12696,13118,20200424,25814
20200421,2,상왕십리,12659,12377,20200424,25036
20200421,2,왕십리,14595,11810,20200424,26405
20200421,2,한양대,6582,7260,20200424,13842
20200421,2,뚝섬,18966,20070,20200424,39036
20200421,2,성수,31717,34624,20200424,66341
20200421,2,건대입구,30383,32626,20200424,63009
20200421,2,구의,22554,21990,20200424,44544
20200421,2,강변,28256,27438,20200424,55694
20200421,2,잠실나루,13405,13045,20200424,26450
20200421,2,잠실,59606,58659,20200424,118265
20200421,2,잠실새내,18810,18713,20200424,37523
20200421,2,종합운동장,5998,6569,20200424,12567
20200421,2,삼성,47899,48871,20200424,96770
20200421,2,선릉,56014,50360,20200424,106374
20200421,2,역삼,49215,53721,20200424,102936
20200421,2,강남,82960,82857,20200424,165817
20200421,2,교대,32875,36946,20200424,69821
20200421,2,서초,20170,20075,20200424,40245
20200421,2,방배,16132,16529,20200424,32661
20200421,2,사당,33748,36963,20200424,70711
20200421,2,낙성대,25374,24419,20200424,49793
20200421,2,서울대입구,43903,42735,20200424,86638
20200421,2,봉천,23079,21407,20200424,44486
20200421,2,신림,60389,58411,20200424,118800
20200421,2,신대방,24873,24008,20200424,48881
20200421,2,구로디지털단지,58564,59004,20200424,117568
20200421,2,대림,23059,23476,20200424,46535
20200421,2,신도림,44434,43343,20200424,87777
20200421,2,문래,20112,20355,20200424,40467
20200421,2,영등포구청,22103,22364,20200424,44467
20200421,2,당산,18499,21688,20200424,40187
20200421,2,합정,27766,28737,20200424,56503
20200421,2,홍대입구,43950,46128,20200424,90078
20200421,2,신촌,29734,30730,20200424,60464
20200421,2,이대,10138,10687,20200424,20825
20200421,2,아현,8610,8407,20200424,17017
20200421,2,충정로,9489,10131,20200424,19620
20200421,2,용답,2197,2207,20200424,4404
20200421,2,신답,1460,1673,20200424,3133
20200421,2,신설동,3105,2905,20200424,6010
20200421,2,도림천,1111,1208,20200424,2319
20200421,2,양천구청,6042,6348,20200424,12390
20200421,2,신정네거리,8657,9047,20200424,17704
20200421,2,용두,1997,2141,20200424,4138
20200422,2,시청,22950,22967,20200425,45917
20200422,2,을지로입구,36467,37928,20200425,74395
20200422,2,을지로3가,20439,20491,20200425,40930
20200422,2,을지로4가,12446,12157,20200425,24603
20200422,2,동대문역사문화공원,10342,11418,20200425,21760
20200422,2,신당,12458,12806,20200425,25264
20200422,2,상왕십리,12668,12257,20200425,24925
20200422,2,왕십리,14496,11840,20200425,26336
20200422,2,한양대,6625,7087,20200425,13712
20200422,2,뚝섬,18676,19894,20200425,38570
20200422,2,성수,31445,34449,20200425,65894
20200422,2,건대입구,30669,33337,20200425,64006
20200422,2,구의,22549,21947,20200425,44496
20200422,2,강변,27751,27052,20200425,54803
20200422,2,잠실나루,13080,12756,20200425,25836
20200422,2,잠실,59309,58414,20200425,117723
20200422,2,잠실새내,18857,18883,20200425,37740
20200422,2,종합운동장,5918,6507,20200425,12425
20200422,2,삼성,47765,48750,20200425,96515
20200422,2,선릉,55979,49991,20200425,105970
20200422,2,역삼,49018,53375,20200425,102393
20200422,2,강남,82439,82489,20200425,164928
20200422,2,교대,32868,36877,20200425,69745
20200422,2,서초,20017,19875,20200425,39892
20200422,2,방배,15543,16035,20200425,31578
20200422,2,사당,34106,37187,20200425,71293
20200422,2,낙성대,25269,24458,20200425,49727
20200422,2,서울대입구,43568,42572,20200425,86140
20200422,2,봉천,22863,21210,20200425,44073
20200422,2,신림,60222,57839,20200425,118061
20200422,2,신대방,24557,23674,20200425,48231
20200422,2,구로디지털단지,58498,58680,20200425,117178
20200422,2,대림,22730,23217,20200425,45947
20200422,2,신도림,45710,44388,20200425,90098
20200422,2,문래,19801,20243,20200425,40044
20200422,2,영등포구청,22041,22332,20200425,44373
20200422,2,당산,18687,21438,20200425,40125
20200422,2,합정,27986,28965,20200425,56951
20200422,2,홍대입구,44792,47248,20200425,92040
20200422,2,신촌,29906,31159,20200425,61065
20200422,2,이대,10340,10642,20200425,20982
20200422,2,아현,8506,8173,20200425,16679
20200422,2,충정로,9617,10174,20200425,19791
20200422,2,용답,2260,2209,20200425,4469
20200422,2,신답,1491,1667,20200425,3158
20200422,2,신설동,3201,3039,20200425,6240
20200422,2,도림천,1119,1195,20200425,2314
20200422,2,양천구청,6083,6364,20200425,12447
20200422,2,신정네거리,8647,8985,20200425,17632
20200422,2,용두,2010,2143,20200425,4153
20200423,2,시청,23122,23308,20200426,46430
20200423,2,을지로입구,36374,37988,20200426,74362
20200423,2,을지로3가,20411,20443,20200426,40854
20200423,2,을지로4가,12323,12200,20200426,24523
20200423,2,동대문역사문화공원,10808,11992,20200426,22800
20200423,2,신당,12748,12986,20200426,25734
20200423,2,상왕십리,12869,12377,20200426,25246
20200423,2,왕십리,14955,12316,20200426,27271
20200423,2,한양대,6551,7407,20200426,13958
20200423,2,뚝섬,18877,20409,20200426,39286
20200423,2,성수,31611,34920,20200426,66531
20200423,2,건대입구,31347,34201,20200426,65548
20200423,2,구의,22680,21918,20200426,44598
20200423,2,강변,28697,27756,20200426,56453
20200423,2,잠실나루,13403,12999,20200426,26402
20200423,2,잠실,60339,59456,20200426,119795
20200423,2,잠실새내,19066,19081,20200426,38147
20200423,2,종합운동장,6027,6608,20200426,12635
20200423,2,삼성,47715,49035,20200426,96750
20200423,2,선릉,56425,50600,20200426,107025
20200423,2,역삼,48526,53867,20200426,102393
20200423,2,강남,83453,84365,20200426,167818
20200423,2,교대,33243,37364,20200426,70607
20200423,2,서초,19914,19781,20200426,39695
20200423,2,방배,16130,16592,20200426,32722
20200423,2,사당,34798,37889,20200426,72687
20200423,2,낙성대,25411,24588,20200426,49999
20200423,2,서울대입구,44448,43035,20200426,87483
20200423,2,봉천,23289,21528,20200426,44817
20200423,2,신림,61043,58474,20200426,119517
20200423,2,신대방,24965,24174,20200426,49139
20200423,2,구로디지털단지,59293,59402,20200426,118695
20200423,2,대림,23232,23726,20200426,46958
20200423,2,신도림,45961,44790,20200426,90751
20200423,2,문래,20281,20704,20200426,40985
20200423,2,영등포구청,22431,22735,20200426,45166
20200423,2,당산,18868,21780,20200426,40648
20200423,2,합정,28603,29697,20200426,58300
20200423,2,홍대입구,46128,49171,20200426,95299
20200423,2,신촌,30298,31203,20200426,61501
20200423,2,이대,10396,10708,20200426,21104
20200423,2,아현,8815,8417,20200426,17232
20200423,2,충정로,9560,10182,20200426,19742
20200423,2,용답,2249,2239,20200426,4488
20200423,2,신답,1542,1673,20200426,3215
20200423,2,신설동,3132,3052,20200426,6184
20200423,2,도림천,1125,1172,20200426,2297
20200423,2,양천구청,6139,6435,20200426,12574
20200423,2,신정네거리,8742,9228,20200426,17970
20200423,2,용두,2084,2288,20200426,4372
20200424,2,시청,22891,23009,20200427,45900
20200424,2,을지로입구,37313,38586,20200427,75899
20200424,2,을지로3가,21003,21429,20200427,42432
20200424,2,을지로4가,12552,12707,20200427,25259
20200424,2,동대문역사문화공원,11193,12311,20200427,23504
20200424,2,신당,13391,13592,20200427,26983
20200424,2,상왕십리,13424,12517,20200427,25941
20200424,2,왕십리,15959,13775,20200427,29734
20200424,2,한양대,6767,7439,20200427,14206
20200424,2,뚝섬,19743,21301,20200427,41044
20200424,2,성수,32446,36230,20200427,68676
20200424,2,건대입구,34457,39568,20200427,74025
20200424,2,구의,23293,22229,20200427,45522
20200424,2,강변,32296,31586,20200427,63882
20200424,2,잠실나루,14168,13375,20200427,27543
20200424,2,잠실,64922,63254,20200427,128176
20200424,2,잠실새내,20505,21324,20200427,41829
20200424,2,종합운동장,6414,6871,20200427,13285
20200424,2,삼성,49082,49975,20200427,99057
20200424,2,선릉,56805,50845,20200427,107650
20200424,2,역삼,47524,53098,20200427,100622
20200424,2,강남,89681,93972,20200427,183653
20200424,2,교대,34151,38855,20200427,73006
20200424,2,서초,20450,20217,20200427,40667
20200424,2,방배,16474,16714,20200427,33188
20200424,2,사당,37730,41765,20200427,79495
20200424,2,낙성대,27071,24917,20200427,51988
20200424,2,서울대입구,47549,45810,20200427,93359
20200424,2,봉천,24282,21728,20200427,46010
20200424,2,신림,63983,60908,20200427,124891
20200424,2,신대방,25967,24031,20200427,49998
20200424,2,구로디지털단지,60890,60812,20200427,121702
20200424,2,대림,23988,24229,20200427,48217
20200424,2,신도림,48204,47824,20200427,96028
20200424,2,문래,20503,21140,20200427,41643
20200424,2,영등포구청,22672,22937,20200427,45609
20200424,2,당산,19775,22396,20200427,42171
20200424,2,합정,30464,33804,20200427,64268
20200424,2,홍대입구,51292,58845,20200427,110137
20200424,2,신촌,33071,35181,20200427,68252
20200424,2,이대,11082,11272,20200427,22354
20200424,2,아현,9229,8600,20200427,17829
20200424,2,충정로,9745,10336,20200427,20081
20200424,2,용답,2462,2302,20200427,4764
20200424,2,신답,1473,1611,20200427,3084
20200424,2,신설동,3164,3024,20200427,6188
20200424,2,도림천,1160,1209,20200427,2369
20200424,2,양천구청,6411,6563,20200427,12974
20200424,2,신정네거리,9148,9415,20200427,18563
20200424,2,용두,2159,2255,20200427,4414
20200425,2,시청,5885,5301,20200428,11186
20200425,2,을지로입구,16771,16732,20200428,33503
20200425,2,을지로3가,7842,7822,20200428,15664
20200425,2,을지로4가,6396,6763,20200428,13159
20200425,2,동대문역사문화공원,8129,8319,20200428,16448
20200425,2,신당,9564,9340,20200428,18904
20200425,2,상왕십리,7947,7359,20200428,15306
20200425,2,왕십리,11501,10000,20200428,21501
20200425,2,한양대,3234,3368,20200428,6602
20200425,2,뚝섬,11548,11863,20200428,23411
20200425,2,성수,14410,16078,20200428,30488
20200425,2,건대입구,30257,34244,20200428,64501
20200425,2,구의,14670,14007,20200428,28677
20200425,2,강변,23881,24553,20200428,48434
20200425,2,잠실나루,6387,6106,20200428,12493
20200425,2,잠실,48694,45503,20200428,94197
20200425,2,잠실새내,13966,15088,20200428,29054
20200425,2,종합운동장,3778,4039,20200428,7817
20200425,2,삼성,21621,21797,20200428,43418
20200425,2,선릉,22375,19863,20200428,42238
20200425,2,역삼,15831,17282,20200428,33113
20200425,2,강남,57149,60256,20200428,117405
20200425,2,교대,15352,16714,20200428,32066
20200425,2,서초,8539,8010,20200428,16549
20200425,2,방배,8857,8888,20200428,17745
20200425,2,사당,27438,30392,20200428,57830
20200425,2,낙성대,19193,17143,20200428,36336
20200425,2,서울대입구,34611,33506,20200428,68117
20200425,2,봉천,15810,14109,20200428,29919
20200425,2,신림,46886,44417,20200428,91303
20200425,2,신대방,17728,16808,20200428,34536
20200425,2,구로디지털단지,31700,31370,20200428,63070
20200425,2,대림,16114,16874,20200428,32988
20200425,2,신도림,35658,35901,20200428,71559
20200425,2,문래,9859,10430,20200428,20289
20200425,2,영등포구청,11080,11219,20200428,22299
20200425,2,당산,11685,12562,20200428,24247
20200425,2,합정,23341,25782,20200428,49123
20200425,2,홍대입구,51661,58556,20200428,110217
20200425,2,신촌,27123,28181,20200428,55304
20200425,2,이대,7773,8074,20200428,15847
20200425,2,아현,5890,5480,20200428,11370
20200425,2,충정로,4895,5103,20200428,9998
20200425,2,용답,1700,1637,20200428,3337
20200425,2,신답,905,952,20200428,1857
20200425,2,신설동,2756,2688,20200428,5444
20200425,2,도림천,701,677,20200428,1378
20200425,2,양천구청,3736,3787,20200428,7523
20200425,2,신정네거리,6052,6164,20200428,12216
20200425,2,용두,1514,1485,20200428,2999
20200426,2,시청,3779,3238,20200429,7017
20200426,2,을지로입구,12083,11487,20200429,23570
20200426,2,을지로3가,4951,4659,20200429,9610
20200426,2,을지로4가,2574,2539,20200429,5113
20200426,2,동대문역사문화공원,5676,6943,20200429,12619
20200426,2,신당,6998,7546,20200429,14544
20200426,2,상왕십리,5406,5407,20200429,10813
20200426,2,왕십리,8008,6682,20200429,14690
20200426,2,한양대,2038,2390,20200429,4428
20200426,2,뚝섬,8457,8549,20200429,17006
20200426,2,성수,9224,10252,20200429,19476
20200426,2,건대입구,23685,23946,20200429,47631
20200426,2,구의,9902,9979,20200429,19881
20200426,2,강변,18668,18850,20200429,37518
20200426,2,잠실나루,4353,4361,20200429,8714
20200426,2,잠실,35233,32964,20200429,68197
20200426,2,잠실새내,8946,9499,20200429,18445
20200426,2,종합운동장,2525,2754,20200429,5279
20200426,2,삼성,14408,14031,20200429,28439
20200426,2,선릉,10990,9664,20200429,20654
20200426,2,역삼,8718,9524,20200429,18242
20200426,2,강남,32442,31585,20200429,64027
20200426,2,교대,8676,9697,20200429,18373
20200426,2,서초,6402,6066,20200429,12468
20200426,2,방배,5421,5688,20200429,11109
20200426,2,사당,18777,20781,20200429,39558
20200426,2,낙성대,13974,13965,20200429,27939
20200426,2,서울대입구,24005,25111,20200429,49116
20200426,2,봉천,10484,10262,20200429,20746
20200426,2,신림,32878,32070,20200429,64948
20200426,2,신대방,13206,12775,20200429,25981
20200426,2,구로디지털단지,20770,20520,20200429,41290
20200426,2,대림,12790,12969,20200429,25759
20200426,2,신도림,22985,23106,20200429,46091
20200426,2,문래,5765,6058,20200429,11823
20200426,2,영등포구청,6458,6485,20200429,12943
20200426,2,당산,8019,8839,20200429,16858
20200426,2,합정,16573,17147,20200429,33720
20200426,2,홍대입구,39297,38351,20200429,77648
20200426,2,신촌,18927,18783,20200429,37710
20200426,2,이대,4773,5146,20200429,9919
20200426,2,아현,4003,3978,20200429,7981
20200426,2,충정로,3258,3420,20200429,6678
20200426,2,용답,1352,1354,20200429,2706
20200426,2,신답,599,603,20200429,1202
20200426,2,신설동,2611,2494,20200429,5105
20200426,2,도림천,398,375,20200429,773
20200426,2,양천구청,2632,2794,20200429,5426
20200426,2,신정네거리,4011,3978,20200429,7989
20200426,2,용두,903,927,20200429,1830
20200427,2,시청,23168,23619,20200430,46787
20200427,2,을지로입구,36786,38188,20200430,74974
20200427,2,을지로3가,20525,20728,20200430,41253
20200427,2,을지로4가,12607,12674,20200430,25281
20200427,2,동대문역사문화공원,10772,11944,20200430,22716
20200427,2,신당,13006,13334,20200430,26340
20200427,2,상왕십리,13000,12574,20200430,25574
20200427,2,왕십리,14758,12168,20200430,26926
20200427,2,한양대,6561,7260,20200430,13821
20200427,2,뚝섬,18774,20290,20200430,39064
20200427,2,성수,32211,35270,20200430,67481
20200427,2,건대입구,30396,32857,20200430,63253
20200427,2,구의,22823,22359,20200430,45182
20200427,2,강변,29992,29320,20200430,59312
20200427,2,잠실나루,13791,13360,20200430,27151
20200427,2,잠실,59475,58916,20200430,118391
20200427,2,잠실새내,19310,19248,20200430,38558
20200427,2,종합운동장,6275,6623,20200430,12898
20200427,2,삼성,48452,49878,20200430,98330
20200427,2,선릉,57394,51696,20200430,109090
20200427,2,역삼,49503,55396,20200430,104899
20200427,2,강남,84080,81425,20200430,165505
20200427,2,교대,33058,36971,20200430,70029
20200427,2,서초,20549,20401,20200430,40950
20200427,2,방배,16019,16760,20200430,32779
20200427,2,사당,34154,38035,20200430,72189
20200427,2,낙성대,25768,24981,20200430,50749
20200427,2,서울대입구,44718,43779,20200430,88497
20200427,2,봉천,23608,21871,20200430,45479
20200427,2,신림,61486,58936,20200430,120422
20200427,2,신대방,25548,24565,20200430,50113
20200427,2,구로디지털단지,60569,60646,20200430,121215
20200427,2,대림,24573,24837,20200430,49410
20200427,2,신도림,46210,44951,20200430,91161
20200427,2,문래,20352,20912,20200430,41264
20200427,2,영등포구청,22511,22863,20200430,45374
20200427,2,당산,19023,22100,20200430,41123
20200427,2,합정,27734,28816,20200430,56550
20200427,2,홍대입구,44201,46497,20200430,90698
20200427,2,신촌,29952,31163,20200430,61115
20200427,2,이대,10395,10881,20200430,21276
20200427,2,아현,8889,8455,20200430,17344
20200427,2,충정로,9860,10245,20200430,20105
20200427,2,용답,2322,2304,20200430,4626
20200427,2,신답,1503,1730,20200430,3233
20200427,2,신설동,3019,2973,20200430,5992
20200427,2,도림천,1163,1181,20200430,2344
20200427,2,양천구청,6437,6677,20200430,13114
20200427,2,신정네거리,9114,9422,20200430,18536
20200427,2,용두,2132,2230,20200430,4362
20200428,2,시청,24053,24451,20200501,48504
20200428,2,을지로입구,37841,39230,20200501,77071
20200428,2,을지로3가,20812,21272,20200501,42084
20200428,2,을지로4가,13073,13061,20200501,26134
20200428,2,동대문역사문화공원,11068,12398,20200501,23466
20200428,2,신당,13251,13415,20200501,26666
20200428,2,상왕십리,13157,12569,20200501,25726
20200428,2,왕십리,15113,12496,20200501,27609
20200428,2,한양대,6870,7552,20200501,14422
20200428,2,뚝섬,19570,20831,20200501,40401
20200428,2,성수,31994,35912,20200501,67906
20200428,2,건대입구,31843,34238,20200501,66081
20200428,2,구의,23293,22516,20200501,45809
20200428,2,강변,29251,28620,20200501,57871
20200428,2,잠실나루,14314,13817,20200501,28131
20200428,2,잠실,62587,61108,20200501,123695
20200428,2,잠실새내,19863,19701,20200501,39564
20200428,2,종합운동장,6260,6736,20200501,12996
20200428,2,삼성,49380,51120,20200501,100500
20200428,2,선릉,57866,52025,20200501,109891
20200428,2,역삼,49808,55890,20200501,105698
20200428,2,강남,86470,83769,20200501,170239
20200428,2,교대,34438,38655,20200501,73093
20200428,2,서초,21142,21244,20200501,42386
20200428,2,방배,16655,17205,20200501,33860
20200428,2,사당,35623,39415,20200501,75038
20200428,2,낙성대,26422,25131,20200501,51553
20200428,2,서울대입구,45882,44404,20200501,90286
20200428,2,봉천,24007,21941,20200501,45948
20200428,2,신림,62189,59691,20200501,121880
20200428,2,신대방,25820,24686,20200501,50506
20200428,2,구로디지털단지,60711,60939,20200501,121650
20200428,2,대림,24429,24736,20200501,49165
20200428,2,신도림,46371,45297,20200501,91668
20200428,2,문래,20822,21224,20200501,42046
20200428,2,영등포구청,22929,23389,20200501,46318
20200428,2,당산,19679,22342,20200501,42021
20200428,2,합정,29066,30443,20200501,59509
20200428,2,홍대입구,46375,49104,20200501,95479
20200428,2,신촌,30972,32242,20200501,63214
20200428,2,이대,10581,11021,20200501,21602
20200428,2,아현,9065,8753,20200501,17818
20200428,2,충정로,9914,10547,20200501,20461
20200428,2,용답,2379,2300,20200501,4679
20200428,2,신답,1463,1679,20200501,3142
20200428,2,신설동,3051,2905,20200501,5956
20200428,2,도림천,1194,1261,20200501,2455
20200428,2,양천구청,6459,6643,20200501,13102
20200428,2,신정네거리,9188,9611,20200501,18799
20200428,2,용두,2143,2278,20200501,4421
20200429,2,시청,24170,24516,20200502,48686
20200429,2,을지로입구,38502,39975,20200502,78477
20200429,2,을지로3가,21673,22039,20200502,43712
20200429,2,을지로4가,13261,13230,20200502,26491
20200429,2,동대문역사문화공원,11741,13060,20200502,24801
20200429,2,신당,13847,13815,20200502,27662
20200429,2,상왕십리,13724,12815,20200502,26539
20200429,2,왕십리,16049,13501,20200502,29550
20200429,2,한양대,6955,7591,20200502,14546
20200429,2,뚝섬,20257,21663,20200502,41920
20200429,2,성수,32807,36839,20200502,69646
20200429,2,건대입구,34530,38742,20200502,73272
20200429,2,구의,24116,22822,20200502,46938
20200429,2,강변,33079,34580,20200502,67659
20200429,2,잠실나루,14705,13939,20200502,28644
20200429,2,잠실,65880,63944,20200502,129824
20200429,2,잠실새내,20816,21736,20200502,42552
20200429,2,종합운동장,6630,7046,20200502,13676
20200429,2,삼성,50453,52318,20200502,102771
20200429,2,선릉,58989,52501,20200502,111490
20200429,2,역삼,49375,55782,20200502,105157
20200429,2,강남,90440,91148,20200502,181588
20200429,2,교대,35023,39927,20200502,74950
20200429,2,서초,21496,21262,20200502,42758
20200429,2,방배,16542,16993,20200502,33535
20200429,2,사당,37959,42028,20200502,79987
20200429,2,낙성대,27735,25223,20200502,52958
20200429,2,서울대입구,48349,45779,20200502,94128
20200429,2,봉천,24791,21779,20200502,46570
20200429,2,신림,65242,61491,20200502,126733
20200429,2,신대방,26686,24488,20200502,51174
20200429,2,구로디지털단지,62592,61780,20200502,124372
20200429,2,대림,25237,25338,20200502,50575
20200429,2,신도림,50027,49767,20200502,99794
20200429,2,문래,21094,21596,20200502,42690
20200429,2,영등포구청,23492,23974,20200502,47466
20200429,2,당산,20349,23298,20200502,43647
20200429,2,합정,30624,33568,20200502,64192
20200429,2,홍대입구,50189,56863,20200502,107052
20200429,2,신촌,32865,35060,20200502,67925
20200429,2,이대,11564,11754,20200502,23318
20200429,2,아현,9532,8794,20200502,18326
20200429,2,충정로,9947,10452,20200502,20399
20200429,2,용답,2424,2310,20200502,4734
20200429,2,신답,1596,1679,20200502,3275
20200429,2,신설동,3212,3093,20200502,6305
20200429,2,도림천,1186,1229,20200502,2415
20200429,2,양천구청,6677,6885,20200502,13562
20200429,2,신정네거리,9505,9683,20200502,19188
20200429,2,용두,2296,2378,20200502,4674
20200430,2,시청,5329,4712,20200503,10041
20200430,2,을지로입구,16106,15554,20200503,31660
20200430,2,을지로3가,6876,6830,20200503,13706
20200430,2,을지로4가,5711,5921,20200503,11632
20200430,2,동대문역사문화공원,8656,9501,20200503,18157
20200430,2,신당,8874,8934,20200503,17808
20200430,2,상왕십리,7262,6606,20200503,13868
20200430,2,왕십리,9542,8232,20200503,17774
20200430,2,한양대,3075,3140,20200503,6215
20200430,2,뚝섬,10948,11204,20200503,22152
20200430,2,성수,12846,14479,20200503,27325
20200430,2,건대입구,27313,29074,20200503,56387
20200430,2,구의,13250,12164,20200503,25414
20200430,2,강변,21721,25894,20200503,47615
20200430,2,잠실나루,5512,5458,20200503,10970
20200430,2,잠실,43683,41208,20200503,84891
20200430,2,잠실새내,11699,12369,20200503,24068
20200430,2,종합운동장,3323,3574,20200503,6897
20200430,2,삼성,18308,18430,20200503,36738
20200430,2,선릉,16147,14116,20200503,30263
20200430,2,역삼,12612,13870,20200503,26482
20200430,2,강남,41984,42466,20200503,84450
20200430,2,교대,11338,12432,20200503,23770
20200430,2,서초,6091,5438,20200503,11529
20200430,2,방배,6950,7065,20200503,14015
20200430,2,사당,22546,24663,20200503,47209
20200430,2,낙성대,16962,14911,20200503,31873
20200430,2,서울대입구,30060,28434,20200503,58494
20200430,2,봉천,14168,12296,20200503,26464
20200430,2,신림,41729,37524,20200503,79253
20200430,2,신대방,16840,15321,20200503,32161
20200430,2,구로디지털단지,27892,26695,20200503,54587
20200430,2,대림,15061,15726,20200503,30787
20200430,2,신도림,29391,29078,20200503,58469
20200430,2,문래,7962,8131,20200503,16093
20200430,2,영등포구청,8579,8568,20200503,17147
20200430,2,당산,10043,10977,20200503,21020
20200430,2,합정,19854,21649,20200503,41503
20200430,2,홍대입구,45089,49461,20200503,94550
20200430,2,신촌,21503,22408,20200503,43911
20200430,2,이대,6730,6896,20200503,13626
20200430,2,아현,5340,4987,20200503,10327
20200430,2,충정로,3777,3619,20200503,7396
20200430,2,용답,1723,1561,20200503,3284
20200430,2,신답,810,752,20200503,1562
20200430,2,신설동,2300,2124,20200503,4424
20200430,2,도림천,624,614,20200503,1238
20200430,2,양천구청,3392,3358,20200503,6750
20200430,2,신정네거리,5396,5215,20200503,10611
20200430,2,용두,1404,1345,20200503,2749
20200501,2,용두,1462,1452,20200504,2914
20200501,2,신정네거리,5761,5812,20200504,11573
20200501,2,양천구청,3887,3874,20200504,7761
20200501,2,도림천,661,666,20200504,1327
20200501,2,신설동,2424,2223,20200504,4647
20200501,2,신답,851,877,20200504,1728
20200501,2,용답,1814,1671,20200504,3485
20200501,2,충정로,4257,4182,20200504,8439
20200501,2,아현,5979,5572,20200504,11551
20200501,2,이대,7660,7803,20200504,15463
20200501,2,신촌,24361,25191,20200504,49552
20200501,2,홍대입구,46068,51319,20200504,97387
20200501,2,합정,20554,22378,20200504,42932
20200501,2,당산,10956,11992,20200504,22948
20200501,2,영등포구청,10591,10717,20200504,21308
20200501,2,문래,8777,9072,20200504,17849
20200501,2,신도림,30968,30724,20200504,61692
20200501,2,대림,16928,17300,20200504,34228
20200501,2,구로디지털단지,30543,29246,20200504,59789
20200501,2,신대방,17565,16226,20200504,33791
20200501,2,신림,43605,40923,20200504,84528
20200501,2,봉천,15175,13595,20200504,28770
20200501,2,서울대입구,33246,31940,20200504,65186
20200501,2,낙성대,17918,16008,20200504,33926
20200501,2,사당,24070,27206,20200504,51276
20200501,2,방배,8566,8639,20200504,17205
20200501,2,서초,9464,9106,20200504,18570
20200501,2,교대,18035,20422,20200504,38457
20200501,2,강남,50937,52351,20200504,103288
20200501,2,역삼,15562,17434,20200504,32996
20200501,2,선릉,20875,19086,20200504,39961
20200501,2,삼성,18739,18940,20200504,37679
20200501,2,종합운동장,3713,4000,20200504,7713
20200501,2,잠실새내,14021,14929,20200504,28950
20200501,2,잠실,46679,43589,20200504,90268
20200501,2,잠실나루,8001,7687,20200504,15688
20200501,2,강변,24872,26446,20200504,51318
20200501,2,구의,14628,13918,20200504,28546
20200501,2,건대입구,28635,31080,20200504,59715
20200501,2,성수,13561,15280,20200504,28841
20200501,2,뚝섬,11129,11603,20200504,22732
20200501,2,한양대,4302,4655,20200504,8957
20200501,2,왕십리,10876,9329,20200504,20205
20200501,2,상왕십리,8290,7666,20200504,15956
20200501,2,신당,9639,9726,20200504,19365
20200501,2,동대문역사문화공원,9562,10528,20200504,20090
20200501,2,을지로4가,7553,7815,20200504,15368
20200501,2,을지로3가,7892,8272,20200504,16164
20200501,2,을지로입구,16847,16500,20200504,33347
20200501,2,시청,6447,5738,20200504,12185
20200502,2,잠실,45826,42912,20200505,88738
20200502,2,잠실새내,12590,13244,20200505,25834
20200502,2,종합운동장,3541,3678,20200505,7219
20200502,2,삼성,20134,20116,20200505,40250
20200502,2,선릉,18267,16419,20200505,34686
20200502,2,역삼,13401,14658,20200505,28059
20200502,2,강남,49717,50389,20200505,100106
20200502,2,교대,13521,14792,20200505,28313
20200502,2,서초,7408,6723,20200505,14131
20200502,2,방배,7804,7802,20200505,15606
20200502,2,사당,23853,26270,20200505,50123
20200502,2,낙성대,16531,15096,20200505,31627
20200502,2,서울대입구,29884,29186,20200505,59070
20200502,2,봉천,13969,12647,20200505,26616
20200502,2,신림,41417,39606,20200505,81023
20200502,2,신대방,16508,15652,20200505,32160
20200502,2,구로디지털단지,28140,27798,20200505,55938
20200502,2,대림,15577,16458,20200505,32035
20200502,2,신도림,32372,32678,20200505,65050
20200502,2,문래,8708,8943,20200505,17651
20200502,2,영등포구청,9668,9817,20200505,19485
20200502,2,당산,10408,11168,20200505,21576
20200502,2,합정,20704,22876,20200505,43580
20200502,2,홍대입구,47806,54534,20200505,102340
20200502,2,신촌,24521,25296,20200505,49817
20200502,2,이대,7146,7286,20200505,14432
20200502,2,아현,5525,5109,20200505,10634
20200502,2,충정로,4376,4470,20200505,8846
20200502,2,용답,1722,1523,20200505,3245
20200502,2,신답,822,779,20200505,1601
20200502,2,신설동,2610,2369,20200505,4979
20200502,2,도림천,698,632,20200505,1330
20200502,2,양천구청,3467,3499,20200505,6966
20200502,2,신정네거리,5243,5328,20200505,10571
20200502,2,용두,1414,1425,20200505,2839
20200502,2,시청,5366,4690,20200505,10056
20200502,2,을지로입구,15801,15077,20200505,30878
20200502,2,을지로3가,6977,7279,20200505,14256
20200502,2,을지로4가,5678,5930,20200505,11608
20200502,2,동대문역사문화공원,8165,8156,20200505,16321
20200502,2,신당,8619,8682,20200505,17301
20200502,2,상왕십리,7335,6833,20200505,14168
20200502,2,왕십리,10389,9057,20200505,19446
20200502,2,한양대,3172,3260,20200505,6432
20200502,2,뚝섬,10087,10467,20200505,20554
20200502,2,성수,12198,14197,20200505,26395
20200502,2,건대입구,27547,31026,20200505,58573
20200502,2,구의,13139,12626,20200505,25765
20200502,2,강변,25884,26126,20200505,52010
20200502,2,잠실나루,5920,5686,20200505,11606
20200503,2,용두,956,1016,20200506,1972
20200503,2,신정네거리,4178,4306,20200506,8484
20200503,2,양천구청,2669,2767,20200506,5436
20200503,2,도림천,330,344,20200506,674
20200503,2,신설동,2502,2470,20200506,4972
20200503,2,신답,609,682,20200506,1291
20200503,2,용답,1409,1456,20200506,2865
20200503,2,충정로,3207,3342,20200506,6549
20200503,2,아현,4176,3973,20200506,8149
20200503,2,이대,5061,5434,20200506,10495
20200503,2,신촌,18607,18827,20200506,37434
20200503,2,홍대입구,38702,39262,20200506,77964
20200503,2,합정,15754,16888,20200506,32642
20200503,2,당산,7668,8296,20200506,15964
20200503,2,영등포구청,6255,6486,20200506,12741
20200503,2,문래,5903,6304,20200506,12207
20200503,2,신도림,23234,23820,20200506,47054
20200503,2,대림,13086,13394,20200506,26480
20200503,2,구로디지털단지,20981,21030,20200506,42011
20200503,2,신대방,13137,13169,20200506,26306
20200503,2,신림,32017,32415,20200506,64432
20200503,2,봉천,10606,10284,20200506,20890
20200503,2,서울대입구,22628,23659,20200506,46287
20200503,2,낙성대,13271,13752,20200506,27023
20200503,2,사당,17782,19873,20200506,37655
20200503,2,방배,5355,5647,20200506,11002
20200503,2,서초,6879,6514,20200506,13393
20200503,2,교대,8424,9415,20200506,17839
20200503,2,강남,31619,30662,20200506,62281
20200503,2,역삼,8299,9154,20200506,17453
20200503,2,선릉,10451,9067,20200506,19518
20200503,2,삼성,14393,14636,20200506,29029
20200503,2,종합운동장,2540,2852,20200506,5392
20200503,2,잠실새내,8678,9202,20200506,17880
20200503,2,잠실,36100,33927,20200506,70027
20200503,2,잠실나루,4268,4343,20200506,8611
20200503,2,강변,22657,20749,20200506,43406
20200503,2,구의,9837,9787,20200506,19624
20200503,2,건대입구,22567,24166,20200506,46733
20200503,2,성수,9134,10512,20200506,19646
20200503,2,뚝섬,7334,7993,20200506,15327
20200503,2,한양대,1969,2239,20200506,4208
20200503,2,왕십리,7698,6851,20200506,14549
20200503,2,상왕십리,5457,5369,20200506,10826
20200503,2,신당,6876,7347,20200506,14223
20200503,2,동대문역사문화공원,6133,7338,20200506,13471
20200503,2,을지로4가,2417,2622,20200506,5039
20200503,2,을지로3가,5442,5153,20200506,10595
20200503,2,을지로입구,12325,11858,20200506,24183
20200503,2,시청,3640,2984,20200506,6624
20200504,2,시청,17575,17680,20200507,35255
20200504,2,을지로입구,31421,31935,20200507,63356
20200504,2,을지로4가,10931,11167,20200507,22098
20200504,2,을지로3가,16523,17106,20200507,33629
20200504,2,용두,1911,2086,20200507,3997
20200504,2,신정네거리,8329,8445,20200507,16774
20200504,2,양천구청,5537,5722,20200507,11259
20200504,2,도림천,1003,1046,20200507,2049
20200504,2,신설동,2771,2629,20200507,5400
20200504,2,신답,1313,1421,20200507,2734
20200504,2,용답,2264,2131,20200507,4395
20200504,2,충정로,8235,8450,20200507,16685
20200504,2,아현,8230,7735,20200507,15965
20200504,2,이대,10141,10631,20200507,20772
20200504,2,신촌,29560,31554,20200507,61114
20200504,2,홍대입구,47186,52986,20200507,100172
20200504,2,합정,25749,28401,20200507,54150
20200504,2,당산,16578,18793,20200507,35371
20200504,2,영등포구청,19165,19853,20200507,39018
20200504,2,문래,16770,17282,20200507,34052
20200504,2,신도림,44751,43923,20200507,88674
20200504,2,대림,22326,22479,20200507,44805
20200504,2,구로디지털단지,48620,48958,20200507,97578
20200504,2,신대방,23534,22249,20200507,45783
20200504,2,신림,56556,54905,20200507,111461
20200504,2,봉천,20776,19176,20200507,39952
20200504,2,서울대입구,41092,40349,20200507,81441
20200504,2,낙성대,22629,21557,20200507,44186
20200504,2,사당,30758,35318,20200507,66076
20200504,2,방배,13414,13540,20200507,26954
20200504,2,서초,15477,15394,20200507,30871
20200504,2,교대,27706,31094,20200507,58800
20200504,2,강남,74360,78135,20200507,152495
20200504,2,역삼,33762,37824,20200507,71586
20200504,2,선릉,43005,38837,20200507,81842
20200504,2,삼성,36103,36745,20200507,72848
20200504,2,종합운동장,5538,5838,20200507,11376
20200504,2,잠실새내,18262,19045,20200507,37307
20200504,2,잠실,56317,54260,20200507,110577
20200504,2,잠실나루,12482,11841,20200507,24323
20200504,2,강변,29659,28438,20200507,58097
20200504,2,구의,20246,19772,20200507,40018
20200504,2,건대입구,32362,36883,20200507,69245
20200504,2,성수,25094,27815,20200507,52909
20200504,2,뚝섬,16016,17348,20200507,33364
20200504,2,한양대,6016,6820,20200507,12836
20200504,2,왕십리,14168,12222,20200507,26390
20200504,2,상왕십리,11371,10791,20200507,22162
20200504,2,신당,12273,12435,20200507,24708
20200504,2,동대문역사문화공원,11106,12339,20200507,23445
20200505,2,신당,7901,8285,20200508,16186
20200505,2,시청,4427,3801,20200508,8228
20200505,2,을지로입구,14277,13757,20200508,28034
20200505,2,을지로3가,5731,5481,20200508,11212
20200505,2,을지로4가,4841,4891,20200508,9732
20200505,2,동대문역사문화공원,7965,8626,20200508,16591
20200505,2,상왕십리,6612,6348,20200508,12960
20200505,2,왕십리,8680,7734,20200508,16414
20200505,2,한양대,2749,3008,20200508,5757
20200505,2,뚝섬,9119,9594,20200508,18713
20200505,2,성수,11335,13050,20200508,24385
20200505,2,건대입구,25479,26799,20200508,52278
20200505,2,구의,11546,11426,20200508,22972
20200505,2,강변,20036,19379,20200508,39415
20200505,2,잠실나루,4916,4933,20200508,9849
20200505,2,잠실,40446,37954,20200508,78400
20200505,2,잠실새내,10480,11258,20200508,21738
20200505,2,종합운동장,2989,3281,20200508,6270
20200505,2,삼성,16777,16769,20200508,33546
20200505,2,선릉,13559,12309,20200508,25868
20200505,2,역삼,11147,12441,20200508,23588
20200505,2,강남,36692,35995,20200508,72687
20200505,2,교대,10236,11208,20200508,21444
20200505,2,서초,5232,4867,20200508,10099
20200505,2,방배,6153,6350,20200508,12503
20200505,2,사당,19366,21294,20200508,40660
20200505,2,낙성대,14287,14530,20200508,28817
20200505,2,서울대입구,26183,26791,20200508,52974
20200505,2,봉천,12235,11941,20200508,24176
20200505,2,신림,35755,35096,20200508,70851
20200505,2,신대방,14831,14453,20200508,29284
20200505,2,구로디지털단지,24516,24693,20200508,49209
20200505,2,대림,13984,14507,20200508,28491
20200505,2,신도림,26142,26296,20200508,52438
20200505,2,문래,6886,7300,20200508,14186
20200505,2,영등포구청,7758,7948,20200508,15706
20200505,2,당산,8802,9619,20200508,18421
20200505,2,합정,17432,18238,20200508,35670
20200505,2,홍대입구,42162,43218,20200508,85380
20200505,2,신촌,19525,19791,20200508,39316
20200505,2,이대,6168,6435,20200508,12603
20200505,2,아현,4823,4744,20200508,9567
20200505,2,충정로,3390,3514,20200508,6904
20200505,2,용답,1483,1496,20200508,2979
20200505,2,신답,725,735,20200508,1460
20200505,2,신설동,1990,1841,20200508,3831
20200505,2,도림천,536,579,20200508,1115
20200505,2,양천구청,2896,2920,20200508,5816
20200505,2,신정네거리,4669,4778,20200508,9447
20200505,2,용두,1231,1262,20200508,2493
20200506,2,을지로3가,21511,21660,20200509,43171
20200506,2,을지로입구,38901,40304,20200509,79205
20200506,2,시청,24261,24599,20200509,48860
20200506,2,을지로4가,13198,13141,20200509,26339
20200506,2,용두,2170,2364,20200509,4534
20200506,2,신정네거리,9653,9951,20200509,19604
20200506,2,양천구청,6740,6990,20200509,13730
20200506,2,도림천,1169,1264,20200509,2433
20200506,2,신설동,3300,3146,20200509,6446
20200506,2,신답,1553,1773,20200509,3326
20200506,2,용답,2477,2355,20200509,4832
20200506,2,충정로,10239,10865,20200509,21104
20200506,2,아현,9325,8991,20200509,18316
20200506,2,이대,11165,11726,20200509,22891
20200506,2,신촌,32155,33791,20200509,65946
20200506,2,홍대입구,48570,51882,20200509,100452
20200506,2,합정,29808,31018,20200509,60826
20200506,2,당산,19950,23103,20200509,43053
20200506,2,영등포구청,23564,24096,20200509,47660
20200506,2,문래,21370,21770,20200509,43140
20200506,2,신도림,49170,48273,20200509,97443
20200506,2,대림,25646,26167,20200509,51813
20200506,2,구로디지털단지,62687,62672,20200509,125359
20200506,2,신대방,26822,25596,20200509,52418
20200506,2,신림,63962,61699,20200509,125661
20200506,2,봉천,24637,22744,20200509,47381
20200506,2,서울대입구,46914,46115,20200509,93029
20200506,2,낙성대,27223,26444,20200509,53667
20200506,2,사당,36417,40519,20200509,76936
20200506,2,방배,17044,17589,20200509,34633
20200506,2,서초,21709,21421,20200509,43130
20200506,2,교대,34881,39415,20200509,74296
20200506,2,강남,89367,90161,20200509,179528
20200506,2,역삼,51463,57577,20200509,109040
20200506,2,선릉,59344,53334,20200509,112678
20200506,2,삼성,52389,53815,20200509,106204
20200506,2,종합운동장,6796,7338,20200509,14134
20200506,2,잠실새내,20697,20737,20200509,41434
20200506,2,잠실,65905,65273,20200509,131178
20200506,2,잠실나루,14922,14493,20200509,29415
20200506,2,강변,32593,31265,20200509,63858
20200506,2,구의,23743,23194,20200509,46937
20200506,2,건대입구,33256,36075,20200509,69331
20200506,2,성수,32471,35770,20200509,68241
20200506,2,뚝섬,19872,21624,20200509,41496
20200506,2,한양대,6972,7895,20200509,14867
20200506,2,왕십리,15128,12575,20200509,27703
20200506,2,상왕십리,13580,13202,20200509,26782
20200506,2,신당,13720,13689,20200509,27409
20200506,2,동대문역사문화공원,11915,13263,20200509,25178
20200507,2,시청,24806,25408,20200510,50214
20200507,2,을지로입구,39757,41099,20200510,80856
20200507,2,을지로3가,21750,22107,20200510,43857
20200507,2,을지로4가,13155,12979,20200510,26134
20200507,2,동대문역사문화공원,11947,13446,20200510,25393
20200507,2,신당,13720,13993,20200510,27713
20200507,2,상왕십리,13729,13238,20200510,26967
20200507,2,왕십리,15760,13050,20200510,28810
20200507,2,한양대,7100,7948,20200510,15048
20200507,2,뚝섬,20047,21726,20200510,41773
20200507,2,성수,32996,36312,20200510,69308
20200507,2,건대입구,34311,37253,20200510,71564
20200507,2,구의,24159,23204,20200510,47363
20200507,2,강변,32718,31994,20200510,64712
20200507,2,잠실나루,15678,15037,20200510,30715
20200507,2,잠실,67215,66501,20200510,133716
20200507,2,잠실새내,20885,20851,20200510,41736
20200507,2,종합운동장,6975,7288,20200510,14263
20200507,2,삼성,52192,53790,20200510,105982
20200507,2,선릉,59693,53999,20200510,113692
20200507,2,역삼,51137,57770,20200510,108907
20200507,2,강남,90788,91500,20200510,182288
20200507,2,교대,35944,41191,20200510,77135
20200507,2,서초,22175,22107,20200510,44282
20200507,2,방배,17405,18023,20200510,35428
20200507,2,사당,37489,41350,20200510,78839
20200507,2,낙성대,27565,26166,20200510,53731
20200507,2,서울대입구,47563,46360,20200510,93923
20200507,2,봉천,24772,22751,20200510,47523
20200507,2,신림,64646,61729,20200510,126375
20200507,2,신대방,26908,25895,20200510,52803
20200507,2,구로디지털단지,62984,63013,20200510,125997
20200507,2,대림,25652,26125,20200510,51777
20200507,2,신도림,49982,48862,20200510,98844
20200507,2,문래,21734,22122,20200510,43856
20200507,2,영등포구청,24145,24514,20200510,48659
20200507,2,당산,20364,23216,20200510,43580
20200507,2,합정,30128,31568,20200510,61696
20200507,2,홍대입구,49960,53197,20200510,103157
20200507,2,신촌,33230,34554,20200510,67784
20200507,2,이대,11450,12025,20200510,23475
20200507,2,아현,9636,8931,20200510,18567
20200507,2,충정로,10361,11015,20200510,21376
20200507,2,용답,2493,2405,20200510,4898
20200507,2,신답,1602,1775,20200510,3377
20200507,2,신설동,3161,3209,20200510,6370
20200507,2,도림천,1128,1225,20200510,2353
20200507,2,양천구청,6850,7067,20200510,13917
20200507,2,신정네거리,9783,10059,20200510,19842
20200507,2,용두,2185,2350,20200510,4535
20200508,2,시청,25698,24401,20200511,50099
20200508,2,을지로입구,41310,40105,20200511,81415
20200508,2,을지로3가,22203,21445,20200511,43648
20200508,2,을지로4가,13168,12740,20200511,25908
20200508,2,동대문역사문화공원,11968,13168,20200511,25136
20200508,2,신당,13998,14297,20200511,28295
20200508,2,상왕십리,14278,13677,20200511,27955
20200508,2,왕십리,16167,13292,20200511,29459
20200508,2,한양대,7469,7617,20200511,15086
20200508,2,뚝섬,20389,21568,20200511,41957
20200508,2,성수,33419,36233,20200511,69652
20200508,2,건대입구,34985,38712,20200511,73697
20200508,2,구의,24398,23708,20200511,48106
20200508,2,강변,38212,36578,20200511,74790
20200508,2,잠실나루,15342,14656,20200511,29998
20200508,2,잠실,68952,68183,20200511,137135
20200508,2,잠실새내,21101,22194,20200511,43295
20200508,2,종합운동장,7396,7611,20200511,15007
20200508,2,삼성,54439,54295,20200511,108734
20200508,2,선릉,59418,52664,20200511,112082
20200508,2,역삼,52679,57152,20200511,109831
20200508,2,강남,92741,93572,20200511,186313
20200508,2,교대,36157,40920,20200511,77077
20200508,2,서초,22451,21756,20200511,44207
20200508,2,방배,17531,18144,20200511,35675
20200508,2,사당,38310,41867,20200511,80177
20200508,2,낙성대,28698,26155,20200511,54853
20200508,2,서울대입구,50119,46968,20200511,97087
20200508,2,봉천,25230,22907,20200511,48137
20200508,2,신림,65837,63117,20200511,128954
20200508,2,신대방,27674,26182,20200511,53856
20200508,2,구로디지털단지,63811,63615,20200511,127426
20200508,2,대림,25924,26206,20200511,52130
20200508,2,신도림,51098,50272,20200511,101370
20200508,2,문래,22023,22328,20200511,44351
20200508,2,영등포구청,24027,23863,20200511,47890
20200508,2,당산,20543,23327,20200511,43870
20200508,2,합정,31105,33055,20200511,64160
20200508,2,홍대입구,51875,56377,20200511,108252
20200508,2,신촌,35131,36251,20200511,71382
20200508,2,이대,12136,12325,20200511,24461
20200508,2,아현,9801,9311,20200511,19112
20200508,2,충정로,10620,11187,20200511,21807
20200508,2,용답,2521,2467,20200511,4988
20200508,2,신답,1605,1929,20200511,3534
20200508,2,신설동,3630,3129,20200511,6759
20200508,2,도림천,1230,1285,20200511,2515
20200508,2,양천구청,6831,7391,20200511,14222
20200508,2,신정네거리,9679,10515,20200511,20194
20200508,2,용두,2556,2566,20200511,5122
20200509,2,서초,11840,10485,20200512,22325
20200509,2,교대,16018,17692,20200512,33710
20200509,2,강남,56045,58417,20200512,114462
20200509,2,역삼,16780,18030,20200512,34810
20200509,2,선릉,22417,19741,20200512,42158
20200509,2,삼성,24116,24518,20200512,48634
20200509,2,종합운동장,3646,4067,20200512,7713
20200509,2,잠실새내,13593,14645,20200512,28238
20200509,2,잠실,47699,45696,20200512,93395
20200509,2,잠실나루,6231,5884,20200512,12115
20200509,2,강변,25452,25305,20200512,50757
20200509,2,구의,13759,13250,20200512,27009
20200509,2,건대입구,26777,30984,20200512,57761
20200509,2,성수,12212,13584,20200512,25796
20200509,2,뚝섬,9034,9261,20200512,18295
20200509,2,한양대,3377,3612,20200512,6989
20200509,2,왕십리,11145,10042,20200512,21187
20200509,2,상왕십리,7831,7191,20200512,15022
20200509,2,신당,8305,8616,20200512,16921
20200509,2,동대문역사문화공원,7563,7706,20200512,15269
20200509,2,을지로4가,5702,5818,20200512,11520
20200509,2,을지로3가,7158,7060,20200512,14218
20200509,2,을지로입구,15513,15711,20200512,31224
20200509,2,시청,5838,5438,20200512,11276
20200509,2,방배,9017,9254,20200512,18271
20200509,2,사당,25629,28740,20200512,54369
20200509,2,낙성대,17586,16249,20200512,33835
20200509,2,서울대입구,31286,30301,20200512,61587
20200509,2,봉천,14791,13758,20200512,28549
20200509,2,신림,42760,41379,20200512,84139
20200509,2,신대방,16477,15738,20200512,32215
20200509,2,구로디지털단지,29382,29242,20200512,58624
20200509,2,대림,15101,16221,20200512,31322
20200509,2,신도림,34747,34740,20200512,69487
20200509,2,문래,9178,9545,20200512,18723
20200509,2,영등포구청,10937,11202,20200512,22139
20200509,2,당산,10056,11168,20200512,21224
20200509,2,합정,21412,23834,20200512,45246
20200509,2,홍대입구,42919,49203,20200512,92122
20200509,2,신촌,25362,26395,20200512,51757
20200509,2,이대,7741,8107,20200512,15848
20200509,2,아현,5688,5419,20200512,11107
20200509,2,충정로,5042,5181,20200512,10223
20200509,2,용답,1590,1543,20200512,3133
20200509,2,신답,791,837,20200512,1628
20200509,2,신설동,1971,1967,20200512,3938
20200509,2,도림천,632,619,20200512,1251
20200509,2,양천구청,3742,3795,20200512,7537
20200509,2,신정네거리,5765,5948,20200512,11713
20200509,2,용두,1255,1334,20200512,2589
20200510,2,아현,4247,4219,20200513,8466
20200510,2,시청,3937,3501,20200513,7438
20200510,2,을지로입구,11877,11693,20200513,23570
20200510,2,을지로3가,5401,5309,20200513,10710
20200510,2,을지로4가,2502,2566,20200513,5068
20200510,2,동대문역사문화공원,6565,7767,20200513,14332
20200510,2,신당,7066,7522,20200513,14588
20200510,2,상왕십리,5787,5774,20200513,11561
20200510,2,왕십리,8288,7309,20200513,15597
20200510,2,한양대,2246,2697,20200513,4943
20200510,2,뚝섬,7665,7950,20200513,15615
20200510,2,성수,9227,10387,20200513,19614
20200510,2,건대입구,23797,24654,20200513,48451
20200510,2,구의,10189,10391,20200513,20580
20200510,2,강변,22255,21093,20200513,43348
20200510,2,잠실나루,4636,4748,20200513,9384
20200510,2,잠실,37902,35227,20200513,73129
20200510,2,잠실새내,9372,10087,20200513,19459
20200510,2,종합운동장,3154,3562,20200513,6716
20200510,2,삼성,15840,15857,20200513,31697
20200510,2,선릉,11654,10059,20200513,21713
20200510,2,역삼,9451,10385,20200513,19836
20200510,2,강남,32837,32355,20200513,65192
20200510,2,교대,9891,10797,20200513,20688
20200510,2,서초,9293,9088,20200513,18381
20200510,2,방배,5998,6417,20200513,12415
20200510,2,사당,20257,22641,20200513,42898
20200510,2,낙성대,13967,14572,20200513,28539
20200510,2,서울대입구,24467,25808,20200513,50275
20200510,2,봉천,11225,10964,20200513,22189
20200510,2,신림,33916,33839,20200513,67755
20200510,2,신대방,13662,13538,20200513,27200
20200510,2,구로디지털단지,21789,21411,20200513,43200
20200510,2,대림,13524,13888,20200513,27412
20200510,2,신도림,25470,25267,20200513,50737
20200510,2,문래,6083,6368,20200513,12451
20200510,2,영등포구청,7056,7393,20200513,14449
20200510,2,당산,7975,8619,20200513,16594
20200510,2,합정,17370,17999,20200513,35369
20200510,2,홍대입구,37728,37595,20200513,75323
20200510,2,신촌,18442,18538,20200513,36980
20200510,2,이대,5470,5756,20200513,11226
20200510,2,충정로,3287,3451,20200513,6738
20200510,2,용답,1392,1441,20200513,2833
20200510,2,신답,635,677,20200513,1312
20200510,2,신설동,2411,2397,20200513,4808
20200510,2,도림천,396,420,20200513,816
20200510,2,양천구청,2812,2955,20200513,5767
20200510,2,신정네거리,4315,4332,20200513,8647
20200510,2,용두,929,955,20200513,1884
20200511,2,시청,23803,23988,20200514,47791
20200511,2,을지로입구,38022,39097,20200514,77119
20200511,2,을지로3가,21038,21120,20200514,42158
20200511,2,을지로4가,12927,12768,20200514,25695
20200511,2,동대문역사문화공원,11270,12444,20200514,23714
20200511,2,신당,13341,13588,20200514,26929
20200511,2,상왕십리,13357,13025,20200514,26382
20200511,2,왕십리,15034,12558,20200514,27592
20200511,2,한양대,7026,7907,20200514,14933
20200511,2,뚝섬,18833,20464,20200514,39297
20200511,2,성수,31608,34898,20200514,66506
20200511,2,건대입구,32347,34660,20200514,67007
20200511,2,구의,23361,23005,20200514,46366
20200511,2,강변,32662,31027,20200514,63689
20200511,2,잠실나루,14463,14098,20200514,28561
20200511,2,잠실,62180,61891,20200514,124071
20200511,2,잠실새내,19920,19899,20200514,39819
20200511,2,종합운동장,6644,7314,20200514,13958
20200511,2,삼성,50455,51905,20200514,102360
20200511,2,선릉,58613,52721,20200514,111334
20200511,2,역삼,51698,57368,20200514,109066
20200511,2,강남,85052,85563,20200514,170615
20200511,2,교대,34956,39386,20200514,74342
20200511,2,서초,21723,21623,20200514,43346
20200511,2,방배,17156,17690,20200514,34846
20200511,2,사당,35857,39534,20200514,75391
20200511,2,낙성대,26430,25896,20200514,52326
20200511,2,서울대입구,46230,45279,20200514,91509
20200511,2,봉천,24181,22538,20200514,46719
20200511,2,신림,62800,60447,20200514,123247
20200511,2,신대방,26411,25382,20200514,51793
20200511,2,구로디지털단지,62056,62482,20200514,124538
20200511,2,대림,25482,25894,20200514,51376
20200511,2,신도림,48314,47086,20200514,95400
20200511,2,문래,21360,21659,20200514,43019
20200511,2,영등포구청,22101,22663,20200514,44764
20200511,2,당산,19581,22672,20200514,42253
20200511,2,합정,28114,29261,20200514,57375
20200511,2,홍대입구,44082,46622,20200514,90704
20200511,2,신촌,30804,31729,20200514,62533
20200511,2,이대,11209,11762,20200514,22971
20200511,2,아현,9401,9046,20200514,18447
20200511,2,충정로,10286,10929,20200514,21215
20200511,2,용답,2446,2376,20200514,4822
20200511,2,신답,1561,1807,20200514,3368
20200511,2,신설동,3138,3009,20200514,6147
20200511,2,도림천,1163,1247,20200514,2410
20200511,2,양천구청,6734,6975,20200514,13709
20200511,2,신정네거리,9583,10062,20200514,19645
20200511,2,용두,2201,2347,20200514,4548
20200512,2,시청,24275,24464,20200515,48739
20200512,2,을지로입구,38779,39789,20200515,78568
20200512,2,을지로3가,21215,21215,20200515,42430
20200512,2,을지로4가,13045,12835,20200515,25880
20200512,2,동대문역사문화공원,11354,12687,20200515,24041
20200512,2,신당,13495,13732,20200515,27227
20200512,2,상왕십리,13401,13058,20200515,26459
20200512,2,왕십리,15129,12639,20200515,27768
20200512,2,한양대,7105,7997,20200515,15102
20200512,2,뚝섬,19537,21188,20200515,40725
20200512,2,성수,32371,35471,20200515,67842
20200512,2,건대입구,32208,34936,20200515,67144
20200512,2,구의,23594,22916,20200515,46510
20200512,2,강변,30342,29316,20200515,59658
20200512,2,잠실나루,14934,14332,20200515,29266
20200512,2,잠실,62522,62208,20200515,124730
20200512,2,잠실새내,19603,19593,20200515,39196
20200512,2,종합운동장,6830,7443,20200515,14273
20200512,2,삼성,50365,51621,20200515,101986
20200512,2,선릉,58312,52017,20200515,110329
20200512,2,역삼,51638,56842,20200515,108480
20200512,2,강남,85863,85711,20200515,171574
20200512,2,교대,35526,39950,20200515,75476
20200512,2,서초,21764,21828,20200515,43592
20200512,2,방배,17000,17659,20200515,34659
20200512,2,사당,36352,40118,20200515,76470
20200512,2,낙성대,26516,25847,20200515,52363
20200512,2,서울대입구,46074,44904,20200515,90978
20200512,2,봉천,24130,22332,20200515,46462
20200512,2,신림,62288,59837,20200515,122125
20200512,2,신대방,26181,25179,20200515,51360
20200512,2,구로디지털단지,61655,62003,20200515,123658
20200512,2,대림,24992,25371,20200515,50363
20200512,2,신도림,46952,45703,20200515,92655
20200512,2,문래,21213,21621,20200515,42834
20200512,2,영등포구청,22691,23108,20200515,45799
20200512,2,당산,19718,22791,20200515,42509
20200512,2,합정,28921,30029,20200515,58950
20200512,2,홍대입구,44383,46527,20200515,90910
20200512,2,신촌,30358,31431,20200515,61789
20200512,2,이대,11151,11628,20200515,22779
20200512,2,아현,9274,8920,20200515,18194
20200512,2,충정로,10147,10815,20200515,20962
20200512,2,용답,2414,2404,20200515,4818
20200512,2,신답,1559,1766,20200515,3325
20200512,2,신설동,3013,2941,20200515,5954
20200512,2,도림천,1176,1247,20200515,2423
20200512,2,양천구청,6557,6960,20200515,13517
20200512,2,신정네거리,9398,9884,20200515,19282
20200512,2,용두,2182,2357,20200515,4539
20200513,2,아현,9443,8983,20200516,18426
20200513,2,시청,24248,24474,20200516,48722
20200513,2,을지로입구,38346,39854,20200516,78200
20200513,2,을지로3가,21504,21552,20200516,43056
20200513,2,을지로4가,13132,12815,20200516,25947
20200513,2,동대문역사문화공원,11427,12802,20200516,24229
20200513,2,신당,13490,13712,20200516,27202
20200513,2,상왕십리,13523,12902,20200516,26425
20200513,2,왕십리,15569,12962,20200516,28531
20200513,2,한양대,7161,7904,20200516,15065
20200513,2,뚝섬,19741,21448,20200516,41189
20200513,2,성수,32558,36021,20200516,68579
20200513,2,건대입구,32678,35235,20200516,67913
20200513,2,구의,23577,22902,20200516,46479
20200513,2,강변,31118,30052,20200516,61170
20200513,2,잠실나루,14527,14077,20200516,28604
20200513,2,잠실,64030,63401,20200516,127431
20200513,2,잠실새내,19840,19991,20200516,39831
20200513,2,종합운동장,6861,7564,20200516,14425
20200513,2,삼성,50687,51799,20200516,102486
20200513,2,선릉,58912,52444,20200516,111356
20200513,2,역삼,51049,56752,20200516,107801
20200513,2,강남,85666,85992,20200516,171658
20200513,2,교대,35650,40593,20200516,76243
20200513,2,서초,22409,22266,20200516,44675
20200513,2,방배,17407,17863,20200516,35270
20200513,2,사당,36736,40174,20200516,76910
20200513,2,낙성대,26914,25779,20200516,52693
20200513,2,서울대입구,46409,45435,20200516,91844
20200513,2,봉천,24333,22498,20200516,46831
20200513,2,신림,62952,60703,20200516,123655
20200513,2,신대방,26375,25448,20200516,51823
20200513,2,구로디지털단지,61688,61534,20200516,123222
20200513,2,대림,24785,25060,20200516,49845
20200513,2,신도림,49190,48293,20200516,97483
20200513,2,문래,21315,21880,20200516,43195
20200513,2,영등포구청,22883,23227,20200516,46110
20200513,2,당산,20084,23359,20200516,43443
20200513,2,합정,29076,30318,20200516,59394
20200513,2,홍대입구,42866,44553,20200516,87419
20200513,2,신촌,30978,32392,20200516,63370
20200513,2,이대,11509,11929,20200516,23438
20200513,2,충정로,10299,10827,20200516,21126
20200513,2,용답,2417,2398,20200516,4815
20200513,2,신답,1508,1758,20200516,3266
20200513,2,신설동,3106,3142,20200516,6248
20200513,2,도림천,1155,1229,20200516,2384
20200513,2,양천구청,6599,7025,20200516,13624
20200513,2,신정네거리,9450,9984,20200516,19434
20200513,2,용두,2296,2336,20200516,4632
20200514,2,신대방,26239,25225,20200517,51464
20200514,2,신림,62741,59649,20200517,122390
20200514,2,봉천,24199,22295,20200517,46494
20200514,2,서울대입구,46571,44963,20200517,91534
20200514,2,낙성대,26920,25778,20200517,52698
20200514,2,사당,36353,40199,20200517,76552
20200514,2,방배,17371,17844,20200517,35215
20200514,2,서초,21190,21423,20200517,42613
20200514,2,교대,34907,39580,20200517,74487
20200514,2,강남,85210,85460,20200517,170670
20200514,2,역삼,50348,56475,20200517,106823
20200514,2,선릉,58036,52252,20200517,110288
20200514,2,삼성,48698,50441,20200517,99139
20200514,2,종합운동장,6804,7653,20200517,14457
20200514,2,잠실새내,19610,19863,20200517,39473
20200514,2,잠실,63003,62412,20200517,125415
20200514,2,잠실나루,14698,14186,20200517,28884
20200514,2,강변,31393,30859,20200517,62252
20200514,2,구의,23403,22712,20200517,46115
20200514,2,건대입구,32392,35105,20200517,67497
20200514,2,성수,32264,36124,20200517,68388
20200514,2,뚝섬,19553,21287,20200517,40840
20200514,2,한양대,6927,7765,20200517,14692
20200514,2,왕십리,15412,12799,20200517,28211
20200514,2,상왕십리,13350,12816,20200517,26166
20200514,2,신당,13274,13460,20200517,26734
20200514,2,동대문역사문화공원,11125,12454,20200517,23579
20200514,2,을지로4가,12694,12777,20200517,25471
20200514,2,을지로3가,20675,20969,20200517,41644
20200514,2,을지로입구,37686,39251,20200517,76937
20200514,2,시청,23670,24081,20200517,47751
20200514,2,용두,2165,2311,20200517,4476
20200514,2,신정네거리,9131,9579,20200517,18710
20200514,2,양천구청,6520,6878,20200517,13398
20200514,2,도림천,1092,1165,20200517,2257
20200514,2,신설동,3069,3048,20200517,6117
20200514,2,신답,1539,1764,20200517,3303
20200514,2,용답,2442,2357,20200517,4799
20200514,2,충정로,10198,10823,20200517,21021
20200514,2,아현,9407,8863,20200517,18270
20200514,2,이대,11283,11744,20200517,23027
20200514,2,신촌,30031,30852,20200517,60883
20200514,2,홍대입구,40427,41614,20200517,82041
20200514,2,합정,28415,29692,20200517,58107
20200514,2,당산,20030,22967,20200517,42997
20200514,2,영등포구청,22584,23049,20200517,45633
20200514,2,문래,21197,21818,20200517,43015
20200514,2,신도림,48413,47346,20200517,95759
20200514,2,대림,24789,25161,20200517,49950
20200514,2,구로디지털단지,61107,60960,20200517,122067
20200515,2,용두,2192,2286,20200518,4478
20200515,2,신정네거리,8949,9668,20200518,18617
20200515,2,양천구청,6439,6905,20200518,13344
20200515,2,도림천,1155,1213,20200518,2368
20200515,2,신설동,3316,3189,20200518,6505
20200515,2,신답,1515,1747,20200518,3262
20200515,2,용답,2402,2298,20200518,4700
20200515,2,충정로,10263,10683,20200518,20946
20200515,2,아현,9140,8622,20200518,17762
20200515,2,이대,11445,11738,20200518,23183
20200515,2,신촌,30229,31328,20200518,61557
20200515,2,홍대입구,39483,41449,20200518,80932
20200515,2,합정,28358,30207,20200518,58565
20200515,2,당산,18827,22118,20200518,40945
20200515,2,영등포구청,22447,22747,20200518,45194
20200515,2,문래,20999,21781,20200518,42780
20200515,2,신도림,48636,47780,20200518,96416
20200515,2,대림,23548,24092,20200518,47640
20200515,2,구로디지털단지,60419,60539,20200518,120958
20200515,2,신대방,25399,24197,20200518,49596
20200515,2,신림,62643,60113,20200518,122756
20200515,2,봉천,23806,21592,20200518,45398
20200515,2,서울대입구,47303,45038,20200518,92341
20200515,2,낙성대,27040,25110,20200518,52150
20200515,2,사당,37226,41461,20200518,78687
20200515,2,방배,17123,17631,20200518,34754
20200515,2,서초,21411,21053,20200518,42464
20200515,2,교대,34472,39489,20200518,73961
20200515,2,강남,86958,89107,20200518,176065
20200515,2,역삼,51231,55774,20200518,107005
20200515,2,선릉,57365,51223,20200518,108588
20200515,2,삼성,49671,50844,20200518,100515
20200515,2,종합운동장,7073,7117,20200518,14190
20200515,2,잠실새내,20208,20820,20200518,41028
20200515,2,잠실,63076,62639,20200518,125715
20200515,2,잠실나루,14288,13591,20200518,27879
20200515,2,강변,33372,32782,20200518,66154
20200515,2,구의,23259,22651,20200518,45910
20200515,2,건대입구,32198,36209,20200518,68407
20200515,2,성수,32370,35703,20200518,68073
20200515,2,뚝섬,19115,20597,20200518,39712
20200515,2,한양대,5965,6298,20200518,12263
20200515,2,왕십리,15605,13628,20200518,29233
20200515,2,상왕십리,13441,12919,20200518,26360
20200515,2,신당,13118,13361,20200518,26479
20200515,2,동대문역사문화공원,10800,12138,20200518,22938
20200515,2,을지로4가,12369,12304,20200518,24673
20200515,2,을지로3가,20684,20817,20200518,41501
20200515,2,을지로입구,37006,37732,20200518,74738
20200515,2,시청,24118,23614,20200518,47732
20200516,2,시청,6156,5781,20200519,11937
20200516,2,을지로입구,15916,16020,20200519,31936
20200516,2,을지로3가,7656,7978,20200519,15634
20200516,2,을지로4가,6326,6530,20200519,12856
20200516,2,동대문역사문화공원,8537,8897,20200519,17434
20200516,2,신당,9509,9755,20200519,19264
20200516,2,상왕십리,8336,7526,20200519,15862
20200516,2,왕십리,12346,10833,20200519,23179
20200516,2,한양대,3660,3741,20200519,7401
20200516,2,뚝섬,10693,11185,20200519,21878
20200516,2,성수,14337,16734,20200519,31071
20200516,2,건대입구,28321,31598,20200519,59919
20200516,2,구의,14746,14221,20200519,28967
20200516,2,강변,25353,25758,20200519,51111
20200516,2,잠실나루,6510,6239,20200519,12749
20200516,2,잠실,47889,45110,20200519,92999
20200516,2,잠실새내,14002,14996,20200519,28998
20200516,2,종합운동장,4489,4874,20200519,9363
20200516,2,삼성,22591,22922,20200519,45513
20200516,2,선릉,23544,20853,20200519,44397
20200516,2,역삼,16715,18101,20200519,34816
20200516,2,강남,54304,55927,20200519,110231
20200516,2,교대,16535,18472,20200519,35007
20200516,2,서초,10785,10021,20200519,20806
20200516,2,방배,9140,9340,20200519,18480
20200516,2,사당,27353,30854,20200519,58207
20200516,2,낙성대,19284,17685,20200519,36969
20200516,2,서울대입구,34460,33695,20200519,68155
20200516,2,봉천,15872,14350,20200519,30222
20200516,2,신림,45918,43577,20200519,89495
20200516,2,신대방,17998,16979,20200519,34977
20200516,2,구로디지털단지,31014,30792,20200519,61806
20200516,2,대림,16690,17528,20200519,34218
20200516,2,신도림,37775,38032,20200519,75807
20200516,2,문래,10500,11159,20200519,21659
20200516,2,영등포구청,11099,11744,20200519,22843
20200516,2,당산,11565,12677,20200519,24242
20200516,2,합정,20479,22200,20200519,42679
20200516,2,홍대입구,32835,34521,20200519,67356
20200516,2,신촌,22510,23306,20200519,45816
20200516,2,이대,8307,8433,20200519,16740
20200516,2,아현,6114,5744,20200519,11858
20200516,2,충정로,5253,5610,20200519,10863
20200516,2,용답,1867,1683,20200519,3550
20200516,2,신답,901,866,20200519,1767
20200516,2,신설동,2589,2555,20200519,5144
20200516,2,도림천,725,697,20200519,1422
20200516,2,양천구청,4003,3985,20200519,7988
20200516,2,신정네거리,5976,5962,20200519,11938
20200516,2,용두,1513,1529,20200519,3042
20200517,2,용두,1059,1049,20200520,2108
20200517,2,신정네거리,4203,4285,20200520,8488
20200517,2,양천구청,3383,3421,20200520,6804
20200517,2,도림천,411,380,20200520,791
20200517,2,신설동,2696,2566,20200520,5262
20200517,2,신답,711,699,20200520,1410
20200517,2,용답,1437,1411,20200520,2848
20200517,2,충정로,3257,3480,20200520,6737
20200517,2,아현,4395,4155,20200520,8550
20200517,2,이대,5338,5684,20200520,11022
20200517,2,신촌,16342,16636,20200520,32978
20200517,2,홍대입구,25617,25017,20200520,50634
20200517,2,합정,15806,16360,20200520,32166
20200517,2,당산,8357,9148,20200520,17505
20200517,2,영등포구청,7199,7478,20200520,14677
20200517,2,문래,6871,7257,20200520,14128
20200517,2,신도림,26229,26053,20200520,52282
20200517,2,대림,13753,14023,20200520,27776
20200517,2,구로디지털단지,21415,20833,20200520,42248
20200517,2,신대방,13759,13304,20200520,27063
20200517,2,신림,34059,33219,20200520,67278
20200517,2,봉천,11150,10646,20200520,21796
20200517,2,서울대입구,25501,26005,20200520,51506
20200517,2,낙성대,14300,14365,20200520,28665
20200517,2,사당,19806,21809,20200520,41615
20200517,2,방배,5935,6199,20200520,12134
20200517,2,서초,9829,9582,20200520,19411
20200517,2,교대,9714,10872,20200520,20586
20200517,2,강남,31463,31048,20200520,62511
20200517,2,역삼,9244,10212,20200520,19456
20200517,2,선릉,11846,10395,20200520,22241
20200517,2,삼성,15886,15867,20200520,31753
20200517,2,종합운동장,3346,3830,20200520,7176
20200517,2,잠실새내,9094,9681,20200520,18775
20200517,2,잠실,36176,33820,20200520,69996
20200517,2,잠실나루,4441,4520,20200520,8961
20200517,2,강변,20249,20512,20200520,40761
20200517,2,구의,10330,10049,20200520,20379
20200517,2,건대입구,22032,22904,20200520,44936
20200517,2,성수,9670,11240,20200520,20910
20200517,2,뚝섬,7791,8106,20200520,15897
20200517,2,한양대,2263,2603,20200520,4866
20200517,2,왕십리,8635,7508,20200520,16143
20200517,2,상왕십리,5834,5643,20200520,11477
20200517,2,신당,7454,7818,20200520,15272
20200517,2,동대문역사문화공원,6454,7904,20200520,14358
20200517,2,을지로4가,2646,2604,20200520,5250
20200517,2,을지로3가,5228,5087,20200520,10315
20200517,2,을지로입구,12031,11795,20200520,23826
20200517,2,시청,3945,3636,20200520,7581
20200518,2,용두,2233,2317,20200521,4550
20200518,2,신정네거리,9152,9644,20200521,18796
20200518,2,양천구청,6348,6863,20200521,13211
20200518,2,도림천,1178,1272,20200521,2450
20200518,2,신설동,3425,3134,20200521,6559
20200518,2,신답,1523,1826,20200521,3349
20200518,2,용답,2366,2330,20200521,4696
20200518,2,충정로,9925,10587,20200521,20512
20200518,2,아현,8931,8900,20200521,17831
20200518,2,이대,10725,11387,20200521,22112
20200518,2,신촌,28764,29694,20200521,58458
20200518,2,홍대입구,36736,37459,20200521,74195
20200518,2,합정,26098,26940,20200521,53038
20200518,2,당산,18029,21039,20200521,39068
20200518,2,영등포구청,22346,22680,20200521,45026
20200518,2,문래,20476,20907,20200521,41383
20200518,2,신도림,46728,45118,20200521,91846
20200518,2,대림,24476,24841,20200521,49317
20200518,2,구로디지털단지,59822,60157,20200521,119979
20200518,2,신대방,25614,24667,20200521,50281
20200518,2,신림,59926,58179,20200521,118105
20200518,2,봉천,23494,22134,20200521,45628
20200518,2,서울대입구,44231,42996,20200521,87227
20200518,2,낙성대,25368,24948,20200521,50316
20200518,2,사당,33166,36352,20200521,69518
20200518,2,방배,16064,16896,20200521,32960
20200518,2,서초,21175,20928,20200521,42103
20200518,2,교대,33324,37642,20200521,70966
20200518,2,강남,82693,81923,20200521,164616
20200518,2,역삼,51599,55365,20200521,106964
20200518,2,선릉,57564,51451,20200521,109015
20200518,2,삼성,49067,49644,20200521,98711
20200518,2,종합운동장,6257,7533,20200521,13790
20200518,2,잠실새내,19186,19310,20200521,38496
20200518,2,잠실,58039,57359,20200521,115398
20200518,2,잠실나루,13814,13612,20200521,27426
20200518,2,강변,30588,29691,20200521,60279
20200518,2,구의,22661,22521,20200521,45182
20200518,2,건대입구,29461,31128,20200521,60589
20200518,2,성수,32172,34632,20200521,66804
20200518,2,뚝섬,18655,19877,20200521,38532
20200518,2,한양대,7104,7677,20200521,14781
20200518,2,왕십리,14421,12089,20200521,26510
20200518,2,상왕십리,13026,12871,20200521,25897
20200518,2,신당,12890,13188,20200521,26078
20200518,2,동대문역사문화공원,10585,11915,20200521,22500
20200518,2,을지로4가,12886,12538,20200521,25424
20200518,2,을지로3가,20664,20082,20200521,40746
20200518,2,을지로입구,36436,36661,20200521,73097
20200518,2,시청,24014,23253,20200521,47267
20200519,2,시청,23735,23964,20200522,47699
20200519,2,을지로입구,36459,37588,20200522,74047
20200519,2,을지로3가,20642,20902,20200522,41544
20200519,2,을지로4가,12634,12491,20200522,25125
20200519,2,동대문역사문화공원,11022,12079,20200522,23101
20200519,2,신당,13108,13412,20200522,26520
20200519,2,상왕십리,13297,12776,20200522,26073
20200519,2,왕십리,14946,12518,20200522,27464
20200519,2,한양대,7102,7900,20200522,15002
20200519,2,뚝섬,18979,20585,20200522,39564
20200519,2,문래,21071,21345,20200522,42416
20200519,2,영등포구청,22452,22883,20200522,45335
20200519,2,당산,18902,21892,20200522,40794
20200519,2,합정,27553,28657,20200522,56210
20200519,2,홍대입구,38355,39776,20200522,78131
20200519,2,신촌,29067,30284,20200522,59351
20200519,2,이대,10904,11329,20200522,22233
20200519,2,아현,8982,8689,20200522,17671
20200519,2,용두,2195,2258,20200522,4453
20200519,2,신정네거리,9071,9438,20200522,18509
20200519,2,양천구청,6544,6766,20200522,13310
20200519,2,도림천,1144,1205,20200522,2349
20200519,2,신설동,3077,3176,20200522,6253
20200519,2,신답,1560,1782,20200522,3342
20200519,2,용답,2353,2345,20200522,4698
20200519,2,충정로,10122,10603,20200522,20725
20200519,2,성수,32296,35821,20200522,68117
20200519,2,건대입구,31092,33314,20200522,64406
20200519,2,구의,23188,22634,20200522,45822
20200519,2,강변,29508,28749,20200522,58257
20200519,2,잠실나루,14432,13891,20200522,28323
20200519,2,잠실,60125,60085,20200522,120210
20200519,2,잠실새내,19556,19401,20200522,38957
20200519,2,종합운동장,6520,6970,20200522,13490
20200519,2,삼성,49263,50872,20200522,100135
20200519,2,선릉,58168,51933,20200522,110101
20200519,2,역삼,50869,55851,20200522,106720
20200519,2,강남,84751,84614,20200522,169365
20200519,2,교대,34440,38974,20200522,73414
20200519,2,서초,21455,21518,20200522,42973
20200519,2,방배,16892,17532,20200522,34424
20200519,2,사당,35217,38756,20200522,73973
20200519,2,낙성대,26214,25158,20200522,51372
20200519,2,서울대입구,45202,44226,20200522,89428
20200519,2,봉천,23908,22067,20200522,45975
20200519,2,신림,61798,59163,20200522,120961
20200519,2,신대방,25570,24528,20200522,50098
20200519,2,구로디지털단지,60507,60792,20200522,121299
20200519,2,대림,24630,24902,20200522,49532
20200519,2,신도림,47538,46603,20200522,94141
20200520,2,용두,2463,2554,20200523,5017
20200520,2,신정네거리,9703,10167,20200523,19870
20200520,2,양천구청,6839,7118,20200523,13957
20200520,2,도림천,1249,1344,20200523,2593
20200520,2,신설동,3251,3178,20200523,6429
20200520,2,신답,1665,1813,20200523,3478
20200520,2,용답,2521,2427,20200523,4948
20200520,2,충정로,10503,11092,20200523,21595
20200520,2,아현,9951,9557,20200523,19508
20200520,2,이대,11578,11998,20200523,23576
20200520,2,신촌,30948,32135,20200523,63083
20200520,2,홍대입구,41893,43706,20200523,85599
20200520,2,합정,29175,30684,20200523,59859
20200520,2,당산,20298,23278,20200523,43576
20200520,2,영등포구청,22902,23290,20200523,46192
20200520,2,문래,21282,21759,20200523,43041
20200520,2,신도림,50060,49217,20200523,99277
20200520,2,대림,25727,26046,20200523,51773
20200520,2,구로디지털단지,62315,62445,20200523,124760
20200520,2,신대방,26915,25715,20200523,52630
20200520,2,신림,63995,61668,20200523,125663
20200520,2,봉천,24870,23017,20200523,47887
20200520,2,서울대입구,47993,46898,20200523,94891
20200520,2,낙성대,27429,26294,20200523,53723
20200520,2,사당,37651,41178,20200523,78829
20200520,2,방배,17308,17772,20200523,35080
20200520,2,서초,22407,22365,20200523,44772
20200520,2,교대,35830,40742,20200523,76572
20200520,2,강남,87805,83990,20200523,171795
20200520,2,역삼,51463,57391,20200523,108854
20200520,2,선릉,59231,53076,20200523,112307
20200520,2,삼성,50999,52340,20200523,103339
20200520,2,종합운동장,7362,7645,20200523,15007
20200520,2,잠실새내,20348,20616,20200523,40964
20200520,2,잠실,65418,64577,20200523,129995
20200520,2,잠실나루,15013,14526,20200523,29539
20200520,2,강변,31093,30502,20200523,61595
20200520,2,구의,23974,23367,20200523,47341
20200520,2,건대입구,33320,35749,20200523,69069
20200520,2,성수,33822,37410,20200523,71232
20200520,2,뚝섬,20385,22064,20200523,42449
20200520,2,한양대,7293,8157,20200523,15450
20200520,2,왕십리,16096,13472,20200523,29568
20200520,2,상왕십리,13690,13355,20200523,27045
20200520,2,신당,13878,14191,20200523,28069
20200520,2,동대문역사문화공원,12116,13507,20200523,25623
20200520,2,을지로4가,13294,13349,20200523,26643
20200520,2,을지로3가,21662,21561,20200523,43223
20200520,2,을지로입구,38697,39549,20200523,78246
20200520,2,시청,24364,24377,20200523,48741
20200521,2,용두,2318,2381,20200524,4699
20200521,2,신정네거리,9399,9857,20200524,19256
20200521,2,양천구청,6742,7060,20200524,13802
20200521,2,도림천,1229,1316,20200524,2545
20200521,2,신설동,3253,3177,20200524,6430
20200521,2,신답,1640,1779,20200524,3419
20200521,2,용답,2485,2478,20200524,4963
20200521,2,충정로,10451,11107,20200524,21558
20200521,2,아현,10021,9409,20200524,19430
20200521,2,이대,11425,11892,20200524,23317
20200521,2,신촌,30849,32031,20200524,62880
20200521,2,홍대입구,42376,44156,20200524,86532
20200521,2,합정,29140,30604,20200524,59744
20200521,2,당산,20332,23301,20200524,43633
20200521,2,영등포구청,22776,23151,20200524,45927
20200521,2,문래,21574,22306,20200524,43880
20200521,2,신도림,49653,48625,20200524,98278
20200521,2,대림,25188,25411,20200524,50599
20200521,2,구로디지털단지,62012,61992,20200524,124004
20200521,2,신대방,26683,25663,20200524,52346
20200521,2,신림,64069,61319,20200524,125388
20200521,2,봉천,24853,22638,20200524,47491
20200521,2,서울대입구,47858,46563,20200524,94421
20200521,2,낙성대,27130,25955,20200524,53085
20200521,2,사당,37544,41341,20200524,78885
20200521,2,방배,17240,17729,20200524,34969
20200521,2,서초,22129,22018,20200524,44147
20200521,2,교대,35893,41074,20200524,76967
20200521,2,강남,87112,83722,20200524,170834
20200521,2,역삼,51020,57200,20200524,108220
20200521,2,선릉,59367,53483,20200524,112850
20200521,2,삼성,50949,52413,20200524,103362
20200521,2,종합운동장,7108,7881,20200524,14989
20200521,2,잠실새내,20677,20751,20200524,41428
20200521,2,잠실,64587,64119,20200524,128706
20200521,2,잠실나루,15132,14637,20200524,29769
20200521,2,강변,31912,32385,20200524,64297
20200521,2,구의,24174,23331,20200524,47505
20200521,2,건대입구,33033,35374,20200524,68407
20200521,2,성수,33299,36912,20200524,70211
20200521,2,뚝섬,20149,21874,20200524,42023
20200521,2,한양대,7239,8193,20200524,15432
20200521,2,왕십리,16284,13432,20200524,29716
20200521,2,상왕십리,13717,13153,20200524,26870
20200521,2,신당,13609,13750,20200524,27359
20200521,2,동대문역사문화공원,11950,13389,20200524,25339
20200521,2,을지로4가,13569,13316,20200524,26885
20200521,2,을지로3가,21279,21445,20200524,42724
20200521,2,을지로입구,37801,38934,20200524,76735
20200521,2,시청,23939,24400,20200524,48339
20200522,2,시청,24016,24000,20200525,48016
20200522,2,을지로입구,38633,39579,20200525,78212
20200522,2,을지로3가,21402,22046,20200525,43448
20200522,2,을지로4가,13482,13386,20200525,26868
20200522,2,동대문역사문화공원,12107,13819,20200525,25926
20200522,2,신당,14072,14408,20200525,28480
20200522,2,상왕십리,13930,13158,20200525,27088
20200522,2,왕십리,17141,14787,20200525,31928
20200522,2,한양대,7293,7961,20200525,15254
20200522,2,뚝섬,20512,22138,20200525,42650
20200522,2,성수,33213,37144,20200525,70357
20200522,2,건대입구,35062,39752,20200525,74814
20200522,2,구의,24176,23517,20200525,47693
20200522,2,강변,35774,35220,20200525,70994
20200522,2,잠실나루,15148,14474,20200525,29622
20200522,2,잠실,67701,66571,20200525,134272
20200522,2,잠실새내,21389,22841,20200525,44230
20200522,2,종합운동장,7497,7737,20200525,15234
20200522,2,삼성,53493,54910,20200525,108403
20200522,2,선릉,58804,52650,20200525,111454
20200522,2,역삼,50592,56690,20200525,107282
20200522,2,강남,90433,87627,20200525,178060
20200522,2,교대,36142,41417,20200525,77559
20200522,2,서초,21681,21616,20200525,43297
20200522,2,방배,17549,17978,20200525,35527
20200522,2,사당,39855,44826,20200525,84681
20200522,2,낙성대,28267,25845,20200525,54112
20200522,2,서울대입구,50230,48122,20200525,98352
20200522,2,봉천,25077,22641,20200525,47718
20200522,2,신림,65604,62815,20200525,128419
20200522,2,신대방,26983,25470,20200525,52453
20200522,2,구로디지털단지,62872,62508,20200525,125380
20200522,2,대림,25465,25958,20200525,51423
20200522,2,신도림,51215,50770,20200525,101985
20200522,2,문래,21368,22541,20200525,43909
20200522,2,영등포구청,22513,23068,20200525,45581
20200522,2,당산,20424,23403,20200525,43827
20200522,2,합정,30881,33280,20200525,64161
20200522,2,홍대입구,44809,48032,20200525,92841
20200522,2,신촌,32260,33736,20200525,65996
20200522,2,이대,11905,12176,20200525,24081
20200522,2,아현,10148,9341,20200525,19489
20200522,2,충정로,10340,11031,20200525,21371
20200522,2,용답,2589,2445,20200525,5034
20200522,2,신답,1622,1751,20200525,3373
20200522,2,신설동,3342,3281,20200525,6623
20200522,2,도림천,1194,1287,20200525,2481
20200522,2,양천구청,6822,7106,20200525,13928
20200522,2,신정네거리,9646,10098,20200525,19744
20200522,2,용두,2342,2394,20200525,4736
20200523,2,아현,6723,6309,20200526,13032
20200523,2,시청,7316,6600,20200526,13916
20200523,2,을지로입구,18679,18145,20200526,36824
20200523,2,을지로3가,8624,9037,20200526,17661
20200523,2,을지로4가,7158,7370,20200526,14528
20200523,2,동대문역사문화공원,9989,10365,20200526,20354
20200523,2,신당,10395,10476,20200526,20871
20200523,2,상왕십리,9009,8122,20200526,17131
20200523,2,왕십리,13008,11310,20200526,24318
20200523,2,한양대,4026,4147,20200526,8173
20200523,2,뚝섬,12912,13707,20200526,26619
20200523,2,성수,15894,18191,20200526,34085
20200523,2,건대입구,30582,34355,20200526,64937
20200523,2,구의,15808,15203,20200526,31011
20200523,2,강변,27831,28152,20200526,55983
20200523,2,잠실나루,7318,7098,20200526,14416
20200523,2,잠실,53116,50293,20200526,103409
20200523,2,잠실새내,15603,16739,20200526,32342
20200523,2,종합운동장,4880,5516,20200526,10396
20200523,2,삼성,25633,26218,20200526,51851
20200523,2,선릉,25347,22786,20200526,48133
20200523,2,역삼,17976,19613,20200526,37589
20200523,2,강남,57581,55094,20200526,112675
20200523,2,교대,17887,20001,20200526,37888
20200523,2,서초,12393,12043,20200526,24436
20200523,2,방배,9937,10160,20200526,20097
20200523,2,사당,30522,34249,20200526,64771
20200523,2,낙성대,21077,19040,20200526,40117
20200523,2,서울대입구,37588,36681,20200526,74269
20200523,2,봉천,17323,15743,20200526,33066
20200523,2,신림,49228,46660,20200526,95888
20200523,2,신대방,19234,18437,20200526,37671
20200523,2,구로디지털단지,33125,32560,20200526,65685
20200523,2,대림,18070,18956,20200526,37026
20200523,2,신도림,40353,40861,20200526,81214
20200523,2,문래,11167,11891,20200526,23058
20200523,2,영등포구청,12156,12673,20200526,24829
20200523,2,당산,12935,14100,20200526,27035
20200523,2,합정,23399,25734,20200526,49133
20200523,2,홍대입구,39978,42823,20200526,82801
20200523,2,신촌,25963,26643,20200526,52606
20200523,2,이대,8819,9183,20200526,18002
20200523,2,충정로,5503,6008,20200526,11511
20200523,2,용답,1893,1837,20200526,3730
20200523,2,신답,976,1015,20200526,1991
20200523,2,신설동,3076,2972,20200526,6048
20200523,2,도림천,758,762,20200526,1520
20200523,2,양천구청,4011,4082,20200526,8093
20200523,2,신정네거리,6567,6745,20200526,13312
20200523,2,용두,1662,1657,20200526,3319
20200524,2,용두,850,868,20200527,1718
20200524,2,신정네거리,4088,4066,20200527,8154
20200524,2,양천구청,2696,2744,20200527,5440
20200524,2,도림천,449,413,20200527,862
20200524,2,신설동,2398,2402,20200527,4800
20200524,2,신답,619,673,20200527,1292
20200524,2,용답,1412,1375,20200527,2787
20200524,2,충정로,3277,3389,20200527,6666
20200524,2,아현,4248,4266,20200527,8514
20200524,2,이대,5474,5854,20200527,11328
20200524,2,신촌,17466,17638,20200527,35104
20200524,2,홍대입구,28389,27729,20200527,56118
20200524,2,합정,15525,16063,20200527,31588
20200524,2,당산,7871,8462,20200527,16333
20200524,2,영등포구청,6615,6708,20200527,13323
20200524,2,문래,6346,6788,20200527,13134
20200524,2,신도림,24801,24813,20200527,49614
20200524,2,대림,13399,13672,20200527,27071
20200524,2,구로디지털단지,20727,20473,20200527,41200
20200524,2,신대방,13473,13080,20200527,26553
20200524,2,신림,33016,32649,20200527,65665
20200524,2,봉천,11077,10554,20200527,21631
20200524,2,서울대입구,24402,25149,20200527,49551
20200524,2,낙성대,13674,14129,20200527,27803
20200524,2,사당,19672,21491,20200527,41163
20200524,2,방배,5964,6234,20200527,12198
20200524,2,서초,9932,9452,20200527,19384
20200524,2,교대,9628,10726,20200527,20354
20200524,2,강남,29974,28110,20200527,58084
20200524,2,역삼,9756,10857,20200527,20613
20200524,2,선릉,11035,9790,20200527,20825
20200524,2,삼성,16735,16900,20200527,33635
20200524,2,종합운동장,3285,3770,20200527,7055
20200524,2,잠실새내,9212,9685,20200527,18897
20200524,2,잠실,36412,33752,20200527,70164
20200524,2,잠실나루,4599,4615,20200527,9214
20200524,2,강변,20132,20496,20200527,40628
20200524,2,구의,10302,10170,20200527,20472
20200524,2,건대입구,22421,22978,20200527,45399
20200524,2,성수,9501,11037,20200527,20538
20200524,2,뚝섬,8296,8384,20200527,16680
20200524,2,한양대,2398,2717,20200527,5115
20200524,2,왕십리,8305,7033,20200527,15338
20200524,2,상왕십리,5756,5697,20200527,11453
20200524,2,신당,6873,7283,20200527,14156
20200524,2,동대문역사문화공원,5882,7207,20200527,13089
20200524,2,을지로4가,2719,2754,20200527,5473
20200524,2,을지로3가,5232,5037,20200527,10269
20200524,2,을지로입구,12285,11996,20200527,24281
20200524,2,시청,4186,3676,20200527,7862
20200525,2,성수,32328,35581,20200528,67909
20200525,2,시청,23781,23857,20200528,47638
20200525,2,을지로입구,38097,39309,20200528,77406
20200525,2,을지로3가,20980,21107,20200528,42087
20200525,2,을지로4가,13401,13192,20200528,26593
20200525,2,동대문역사문화공원,11688,13206,20200528,24894
20200525,2,신당,13513,14001,20200528,27514
20200525,2,상왕십리,13649,13132,20200528,26781
20200525,2,왕십리,15465,13034,20200528,28499
20200525,2,한양대,7200,8166,20200528,15366
20200525,2,뚝섬,19430,21023,20200528,40453
20200525,2,용두,2257,2330,20200528,4587
20200525,2,신정네거리,9530,9985,20200528,19515
20200525,2,양천구청,6747,6949,20200528,13696
20200525,2,도림천,1232,1264,20200528,2496
20200525,2,신설동,3245,3229,20200528,6474
20200525,2,신답,1640,1808,20200528,3448
20200525,2,용답,2439,2359,20200528,4798
20200525,2,충정로,10556,11145,20200528,21701
20200525,2,아현,9568,9222,20200528,18790
20200525,2,이대,11340,11879,20200528,23219
20200525,2,신촌,29926,31105,20200528,61031
20200525,2,홍대입구,40894,42579,20200528,83473
20200525,2,합정,28021,29374,20200528,57395
20200525,2,당산,19645,22716,20200528,42361
20200525,2,영등포구청,22881,23412,20200528,46293
20200525,2,문래,21038,21624,20200528,42662
20200525,2,신도림,48800,47461,20200528,96261
20200525,2,대림,25559,25796,20200528,51355
20200525,2,구로디지털단지,61751,62174,20200528,123925
20200525,2,신대방,26629,25448,20200528,52077
20200525,2,신림,63128,60662,20200528,123790
20200525,2,봉천,24868,22892,20200528,47760
20200525,2,서울대입구,46534,45852,20200528,92386
20200525,2,낙성대,26504,26157,20200528,52661
20200525,2,사당,35800,39765,20200528,75565
20200525,2,방배,17207,17977,20200528,35184
20200525,2,서초,21889,21867,20200528,43756
20200525,2,교대,34950,39418,20200528,74368
20200525,2,강남,84834,80899,20200528,165733
20200525,2,역삼,51049,56875,20200528,107924
20200525,2,선릉,58869,52835,20200528,111704
20200525,2,삼성,50272,51505,20200528,101777
20200525,2,종합운동장,6852,7393,20200528,14245
20200525,2,잠실새내,20037,20132,20200528,40169
20200525,2,잠실,61968,61336,20200528,123304
20200525,2,잠실나루,14612,14339,20200528,28951
20200525,2,강변,32180,31827,20200528,64007
20200525,2,구의,23799,23253,20200528,47052
20200525,2,건대입구,31854,34487,20200528,66341
20200526,2,잠실나루,14611,14350,20200529,28961
20200526,2,용두,2204,2320,20200529,4524
20200526,2,신정네거리,9498,9998,20200529,19496
20200526,2,양천구청,6697,7079,20200529,13776
20200526,2,도림천,1284,1334,20200529,2618
20200526,2,신설동,3151,3057,20200529,6208
20200526,2,신답,1561,1813,20200529,3374
20200526,2,용답,2514,2531,20200529,5045
20200526,2,충정로,10604,11205,20200529,21809
20200526,2,아현,9851,9593,20200529,19444
20200526,2,이대,11463,11935,20200529,23398
20200526,2,신촌,30420,31550,20200529,61970
20200526,2,홍대입구,41381,43274,20200529,84655
20200526,2,합정,29121,30295,20200529,59416
20200526,2,당산,19737,22703,20200529,42440
20200526,2,영등포구청,22817,23140,20200529,45957
20200526,2,문래,21543,22089,20200529,43632
20200526,2,신도림,47862,46720,20200529,94582
20200526,2,대림,25073,25568,20200529,50641
20200526,2,구로디지털단지,61761,62205,20200529,123966
20200526,2,신대방,26643,25641,20200529,52284
20200526,2,신림,62647,60617,20200529,123264
20200526,2,봉천,24809,22898,20200529,47707
20200526,2,서울대입구,47299,46216,20200529,93515
20200526,2,낙성대,27275,26400,20200529,53675
20200526,2,사당,37029,40291,20200529,77320
20200526,2,방배,17379,18068,20200529,35447
20200526,2,서초,22280,22188,20200529,44468
20200526,2,교대,35804,40376,20200529,76180
20200526,2,강남,85628,85358,20200529,170986
20200526,2,역삼,52496,57539,20200529,110035
20200526,2,선릉,59949,52621,20200529,112570
20200526,2,삼성,52375,53823,20200529,106198
20200526,2,종합운동장,6989,7785,20200529,14774
20200526,2,잠실새내,20476,20564,20200529,41040
20200526,2,잠실,62950,62697,20200529,125647
20200526,2,강변,30631,29805,20200529,60436
20200526,2,구의,24199,23522,20200529,47721
20200526,2,건대입구,31655,34156,20200529,65811
20200526,2,성수,32295,35423,20200529,67718
20200526,2,뚝섬,19778,21335,20200529,41113
20200526,2,한양대,7780,8654,20200529,16434
20200526,2,왕십리,15493,12642,20200529,28135
20200526,2,상왕십리,13901,13459,20200529,27360
20200526,2,신당,13530,13878,20200529,27408
20200526,2,동대문역사문화공원,11745,12862,20200529,24607
20200526,2,을지로4가,13400,13174,20200529,26574
20200526,2,을지로3가,21545,21297,20200529,42842
20200526,2,을지로입구,39233,40363,20200529,79596
20200526,2,시청,24454,24228,20200529,48682
20200527,2,봉천,25176,23108,20200530,48284
20200527,2,용두,2304,2332,20200530,4636
20200527,2,신정네거리,9636,10091,20200530,19727
20200527,2,양천구청,6755,6986,20200530,13741
20200527,2,도림천,1283,1438,20200530,2721
20200527,2,신설동,3371,3317,20200530,6688
20200527,2,신답,1634,1813,20200530,3447
20200527,2,용답,2538,2479,20200530,5017
20200527,2,충정로,10548,11258,20200530,21806
20200527,2,아현,10168,9616,20200530,19784
20200527,2,이대,11893,12527,20200530,24420
20200527,2,신촌,31186,32742,20200530,63928
20200527,2,홍대입구,44019,46286,20200530,90305
20200527,2,신림,64415,61816,20200530,126231
20200527,2,서울대입구,48262,47236,20200530,95498
20200527,2,낙성대,27861,26651,20200530,54512
20200527,2,사당,38167,41479,20200530,79646
20200527,2,방배,17752,18127,20200530,35879
20200527,2,서초,22391,22633,20200530,45024
20200527,2,강변,31312,30587,20200530,61899
20200527,2,잠실나루,15053,14491,20200530,29544
20200527,2,잠실,65775,64989,20200530,130764
20200527,2,잠실새내,20549,20850,20200530,41399
20200527,2,종합운동장,7436,8039,20200530,15475
20200527,2,삼성,52363,54164,20200530,106527
20200527,2,선릉,59976,53842,20200530,113818
20200527,2,역삼,51293,57242,20200530,108535
20200527,2,강남,86774,87016,20200530,173790
20200527,2,교대,36326,41035,20200530,77361
20200527,2,합정,29357,31043,20200530,60400
20200527,2,당산,20543,23752,20200530,44295
20200527,2,영등포구청,23235,23610,20200530,46845
20200527,2,문래,21630,22185,20200530,43815
20200527,2,신도림,49621,48573,20200530,98194
20200527,2,대림,25777,26033,20200530,51810
20200527,2,구로디지털단지,62813,62671,20200530,125484
20200527,2,신대방,27428,26290,20200530,53718
20200527,2,구의,24049,23672,20200530,47721
20200527,2,건대입구,33000,35725,20200530,68725
20200527,2,성수,32556,36072,20200530,68628
20200527,2,뚝섬,20347,21975,20200530,42322
20200527,2,한양대,7792,8767,20200530,16559
20200527,2,왕십리,16182,13085,20200530,29267
20200527,2,상왕십리,13956,13432,20200530,27388
20200527,2,신당,13990,14086,20200530,28076
20200527,2,동대문역사문화공원,12489,13817,20200530,26306
20200527,2,을지로4가,13474,13415,20200530,26889
20200527,2,을지로3가,21350,21872,20200530,43222
20200527,2,을지로입구,39533,40793,20200530,80326
20200527,2,시청,24691,24806,20200530,49497
20200528,2,용두,2225,2317,20200531,4542
20200528,2,신정네거리,9556,9860,20200531,19416
20200528,2,양천구청,6550,6916,20200531,13466
20200528,2,도림천,1289,1358,20200531,2647
20200528,2,신설동,3232,3141,20200531,6373
20200528,2,신답,1582,1815,20200531,3397
20200528,2,용답,2483,2463,20200531,4946
20200528,2,충정로,9737,10445,20200531,20182
20200528,2,아현,9956,9507,20200531,19463
20200528,2,이대,11499,11935,20200531,23434
20200528,2,신촌,30835,32150,20200531,62985
20200528,2,홍대입구,42576,45043,20200531,87619
20200528,2,합정,29184,30461,20200531,59645
20200528,2,당산,20089,22985,20200531,43074
20200528,2,영등포구청,22984,23485,20200531,46469
20200528,2,문래,21382,21789,20200531,43171
20200528,2,신도림,48347,47457,20200531,95804
20200528,2,대림,25336,25485,20200531,50821
20200528,2,구로디지털단지,61758,61776,20200531,123534
20200528,2,신대방,26673,25553,20200531,52226
20200528,2,신림,63499,60538,20200531,124037
20200528,2,봉천,24736,22572,20200531,47308
20200528,2,서울대입구,47483,45995,20200531,93478
20200528,2,낙성대,27570,26320,20200531,53890
20200528,2,사당,37177,41129,20200531,78306
20200528,2,방배,17521,17936,20200531,35457
20200528,2,서초,21823,21964,20200531,43787
20200528,2,교대,35307,40027,20200531,75334
20200528,2,강남,84735,85368,20200531,170103
20200528,2,역삼,50832,56940,20200531,107772
20200528,2,선릉,59280,53173,20200531,112453
20200528,2,삼성,51711,53813,20200531,105524
20200528,2,종합운동장,7100,8002,20200531,15102
20200528,2,잠실새내,20193,20353,20200531,40546
20200528,2,잠실,63788,63490,20200531,127278
20200528,2,잠실나루,14903,14258,20200531,29161
20200528,2,강변,31687,31520,20200531,63207
20200528,2,구의,24071,23146,20200531,47217
20200528,2,건대입구,32392,34933,20200531,67325
20200528,2,성수,31354,34975,20200531,66329
20200528,2,뚝섬,20052,21739,20200531,41791
20200528,2,한양대,7788,8866,20200531,16654
20200528,2,왕십리,15877,12648,20200531,28525
20200528,2,상왕십리,13807,13329,20200531,27136
20200528,2,신당,13619,13723,20200531,27342
20200528,2,동대문역사문화공원,12033,13553,20200531,25586
20200528,2,을지로4가,13338,13207,20200531,26545
20200528,2,을지로3가,21336,21472,20200531,42808
20200528,2,을지로입구,39074,40543,20200531,79617
20200528,2,시청,24385,24579,20200531,48964
20200529,2,시청,23759,23759,20200601,47518
20200529,2,을지로입구,38951,40279,20200601,79230
20200529,2,을지로3가,21362,22241,20200601,43603
20200529,2,을지로4가,13113,13205,20200601,26318
20200529,2,동대문역사문화공원,12354,14070,20200601,26424
20200529,2,신당,13932,14115,20200601,28047
20200529,2,상왕십리,14016,13294,20200601,27310
20200529,2,왕십리,16471,13748,20200601,30219
20200529,2,한양대,7671,8264,20200601,15935
20200529,2,뚝섬,20182,21853,20200601,42035
20200529,2,성수,31547,35289,20200601,66836
20200529,2,건대입구,34350,38566,20200601,72916
20200529,2,구의,24249,23136,20200601,47385
20200529,2,강변,35163,35319,20200601,70482
20200529,2,잠실나루,14892,14350,20200601,29242
20200529,2,잠실,66757,66017,20200601,132774
20200529,2,잠실새내,21157,22271,20200601,43428
20200529,2,종합운동장,7841,7935,20200601,15776
20200529,2,삼성,52743,54294,20200601,107037
20200529,2,선릉,58214,52533,20200601,110747
20200529,2,역삼,49677,55787,20200601,105464
20200529,2,강남,88100,90203,20200601,178303
20200529,2,교대,35734,40957,20200601,76691
20200529,2,서초,21844,21669,20200601,43513
20200529,2,방배,17668,18181,20200601,35849
20200529,2,사당,39057,43631,20200601,82688
20200529,2,낙성대,28567,26257,20200601,54824
20200529,2,서울대입구,50081,48376,20200601,98457
20200529,2,봉천,25352,22693,20200601,48045
20200529,2,신림,65460,62151,20200601,127611
20200529,2,신대방,27060,25494,20200601,52554
20200529,2,구로디지털단지,62849,62258,20200601,125107
20200529,2,대림,25355,25679,20200601,51034
20200529,2,신도림,50188,49719,20200601,99907
20200529,2,문래,21339,22288,20200601,43627
20200529,2,영등포구청,22960,23196,20200601,46156
20200529,2,당산,20421,23855,20200601,44276
20200529,2,합정,30583,33373,20200601,63956
20200529,2,홍대입구,45981,49800,20200601,95781
20200529,2,신촌,32351,33926,20200601,66277
20200529,2,이대,11959,12120,20200601,24079
20200529,2,아현,10128,9264,20200601,19392
20200529,2,충정로,9509,9915,20200601,19424
20200529,2,용답,2567,2462,20200601,5029
20200529,2,신답,1650,1784,20200601,3434
20200529,2,신설동,3204,3132,20200601,6336
20200529,2,도림천,1288,1336,20200601,2624
20200529,2,양천구청,6671,6932,20200601,13603
20200529,2,신정네거리,9558,10194,20200601,19752
20200529,2,용두,2355,2355,20200601,4710
20200530,2,을지로입구,17407,16950,20200602,34357
20200530,2,을지로3가,8285,8760,20200602,17045
20200530,2,을지로4가,6809,7091,20200602,13900
20200530,2,동대문역사문화공원,8959,9402,20200602,18361
20200530,2,신당,9960,10043,20200602,20003
20200530,2,상왕십리,8895,8188,20200602,17083
20200530,2,왕십리,12224,10341,20200602,22565
20200530,2,한양대,4389,4539,20200602,8928
20200530,2,뚝섬,11528,12302,20200602,23830
20200530,2,성수,13522,15552,20200602,29074
20200530,2,건대입구,29606,32781,20200602,62387
20200530,2,구의,15190,14397,20200602,29587
20200530,2,강변,26875,27473,20200602,54348
20200530,2,잠실나루,7107,6792,20200602,13899
20200530,2,잠실,51429,48367,20200602,99796
20200530,2,잠실새내,14795,16013,20200602,30808
20200530,2,종합운동장,4413,4832,20200602,9245
20200530,2,삼성,24644,25076,20200602,49720
20200530,2,선릉,23127,20590,20200602,43717
20200530,2,역삼,17286,18838,20200602,36124
20200530,2,강남,54966,55940,20200602,110906
20200530,2,교대,17175,19468,20200602,36643
20200530,2,서초,11160,11316,20200602,22476
20200530,2,방배,10108,10252,20200602,20360
20200530,2,사당,28545,32419,20200602,60964
20200530,2,낙성대,20296,18674,20200602,38970
20200530,2,서울대입구,36304,34893,20200602,71197
20200530,2,봉천,16741,14967,20200602,31708
20200530,2,신림,47490,44572,20200602,92062
20200530,2,신대방,18798,17788,20200602,36586
20200530,2,구로디지털단지,31827,31639,20200602,63466
20200530,2,대림,17307,18237,20200602,35544
20200530,2,신도림,38387,38736,20200602,77123
20200530,2,문래,10615,11178,20200602,21793
20200530,2,영등포구청,11592,12038,20200602,23630
20200530,2,당산,12082,13417,20200602,25499
20200530,2,합정,22586,25347,20200602,47933
20200530,2,홍대입구,41205,44728,20200602,85933
20200530,2,신촌,25259,26237,20200602,51496
20200530,2,이대,8287,8171,20200602,16458
20200530,2,아현,6405,6052,20200602,12457
20200530,2,충정로,4952,5178,20200602,10130
20200530,2,용답,1801,1679,20200602,3480
20200530,2,신답,879,916,20200602,1795
20200530,2,신설동,2872,2763,20200602,5635
20200530,2,도림천,734,689,20200602,1423
20200530,2,양천구청,4448,4368,20200602,8816
20200530,2,신정네거리,6503,6591,20200602,13094
20200530,2,용두,1464,1512,20200602,2976
20200530,2,시청,6448,5952,20200602,12400
20200531,2,아현,4346,4310,20200603,8656
20200531,2,시청,3854,3518,20200603,7372
20200531,2,을지로입구,12475,12303,20200603,24778
20200531,2,을지로3가,5267,5117,20200603,10384
20200531,2,을지로4가,2643,2658,20200603,5301
20200531,2,동대문역사문화공원,5919,7185,20200603,13104
20200531,2,신당,7120,7477,20200603,14597
20200531,2,상왕십리,5718,5611,20200603,11329
20200531,2,왕십리,8373,7062,20200603,15435
20200531,2,한양대,2417,2660,20200603,5077
20200531,2,뚝섬,7779,8124,20200603,15903
20200531,2,성수,8722,10124,20200603,18846
20200531,2,건대입구,22075,22982,20200603,45057
20200531,2,구의,10123,10020,20200603,20143
20200531,2,강변,20600,20206,20200603,40806
20200531,2,잠실나루,4469,4707,20200603,9176
20200531,2,잠실,36444,34136,20200603,70580
20200531,2,잠실새내,9236,9637,20200603,18873
20200531,2,종합운동장,3161,3599,20200603,6760
20200531,2,삼성,16464,16620,20200603,33084
20200531,2,선릉,11207,9822,20200603,21029
20200531,2,역삼,9621,10688,20200603,20309
20200531,2,강남,30239,29861,20200603,60100
20200531,2,교대,9709,10767,20200603,20476
20200531,2,서초,9724,9464,20200603,19188
20200531,2,방배,5887,6134,20200603,12021
20200531,2,사당,18987,21042,20200603,40029
20200531,2,낙성대,14358,14696,20200603,29054
20200531,2,서울대입구,25055,26224,20200603,51279
20200531,2,봉천,11124,10630,20200603,21754
20200531,2,신림,33732,32802,20200603,66534
20200531,2,신대방,13616,13291,20200603,26907
20200531,2,구로디지털단지,21054,20642,20200603,41696
20200531,2,대림,13335,13532,20200603,26867
20200531,2,신도림,24398,24763,20200603,49161
20200531,2,문래,6441,6754,20200603,13195
20200531,2,영등포구청,6637,6953,20200603,13590
20200531,2,당산,8055,8753,20200603,16808
20200531,2,합정,16138,16757,20200603,32895
20200531,2,홍대입구,30550,29918,20200603,60468
20200531,2,신촌,17612,17577,20200603,35189
20200531,2,이대,5353,5438,20200603,10791
20200531,2,용두,949,966,20200603,1915
20200531,2,신정네거리,4228,4068,20200603,8296
20200531,2,양천구청,2746,2762,20200603,5508
20200531,2,도림천,408,398,20200603,806
20200531,2,신설동,2556,2589,20200603,5145
20200531,2,신답,616,640,20200603,1256
20200531,2,용답,1400,1420,20200603,2820
20200531,2,충정로,3134,3381,20200603,6515
20200101,3,오금,2215,2210,20200104,4425
20200101,3,경찰병원,2689,2816,20200104,5505
20200101,3,가락시장,3711,3584,20200104,7295
20200101,3,수서,9190,9114,20200104,18304
20200101,3,일원,3016,3423,20200104,6439
20200101,3,대청,3906,3658,20200104,7564
20200101,3,학여울,595,625,20200104,1220
20200101,3,대치,5074,4656,20200104,9730
20200101,3,도곡,1708,1802,20200104,3510
20200101,3,매봉,3265,3225,20200104,6490
20200101,3,양재,10750,11705,20200104,22455
20200101,3,남부터미널,14564,15123,20200104,29687
20200101,3,교대,3299,1977,20200104,5276
20200101,3,고속터미널,39526,34867,20200104,74393
20200101,3,잠원,2373,2355,20200104,4728
20200101,3,신사,14593,13688,20200104,28281
20200101,3,압구정,9788,10110,20200104,19898
20200101,3,옥수,4370,4673,20200104,9043
20200101,3,금호,3846,3735,20200104,7581
20200101,3,약수,5909,5812,20200104,11721
20200101,3,동대입구,5490,6806,20200104,12296
20200101,3,을지로3가,3686,3543,20200104,7229
20200101,3,종로3가,4173,6053,20200104,10226
20200101,3,안국,11837,12378,20200104,24215
20200101,3,경복궁,12647,13381,20200104,26028
20200101,3,독립문,3791,4020,20200104,7811
20200101,3,무악재,1740,1986,20200104,3726
20200101,3,홍제,8618,8389,20200104,17007
20200101,3,녹번,5554,5275,20200104,10829
20200101,3,불광,8935,10408,20200104,19343
20200101,3,연신내,21529,21007,20200104,42536
20200101,3,구파발,11160,11563,20200104,22723
20200101,3,지축,795,856,20200104,1651
20200102,3,지축,1989,2097,20200105,4086
20200102,3,구파발,23882,22075,20200105,45957
20200102,3,연신내,43744,41453,20200105,85197
20200102,3,불광,18451,20089,20200105,38540
20200102,3,녹번,15120,13308,20200105,28428
20200102,3,홍제,19458,18524,20200105,37982
20200102,3,무악재,4386,4476,20200105,8862
20200102,3,독립문,8030,8249,20200105,16279
20200102,3,경복궁,24304,24658,20200105,48962
20200102,3,안국,26607,27464,20200105,54071
20200102,3,종로3가,12265,14862,20200105,27127
20200102,3,을지로3가,12998,13470,20200105,26468
20200102,3,충무로,1,0,20200105,1
20200102,3,동대입구,10099,11550,20200105,21649
20200102,3,약수,14495,14270,20200105,28765
20200102,3,금호,9308,8683,20200105,17991
20200102,3,옥수,10222,10659,20200105,20881
20200102,3,압구정,38379,41515,20200105,79894
20200102,3,신사,36170,39068,20200105,75238
20200102,3,잠원,6764,6637,20200105,13401
20200102,3,고속터미널,55884,51160,20200105,107044
20200102,3,교대,16689,10798,20200105,27487
20200102,3,남부터미널,35067,35037,20200105,70104
20200102,3,양재,43164,46934,20200105,90098
20200102,3,매봉,13108,12524,20200105,25632
20200102,3,도곡,6240,6160,20200105,12400
20200102,3,대치,13874,13476,20200105,27350
20200102,3,학여울,1917,2010,20200105,3927
20200102,3,대청,10965,10082,20200105,21047
20200102,3,일원,11275,11140,20200105,22415
20200102,3,수서,18957,18996,20200105,37953
20200102,3,가락시장,10396,10228,20200105,20624
20200102,3,경찰병원,9095,9184,20200105,18279
20200102,3,오금,7294,6404,20200105,13698
20200103,3,지축,2136,2225,20200106,4361
20200103,3,구파발,24746,22782,20200106,47528
20200103,3,연신내,46449,44268,20200106,90717
20200103,3,불광,19376,20773,20200106,40149
20200103,3,녹번,16068,13844,20200106,29912
20200103,3,홍제,20597,19358,20200106,39955
20200103,3,무악재,4562,4571,20200106,9133
20200103,3,독립문,8531,8636,20200106,17167
20200103,3,경복궁,27754,27280,20200106,55034
20200103,3,안국,28369,29379,20200106,57748
20200103,3,종로3가,12961,16385,20200106,29346
20200103,3,을지로3가,13798,14521,20200106,28319
20200103,3,충무로,1,0,20200106,1
20200103,3,동대입구,10670,11699,20200106,22369
20200103,3,약수,15542,14912,20200106,30454
20200103,3,금호,9831,8920,20200106,18751
20200103,3,옥수,10817,10921,20200106,21738
20200103,3,압구정,41656,45086,20200106,86742
20200103,3,신사,39476,43942,20200106,83418
20200103,3,잠원,7302,6887,20200106,14189
20200103,3,고속터미널,62892,63136,20200106,126028
20200103,3,교대,16935,11032,20200106,27967
20200103,3,남부터미널,37616,37595,20200106,75211
20200103,3,양재,47845,50358,20200106,98203
20200103,3,매봉,13639,13162,20200106,26801
20200103,3,도곡,6615,6466,20200106,13081
20200103,3,대치,14743,14319,20200106,29062
20200103,3,학여울,2600,2635,20200106,5235
20200103,3,대청,11658,10619,20200106,22277
20200103,3,일원,11640,11129,20200106,22769
20200103,3,수서,21576,20813,20200106,42389
20200103,3,가락시장,11701,11430,20200106,23131
20200103,3,경찰병원,9217,9217,20200106,18434
20200103,3,오금,7610,6610,20200106,14220
20200104,3,오금,4725,4208,20200107,8933
20200104,3,지축,1533,1615,20200107,3148
20200104,3,구파발,18029,17398,20200107,35427
20200104,3,연신내,35604,34264,20200107,69868
20200104,3,불광,15324,17348,20200107,32672
20200104,3,녹번,10789,9216,20200107,20005
20200104,3,홍제,15700,15112,20200107,30812
20200104,3,무악재,3159,3220,20200107,6379
20200104,3,독립문,7398,7539,20200107,14937
20200104,3,경복궁,26351,22669,20200107,49020
20200104,3,안국,20711,22650,20200107,43361
20200104,3,종로3가,8103,12359,20200107,20462
20200104,3,을지로3가,6931,7364,20200107,14295
20200104,3,충무로,1,0,20200107,1
20200104,3,동대입구,8627,9756,20200107,18383
20200104,3,약수,10907,10291,20200107,21198
20200104,3,금호,7030,6290,20200107,13320
20200104,3,옥수,8027,7987,20200107,16014
20200104,3,압구정,30384,32219,20200107,62603
20200104,3,신사,30453,33081,20200107,63534
20200104,3,잠원,4821,4461,20200107,9282
20200104,3,고속터미널,68676,67117,20200107,135793
20200104,3,교대,8774,5246,20200107,14020
20200104,3,남부터미널,29137,28329,20200107,57466
20200104,3,양재,25516,27259,20200107,52775
20200104,3,매봉,6504,5984,20200107,12488
20200104,3,도곡,4199,4169,20200107,8368
20200104,3,대치,11563,10373,20200107,21936
20200104,3,학여울,2090,2122,20200107,4212
20200104,3,대청,7040,6412,20200107,13452
20200104,3,일원,5905,5822,20200107,11727
20200104,3,수서,15711,15384,20200107,31095
20200104,3,가락시장,7622,7266,20200107,14888
20200104,3,경찰병원,4840,4756,20200107,9596
20200105,3,지축,1127,1171,20200108,2298
20200105,3,구파발,13763,13946,20200108,27709
20200105,3,연신내,26339,24829,20200108,51168
20200105,3,불광,11326,13497,20200108,24823
20200105,3,녹번,7510,6650,20200108,14160
20200105,3,홍제,11184,10684,20200108,21868
20200105,3,무악재,2157,2326,20200108,4483
20200105,3,독립문,5360,5717,20200108,11077
20200105,3,경복궁,13690,14125,20200108,27815
20200105,3,안국,12912,13868,20200108,26780
20200105,3,종로3가,4817,6875,20200108,11692
20200105,3,을지로3가,4417,4439,20200108,8856
20200105,3,동대입구,6890,7949,20200108,14839
20200105,3,약수,8215,7899,20200108,16114
20200105,3,금호,5256,4964,20200108,10220
20200105,3,옥수,5658,6124,20200108,11782
20200105,3,압구정,17776,18210,20200108,35986
20200105,3,신사,17917,18149,20200108,36066
20200105,3,잠원,3200,3253,20200108,6453
20200105,3,고속터미널,55120,52535,20200108,107655
20200105,3,교대,5042,3011,20200108,8053
20200105,3,남부터미널,18505,19554,20200108,38059
20200105,3,양재,17568,19256,20200108,36824
20200105,3,매봉,4415,4297,20200108,8712
20200105,3,도곡,2568,2658,20200108,5226
20200105,3,대치,7254,6482,20200108,13736
20200105,3,학여울,1368,1443,20200108,2811
20200105,3,대청,4921,4691,20200108,9612
20200105,3,일원,4287,4679,20200108,8966
20200105,3,수서,11647,11825,20200108,23472
20200105,3,가락시장,4659,4845,20200108,9504
20200105,3,경찰병원,3464,3410,20200108,6874
20200105,3,오금,3410,3277,20200108,6687
20200106,3,지축,2063,2156,20200109,4219
20200106,3,구파발,24253,22488,20200109,46741
20200106,3,연신내,43966,42042,20200109,86008
20200106,3,불광,18763,20299,20200109,39062
20200106,3,녹번,15558,13850,20200109,29408
20200106,3,홍제,19907,19029,20200109,38936
20200106,3,무악재,4477,4594,20200109,9071
20200106,3,독립문,7754,7977,20200109,15731
20200106,3,경복궁,23002,23363,20200109,46365
20200106,3,안국,25770,26599,20200109,52369
20200106,3,종로3가,12645,14579,20200109,27224
20200106,3,을지로3가,13638,13882,20200109,27520
20200106,3,충무로,1,0,20200109,1
20200106,3,동대입구,10432,11162,20200109,21594
20200106,3,약수,15443,15045,20200109,30488
20200106,3,금호,9441,8865,20200109,18306
20200106,3,옥수,10442,10911,20200109,21353
20200106,3,압구정,39011,42644,20200109,81655
20200106,3,신사,36355,38647,20200109,75002
20200106,3,잠원,7289,7111,20200109,14400
20200106,3,고속터미널,54701,51591,20200109,106292
20200106,3,교대,17323,11352,20200109,28675
20200106,3,남부터미널,35316,35716,20200109,71032
20200106,3,양재,45889,49667,20200109,95556
20200106,3,매봉,13919,13205,20200109,27124
20200106,3,도곡,6562,6613,20200109,13175
20200106,3,대치,14193,13984,20200109,28177
20200106,3,학여울,2108,2149,20200109,4257
20200106,3,대청,11506,10390,20200109,21896
20200106,3,일원,11826,12177,20200109,24003
20200106,3,수서,19558,19935,20200109,39493
20200106,3,가락시장,11243,10904,20200109,22147
20200106,3,경찰병원,9636,9726,20200109,19362
20200106,3,오금,7551,6602,20200109,14153
20200107,3,지축,1930,2058,20200110,3988
20200107,3,구파발,23350,21562,20200110,44912
20200107,3,연신내,42117,40569,20200110,82686
20200107,3,불광,18006,19458,20200110,37464
20200107,3,녹번,15209,13758,20200110,28967
20200107,3,홍제,19371,18398,20200110,37769
20200107,3,무악재,4332,4610,20200110,8942
20200107,3,독립문,7635,7794,20200110,15429
20200107,3,경복궁,22466,21742,20200110,44208
20200107,3,안국,25352,25711,20200110,51063
20200107,3,종로3가,12433,14350,20200110,26783
20200107,3,을지로3가,13297,13699,20200110,26996
20200107,3,충무로,2,0,20200110,2
20200107,3,동대입구,10794,11392,20200110,22186
20200107,3,약수,15128,14670,20200110,29798
20200107,3,금호,9108,8604,20200110,17712
20200107,3,옥수,10258,10704,20200110,20962
20200107,3,압구정,38236,41272,20200110,79508
20200107,3,신사,35580,37931,20200110,73511
20200107,3,잠원,7098,6964,20200110,14062
20200107,3,고속터미널,52659,50550,20200110,103209
20200107,3,교대,17132,10965,20200110,28097
20200107,3,남부터미널,34322,34670,20200110,68992
20200107,3,양재,46677,50246,20200110,96923
20200107,3,매봉,13551,13028,20200110,26579
20200107,3,도곡,6692,6590,20200110,13282
20200107,3,대치,14257,13910,20200110,28167
20200107,3,학여울,2007,2075,20200110,4082
20200107,3,대청,11460,10416,20200110,21876
20200107,3,일원,12060,12261,20200110,24321
20200107,3,수서,19280,19378,20200110,38658
20200107,3,가락시장,10844,10490,20200110,21334
20200107,3,경찰병원,9463,9363,20200110,18826
20200107,3,오금,7354,6549,20200110,13903
20200108,3,지축,2189,2218,20200111,4407
20200108,3,구파발,24588,22740,20200111,47328
20200108,3,연신내,44828,42768,20200111,87596
20200108,3,불광,19142,20539,20200111,39681
20200108,3,녹번,15915,14205,20200111,30120
20200108,3,홍제,20469,19369,20200111,39838
20200108,3,무악재,4634,4578,20200111,9212
20200108,3,독립문,8247,8527,20200111,16774
20200108,3,경복궁,23939,24334,20200111,48273
20200108,3,안국,26412,27881,20200111,54293
20200108,3,종로3가,12523,14895,20200111,27418
20200108,3,을지로3가,13726,14233,20200111,27959
20200108,3,충무로,4,0,20200111,4
20200108,3,동대입구,10803,11427,20200111,22230
20200108,3,약수,15482,14999,20200111,30481
20200108,3,금호,9660,8856,20200111,18516
20200108,3,옥수,10708,11033,20200111,21741
20200108,3,압구정,38850,42043,20200111,80893
20200108,3,신사,36436,38931,20200111,75367
20200108,3,잠원,7214,7022,20200111,14236
20200108,3,고속터미널,53961,51851,20200111,105812
20200108,3,교대,18017,11536,20200111,29553
20200108,3,남부터미널,35635,35815,20200111,71450
20200108,3,양재,48325,52303,20200111,100628
20200108,3,매봉,14099,13447,20200111,27546
20200108,3,도곡,6683,6653,20200111,13336
20200108,3,대치,14483,14199,20200111,28682
20200108,3,학여울,2147,2179,20200111,4326
20200108,3,대청,11961,10738,20200111,22699
20200108,3,일원,12448,12584,20200111,25032
20200108,3,수서,20017,20051,20200111,40068
20200108,3,가락시장,11433,11096,20200111,22529
20200108,3,경찰병원,9351,9438,20200111,18789
20200108,3,오금,7762,6952,20200111,14714
20200109,3,지축,2187,2266,20200112,4453
20200109,3,구파발,25276,23530,20200112,48806
20200109,3,연신내,45242,43232,20200112,88474
20200109,3,불광,19548,21038,20200112,40586
20200109,3,녹번,16023,14191,20200112,30214
20200109,3,홍제,20698,19558,20200112,40256
20200109,3,무악재,4658,4724,20200112,9382
20200109,3,독립문,8309,8635,20200112,16944
20200109,3,경복궁,24899,24889,20200112,49788
20200109,3,안국,26951,28539,20200112,55490
20200109,3,종로3가,12892,15417,20200112,28309
20200109,3,을지로3가,13777,14150,20200112,27927
20200109,3,동대입구,11380,12329,20200112,23709
20200109,3,약수,15812,15479,20200112,31291
20200109,3,금호,9673,8917,20200112,18590
20200109,3,옥수,10793,11080,20200112,21873
20200109,3,압구정,39926,43481,20200112,83407
20200109,3,신사,37854,40867,20200112,78721
20200109,3,잠원,7182,6969,20200112,14151
20200109,3,고속터미널,55859,54515,20200112,110374
20200109,3,교대,18310,11708,20200112,30018
20200109,3,남부터미널,36964,37342,20200112,74306
20200109,3,양재,49007,52970,20200112,101977
20200109,3,매봉,14072,13474,20200112,27546
20200109,3,도곡,6745,6820,20200112,13565
20200109,3,대치,14576,14119,20200112,28695
20200109,3,학여울,2159,2200,20200112,4359
20200109,3,대청,11697,10660,20200112,22357
20200109,3,일원,12415,12329,20200112,24744
20200109,3,수서,20551,20517,20200112,41068
20200109,3,가락시장,11730,11413,20200112,23143
20200109,3,경찰병원,9450,9432,20200112,18882
20200109,3,오금,8072,7146,20200112,15218
20200110,3,지축,2237,2261,20200113,4498
20200110,3,구파발,25440,23298,20200113,48738
20200110,3,연신내,46987,45485,20200113,92472
20200110,3,불광,20164,21572,20200113,41736
20200110,3,녹번,16320,14325,20200113,30645
20200110,3,홍제,21494,20062,20200113,41556
20200110,3,무악재,4679,4720,20200113,9399
20200110,3,독립문,8734,8875,20200113,17609
20200110,3,경복궁,25844,26345,20200113,52189
20200110,3,안국,27700,29247,20200113,56947
20200110,3,종로3가,13205,16182,20200113,29387
20200110,3,을지로3가,14135,14502,20200113,28637
20200110,3,충무로,3,0,20200113,3
20200110,3,동대입구,11484,12390,20200113,23874
20200110,3,약수,16354,15615,20200113,31969
20200110,3,금호,9930,9235,20200113,19165
20200110,3,옥수,11283,11398,20200113,22681
20200110,3,압구정,41781,45616,20200113,87397
20200110,3,신사,39918,44161,20200113,84079
20200110,3,잠원,7652,7177,20200113,14829
20200110,3,고속터미널,65813,66587,20200113,132400
20200110,3,교대,18792,11979,20200113,30771
20200110,3,남부터미널,40827,40226,20200113,81053
20200110,3,양재,51602,53686,20200113,105288
20200110,3,매봉,14175,13630,20200113,27805
20200110,3,도곡,7044,6988,20200113,14032
20200110,3,대치,15091,14741,20200113,29832
20200110,3,학여울,2927,2935,20200113,5862
20200110,3,대청,11884,10700,20200113,22584
20200110,3,일원,12083,11884,20200113,23967
20200110,3,수서,22940,21827,20200113,44767
20200110,3,가락시장,12183,12185,20200113,24368
20200110,3,경찰병원,9617,9555,20200113,19172
20200110,3,오금,8278,7199,20200113,15477
20200111,3,지축,1565,1681,20200114,3246
20200111,3,구파발,19056,18379,20200114,37435
20200111,3,연신내,38171,36184,20200114,74355
20200111,3,불광,15964,18206,20200114,34170
20200111,3,녹번,11627,10073,20200114,21700
20200111,3,홍제,16755,16081,20200114,32836
20200111,3,무악재,3362,3527,20200114,6889
20200111,3,독립문,7761,8027,20200114,15788
20200111,3,경복궁,27756,26755,20200114,54511
20200111,3,안국,22094,23885,20200114,45979
20200111,3,종로3가,9055,13456,20200114,22511
20200111,3,을지로3가,7276,8027,20200114,15303
20200111,3,충무로,2,0,20200114,2
20200111,3,동대입구,10190,11441,20200114,21631
20200111,3,약수,11546,10660,20200114,22206
20200111,3,금호,7486,6648,20200114,14134
20200111,3,옥수,8407,8588,20200114,16995
20200111,3,압구정,32258,34679,20200114,66937
20200111,3,신사,33286,35882,20200114,69168
20200111,3,잠원,5108,4867,20200114,9975
20200111,3,고속터미널,74941,74985,20200114,149926
20200111,3,교대,9851,5848,20200114,15699
20200111,3,남부터미널,32084,31125,20200114,63209
20200111,3,양재,29816,31233,20200114,61049
20200111,3,매봉,7252,6830,20200114,14082
20200111,3,도곡,4434,4505,20200114,8939
20200111,3,대치,11802,10609,20200114,22411
20200111,3,학여울,2448,2501,20200114,4949
20200111,3,대청,7591,6914,20200114,14505
20200111,3,일원,6448,6548,20200114,12996
20200111,3,수서,17036,16657,20200114,33693
20200111,3,가락시장,8384,7948,20200114,16332
20200111,3,경찰병원,5210,4987,20200114,10197
20200111,3,오금,5098,4699,20200114,9797
20200112,3,지축,1142,1194,20200115,2336
20200112,3,구파발,13937,13819,20200115,27756
20200112,3,연신내,26954,25803,20200115,52757
20200112,3,불광,11920,13714,20200115,25634
20200112,3,녹번,7587,6764,20200115,14351
20200112,3,홍제,11294,10993,20200115,22287
20200112,3,무악재,2252,2498,20200115,4750
20200112,3,독립문,5699,5847,20200115,11546
20200112,3,경복궁,15312,15862,20200115,31174
20200112,3,안국,14523,15009,20200115,29532
20200112,3,종로3가,5364,7534,20200115,12898
20200112,3,을지로3가,4877,4817,20200115,9694
20200112,3,동대입구,7680,8675,20200115,16355
20200112,3,약수,8573,8217,20200115,16790
20200112,3,금호,5267,5068,20200115,10335
20200112,3,옥수,5809,6320,20200115,12129
20200112,3,압구정,18457,18800,20200115,37257
20200112,3,신사,19599,19642,20200115,39241
20200112,3,잠원,3229,3338,20200115,6567
20200112,3,고속터미널,58310,57631,20200115,115941
20200112,3,교대,5831,3406,20200115,9237
20200112,3,남부터미널,20644,22176,20200115,42820
20200112,3,양재,18870,20520,20200115,39390
20200112,3,매봉,4619,4558,20200115,9177
20200112,3,도곡,2463,2594,20200115,5057
20200112,3,대치,7556,6887,20200115,14443
20200112,3,학여울,1828,1975,20200115,3803
20200112,3,대청,4957,4755,20200115,9712
20200112,3,일원,4423,4706,20200115,9129
20200112,3,수서,12318,12535,20200115,24853
20200112,3,가락시장,4671,5035,20200115,9706
20200112,3,경찰병원,3671,3727,20200115,7398
20200112,3,오금,3510,3367,20200115,6877
20200113,3,지축,2224,2274,20200116,4498
20200113,3,구파발,24645,22523,20200116,47168
20200113,3,연신내,44370,42512,20200116,86882
20200113,3,불광,19157,20578,20200116,39735
20200113,3,녹번,15815,14054,20200116,29869
20200113,3,홍제,20428,19286,20200116,39714
20200113,3,무악재,4518,4563,20200116,9081
20200113,3,독립문,8059,8193,20200116,16252
20200113,3,경복궁,24252,24388,20200116,48640
20200113,3,안국,26343,27157,20200116,53500
20200113,3,종로3가,12632,15021,20200116,27653
20200113,3,을지로3가,13555,14056,20200116,27611
20200113,3,충무로,1,0,20200116,1
20200113,3,동대입구,10194,10989,20200116,21183
20200113,3,약수,15388,15087,20200116,30475
20200113,3,금호,9458,8786,20200116,18244
20200113,3,옥수,10753,11107,20200116,21860
20200113,3,압구정,39255,42799,20200116,82054
20200113,3,신사,37213,39404,20200116,76617
20200113,3,잠원,7191,6865,20200116,14056
20200113,3,고속터미널,55448,53223,20200116,108671
20200113,3,교대,17944,11700,20200116,29644
20200113,3,남부터미널,35653,36116,20200116,71769
20200113,3,양재,46691,51221,20200116,97912
20200113,3,매봉,13995,13292,20200116,27287
20200113,3,도곡,6653,6714,20200116,13367
20200113,3,대치,14653,14057,20200116,28710
20200113,3,학여울,2137,2201,20200116,4338
20200113,3,대청,11479,10393,20200116,21872
20200113,3,일원,12290,12401,20200116,24691
20200113,3,수서,20025,20321,20200116,40346
20200113,3,가락시장,11747,11463,20200116,23210
20200113,3,경찰병원,9465,9432,20200116,18897
20200113,3,오금,7543,6714,20200116,14257
20200114,3,오금,7804,6935,20200117,14739
20200114,3,경찰병원,9421,9516,20200117,18937
20200114,3,가락시장,11905,11573,20200117,23478
20200114,3,수서,20276,20227,20200117,40503
20200114,3,일원,12387,12365,20200117,24752
20200114,3,대청,11580,10541,20200117,22121
20200114,3,학여울,2294,2360,20200117,4654
20200114,3,대치,14688,14261,20200117,28949
20200114,3,도곡,6730,6775,20200117,13505
20200114,3,매봉,14225,13578,20200117,27803
20200114,3,양재,48868,52556,20200117,101424
20200114,3,남부터미널,37083,37468,20200117,74551
20200114,3,교대,18617,11916,20200117,30533
20200114,3,고속터미널,55611,53555,20200117,109166
20200114,3,잠원,7295,7080,20200117,14375
20200114,3,신사,37687,40245,20200117,77932
20200114,3,압구정,39632,42935,20200117,82567
20200114,3,옥수,10849,11219,20200117,22068
20200114,3,금호,9530,8797,20200117,18327
20200114,3,약수,15622,15363,20200117,30985
20200114,3,동대입구,10899,11768,20200117,22667
20200114,3,충무로,2,0,20200117,2
20200114,3,을지로3가,13594,13981,20200117,27575
20200114,3,종로3가,12877,15095,20200117,27972
20200114,3,안국,27153,28268,20200117,55421
20200114,3,경복궁,23318,23212,20200117,46530
20200114,3,독립문,8748,8920,20200117,17668
20200114,3,무악재,4619,4670,20200117,9289
20200114,3,홍제,20339,19430,20200117,39769
20200114,3,녹번,15912,14121,20200117,30033
20200114,3,불광,19384,21004,20200117,40388
20200114,3,연신내,44547,42434,20200117,86981
20200114,3,구파발,24764,22889,20200117,47653
20200114,3,지축,2317,2364,20200117,4681
20200115,3,지축,2265,2341,20200118,4606
20200115,3,구파발,25053,23113,20200118,48166
20200115,3,연신내,45300,43279,20200118,88579
20200115,3,불광,19511,20987,20200118,40498
20200115,3,녹번,16140,14191,20200118,30331
20200115,3,홍제,20505,19572,20200118,40077
20200115,3,무악재,4638,4619,20200118,9257
20200115,3,독립문,8585,8956,20200118,17541
20200115,3,경복궁,25642,25822,20200118,51464
20200115,3,안국,27423,28701,20200118,56124
20200115,3,종로3가,13160,15591,20200118,28751
20200115,3,을지로3가,13793,14270,20200118,28063
20200115,3,동대입구,10782,11616,20200118,22398
20200115,3,약수,15673,15034,20200118,30707
20200115,3,금호,9848,9161,20200118,19009
20200115,3,옥수,10818,11010,20200118,21828
20200115,3,압구정,39837,43386,20200118,83223
20200115,3,신사,37879,40447,20200118,78326
20200115,3,잠원,7315,7105,20200118,14420
20200115,3,고속터미널,55935,54187,20200118,110122
20200115,3,교대,18711,12027,20200118,30738
20200115,3,남부터미널,37812,38197,20200118,76009
20200115,3,양재,48614,52301,20200118,100915
20200115,3,매봉,14212,13532,20200118,27744
20200115,3,도곡,6788,6912,20200118,13700
20200115,3,대치,14474,14171,20200118,28645
20200115,3,학여울,2349,2488,20200118,4837
20200115,3,대청,11675,10543,20200118,22218
20200115,3,일원,12133,12184,20200118,24317
20200115,3,수서,20226,19985,20200118,40211
20200115,3,가락시장,11999,11758,20200118,23757
20200115,3,경찰병원,9596,9556,20200118,19152
20200115,3,오금,7696,6889,20200118,14585
20200116,3,오금,7833,6876,20200119,14709
20200116,3,경찰병원,9711,9622,20200119,19333
20200116,3,가락시장,12059,11783,20200119,23842
20200116,3,수서,20358,20366,20200119,40724
20200116,3,일원,12490,12314,20200119,24804
20200116,3,대청,12165,11009,20200119,23174
20200116,3,학여울,2838,2867,20200119,5705
20200116,3,대치,14674,14410,20200119,29084
20200116,3,도곡,6729,6710,20200119,13439
20200116,3,매봉,14264,13687,20200119,27951
20200116,3,양재,49622,54147,20200119,103769
20200116,3,남부터미널,37909,38385,20200119,76294
20200116,3,교대,19043,11999,20200119,31042
20200116,3,고속터미널,57267,54944,20200119,112211
20200116,3,잠원,7347,7042,20200119,14389
20200116,3,신사,38552,41525,20200119,80077
20200116,3,압구정,39919,43534,20200119,83453
20200116,3,옥수,11053,11341,20200119,22394
20200116,3,금호,9767,9040,20200119,18807
20200116,3,약수,15809,15093,20200119,30902
20200116,3,동대입구,13707,15178,20200119,28885
20200116,3,충무로,3,0,20200119,3
20200116,3,을지로3가,13584,14339,20200119,27923
20200116,3,종로3가,13422,15826,20200119,29248
20200116,3,안국,27222,29021,20200119,56243
20200116,3,경복궁,25324,25442,20200119,50766
20200116,3,독립문,8555,8833,20200119,17388
20200116,3,무악재,4683,4645,20200119,9328
20200116,3,홍제,20324,19195,20200119,39519
20200116,3,녹번,16304,14242,20200119,30546
20200116,3,불광,19346,21121,20200119,40467
20200116,3,연신내,45344,43393,20200119,88737
20200116,3,구파발,24815,22845,20200119,47660
20200116,3,지축,2366,2362,20200119,4728
20200117,3,지축,2432,2384,20200120,4816
20200117,3,구파발,25481,23260,20200120,48741
20200117,3,연신내,46920,44864,20200120,91784
20200117,3,불광,20079,21673,20200120,41752
20200117,3,녹번,16589,14249,20200120,30838
20200117,3,홍제,21296,19760,20200120,41056
20200117,3,무악재,4758,4736,20200120,9494
20200117,3,독립문,8821,8939,20200120,17760
20200117,3,경복궁,26220,26475,20200120,52695
20200117,3,안국,28013,29364,20200120,57377
20200117,3,종로3가,13687,16962,20200120,30649
20200117,3,을지로3가,14009,15080,20200120,29089
20200117,3,충무로,2,0,20200120,2
20200117,3,동대입구,10907,11894,20200120,22801
20200117,3,약수,16467,15907,20200120,32374
20200117,3,금호,10357,9548,20200120,19905
20200117,3,옥수,11384,11527,20200120,22911
20200117,3,압구정,42755,46843,20200120,89598
20200117,3,신사,41071,45464,20200120,86535
20200117,3,잠원,7771,7364,20200120,15135
20200117,3,고속터미널,66462,65405,20200120,131867
20200117,3,교대,19706,12821,20200120,32527
20200117,3,남부터미널,42638,41629,20200120,84267
20200117,3,양재,52607,55071,20200120,107678
20200117,3,매봉,14028,13507,20200120,27535
20200117,3,도곡,6787,7109,20200120,13896
20200117,3,대치,15011,14517,20200120,29528
20200117,3,학여울,2762,2884,20200120,5646
20200117,3,대청,11815,10793,20200120,22608
20200117,3,일원,12191,11636,20200120,23827
20200117,3,수서,22789,21931,20200120,44720
20200117,3,가락시장,12609,12490,20200120,25099
20200117,3,경찰병원,9966,9819,20200120,19785
20200117,3,오금,7861,6894,20200120,14755
20200118,3,지축,1705,1735,20200121,3440
20200118,3,구파발,18435,18132,20200121,36567
20200118,3,연신내,37597,35534,20200121,73131
20200118,3,불광,16189,18492,20200121,34681
20200118,3,녹번,11619,9760,20200121,21379
20200118,3,홍제,16703,15807,20200121,32510
20200118,3,무악재,3349,3462,20200121,6811
20200118,3,독립문,7779,8211,20200121,15990
20200118,3,경복궁,25236,23868,20200121,49104
20200118,3,안국,22907,24476,20200121,47383
20200118,3,종로3가,9037,13111,20200121,22148
20200118,3,을지로3가,7516,8185,20200121,15701
20200118,3,충무로,1,0,20200121,1
20200118,3,동대입구,9013,10311,20200121,19324
20200118,3,약수,11699,11029,20200121,22728
20200118,3,금호,7298,6651,20200121,13949
20200118,3,옥수,8624,8595,20200121,17219
20200118,3,압구정,32502,34824,20200121,67326
20200118,3,신사,32899,35561,20200121,68460
20200118,3,잠원,5118,4896,20200121,10014
20200118,3,고속터미널,73140,71346,20200121,144486
20200118,3,교대,9842,5758,20200121,15600
20200118,3,남부터미널,33497,32652,20200121,66149
20200118,3,양재,28382,30057,20200121,58439
20200118,3,매봉,7220,6778,20200121,13998
20200118,3,도곡,4944,4934,20200121,9878
20200118,3,대치,11839,10564,20200121,22403
20200118,3,학여울,2051,2032,20200121,4083
20200118,3,대청,7833,6966,20200121,14799
20200118,3,일원,6620,6634,20200121,13254
20200118,3,수서,16938,17047,20200121,33985
20200118,3,가락시장,8459,8208,20200121,16667
20200118,3,경찰병원,5365,5267,20200121,10632
20200118,3,오금,4991,4491,20200121,9482
20200119,3,약수,8495,7827,20200122,16322
20200119,3,지축,1272,1285,20200122,2557
20200119,3,구파발,13655,13920,20200122,27575
20200119,3,연신내,26659,25087,20200122,51746
20200119,3,불광,11576,13258,20200122,24834
20200119,3,녹번,7772,6818,20200122,14590
20200119,3,홍제,11204,10764,20200122,21968
20200119,3,무악재,2175,2357,20200122,4532
20200119,3,독립문,5664,6024,20200122,11688
20200119,3,경복궁,14083,14376,20200122,28459
20200119,3,안국,13206,13853,20200122,27059
20200119,3,종로3가,5162,7119,20200122,12281
20200119,3,을지로3가,4590,4679,20200122,9269
20200119,3,동대입구,8943,9854,20200122,18797
20200119,3,금호,5240,4947,20200122,10187
20200119,3,옥수,5666,6114,20200122,11780
20200119,3,압구정,18860,19506,20200122,38366
20200119,3,신사,18761,18912,20200122,37673
20200119,3,잠원,3230,3394,20200122,6624
20200119,3,고속터미널,53784,54963,20200122,108747
20200119,3,교대,5522,3373,20200122,8895
20200119,3,남부터미널,20745,22364,20200122,43109
20200119,3,양재,18752,21019,20200122,39771
20200119,3,매봉,4554,4490,20200122,9044
20200119,3,도곡,2638,2770,20200122,5408
20200119,3,대치,7464,6697,20200122,14161
20200119,3,학여울,1203,1265,20200122,2468
20200119,3,대청,4943,4838,20200122,9781
20200119,3,일원,4418,4700,20200122,9118
20200119,3,수서,12165,12370,20200122,24535
20200119,3,가락시장,5367,5406,20200122,10773
20200119,3,경찰병원,3662,3811,20200122,7473
20200119,3,오금,3586,3367,20200122,6953
20200120,3,오금,7715,6749,20200123,14464
20200120,3,경찰병원,9762,9767,20200123,19529
20200120,3,가락시장,12229,11898,20200123,24127
20200120,3,수서,20134,20743,20200123,40877
20200120,3,일원,12021,11965,20200123,23986
20200120,3,대청,11790,10757,20200123,22547
20200120,3,학여울,2164,2206,20200123,4370
20200120,3,대치,14690,14316,20200123,29006
20200120,3,도곡,6742,6847,20200123,13589
20200120,3,매봉,14225,13656,20200123,27881
20200120,3,양재,47763,52309,20200123,100072
20200120,3,남부터미널,36377,37260,20200123,73637
20200120,3,교대,18023,11678,20200123,29701
20200120,3,고속터미널,55697,54306,20200123,110003
20200120,3,잠원,7405,7145,20200123,14550
20200120,3,신사,37567,40006,20200123,77573
20200120,3,압구정,39987,43316,20200123,83303
20200120,3,옥수,10672,11035,20200123,21707
20200120,3,금호,9652,9070,20200123,18722
20200120,3,약수,15747,15240,20200123,30987
20200120,3,동대입구,9902,10763,20200123,20665
20200120,3,충무로,3,0,20200123,3
20200120,3,을지로3가,13449,14030,20200123,27479
20200120,3,종로3가,13071,15507,20200123,28578
20200120,3,안국,26372,27326,20200123,53698
20200120,3,경복궁,24136,24660,20200123,48796
20200120,3,독립문,7995,8214,20200123,16209
20200120,3,무악재,4624,4617,20200123,9241
20200120,3,홍제,20523,19480,20200123,40003
20200120,3,녹번,16112,14203,20200123,30315
20200120,3,불광,19161,20829,20200123,39990
20200120,3,연신내,45052,42852,20200123,87904
20200120,3,구파발,25054,22853,20200123,47907
20200120,3,지축,2378,2450,20200123,4828
20200121,3,지축,2395,2393,20200124,4788
20200121,3,구파발,25272,23095,20200124,48367
20200121,3,연신내,45627,43517,20200124,89144
20200121,3,불광,20057,21820,20200124,41877
20200121,3,녹번,16152,15145,20200124,31297
20200121,3,홍제,20521,19640,20200124,40161
20200121,3,무악재,4603,4596,20200124,9199
20200121,3,독립문,8610,8726,20200124,17336
20200121,3,경복궁,23512,23205,20200124,46717
20200121,3,안국,26795,27820,20200124,54615
20200121,3,종로3가,13284,15540,20200124,28824
20200121,3,을지로3가,13390,13898,20200124,27288
20200121,3,충무로,2,0,20200124,2
20200121,3,동대입구,11198,11620,20200124,22818
20200121,3,약수,15795,15488,20200124,31283
20200121,3,금호,9829,8971,20200124,18800
20200121,3,옥수,10825,11116,20200124,21941
20200121,3,압구정,40551,43660,20200124,84211
20200121,3,신사,38189,40733,20200124,78922
20200121,3,잠원,7424,7097,20200124,14521
20200121,3,고속터미널,55817,57254,20200124,113071
20200121,3,교대,18789,11685,20200124,30474
20200121,3,남부터미널,37479,38891,20200124,76370
20200121,3,양재,48800,52381,20200124,101181
20200121,3,매봉,14364,13782,20200124,28146
20200121,3,도곡,6767,6777,20200124,13544
20200121,3,대치,15111,14682,20200124,29793
20200121,3,학여울,2148,2120,20200124,4268
20200121,3,대청,11918,10903,20200124,22821
20200121,3,일원,12360,12113,20200124,24473
20200121,3,수서,20129,20299,20200124,40428
20200121,3,가락시장,12308,12375,20200124,24683
20200121,3,경찰병원,9346,9319,20200124,18665
20200121,3,오금,7735,6801,20200124,14536
20200122,3,지축,2408,2411,20200125,4819
20200122,3,구파발,24808,22571,20200125,47379
20200122,3,연신내,46047,43633,20200125,89680
20200122,3,불광,19646,21194,20200125,40840
20200122,3,녹번,16096,14123,20200125,30219
20200122,3,홍제,20944,19383,20200125,40327
20200122,3,무악재,4590,4574,20200125,9164
20200122,3,독립문,8661,8708,20200125,17369
20200122,3,경복궁,24769,24470,20200125,49239
20200122,3,안국,25829,26703,20200125,52532
20200122,3,종로3가,12861,15242,20200125,28103
20200122,3,을지로3가,13468,13965,20200125,27433
20200122,3,충무로,3,0,20200125,3
20200122,3,동대입구,9635,10202,20200125,19837
20200122,3,약수,15850,15120,20200125,30970
20200122,3,금호,9932,9100,20200125,19032
20200122,3,옥수,10793,11025,20200125,21818
20200122,3,압구정,40252,43283,20200125,83535
20200122,3,신사,37663,40050,20200125,77713
20200122,3,잠원,7315,7111,20200125,14426
20200122,3,고속터미널,54285,64702,20200125,118987
20200122,3,교대,18128,11604,20200125,29732
20200122,3,남부터미널,37820,41117,20200125,78937
20200122,3,양재,47858,51511,20200125,99369
20200122,3,매봉,13920,13201,20200125,27121
20200122,3,도곡,6533,6486,20200125,13019
20200122,3,대치,14625,14148,20200125,28773
20200122,3,학여울,2061,2110,20200125,4171
20200122,3,대청,11638,10433,20200125,22071
20200122,3,일원,12032,11790,20200125,23822
20200122,3,수서,19817,20513,20200125,40330
20200122,3,가락시장,12355,12022,20200125,24377
20200122,3,경찰병원,9458,9324,20200125,18782
20200122,3,오금,7704,6760,20200125,14464
20200123,3,지축,2312,2240,20200126,4552
20200123,3,구파발,23572,20982,20200126,44554
20200123,3,연신내,44684,42443,20200126,87127
20200123,3,불광,18803,20122,20200126,38925
20200123,3,녹번,15293,12617,20200126,27910
20200123,3,홍제,19753,18040,20200126,37793
20200123,3,무악재,4399,4160,20200126,8559
20200123,3,독립문,8192,7874,20200126,16066
20200123,3,경복궁,22144,21259,20200126,43403
20200123,3,안국,19832,20866,20200126,40698
20200123,3,종로3가,11673,14468,20200126,26141
20200123,3,을지로3가,12037,12441,20200126,24478
20200123,3,충무로,3,0,20200126,3
20200123,3,동대입구,8841,9238,20200126,18079
20200123,3,약수,15027,13652,20200126,28679
20200123,3,금호,9518,8406,20200126,17924
20200123,3,옥수,10522,10456,20200126,20978
20200123,3,압구정,37237,39778,20200126,77015
20200123,3,신사,35753,38232,20200126,73985
20200123,3,잠원,6783,6380,20200126,13163
20200123,3,고속터미널,56454,96688,20200126,153142
20200123,3,교대,15263,9687,20200126,24950
20200123,3,남부터미널,36600,45800,20200126,82400
20200123,3,양재,43985,44179,20200126,88164
20200123,3,매봉,12572,11514,20200126,24086
20200123,3,도곡,5942,6030,20200126,11972
20200123,3,대치,14114,13519,20200126,27633
20200123,3,학여울,1933,1886,20200126,3819
20200123,3,대청,10920,9451,20200126,20371
20200123,3,일원,11397,10802,20200126,22199
20200123,3,수서,18874,20910,20200126,39784
20200123,3,가락시장,11655,11321,20200126,22976
20200123,3,경찰병원,8801,8278,20200126,17079
20200123,3,오금,7149,5891,20200126,13040
20200124,3,오금,2615,1958,20200127,4573
20200124,3,경찰병원,2786,2294,20200127,5080
20200124,3,가락시장,4566,4160,20200127,8726
20200124,3,수서,8290,10985,20200127,19275
20200124,3,일원,2961,2786,20200127,5747
20200124,3,대청,3979,3083,20200127,7062
20200124,3,학여울,577,542,20200127,1119
20200124,3,대치,5428,4486,20200127,9914
20200124,3,도곡,1814,1659,20200127,3473
20200124,3,매봉,3188,2664,20200127,5852
20200124,3,양재,9425,9087,20200127,18512
20200124,3,남부터미널,15661,24268,20200127,39929
20200124,3,교대,3248,1749,20200127,4997
20200124,3,고속터미널,31403,65199,20200127,96602
20200124,3,잠원,2471,2181,20200127,4652
20200124,3,신사,12762,13077,20200127,25839
20200124,3,압구정,13710,13890,20200127,27600
20200124,3,옥수,4477,4111,20200127,8588
20200124,3,금호,4082,3506,20200127,7588
20200124,3,약수,5980,5048,20200127,11028
20200124,3,동대입구,4431,4768,20200127,9199
20200124,3,을지로3가,2634,2582,20200127,5216
20200124,3,종로3가,3477,5179,20200127,8656
20200124,3,안국,9525,9845,20200127,19370
20200124,3,경복궁,10654,11574,20200127,22228
20200124,3,독립문,3824,3493,20200127,7317
20200124,3,무악재,1788,1678,20200127,3466
20200124,3,홍제,8926,8069,20200127,16995
20200124,3,녹번,6188,4950,20200127,11138
20200124,3,불광,8706,9484,20200127,18190
20200124,3,연신내,22045,19669,20200127,41714
20200124,3,구파발,10691,10217,20200127,20908
20200124,3,지축,954,993,20200127,1947
20200125,3,지축,913,923,20200128,1836
20200125,3,구파발,9653,9332,20200128,18985
20200125,3,연신내,18520,18501,20200128,37021
20200125,3,불광,7104,7828,20200128,14932
20200125,3,녹번,5537,4879,20200128,10416
20200125,3,홍제,8213,7991,20200128,16204
20200125,3,무악재,1619,1694,20200128,3313
20200125,3,독립문,3058,3103,20200128,6161
20200125,3,경복궁,15808,18693,20200128,34501
20200125,3,안국,11877,11894,20200128,23771
20200125,3,종로3가,3084,5025,20200128,8109
20200125,3,을지로3가,2216,1967,20200128,4183
20200125,3,동대입구,5578,6737,20200128,12315
20200125,3,약수,5147,4907,20200128,10054
20200125,3,금호,3598,3497,20200128,7095
20200125,3,옥수,3612,3794,20200128,7406
20200125,3,압구정,5622,6060,20200128,11682
20200125,3,신사,6173,7244,20200128,13417
20200125,3,잠원,1732,1894,20200128,3626
20200125,3,고속터미널,32956,28370,20200128,61326
20200125,3,교대,1644,1079,20200128,2723
20200125,3,남부터미널,14255,12845,20200128,27100
20200125,3,양재,6568,7397,20200128,13965
20200125,3,매봉,2038,1998,20200128,4036
20200125,3,도곡,1119,1148,20200128,2267
20200125,3,대치,3212,3104,20200128,6316
20200125,3,학여울,476,478,20200128,954
20200125,3,대청,2945,2903,20200128,5848
20200125,3,일원,2409,2475,20200128,4884
20200125,3,수서,9477,8585,20200128,18062
20200125,3,가락시장,2659,2580,20200128,5239
20200125,3,경찰병원,2163,2161,20200128,4324
20200125,3,오금,1984,1928,20200128,3912
20200126,3,지축,1055,1054,20200129,2109
20200126,3,구파발,11926,12295,20200129,24221
20200126,3,연신내,23242,23115,20200129,46357
20200126,3,불광,9872,11906,20200129,21778
20200126,3,녹번,6236,5793,20200129,12029
20200126,3,홍제,9329,9091,20200129,18420
20200126,3,무악재,1798,2069,20200129,3867
20200126,3,독립문,4464,4736,20200129,9200
20200126,3,경복궁,15254,18252,20200129,33506
20200126,3,안국,12795,13947,20200129,26742
20200126,3,종로3가,4105,6728,20200129,10833
20200126,3,을지로3가,3900,3704,20200129,7604
20200126,3,동대입구,6923,8773,20200129,15696
20200126,3,약수,6438,6579,20200129,13017
20200126,3,금호,4420,4305,20200129,8725
20200126,3,옥수,4640,5026,20200129,9666
20200126,3,압구정,10915,11770,20200129,22685
20200126,3,신사,12266,14135,20200129,26401
20200126,3,잠원,2525,2427,20200129,4952
20200126,3,고속터미널,59992,36321,20200129,96313
20200126,3,교대,3221,2119,20200129,5340
20200126,3,남부터미널,20628,14972,20200129,35600
20200126,3,양재,10575,12261,20200129,22836
20200126,3,매봉,3114,3176,20200129,6290
20200126,3,도곡,1731,1762,20200129,3493
20200126,3,대치,4473,4476,20200129,8949
20200126,3,학여울,589,646,20200129,1235
20200126,3,대청,3802,3830,20200129,7632
20200126,3,일원,3186,3325,20200129,6511
20200126,3,수서,11296,8210,20200129,19506
20200126,3,가락시장,3401,3482,20200129,6883
20200126,3,경찰병원,2602,2969,20200129,5571
20200126,3,오금,2687,2731,20200129,5418
20200127,3,지축,1065,1026,20200130,2091
20200127,3,구파발,11673,12512,20200130,24185
20200127,3,연신내,23534,23065,20200130,46599
20200127,3,불광,10124,12213,20200130,22337
20200127,3,녹번,6159,5711,20200130,11870
20200127,3,홍제,9359,9413,20200130,18772
20200127,3,무악재,2031,2156,20200130,4187
20200127,3,독립문,4114,4464,20200130,8578
20200127,3,경복궁,12337,13326,20200130,25663
20200127,3,안국,11764,12387,20200130,24151
20200127,3,종로3가,4434,6638,20200130,11072
20200127,3,을지로3가,3480,3213,20200130,6693
20200127,3,동대입구,4417,5357,20200130,9774
20200127,3,약수,6426,6619,20200130,13045
20200127,3,금호,4461,4293,20200130,8754
20200127,3,옥수,4894,5469,20200130,10363
20200127,3,압구정,14373,15375,20200130,29748
20200127,3,신사,16098,17206,20200130,33304
20200127,3,잠원,2769,2888,20200130,5657
20200127,3,고속터미널,64244,39980,20200130,104224
20200127,3,교대,4065,2689,20200130,6754
20200127,3,남부터미널,23046,18404,20200130,41450
20200127,3,양재,11748,14358,20200130,26106
20200127,3,매봉,3583,3620,20200130,7203
20200127,3,도곡,2035,2252,20200130,4287
20200127,3,대치,5640,5289,20200130,10929
20200127,3,학여울,655,667,20200130,1322
20200127,3,대청,4025,4140,20200130,8165
20200127,3,일원,3224,3686,20200130,6910
20200127,3,수서,12244,9235,20200130,21479
20200127,3,가락시장,4086,4358,20200130,8444
20200127,3,경찰병원,2997,3200,20200130,6197
20200127,3,오금,2668,2565,20200130,5233
20200128,3,지축,2298,2258,20200131,4556
20200128,3,구파발,22157,20664,20200131,42821
20200128,3,연신내,41591,39632,20200131,81223
20200128,3,불광,17648,19211,20200131,36859
20200128,3,녹번,14264,12932,20200131,27196
20200128,3,홍제,18523,17815,20200131,36338
20200128,3,무악재,4093,4151,20200131,8244
20200128,3,독립문,7300,7563,20200131,14863
20200128,3,경복궁,20100,19910,20200131,40010
20200128,3,안국,22423,23408,20200131,45831
20200128,3,종로3가,11587,13732,20200131,25319
20200128,3,을지로3가,11636,12082,20200131,23718
20200128,3,동대입구,8025,8741,20200131,16766
20200128,3,약수,13795,13511,20200131,27306
20200128,3,금호,8654,8166,20200131,16820
20200128,3,옥수,9528,9956,20200131,19484
20200128,3,압구정,34755,37853,20200131,72608
20200128,3,신사,32493,34874,20200131,67367
20200128,3,잠원,6232,6029,20200131,12261
20200128,3,고속터미널,52376,42944,20200131,95320
20200128,3,교대,14669,9854,20200131,24523
20200128,3,남부터미널,34530,33074,20200131,67604
20200128,3,양재,40274,44207,20200131,84481
20200128,3,매봉,12581,11938,20200131,24519
20200128,3,도곡,5709,5803,20200131,11512
20200128,3,대치,12615,12327,20200131,24942
20200128,3,학여울,1831,1841,20200131,3672
20200128,3,대청,10406,9720,20200131,20126
20200128,3,일원,10409,10568,20200131,20977
20200128,3,수서,18095,17328,20200131,35423
20200128,3,가락시장,9761,9606,20200131,19367
20200128,3,경찰병원,8379,8572,20200131,16951
20200128,3,오금,6942,6154,20200131,13096
20200129,3,지축,2364,2445,20200201,4809
20200129,3,구파발,23615,22076,20200201,45691
20200129,3,연신내,43144,41133,20200201,84277
20200129,3,불광,18538,19990,20200201,38528
20200129,3,녹번,15256,13662,20200201,28918
20200129,3,홍제,19511,18562,20200201,38073
20200129,3,무악재,4351,4338,20200201,8689
20200129,3,독립문,8025,8103,20200201,16128
20200129,3,경복궁,23199,23213,20200201,46412
20200129,3,안국,24716,25993,20200201,50709
20200129,3,종로3가,12332,14416,20200201,26748
20200129,3,을지로3가,12744,13231,20200201,25975
20200129,3,충무로,1,0,20200201,1
20200129,3,동대입구,9745,10525,20200201,20270
20200129,3,약수,14626,14196,20200201,28822
20200129,3,금호,9171,8496,20200201,17667
20200129,3,옥수,10074,10361,20200201,20435
20200129,3,압구정,35980,38951,20200201,74931
20200129,3,신사,34331,36927,20200201,71258
20200129,3,잠원,6715,6358,20200201,13073
20200129,3,고속터미널,46965,43772,20200201,90737
20200129,3,교대,16474,10985,20200201,27459
20200129,3,남부터미널,36241,36553,20200201,72794
20200129,3,양재,43884,47684,20200201,91568
20200129,3,매봉,13241,12736,20200201,25977
20200129,3,도곡,6171,6281,20200201,12452
20200129,3,대치,12879,12686,20200201,25565
20200129,3,학여울,2088,2140,20200201,4228
20200129,3,대청,11050,10097,20200201,21147
20200129,3,일원,10950,11050,20200201,22000
20200129,3,수서,18280,18455,20200201,36735
20200129,3,가락시장,10398,10099,20200201,20497
20200129,3,경찰병원,9068,9093,20200201,18161
20200129,3,오금,7245,6315,20200201,13560
20200130,3,오금,7388,6244,20200202,13632
20200130,3,경찰병원,9040,8959,20200202,17999
20200130,3,가락시장,10782,10627,20200202,21409
20200130,3,수서,18765,18889,20200202,37654
20200130,3,일원,11123,10876,20200202,21999
20200130,3,대청,11664,10467,20200202,22131
20200130,3,학여울,2049,2067,20200202,4116
20200130,3,대치,13405,13346,20200202,26751
20200130,3,도곡,6237,6358,20200202,12595
20200130,3,매봉,13430,12900,20200202,26330
20200130,3,양재,45133,48693,20200202,93826
20200130,3,남부터미널,35597,36004,20200202,71601
20200130,3,교대,16862,11028,20200202,27890
20200130,3,고속터미널,46824,44865,20200202,91689
20200130,3,잠원,6599,6370,20200202,12969
20200130,3,신사,35221,37930,20200202,73151
20200130,3,압구정,36114,39080,20200202,75194
20200130,3,옥수,10159,10586,20200202,20745
20200130,3,금호,9151,8508,20200202,17659
20200130,3,약수,14938,14587,20200202,29525
20200130,3,동대입구,8658,9475,20200202,18133
20200130,3,충무로,3,0,20200202,3
20200130,3,을지로3가,12925,13379,20200202,26304
20200130,3,종로3가,12103,14247,20200202,26350
20200130,3,안국,24658,25950,20200202,50608
20200130,3,경복궁,22529,22646,20200202,45175
20200130,3,독립문,7816,8025,20200202,15841
20200130,3,무악재,4385,4487,20200202,8872
20200130,3,홍제,19389,18518,20200202,37907
20200130,3,녹번,15178,13641,20200202,28819
20200130,3,불광,18497,20054,20200202,38551
20200130,3,연신내,44083,41588,20200202,85671
20200130,3,구파발,23665,21734,20200202,45399
20200130,3,지축,2443,2460,20200202,4903
20200131,3,지축,2480,2530,20200203,5010
20200131,3,구파발,23677,21650,20200203,45327
20200131,3,연신내,44285,42198,20200203,86483
20200131,3,불광,18682,20028,20200203,38710
20200131,3,녹번,15321,13171,20200203,28492
20200131,3,홍제,19579,18364,20200203,37943
20200131,3,무악재,4292,4370,20200203,8662
20200131,3,독립문,7835,8036,20200203,15871
20200131,3,경복궁,22457,22878,20200203,45335
20200131,3,안국,25464,26268,20200203,51732
20200131,3,종로3가,12215,14790,20200203,27005
20200131,3,을지로3가,13053,13719,20200203,26772
20200131,3,동대입구,8778,9411,20200203,18189
20200131,3,약수,15005,14466,20200203,29471
20200131,3,금호,9447,8678,20200203,18125
20200131,3,옥수,10195,10294,20200203,20489
20200131,3,압구정,36564,40008,20200203,76572
20200131,3,신사,36076,39449,20200203,75525
20200131,3,잠원,6757,6404,20200203,13161
20200131,3,고속터미널,50449,50455,20200203,100904
20200131,3,교대,17260,11312,20200203,28572
20200131,3,남부터미널,37568,37716,20200203,75284
20200131,3,양재,47892,50351,20200203,98243
20200131,3,매봉,13227,12695,20200203,25922
20200131,3,도곡,5999,6303,20200203,12302
20200131,3,대치,13783,13563,20200203,27346
20200131,3,학여울,4182,4095,20200203,8277
20200131,3,대청,11635,10409,20200203,22044
20200131,3,일원,10826,10582,20200203,21408
20200131,3,수서,20620,20035,20200203,40655
20200131,3,가락시장,11122,10875,20200203,21997
20200131,3,경찰병원,9012,8859,20200203,17871
20200131,3,오금,7300,6260,20200203,13560
20200201,3,지축,1553,1574,20200204,3127
20200201,3,구파발,14928,14550,20200204,29478
20200201,3,연신내,32166,30646,20200204,62812
20200201,3,불광,13336,15168,20200204,28504
20200201,3,녹번,9152,8002,20200204,17154
20200201,3,홍제,13876,13251,20200204,27127
20200201,3,무악재,2635,2750,20200204,5385
20200201,3,독립문,5647,5867,20200204,11514
20200201,3,경복궁,16031,15026,20200204,31057
20200201,3,안국,15077,16920,20200204,31997
20200201,3,종로3가,6521,9262,20200204,15783
20200201,3,을지로3가,5533,5986,20200204,11519
20200201,3,동대입구,6015,6637,20200204,12652
20200201,3,약수,9443,8926,20200204,18369
20200201,3,금호,5941,5413,20200204,11354
20200201,3,옥수,6476,6507,20200204,12983
20200201,3,압구정,24392,25842,20200204,50234
20200201,3,신사,25918,27611,20200204,53529
20200201,3,잠원,3911,3785,20200204,7696
20200201,3,고속터미널,48285,47465,20200204,95750
20200201,3,교대,7547,4459,20200204,12006
20200201,3,남부터미널,24385,24269,20200204,48654
20200201,3,양재,23310,24924,20200204,48234
20200201,3,매봉,5510,5148,20200204,10658
20200201,3,도곡,3285,3226,20200204,6511
20200201,3,대치,9720,8781,20200204,18501
20200201,3,학여울,3224,3291,20200204,6515
20200201,3,대청,6211,5703,20200204,11914
20200201,3,일원,4802,4791,20200204,9593
20200201,3,수서,12764,12555,20200204,25319
20200201,3,가락시장,6367,6038,20200204,12405
20200201,3,경찰병원,4350,4134,20200204,8484
20200201,3,오금,3877,3357,20200204,7234
20200202,3,지축,1035,1116,20200205,2151
20200202,3,구파발,11179,11177,20200205,22356
20200202,3,연신내,23048,21836,20200205,44884
20200202,3,불광,9699,11253,20200205,20952
20200202,3,녹번,6214,5476,20200205,11690
20200202,3,홍제,9456,9089,20200205,18545
20200202,3,무악재,1804,1977,20200205,3781
20200202,3,독립문,3999,4268,20200205,8267
20200202,3,경복궁,11016,11023,20200205,22039
20200202,3,안국,9801,10486,20200205,20287
20200202,3,종로3가,3833,5043,20200205,8876
20200202,3,을지로3가,3619,3519,20200205,7138
20200202,3,충무로,1,0,20200205,1
20200202,3,동대입구,5279,5620,20200205,10899
20200202,3,약수,7030,6657,20200205,13687
20200202,3,금호,4303,4087,20200205,8390
20200202,3,옥수,4508,4740,20200205,9248
20200202,3,압구정,13656,14020,20200205,27676
20200202,3,신사,14615,14805,20200205,29420
20200202,3,잠원,2554,2646,20200205,5200
20200202,3,고속터미널,36088,35775,20200205,71863
20200202,3,교대,4442,2755,20200205,7197
20200202,3,남부터미널,15999,17297,20200205,33296
20200202,3,양재,14885,16903,20200205,31788
20200202,3,매봉,3639,3565,20200205,7204
20200202,3,도곡,2150,2289,20200205,4439
20200202,3,대치,6099,5374,20200205,11473
20200202,3,학여울,2518,2454,20200205,4972
20200202,3,대청,4204,3902,20200205,8106
20200202,3,일원,3428,3702,20200205,7130
20200202,3,수서,9549,9488,20200205,19037
20200202,3,가락시장,3905,4199,20200205,8104
20200202,3,경찰병원,2800,2824,20200205,5624
20200202,3,오금,2935,2705,20200205,5640
20200203,3,지축,2388,2443,20200206,4831
20200203,3,구파발,22291,20735,20200206,43026
20200203,3,연신내,41554,39424,20200206,80978
20200203,3,불광,17362,18267,20200206,35629
20200203,3,녹번,14403,12947,20200206,27350
20200203,3,홍제,18228,17486,20200206,35714
20200203,3,무악재,4134,4215,20200206,8349
20200203,3,독립문,7540,7688,20200206,15228
20200203,3,경복궁,20792,20682,20200206,41474
20200203,3,안국,23145,23963,20200206,47108
20200203,3,종로3가,11354,13269,20200206,24623
20200203,3,을지로3가,12355,12677,20200206,25032
20200203,3,동대입구,6869,7363,20200206,14232
20200203,3,약수,14196,13760,20200206,27956
20200203,3,금호,8776,8205,20200206,16981
20200203,3,옥수,9481,9859,20200206,19340
20200203,3,압구정,33694,36149,20200206,69843
20200203,3,신사,32444,34445,20200206,66889
20200203,3,잠원,6311,6217,20200206,12528
20200203,3,고속터미널,40831,38708,20200206,79539
20200203,3,교대,15511,10317,20200206,25828
20200203,3,남부터미널,30820,31755,20200206,62575
20200203,3,양재,41884,45563,20200206,87447
20200203,3,매봉,12897,12311,20200206,25208
20200203,3,도곡,5767,5868,20200206,11635
20200203,3,대치,12309,12291,20200206,24600
20200203,3,학여울,2995,3100,20200206,6095
20200203,3,대청,10978,9970,20200206,20948
20200203,3,일원,10728,10651,20200206,21379
20200203,3,수서,17466,18025,20200206,35491
20200203,3,가락시장,10021,9808,20200206,19829
20200203,3,경찰병원,8803,8891,20200206,17694
20200203,3,오금,7180,6161,20200206,13341
20200204,3,지축,2378,2473,20200207,4851
20200204,3,구파발,23156,21464,20200207,44620
20200204,3,연신내,41738,39651,20200207,81389
20200204,3,불광,17691,18936,20200207,36627
20200204,3,녹번,14654,13253,20200207,27907
20200204,3,홍제,18686,18011,20200207,36697
20200204,3,무악재,4289,4374,20200207,8663
20200204,3,독립문,8101,8172,20200207,16273
20200204,3,경복궁,20443,19988,20200207,40431
20200204,3,안국,24460,24870,20200207,49330
20200204,3,종로3가,11686,13309,20200207,24995
20200204,3,을지로3가,12762,12818,20200207,25580
20200204,3,충무로,2,0,20200207,2
20200204,3,동대입구,7017,7435,20200207,14452
20200204,3,약수,14506,13938,20200207,28444
20200204,3,금호,8862,8350,20200207,17212
20200204,3,옥수,9695,10177,20200207,19872
20200204,3,압구정,34232,36950,20200207,71182
20200204,3,신사,33537,35550,20200207,69087
20200204,3,잠원,6365,6312,20200207,12677
20200204,3,고속터미널,40058,38177,20200207,78235
20200204,3,교대,15633,10210,20200207,25843
20200204,3,남부터미널,32259,33162,20200207,65421
20200204,3,양재,43625,46692,20200207,90317
20200204,3,매봉,12623,12100,20200207,24723
20200204,3,도곡,6009,5998,20200207,12007
20200204,3,대치,12585,12502,20200207,25087
20200204,3,학여울,1870,1965,20200207,3835
20200204,3,대청,11120,10217,20200207,21337
20200204,3,일원,10694,10828,20200207,21522
20200204,3,수서,17893,17981,20200207,35874
20200204,3,가락시장,10005,9767,20200207,19772
20200204,3,경찰병원,8591,8574,20200207,17165
20200204,3,오금,7087,6446,20200207,13533
20200205,3,지축,2294,2374,20200208,4668
20200205,3,구파발,22182,20439,20200208,42621
20200205,3,연신내,40574,38585,20200208,79159
20200205,3,불광,16723,17898,20200208,34621
20200205,3,녹번,14418,12668,20200208,27086
20200205,3,홍제,17896,17209,20200208,35105
20200205,3,무악재,4085,4116,20200208,8201
20200205,3,독립문,7282,7533,20200208,14815
20200205,3,경복궁,21062,21059,20200208,42121
20200205,3,안국,23078,23801,20200208,46879
20200205,3,종로3가,11228,12823,20200208,24051
20200205,3,을지로3가,12394,12847,20200208,25241
20200205,3,충무로,2,0,20200208,2
20200205,3,동대입구,8144,8612,20200208,16756
20200205,3,약수,13929,13586,20200208,27515
20200205,3,금호,8615,8008,20200208,16623
20200205,3,옥수,9199,9691,20200208,18890
20200205,3,압구정,32984,35511,20200208,68495
20200205,3,신사,32329,34530,20200208,66859
20200205,3,잠원,6134,5947,20200208,12081
20200205,3,고속터미널,40045,38165,20200208,78210
20200205,3,교대,15349,9959,20200208,25308
20200205,3,남부터미널,32278,32918,20200208,65196
20200205,3,양재,42147,45273,20200208,87420
20200205,3,매봉,12630,12065,20200208,24695
20200205,3,도곡,5898,5863,20200208,11761
20200205,3,대치,12090,12072,20200208,24162
20200205,3,학여울,1749,1751,20200208,3500
20200205,3,대청,10636,10029,20200208,20665
20200205,3,일원,10407,10209,20200208,20616
20200205,3,수서,17483,17520,20200208,35003
20200205,3,가락시장,9807,9533,20200208,19340
20200205,3,경찰병원,8385,8325,20200208,16710
20200205,3,오금,6993,6108,20200208,13101
20200206,3,지축,2381,2461,20200209,4842
20200206,3,구파발,21551,19847,20200209,41398
20200206,3,연신내,40734,38527,20200209,79261
20200206,3,불광,16644,17571,20200209,34215
20200206,3,녹번,14157,12343,20200209,26500
20200206,3,홍제,17588,16769,20200209,34357
20200206,3,무악재,4044,4028,20200209,8072
20200206,3,독립문,6961,7209,20200209,14170
20200206,3,경복궁,20630,20284,20200209,40914
20200206,3,안국,22625,23578,20200209,46203
20200206,3,종로3가,11219,12742,20200209,23961
20200206,3,을지로3가,11956,12598,20200209,24554
20200206,3,충무로,3,0,20200209,3
20200206,3,동대입구,6944,7377,20200209,14321
20200206,3,약수,13869,13441,20200209,27310
20200206,3,금호,8323,7769,20200209,16092
20200206,3,옥수,9225,9584,20200209,18809
20200206,3,압구정,32269,34856,20200209,67125
20200206,3,신사,32235,34693,20200209,66928
20200206,3,잠원,6048,5791,20200209,11839
20200206,3,고속터미널,39941,38833,20200209,78774
20200206,3,교대,15312,10086,20200209,25398
20200206,3,남부터미널,31101,31597,20200209,62698
20200206,3,양재,42171,45822,20200209,87993
20200206,3,매봉,12462,11938,20200209,24400
20200206,3,도곡,5653,5732,20200209,11385
20200206,3,대치,12214,12158,20200209,24372
20200206,3,학여울,1789,1759,20200209,3548
20200206,3,대청,10654,9731,20200209,20385
20200206,3,일원,10194,10105,20200209,20299
20200206,3,수서,17178,17250,20200209,34428
20200206,3,가락시장,9223,9045,20200209,18268
20200206,3,경찰병원,8004,8100,20200209,16104
20200206,3,오금,6772,5864,20200209,12636
20200207,3,지축,2473,2527,20200210,5000
20200207,3,구파발,22287,19884,20200210,42171
20200207,3,연신내,42640,40898,20200210,83538
20200207,3,불광,17782,18932,20200210,36714
20200207,3,녹번,14552,12705,20200210,27257
20200207,3,홍제,18423,17399,20200210,35822
20200207,3,무악재,4240,4084,20200210,8324
20200207,3,독립문,7451,7799,20200210,15250
20200207,3,경복궁,21710,21618,20200210,43328
20200207,3,안국,23292,24168,20200210,47460
20200207,3,종로3가,11489,13701,20200210,25190
20200207,3,을지로3가,12517,13075,20200210,25592
20200207,3,충무로,1,0,20200210,1
20200207,3,동대입구,8230,8646,20200210,16876
20200207,3,약수,14427,14267,20200210,28694
20200207,3,금호,8980,8259,20200210,17239
20200207,3,옥수,9646,9863,20200210,19509
20200207,3,압구정,34878,37931,20200210,72809
20200207,3,신사,34561,38102,20200210,72663
20200207,3,잠원,6238,6133,20200210,12371
20200207,3,고속터미널,45957,47438,20200210,93395
20200207,3,교대,15586,10360,20200210,25946
20200207,3,남부터미널,34049,34481,20200210,68530
20200207,3,양재,45093,46667,20200210,91760
20200207,3,매봉,12520,11936,20200210,24456
20200207,3,도곡,5849,5876,20200210,11725
20200207,3,대치,12454,12219,20200210,24673
20200207,3,학여울,2084,2106,20200210,4190
20200207,3,대청,10662,9734,20200210,20396
20200207,3,일원,10051,9900,20200210,19951
20200207,3,수서,19065,18769,20200210,37834
20200207,3,가락시장,9832,9558,20200210,19390
20200207,3,경찰병원,8078,8009,20200210,16087
20200207,3,오금,6970,6142,20200210,13112
20200208,3,지축,1585,1653,20200211,3238
20200208,3,구파발,14389,14145,20200211,28534
20200208,3,연신내,30916,29405,20200211,60321
20200208,3,불광,12698,14211,20200211,26909
20200208,3,녹번,9060,7739,20200211,16799
20200208,3,홍제,12759,12191,20200211,24950
20200208,3,무악재,2492,2681,20200211,5173
20200208,3,독립문,5229,5221,20200211,10450
20200208,3,경복궁,15656,14698,20200211,30354
20200208,3,안국,13687,15099,20200211,28786
20200208,3,종로3가,6171,8458,20200211,14629
20200208,3,을지로3가,5197,5722,20200211,10919
20200208,3,동대입구,5962,6659,20200211,12621
20200208,3,약수,9060,8423,20200211,17483
20200208,3,금호,5735,5209,20200211,10944
20200208,3,옥수,6401,6399,20200211,12800
20200208,3,압구정,24112,25521,20200211,49633
20200208,3,신사,24898,26827,20200211,51725
20200208,3,잠원,3875,3741,20200211,7616
20200208,3,고속터미널,45894,45634,20200211,91528
20200208,3,교대,7063,4261,20200211,11324
20200208,3,남부터미널,23193,23187,20200211,46380
20200208,3,양재,22077,23495,20200211,45572
20200208,3,매봉,5355,5050,20200211,10405
20200208,3,도곡,3258,3391,20200211,6649
20200208,3,대치,9697,8675,20200211,18372
20200208,3,학여울,1051,1028,20200211,2079
20200208,3,대청,5910,5353,20200211,11263
20200208,3,일원,4781,4681,20200211,9462
20200208,3,수서,11680,11431,20200211,23111
20200208,3,가락시장,5695,5295,20200211,10990
20200208,3,경찰병원,3715,3561,20200211,7276
20200208,3,오금,3620,3305,20200211,6925
20200209,3,지축,1098,1105,20200212,2203
20200209,3,구파발,11296,11155,20200212,22451
20200209,3,연신내,22565,21358,20200212,43923
20200209,3,불광,9368,11037,20200212,20405
20200209,3,녹번,6116,5509,20200212,11625
20200209,3,홍제,8982,8569,20200212,17551
20200209,3,무악재,1801,1933,20200212,3734
20200209,3,독립문,3937,4079,20200212,8016
20200209,3,경복궁,10467,10523,20200212,20990
20200209,3,안국,9277,9931,20200212,19208
20200209,3,종로3가,3666,5047,20200212,8713
20200209,3,을지로3가,3264,3193,20200212,6457
20200209,3,동대입구,5922,6475,20200212,12397
20200209,3,약수,6775,6487,20200212,13262
20200209,3,금호,4239,4021,20200212,8260
20200209,3,옥수,4475,4780,20200212,9255
20200209,3,압구정,13555,14182,20200212,27737
20200209,3,신사,15426,15456,20200212,30882
20200209,3,잠원,2629,2625,20200212,5254
20200209,3,고속터미널,38085,36400,20200212,74485
20200209,3,교대,4326,2693,20200212,7019
20200209,3,남부터미널,15618,16795,20200212,32413
20200209,3,양재,14071,15914,20200212,29985
20200209,3,매봉,3749,3801,20200212,7550
20200209,3,도곡,1961,2055,20200212,4016
20200209,3,대치,6486,5829,20200212,12315
20200209,3,학여울,732,674,20200212,1406
20200209,3,대청,3979,3830,20200212,7809
20200209,3,일원,3191,3517,20200212,6708
20200209,3,수서,9137,9210,20200212,18347
20200209,3,가락시장,3378,3591,20200212,6969
20200209,3,경찰병원,2733,2745,20200212,5478
20200209,3,오금,2904,2747,20200212,5651
20200210,3,지축,2587,2716,20200213,5303
20200210,3,구파발,22606,20907,20200213,43513
20200210,3,연신내,40931,39073,20200213,80004
20200210,3,불광,17319,18680,20200213,35999
20200210,3,녹번,14252,12769,20200213,27021
20200210,3,홍제,18129,17228,20200213,35357
20200210,3,무악재,3983,4106,20200213,8089
20200210,3,독립문,7153,7144,20200213,14297
20200210,3,경복궁,20591,20478,20200213,41069
20200210,3,안국,22010,22765,20200213,44775
20200210,3,종로3가,11456,13589,20200213,25045
20200210,3,을지로3가,12078,12662,20200213,24740
20200210,3,충무로,1,0,20200213,1
20200210,3,동대입구,7846,8412,20200213,16258
20200210,3,약수,13928,13658,20200213,27586
20200210,3,금호,8658,8087,20200213,16745
20200210,3,옥수,9414,9819,20200213,19233
20200210,3,압구정,33320,35885,20200213,69205
20200210,3,신사,33601,35898,20200213,69499
20200210,3,잠원,6302,6153,20200213,12455
20200210,3,고속터미널,37782,35128,20200213,72910
20200210,3,교대,15024,9985,20200213,25009
20200210,3,남부터미널,30561,31567,20200213,62128
20200210,3,양재,41475,45297,20200213,86772
20200210,3,매봉,12487,11975,20200213,24462
20200210,3,도곡,5798,5793,20200213,11591
20200210,3,대치,12300,11943,20200213,24243
20200210,3,학여울,1795,1825,20200213,3620
20200210,3,대청,10340,9522,20200213,19862
20200210,3,일원,10177,10099,20200213,20276
20200210,3,수서,17029,17114,20200213,34143
20200210,3,가락시장,9704,9377,20200213,19081
20200210,3,경찰병원,8385,8489,20200213,16874
20200210,3,오금,6767,6032,20200213,12799
20200211,3,지축,2686,2782,20200214,5468
20200211,3,구파발,23170,21324,20200214,44494
20200211,3,연신내,42315,40104,20200214,82419
20200211,3,불광,17756,19219,20200214,36975
20200211,3,녹번,14554,12922,20200214,27476
20200211,3,홍제,18728,17711,20200214,36439
20200211,3,무악재,4177,4194,20200214,8371
20200211,3,독립문,7343,7526,20200214,14869
20200211,3,경복궁,20908,20464,20200214,41372
20200211,3,안국,22638,23841,20200214,46479
20200211,3,종로3가,11682,13628,20200214,25310
20200211,3,을지로3가,12508,13018,20200214,25526
20200211,3,동대입구,8123,8827,20200214,16950
20200211,3,약수,14438,13968,20200214,28406
20200211,3,금호,8951,8379,20200214,17330
20200211,3,옥수,9927,10182,20200214,20109
20200211,3,압구정,34800,37522,20200214,72322
20200211,3,신사,34661,37193,20200214,71854
20200211,3,잠원,6489,6269,20200214,12758
20200211,3,고속터미널,43394,41968,20200214,85362
20200211,3,교대,15999,10430,20200214,26429
20200211,3,남부터미널,31937,32851,20200214,64788
20200211,3,양재,43115,46612,20200214,89727
20200211,3,매봉,12894,12298,20200214,25192
20200211,3,도곡,5783,5900,20200214,11683
20200211,3,대치,12791,12442,20200214,25233
20200211,3,학여울,1842,1894,20200214,3736
20200211,3,대청,10643,9979,20200214,20622
20200211,3,일원,10622,10510,20200214,21132
20200211,3,수서,17216,17474,20200214,34690
20200211,3,가락시장,9911,9714,20200214,19625
20200211,3,경찰병원,8575,8525,20200214,17100
20200211,3,오금,6981,6114,20200214,13095
20200212,3,지축,2497,2639,20200215,5136
20200212,3,구파발,22559,20786,20200215,43345
20200212,3,연신내,40242,38421,20200215,78663
20200212,3,불광,16924,18286,20200215,35210
20200212,3,녹번,14274,12625,20200215,26899
20200212,3,홍제,18133,17102,20200215,35235
20200212,3,무악재,4032,4078,20200215,8110
20200212,3,독립문,6877,7093,20200215,13970
20200212,3,경복궁,20493,20214,20200215,40707
20200212,3,안국,21527,22189,20200215,43716
20200212,3,종로3가,11704,13392,20200215,25096
20200212,3,을지로3가,12701,12889,20200215,25590
20200212,3,동대입구,7955,8237,20200215,16192
20200212,3,약수,13701,13444,20200215,27145
20200212,3,금호,8547,8120,20200215,16667
20200212,3,옥수,9450,9851,20200215,19301
20200212,3,압구정,33300,35922,20200215,69222
20200212,3,신사,33004,35435,20200215,68439
20200212,3,잠원,6265,6105,20200215,12370
20200212,3,고속터미널,42389,40638,20200215,83027
20200212,3,교대,15583,10227,20200215,25810
20200212,3,남부터미널,31781,32437,20200215,64218
20200212,3,양재,42230,45366,20200215,87596
20200212,3,매봉,12685,12106,20200215,24791
20200212,3,도곡,5682,5789,20200215,11471
20200212,3,대치,12296,12186,20200215,24482
20200212,3,학여울,1798,1834,20200215,3632
20200212,3,대청,10534,9711,20200215,20245
20200212,3,일원,10180,10134,20200215,20314
20200212,3,수서,17060,17207,20200215,34267
20200212,3,가락시장,9589,9356,20200215,18945
20200212,3,경찰병원,8531,8522,20200215,17053
20200212,3,오금,6812,5906,20200215,12718
20200213,3,지축,2724,2752,20200216,5476
20200213,3,구파발,23402,21507,20200216,44909
20200213,3,연신내,42516,40377,20200216,82893
20200213,3,불광,17861,19143,20200216,37004
20200213,3,녹번,14700,13137,20200216,27837
20200213,3,홍제,18653,17584,20200216,36237
20200213,3,무악재,4129,4194,20200216,8323
20200213,3,독립문,7393,7474,20200216,14867
20200213,3,경복궁,23140,22931,20200216,46071
20200213,3,안국,22945,23916,20200216,46861
20200213,3,종로3가,11673,13884,20200216,25557
20200213,3,을지로3가,12463,13242,20200216,25705
20200213,3,충무로,3,0,20200216,3
20200213,3,동대입구,9759,10877,20200216,20636
20200213,3,약수,14361,13855,20200216,28216
20200213,3,금호,9125,8376,20200216,17501
20200213,3,옥수,9866,10265,20200216,20131
20200213,3,압구정,34554,37497,20200216,72051
20200213,3,신사,35369,38166,20200216,73535
20200213,3,잠원,6590,6360,20200216,12950
20200213,3,고속터미널,46505,44726,20200216,91231
20200213,3,교대,16164,10580,20200216,26744
20200213,3,남부터미널,33294,34254,20200216,67548
20200213,3,양재,43062,46940,20200216,90002
20200213,3,매봉,12886,12414,20200216,25300
20200213,3,도곡,5858,5864,20200216,11722
20200213,3,대치,13116,12849,20200216,25965
20200213,3,학여울,1955,1977,20200216,3932
20200213,3,대청,10629,9638,20200216,20267
20200213,3,일원,10422,10322,20200216,20744
20200213,3,수서,17990,18085,20200216,36075
20200213,3,가락시장,10231,9955,20200216,20186
20200213,3,경찰병원,8729,8695,20200216,17424
20200213,3,오금,7198,6284,20200216,13482
20200214,3,지축,2853,2883,20200217,5736
20200214,3,구파발,24144,21831,20200217,45975
20200214,3,연신내,45022,42652,20200217,87674
20200214,3,불광,18822,20272,20200217,39094
20200214,3,녹번,15232,13078,20200217,28310
20200214,3,홍제,19793,18308,20200217,38101
20200214,3,무악재,4397,4268,20200217,8665
20200214,3,독립문,7726,7905,20200217,15631
20200214,3,경복궁,23422,23275,20200217,46697
20200214,3,안국,23873,24810,20200217,48683
20200214,3,종로3가,11743,14473,20200217,26216
20200214,3,을지로3가,12778,13650,20200217,26428
20200214,3,충무로,3,0,20200217,3
20200214,3,동대입구,8587,9217,20200217,17804
20200214,3,약수,15048,14616,20200217,29664
20200214,3,금호,9837,9017,20200217,18854
20200214,3,옥수,10241,10562,20200217,20803
20200214,3,압구정,38068,41279,20200217,79347
20200214,3,신사,38461,42376,20200217,80837
20200214,3,잠원,6844,6502,20200217,13346
20200214,3,고속터미널,54910,56984,20200217,111894
20200214,3,교대,16541,10769,20200217,27310
20200214,3,남부터미널,36791,37263,20200217,74054
20200214,3,양재,46346,48278,20200217,94624
20200214,3,매봉,13141,12394,20200217,25535
20200214,3,도곡,6076,6070,20200217,12146
20200214,3,대치,13845,13516,20200217,27361
20200214,3,학여울,2086,2036,20200217,4122
20200214,3,대청,10864,9955,20200217,20819
20200214,3,일원,10721,10323,20200217,21044
20200214,3,수서,20070,19540,20200217,39610
20200214,3,가락시장,10821,10609,20200217,21430
20200214,3,경찰병원,8817,8760,20200217,17577
20200214,3,오금,7324,6336,20200217,13660
20200215,3,지축,1863,1836,20200218,3699
20200215,3,구파발,16272,15495,20200218,31767
20200215,3,연신내,33302,31446,20200218,64748
20200215,3,불광,13831,15790,20200218,29621
20200215,3,녹번,9844,8488,20200218,18332
20200215,3,홍제,14524,13661,20200218,28185
20200215,3,무악재,2887,3172,20200218,6059
20200215,3,독립문,5783,6088,20200218,11871
20200215,3,경복궁,17190,16015,20200218,33205
20200215,3,안국,14766,16335,20200218,31101
20200215,3,종로3가,7207,10229,20200218,17436
20200215,3,을지로3가,5659,6191,20200218,11850
20200215,3,동대입구,6668,7311,20200218,13979
20200215,3,약수,10057,9411,20200218,19468
20200215,3,금호,6455,5858,20200218,12313
20200215,3,옥수,7125,7265,20200218,14390
20200215,3,압구정,27140,28877,20200218,56017
20200215,3,신사,28006,29978,20200218,57984
20200215,3,잠원,4260,4013,20200218,8273
20200215,3,고속터미널,55262,54961,20200218,110223
20200215,3,교대,7579,4506,20200218,12085
20200215,3,남부터미널,25635,25519,20200218,51154
20200215,3,양재,23969,25686,20200218,49655
20200215,3,매봉,5797,5501,20200218,11298
20200215,3,도곡,4017,4095,20200218,8112
20200215,3,대치,9947,9073,20200218,19020
20200215,3,학여울,1737,1759,20200218,3496
20200215,3,대청,6516,5927,20200218,12443
20200215,3,일원,4969,4894,20200218,9863
20200215,3,수서,13858,13767,20200218,27625
20200215,3,가락시장,6867,6591,20200218,13458
20200215,3,경찰병원,4475,4259,20200218,8734
20200215,3,오금,4319,3973,20200218,8292
20200216,3,지축,1239,1271,20200219,2510
20200216,3,구파발,11806,12054,20200219,23860
20200216,3,연신내,23450,22156,20200219,45606
20200216,3,녹번,6439,5691,20200219,12130
20200216,3,홍제,9493,9142,20200219,18635
20200216,3,무악재,1994,2118,20200219,4112
20200216,3,독립문,3949,4032,20200219,7981
20200216,3,경복궁,10234,10322,20200219,20556
20200216,3,안국,9108,9681,20200219,18789
20200216,3,종로3가,4181,5535,20200219,9716
20200216,3,을지로3가,3550,3561,20200219,7111
20200216,3,동대입구,5044,5503,20200219,10547
20200216,3,약수,7117,6715,20200219,13832
20200216,3,금호,4442,4308,20200219,8750
20200216,3,옥수,4781,5031,20200219,9812
20200216,3,압구정,15851,16348,20200219,32199
20200216,3,신사,16056,16056,20200219,32112
20200216,3,잠원,2710,2838,20200219,5548
20200216,3,고속터미널,44074,41850,20200219,85924
20200216,3,교대,4339,2792,20200219,7131
20200216,3,남부터미널,16915,17790,20200219,34705
20200216,3,양재,15489,17389,20200219,32878
20200216,3,매봉,3753,3748,20200219,7501
20200216,3,도곡,2128,2198,20200219,4326
20200216,3,대치,6568,5853,20200219,12421
20200216,3,학여울,1139,1224,20200219,2363
20200216,3,대청,4157,4021,20200219,8178
20200216,3,일원,3718,4019,20200219,7737
20200216,3,수서,10684,10561,20200219,21245
20200216,3,가락시장,3976,4238,20200219,8214
20200216,3,경찰병원,3212,3289,20200219,6501
20200216,3,오금,3135,2984,20200219,6119
20200216,3,불광,9882,11461,20200219,21343
20200217,3,지축,2746,2861,20200220,5607
20200217,3,구파발,23178,20985,20200220,44163
20200217,3,연신내,41100,38731,20200220,79831
20200217,3,불광,17215,18678,20200220,35893
20200217,3,녹번,14361,12869,20200220,27230
20200217,3,홍제,18295,17502,20200220,35797
20200217,3,무악재,4226,4251,20200220,8477
20200217,3,독립문,6882,6851,20200220,13733
20200217,3,경복궁,21358,21555,20200220,42913
20200217,3,안국,21776,22510,20200220,44286
20200217,3,종로3가,11618,13548,20200220,25166
20200217,3,을지로3가,12393,12927,20200220,25320
20200217,3,충무로,2,0,20200220,2
20200217,3,동대입구,7914,8513,20200220,16427
20200217,3,약수,14085,13684,20200220,27769
20200217,3,금호,8948,8248,20200220,17196
20200217,3,옥수,9620,10096,20200220,19716
20200217,3,압구정,34508,37442,20200220,71950
20200217,3,신사,34023,36487,20200220,70510
20200217,3,잠원,6769,6371,20200220,13140
20200217,3,고속터미널,44911,42764,20200220,87675
20200217,3,교대,15687,10408,20200220,26095
20200217,3,남부터미널,32431,33002,20200220,65433
20200217,3,양재,42528,46154,20200220,88682
20200217,3,매봉,13215,12499,20200220,25714
20200217,3,도곡,6014,6098,20200220,12112
20200217,3,대치,13278,13106,20200220,26384
20200217,3,학여울,1911,1959,20200220,3870
20200217,3,대청,10646,9830,20200220,20476
20200217,3,일원,11219,11238,20200220,22457
20200217,3,수서,18479,19005,20200220,37484
20200217,3,가락시장,10380,10105,20200220,20485
20200217,3,경찰병원,9515,9342,20200220,18857
20200217,3,오금,7418,6455,20200220,13873
20200218,3,지축,2840,2815,20200221,5655
20200218,3,구파발,23001,21181,20200221,44182
20200218,3,연신내,41045,39151,20200221,80196
20200218,3,불광,17595,19066,20200221,36661
20200218,3,녹번,14502,12853,20200221,27355
20200218,3,홍제,18445,17439,20200221,35884
20200218,3,무악재,4227,4183,20200221,8410
20200218,3,독립문,7076,7213,20200221,14289
20200218,3,경복궁,21104,20513,20200221,41617
20200218,3,안국,21851,22920,20200221,44771
20200218,3,종로3가,11552,13475,20200221,25027
20200218,3,을지로3가,12408,12846,20200221,25254
20200218,3,충무로,1,0,20200221,1
20200218,3,동대입구,8588,9205,20200221,17793
20200218,3,약수,14473,13877,20200221,28350
20200218,3,금호,8864,8263,20200221,17127
20200218,3,옥수,9858,10155,20200221,20013
20200218,3,압구정,34764,37571,20200221,72335
20200218,3,신사,34857,37331,20200221,72188
20200218,3,잠원,6497,6267,20200221,12764
20200218,3,고속터미널,44601,42587,20200221,87188
20200218,3,교대,15880,10393,20200221,26273
20200218,3,남부터미널,32453,33386,20200221,65839
20200218,3,양재,43022,46405,20200221,89427
20200218,3,매봉,13059,12480,20200221,25539
20200218,3,도곡,5725,5790,20200221,11515
20200218,3,대치,13138,12747,20200221,25885
20200218,3,학여울,1948,1947,20200221,3895
20200218,3,대청,10602,9882,20200221,20484
20200218,3,일원,10706,10548,20200221,21254
20200218,3,수서,17727,17811,20200221,35538
20200218,3,가락시장,10044,9865,20200221,19909
20200218,3,경찰병원,8693,8904,20200221,17597
20200218,3,오금,7180,6293,20200221,13473
20200219,3,지축,2940,2917,20200222,5857
20200219,3,구파발,23192,21383,20200222,44575
20200219,3,연신내,42438,40558,20200222,82996
20200219,3,불광,17966,19321,20200222,37287
20200219,3,녹번,14678,12992,20200222,27670
20200219,3,홍제,18761,17959,20200222,36720
20200219,3,무악재,4235,4227,20200222,8462
20200219,3,독립문,7387,7629,20200222,15016
20200219,3,경복궁,22518,22771,20200222,45289
20200219,3,안국,22275,22976,20200222,45251
20200219,3,종로3가,11541,13408,20200222,24949
20200219,3,을지로3가,12965,13150,20200222,26115
20200219,3,충무로,2,0,20200222,2
20200219,3,동대입구,8313,8950,20200222,17263
20200219,3,약수,14156,14002,20200222,28158
20200219,3,금호,8951,8295,20200222,17246
20200219,3,옥수,9558,9991,20200222,19549
20200219,3,압구정,34876,37901,20200222,72777
20200219,3,신사,34860,37367,20200222,72227
20200219,3,잠원,6618,6269,20200222,12887
20200219,3,고속터미널,44234,42470,20200222,86704
20200219,3,교대,15919,10491,20200222,26410
20200219,3,남부터미널,33645,34444,20200222,68089
20200219,3,양재,43365,46994,20200222,90359
20200219,3,매봉,12963,12431,20200222,25394
20200219,3,도곡,5785,5889,20200222,11674
20200219,3,대치,12940,12542,20200222,25482
20200219,3,학여울,2062,2019,20200222,4081
20200219,3,대청,10518,9733,20200222,20251
20200219,3,일원,10592,10559,20200222,21151
20200219,3,수서,18035,17880,20200222,35915
20200219,3,가락시장,10000,9906,20200222,19906
20200219,3,경찰병원,8737,8809,20200222,17546
20200219,3,오금,7159,6201,20200222,13360
20200220,3,지축,3000,2937,20200223,5937
20200220,3,구파발,22751,21001,20200223,43752
20200220,3,연신내,41355,39210,20200223,80565
20200220,3,불광,17196,18677,20200223,35873
20200220,3,녹번,14427,12719,20200223,27146
20200220,3,홍제,18423,17397,20200223,35820
20200220,3,무악재,4190,4283,20200223,8473
20200220,3,독립문,7151,7453,20200223,14604
20200220,3,경복궁,21154,21187,20200223,42341
20200220,3,안국,21810,22928,20200223,44738
20200220,3,종로3가,11434,13194,20200223,24628
20200220,3,을지로3가,12315,12930,20200223,25245
20200220,3,충무로,4,0,20200223,4
20200220,3,동대입구,8599,9419,20200223,18018
20200220,3,약수,14052,13649,20200223,27701
20200220,3,금호,8625,7994,20200223,16619
20200220,3,옥수,9570,9735,20200223,19305
20200220,3,압구정,33993,36739,20200223,70732
20200220,3,신사,34689,37521,20200223,72210
20200220,3,잠원,6413,6218,20200223,12631
20200220,3,고속터미널,43829,42658,20200223,86487
20200220,3,교대,16323,10588,20200223,26911
20200220,3,남부터미널,32531,33232,20200223,65763
20200220,3,양재,43295,47009,20200223,90304
20200220,3,매봉,12719,12185,20200223,24904
20200220,3,도곡,5611,5762,20200223,11373
20200220,3,대치,12683,12356,20200223,25039
20200220,3,학여울,2056,2089,20200223,4145
20200220,3,대청,10370,9544,20200223,19914
20200220,3,일원,10408,10181,20200223,20589
20200220,3,수서,18033,18010,20200223,36043
20200220,3,가락시장,10061,9777,20200223,19838
20200220,3,경찰병원,8423,8368,20200223,16791
20200220,3,오금,7131,6219,20200223,13350
20200221,3,지축,2794,2770,20200224,5564
20200221,3,구파발,20158,18068,20200224,38226
20200221,3,연신내,40000,37700,20200224,77700
20200221,3,불광,16622,17704,20200224,34326
20200221,3,녹번,13932,12186,20200224,26118
20200221,3,홍제,17908,16675,20200224,34583
20200221,3,무악재,4026,3964,20200224,7990
20200221,3,독립문,6639,6812,20200224,13451
20200221,3,경복궁,19451,19312,20200224,38763
20200221,3,안국,20666,20946,20200224,41612
20200221,3,종로3가,11019,12765,20200224,23784
20200221,3,을지로3가,11905,12200,20200224,24105
20200221,3,충무로,1,0,20200224,1
20200221,3,동대입구,8304,8919,20200224,17223
20200221,3,약수,13823,13644,20200224,27467
20200221,3,금호,8629,7782,20200224,16411
20200221,3,옥수,9307,9477,20200224,18784
20200221,3,압구정,34277,37056,20200224,71333
20200221,3,신사,34554,37593,20200224,72147
20200221,3,잠원,6292,6013,20200224,12305
20200221,3,고속터미널,44955,46750,20200224,91705
20200221,3,교대,15374,10172,20200224,25546
20200221,3,남부터미널,33590,33870,20200224,67460
20200221,3,양재,42796,45031,20200224,87827
20200221,3,매봉,12246,11738,20200224,23984
20200221,3,도곡,5614,5625,20200224,11239
20200221,3,대치,12369,12200,20200224,24569
20200221,3,학여울,1829,1820,20200224,3649
20200221,3,대청,10036,9283,20200224,19319
20200221,3,일원,9807,9485,20200224,19292
20200221,3,수서,18486,18098,20200224,36584
20200221,3,가락시장,9924,9599,20200224,19523
20200221,3,경찰병원,8174,8104,20200224,16278
20200221,3,오금,6747,5949,20200224,12696
20200222,3,지축,1516,1576,20200225,3092
20200222,3,구파발,11014,10670,20200225,21684
20200222,3,연신내,26107,24773,20200225,50880
20200222,3,불광,10550,11824,20200225,22374
20200222,3,녹번,7602,6608,20200225,14210
20200222,3,홍제,11092,10677,20200225,21769
20200222,3,무악재,2178,2219,20200225,4397
20200222,3,독립문,4291,4356,20200225,8647
20200222,3,경복궁,11496,10820,20200225,22316
20200222,3,안국,9491,10536,20200225,20027
20200222,3,종로3가,5064,6549,20200225,11613
20200222,3,을지로3가,4275,4552,20200225,8827
20200222,3,충무로,2,0,20200225,2
20200222,3,동대입구,5321,5783,20200225,11104
20200222,3,약수,8094,7701,20200225,15795
20200222,3,금호,5021,4509,20200225,9530
20200222,3,옥수,5488,5608,20200225,11096
20200222,3,압구정,21832,22969,20200225,44801
20200222,3,신사,22722,24326,20200225,47048
20200222,3,잠원,3576,3346,20200225,6922
20200222,3,고속터미널,38955,38984,20200225,77939
20200222,3,교대,5720,3597,20200225,9317
20200222,3,남부터미널,20116,20010,20200225,40126
20200222,3,양재,18954,20080,20200225,39034
20200222,3,매봉,4432,4285,20200225,8717
20200222,3,도곡,3007,3250,20200225,6257
20200222,3,대치,8320,7509,20200225,15829
20200222,3,학여울,886,898,20200225,1784
20200222,3,대청,5102,4760,20200225,9862
20200222,3,일원,3942,3867,20200225,7809
20200222,3,수서,9978,9756,20200225,19734
20200222,3,가락시장,5356,4918,20200225,10274
20200222,3,경찰병원,3629,3487,20200225,7116
20200222,3,오금,3718,3302,20200225,7020
20200223,3,지축,1006,1002,20200226,2008
20200223,3,구파발,8177,8202,20200226,16379
20200223,3,연신내,16974,15934,20200226,32908
20200223,3,불광,7535,8755,20200226,16290
20200223,3,녹번,4900,4292,20200226,9192
20200223,3,홍제,7002,6807,20200226,13809
20200223,3,무악재,1394,1514,20200226,2908
20200223,3,독립문,3000,3250,20200226,6250
20200223,3,경복궁,7765,7687,20200226,15452
20200223,3,안국,6442,6800,20200226,13242
20200223,3,종로3가,2671,3464,20200226,6135
20200223,3,을지로3가,2466,2483,20200226,4949
20200223,3,동대입구,5868,6522,20200226,12390
20200223,3,약수,5507,5344,20200226,10851
20200223,3,금호,3333,3285,20200226,6618
20200223,3,옥수,3688,3887,20200226,7575
20200223,3,압구정,11157,11592,20200226,22749
20200223,3,신사,12655,12686,20200226,25341
20200223,3,잠원,1904,1986,20200226,3890
20200223,3,고속터미널,26816,25718,20200226,52534
20200223,3,교대,3401,2124,20200226,5525
20200223,3,남부터미널,12188,13072,20200226,25260
20200223,3,양재,10677,12396,20200226,23073
20200223,3,매봉,2655,2651,20200226,5306
20200223,3,도곡,1597,1695,20200226,3292
20200223,3,대치,4874,4243,20200226,9117
20200223,3,학여울,612,583,20200226,1195
20200223,3,대청,3153,2994,20200226,6147
20200223,3,일원,2466,2759,20200226,5225
20200223,3,수서,7168,7071,20200226,14239
20200223,3,가락시장,2765,3032,20200226,5797
20200223,3,경찰병원,2110,2224,20200226,4334
20200223,3,오금,2304,2166,20200226,4470
20200224,3,지축,2480,2567,20200227,5047
20200224,3,구파발,17187,15662,20200227,32849
20200224,3,연신내,33427,31554,20200227,64981
20200224,3,불광,14290,15374,20200227,29664
20200224,3,녹번,12323,11131,20200227,23454
20200224,3,홍제,15472,14572,20200227,30044
20200224,3,무악재,3436,3470,20200227,6906
20200224,3,독립문,5918,5945,20200227,11863
20200224,3,경복궁,16015,16098,20200227,32113
20200224,3,안국,18196,18327,20200227,36523
20200224,3,종로3가,9767,11144,20200227,20911
20200224,3,을지로3가,10692,10971,20200227,21663
20200224,3,충무로,3,0,20200227,3
20200224,3,동대입구,6929,7367,20200227,14296
20200224,3,약수,11830,11631,20200227,23461
20200224,3,금호,7457,7003,20200227,14460
20200224,3,옥수,7793,8095,20200227,15888
20200224,3,압구정,28291,30559,20200227,58850
20200224,3,신사,27791,29596,20200227,57387
20200224,3,잠원,4887,4926,20200227,9813
20200224,3,고속터미널,29411,27791,20200227,57202
20200224,3,교대,13362,8912,20200227,22274
20200224,3,남부터미널,25219,26120,20200227,51339
20200224,3,양재,35358,38601,20200227,73959
20200224,3,매봉,10683,10207,20200227,20890
20200224,3,도곡,4632,4640,20200227,9272
20200224,3,대치,9379,9178,20200227,18557
20200224,3,학여울,1525,1554,20200227,3079
20200224,3,대청,8679,8035,20200227,16714
20200224,3,일원,8020,8047,20200227,16067
20200224,3,수서,13471,13708,20200227,27179
20200224,3,가락시장,7916,7778,20200227,15694
20200224,3,경찰병원,7265,7199,20200227,14464
20200224,3,오금,5973,5293,20200227,11266
20200225,3,지축,2251,2321,20200228,4572
20200225,3,구파발,15961,14385,20200228,30346
20200225,3,연신내,31262,29466,20200228,60728
20200225,3,불광,13059,14001,20200228,27060
20200225,3,녹번,11521,10388,20200228,21909
20200225,3,홍제,14109,13447,20200228,27556
20200225,3,무악재,3270,3218,20200228,6488
20200225,3,독립문,5134,5157,20200228,10291
20200225,3,경복궁,15426,14979,20200228,30405
20200225,3,안국,16450,16756,20200228,33206
20200225,3,종로3가,8500,9653,20200228,18153
20200225,3,을지로3가,10007,10529,20200228,20536
20200225,3,충무로,3,0,20200228,3
20200225,3,동대입구,6387,6701,20200228,13088
20200225,3,약수,11165,11067,20200228,22232
20200225,3,금호,6731,6333,20200228,13064
20200225,3,옥수,6986,7332,20200228,14318
20200225,3,압구정,26444,28590,20200228,55034
20200225,3,신사,25742,27746,20200228,53488
20200225,3,잠원,4477,4400,20200228,8877
20200225,3,고속터미널,26066,24938,20200228,51004
20200225,3,교대,11782,7988,20200228,19770
20200225,3,남부터미널,23655,24430,20200228,48085
20200225,3,양재,33464,36213,20200228,69677
20200225,3,매봉,10102,9755,20200228,19857
20200225,3,도곡,4118,4110,20200228,8228
20200225,3,대치,7947,7919,20200228,15866
20200225,3,학여울,1350,1313,20200228,2663
20200225,3,대청,7939,7292,20200228,15231
20200225,3,일원,7325,7338,20200228,14663
20200225,3,수서,11972,12069,20200228,24041
20200225,3,가락시장,7345,6953,20200228,14298
20200225,3,경찰병원,6516,6531,20200228,13047
20200225,3,오금,5471,4753,20200228,10224
20200226,3,지축,2322,2434,20200229,4756
20200226,3,구파발,16003,14420,20200229,30423
20200226,3,연신내,31973,30058,20200229,62031
20200226,3,불광,13319,14314,20200229,27633
20200226,3,녹번,11564,10437,20200229,22001
20200226,3,홍제,14333,13704,20200229,28037
20200226,3,무악재,3188,3233,20200229,6421
20200226,3,독립문,5447,5507,20200229,10954
20200226,3,경복궁,15977,15865,20200229,31842
20200226,3,안국,16644,16972,20200229,33616
20200226,3,종로3가,8660,9875,20200229,18535
20200226,3,을지로3가,9972,10237,20200229,20209
20200226,3,충무로,1,0,20200229,1
20200226,3,동대입구,6395,6841,20200229,13236
20200226,3,약수,11017,10904,20200229,21921
20200226,3,금호,6803,6369,20200229,13172
20200226,3,옥수,7158,7351,20200229,14509
20200226,3,압구정,25652,27677,20200229,53329
20200226,3,신사,25887,27657,20200229,53544
20200226,3,잠원,4413,4392,20200229,8805
20200226,3,고속터미널,25639,24616,20200229,50255
20200226,3,교대,11614,7917,20200229,19531
20200226,3,남부터미널,23194,23953,20200229,47147
20200226,3,양재,32483,35067,20200229,67550
20200226,3,매봉,10092,9558,20200229,19650
20200226,3,도곡,4013,4042,20200229,8055
20200226,3,대치,7663,7620,20200229,15283
20200226,3,학여울,1346,1361,20200229,2707
20200226,3,대청,7979,7395,20200229,15374
20200226,3,일원,6975,6987,20200229,13962
20200226,3,수서,11511,11739,20200229,23250
20200226,3,가락시장,7132,6971,20200229,14103
20200226,3,경찰병원,6218,6218,20200229,12436
20200226,3,오금,5280,4670,20200229,9950
20200227,3,지축,2276,2319,20200301,4595
20200227,3,구파발,15284,13657,20200301,28941
20200227,3,연신내,31199,29229,20200301,60428
20200227,3,불광,12960,13989,20200301,26949
20200227,3,녹번,11330,10147,20200301,21477
20200227,3,홍제,13858,13268,20200301,27126
20200227,3,무악재,3259,3232,20200301,6491
20200227,3,독립문,5148,5269,20200301,10417
20200227,3,경복궁,14800,14608,20200301,29408
20200227,3,안국,15850,16316,20200301,32166
20200227,3,종로3가,8400,9519,20200301,17919
20200227,3,을지로3가,9479,9993,20200301,19472
20200227,3,충무로,1,0,20200301,1
20200227,3,동대입구,6308,6716,20200301,13024
20200227,3,약수,10756,10481,20200301,21237
20200227,3,금호,6493,6038,20200301,12531
20200227,3,옥수,6948,7170,20200301,14118
20200227,3,압구정,24411,26272,20200301,50683
20200227,3,신사,24991,26909,20200301,51900
20200227,3,잠원,4272,4256,20200301,8528
20200227,3,고속터미널,24867,24334,20200301,49201
20200227,3,교대,12190,7980,20200301,20170
20200227,3,남부터미널,22375,23102,20200301,45477
20200227,3,양재,31633,34145,20200301,65778
20200227,3,매봉,9605,9199,20200301,18804
20200227,3,도곡,3897,3945,20200301,7842
20200227,3,대치,7353,7263,20200301,14616
20200227,3,학여울,1314,1320,20200301,2634
20200227,3,대청,7711,7190,20200301,14901
20200227,3,일원,6890,6707,20200301,13597
20200227,3,수서,11411,11548,20200301,22959
20200227,3,가락시장,6987,6976,20200301,13963
20200227,3,경찰병원,5983,5946,20200301,11929
20200227,3,오금,5121,4495,20200301,9616
20200228,3,지축,2182,2161,20200302,4343
20200228,3,구파발,13914,12234,20200302,26148
20200228,3,연신내,29822,28040,20200302,57862
20200228,3,불광,12250,13061,20200302,25311
20200228,3,녹번,10903,9626,20200302,20529
20200228,3,홍제,13546,12900,20200302,26446
20200228,3,무악재,2966,3013,20200302,5979
20200228,3,독립문,4828,5023,20200302,9851
20200228,3,경복궁,13572,13542,20200302,27114
20200228,3,안국,15256,15271,20200302,30527
20200228,3,종로3가,8400,9587,20200302,17987
20200228,3,을지로3가,9198,9454,20200302,18652
20200228,3,동대입구,6006,6305,20200302,12311
20200228,3,약수,10491,10310,20200302,20801
20200228,3,금호,6437,5941,20200302,12378
20200228,3,옥수,6630,6720,20200302,13350
20200228,3,압구정,23828,26050,20200302,49878
20200228,3,신사,24579,26671,20200302,51250
20200228,3,잠원,3956,3863,20200302,7819
20200228,3,고속터미널,23477,24773,20200302,48250
20200228,3,교대,10826,7362,20200302,18188
20200228,3,남부터미널,22742,23452,20200302,46194
20200228,3,양재,31366,32525,20200302,63891
20200228,3,매봉,9212,8945,20200302,18157
20200228,3,도곡,3873,3770,20200302,7643
20200228,3,대치,7243,7134,20200302,14377
20200228,3,학여울,1244,1243,20200302,2487
20200228,3,대청,7233,6654,20200302,13887
20200228,3,일원,6398,6311,20200302,12709
20200228,3,수서,11689,11695,20200302,23384
20200228,3,가락시장,6771,6707,20200302,13478
20200228,3,경찰병원,5840,5659,20200302,11499
20200228,3,오금,5025,4331,20200302,9356
20200229,3,지축,1098,1154,20200303,2252
20200229,3,구파발,7947,7552,20200303,15499
20200229,3,연신내,19279,18111,20200303,37390
20200229,3,불광,8166,9378,20200303,17544
20200229,3,녹번,5810,5060,20200303,10870
20200229,3,홍제,8381,7962,20200303,16343
20200229,3,무악재,1658,1628,20200303,3286
20200229,3,독립문,3259,3168,20200303,6427
20200229,3,경복궁,6120,6286,20200303,12406
20200229,3,안국,5647,6402,20200303,12049
20200229,3,종로3가,3196,4230,20200303,7426
20200229,3,을지로3가,2852,3002,20200303,5854
20200229,3,충무로,1,0,20200303,1
20200229,3,동대입구,3771,4155,20200303,7926
20200229,3,약수,6122,5782,20200303,11904
20200229,3,금호,3859,3619,20200303,7478
20200229,3,옥수,4015,4022,20200303,8037
20200229,3,압구정,14833,15677,20200303,30510
20200229,3,신사,14869,15891,20200303,30760
20200229,3,잠원,2158,2016,20200303,4174
20200229,3,고속터미널,19964,20287,20200303,40251
20200229,3,교대,3617,2370,20200303,5987
20200229,3,남부터미널,11114,11204,20200303,22318
20200229,3,양재,11517,12516,20200303,24033
20200229,3,매봉,3182,3018,20200303,6200
20200229,3,도곡,1811,1814,20200303,3625
20200229,3,대치,4046,3823,20200303,7869
20200229,3,학여울,589,567,20200303,1156
20200229,3,대청,3356,3075,20200303,6431
20200229,3,일원,2618,2490,20200303,5108
20200229,3,수서,5672,5828,20200303,11500
20200229,3,가락시장,3643,3330,20200303,6973
20200229,3,경찰병원,2419,2264,20200303,4683
20200229,3,오금,2256,2006,20200303,4262
20200301,3,지축,737,666,20200304,1403
20200301,3,구파발,5803,5891,20200304,11694
20200301,3,연신내,12998,12125,20200304,25123
20200301,3,불광,5821,6725,20200304,12546
20200301,3,녹번,3547,3200,20200304,6747
20200301,3,홍제,5396,5053,20200304,10449
20200301,3,무악재,1014,1060,20200304,2074
20200301,3,독립문,2340,2372,20200304,4712
20200301,3,경복궁,4276,4402,20200304,8678
20200301,3,안국,3667,3953,20200304,7620
20200301,3,종로3가,1669,2097,20200304,3766
20200301,3,을지로3가,1206,1219,20200304,2425
20200301,3,동대입구,2782,3102,20200304,5884
20200301,3,약수,3870,3623,20200304,7493
20200301,3,금호,2418,2336,20200304,4754
20200301,3,옥수,2619,2777,20200304,5396
20200301,3,압구정,7036,7402,20200304,14438
20200301,3,신사,7621,7555,20200304,15176
20200301,3,잠원,1271,1258,20200304,2529
20200301,3,고속터미널,16392,16095,20200304,32487
20200301,3,교대,2079,1420,20200304,3499
20200301,3,남부터미널,7120,7615,20200304,14735
20200301,3,양재,6575,7783,20200304,14358
20200301,3,매봉,1896,1874,20200304,3770
20200301,3,도곡,941,1010,20200304,1951
20200301,3,대치,2146,2049,20200304,4195
20200301,3,학여울,395,401,20200304,796
20200301,3,대청,2063,1940,20200304,4003
20200301,3,일원,1580,1805,20200304,3385
20200301,3,수서,4231,4301,20200304,8532
20200301,3,가락시장,2058,2208,20200304,4266
20200301,3,경찰병원,1463,1451,20200304,2914
20200301,3,오금,1472,1378,20200304,2850
20200302,3,지축,2321,2363,20200305,4684
20200302,3,구파발,14582,13332,20200305,27914
20200302,3,연신내,30454,28816,20200305,59270
20200302,3,불광,12710,13472,20200305,26182
20200302,3,녹번,10812,9769,20200305,20581
20200302,3,홍제,13520,13017,20200305,26537
20200302,3,무악재,3090,3099,20200305,6189
20200302,3,독립문,5032,5194,20200305,10226
20200302,3,경복궁,13190,13076,20200305,26266
20200302,3,안국,14663,15164,20200305,29827
20200302,3,종로3가,8059,9120,20200305,17179
20200302,3,을지로3가,9013,9394,20200305,18407
20200302,3,충무로,1,0,20200305,1
20200302,3,동대입구,5665,6070,20200305,11735
20200302,3,약수,10433,10262,20200305,20695
20200302,3,금호,6320,5970,20200305,12290
20200302,3,옥수,6641,6998,20200305,13639
20200302,3,압구정,23499,25318,20200305,48817
20200302,3,신사,23498,25046,20200305,48544
20200302,3,잠원,4107,4016,20200305,8123
20200302,3,고속터미널,23169,21627,20200305,44796
20200302,3,교대,10680,7249,20200305,17929
20200302,3,남부터미널,21960,22510,20200305,44470
20200302,3,양재,30347,32813,20200305,63160
20200302,3,매봉,9532,9126,20200305,18658
20200302,3,도곡,3933,3938,20200305,7871
20200302,3,대치,7461,7254,20200305,14715
20200302,3,학여울,1260,1276,20200305,2536
20200302,3,대청,7573,6884,20200305,14457
20200302,3,일원,6695,6669,20200305,13364
20200302,3,수서,10868,11301,20200305,22169
20200302,3,가락시장,6946,6743,20200305,13689
20200302,3,경찰병원,5850,5928,20200305,11778
20200302,3,오금,5115,4430,20200305,9545
20200303,3,지축,2270,2389,20200306,4659
20200303,3,구파발,14664,13307,20200306,27971
20200303,3,연신내,30425,28634,20200306,59059
20200303,3,불광,12622,13456,20200306,26078
20200303,3,녹번,10914,9872,20200306,20786
20200303,3,홍제,13520,12827,20200306,26347
20200303,3,무악재,3023,3093,20200306,6116
20200303,3,독립문,5061,5180,20200306,10241
20200303,3,경복궁,13228,13055,20200306,26283
20200303,3,안국,14751,15194,20200306,29945
20200303,3,종로3가,8573,9756,20200306,18329
20200303,3,을지로3가,8996,9481,20200306,18477
20200303,3,동대입구,5678,6030,20200306,11708
20200303,3,약수,10461,10201,20200306,20662
20200303,3,금호,6245,5956,20200306,12201
20200303,3,옥수,6688,6944,20200306,13632
20200303,3,압구정,23718,25564,20200306,49282
20200303,3,신사,23814,25265,20200306,49079
20200303,3,잠원,4091,4058,20200306,8149
20200303,3,고속터미널,22000,21448,20200306,43448
20200303,3,교대,11085,7403,20200306,18488
20200303,3,남부터미널,21420,22143,20200306,43563
20200303,3,양재,30342,32737,20200306,63079
20200303,3,매봉,9451,9037,20200306,18488
20200303,3,도곡,3801,3869,20200306,7670
20200303,3,대치,7519,7414,20200306,14933
20200303,3,학여울,1216,1226,20200306,2442
20200303,3,대청,7414,6791,20200306,14205
20200303,3,일원,6784,6598,20200306,13382
20200303,3,수서,10721,10978,20200306,21699
20200303,3,가락시장,6967,6684,20200306,13651
20200303,3,경찰병원,6052,6059,20200306,12111
20200303,3,오금,5096,4518,20200306,9614
20200304,3,지축,2244,2350,20200307,4594
20200304,3,구파발,14539,13091,20200307,27630
20200304,3,연신내,30192,28564,20200307,58756
20200304,3,불광,12522,13370,20200307,25892
20200304,3,녹번,10791,9737,20200307,20528
20200304,3,홍제,13349,12891,20200307,26240
20200304,3,무악재,3023,3083,20200307,6106
20200304,3,독립문,4999,5162,20200307,10161
20200304,3,경복궁,13360,13326,20200307,26686
20200304,3,안국,14477,14869,20200307,29346
20200304,3,종로3가,8800,9801,20200307,18601
20200304,3,을지로3가,8961,9383,20200307,18344
20200304,3,동대입구,5739,5967,20200307,11706
20200304,3,약수,10147,9955,20200307,20102
20200304,3,금호,6310,5994,20200307,12304
20200304,3,옥수,6585,6848,20200307,13433
20200304,3,압구정,23397,25178,20200307,48575
20200304,3,신사,23715,25081,20200307,48796
20200304,3,잠원,4066,4022,20200307,8088
20200304,3,고속터미널,22235,21825,20200307,44060
20200304,3,교대,11122,7605,20200307,18727
20200304,3,남부터미널,21502,22237,20200307,43739
20200304,3,양재,30353,32737,20200307,63090
20200304,3,매봉,9368,9084,20200307,18452
20200304,3,도곡,3884,3896,20200307,7780
20200304,3,대치,7432,7292,20200307,14724
20200304,3,학여울,1229,1273,20200307,2502
20200304,3,대청,7565,6824,20200307,14389
20200304,3,일원,6669,6573,20200307,13242
20200304,3,수서,10709,10939,20200307,21648
20200304,3,가락시장,6918,6735,20200307,13653
20200304,3,경찰병원,5951,5964,20200307,11915
20200304,3,오금,5050,4474,20200307,9524
20200305,3,지축,2286,2327,20200308,4613
20200305,3,구파발,14669,13299,20200308,27968
20200305,3,연신내,30494,28833,20200308,59327
20200305,3,불광,12733,13521,20200308,26254
20200305,3,녹번,10879,9749,20200308,20628
20200305,3,홍제,13819,13198,20200308,27017
20200305,3,무악재,3053,3098,20200308,6151
20200305,3,독립문,5063,5211,20200308,10274
20200305,3,경복궁,13584,13404,20200308,26988
20200305,3,안국,13966,14597,20200308,28563
20200305,3,종로3가,8766,9959,20200308,18725
20200305,3,을지로3가,8996,9395,20200308,18391
20200305,3,충무로,1,0,20200308,1
20200305,3,동대입구,5599,6041,20200308,11640
20200305,3,약수,10413,10176,20200308,20589
20200305,3,금호,6244,5885,20200308,12129
20200305,3,옥수,6601,6913,20200308,13514
20200305,3,압구정,23495,25380,20200308,48875
20200305,3,신사,23878,25499,20200308,49377
20200305,3,잠원,4079,4037,20200308,8116
20200305,3,고속터미널,22946,22625,20200308,45571
20200305,3,교대,11720,7724,20200308,19444
20200305,3,남부터미널,21686,22152,20200308,43838
20200305,3,양재,30846,33203,20200308,64049
20200305,3,매봉,9306,8821,20200308,18127
20200305,3,도곡,3776,3826,20200308,7602
20200305,3,대치,7595,7358,20200308,14953
20200305,3,학여울,1251,1252,20200308,2503
20200305,3,대청,7476,6801,20200308,14277
20200305,3,일원,6720,6625,20200308,13345
20200305,3,수서,10903,11065,20200308,21968
20200305,3,가락시장,7065,6916,20200308,13981
20200305,3,경찰병원,5864,5973,20200308,11837
20200305,3,오금,4982,4341,20200308,9323
20200306,3,지축,2380,2453,20200309,4833
20200306,3,구파발,15165,13520,20200309,28685
20200306,3,연신내,31695,30129,20200309,61824
20200306,3,불광,12982,13868,20200309,26850
20200306,3,녹번,11093,9721,20200309,20814
20200306,3,홍제,14090,13280,20200309,27370
20200306,3,무악재,3032,3010,20200309,6042
20200306,3,독립문,5254,5420,20200309,10674
20200306,3,경복궁,14008,13826,20200309,27834
20200306,3,안국,14033,14668,20200309,28701
20200306,3,종로3가,8453,9927,20200309,18380
20200306,3,을지로3가,8877,9566,20200309,18443
20200306,3,충무로,1,0,20200309,1
20200306,3,동대입구,5752,6184,20200309,11936
20200306,3,약수,10849,10484,20200309,21333
20200306,3,금호,6615,6177,20200309,12792
20200306,3,옥수,7080,7051,20200309,14131
20200306,3,압구정,25225,27265,20200309,52490
20200306,3,신사,24983,27306,20200309,52289
20200306,3,잠원,4237,4072,20200309,8309
20200306,3,고속터미널,27124,28593,20200309,55717
20200306,3,교대,11475,7639,20200309,19114
20200306,3,남부터미널,23494,23931,20200309,47425
20200306,3,양재,32245,33658,20200309,65903
20200306,3,매봉,9504,9012,20200309,18516
20200306,3,도곡,4046,4016,20200309,8062
20200306,3,대치,7842,7662,20200309,15504
20200306,3,학여울,1323,1298,20200309,2621
20200306,3,대청,7599,6967,20200309,14566
20200306,3,일원,6792,6585,20200309,13377
20200306,3,수서,12136,12121,20200309,24257
20200306,3,가락시장,7241,7013,20200309,14254
20200306,3,경찰병원,5936,5948,20200309,11884
20200306,3,오금,5282,4558,20200309,9840
20200307,3,지축,1341,1373,20200310,2714
20200307,3,구파발,8952,8843,20200310,17795
20200307,3,연신내,21579,20100,20200310,41679
20200307,3,불광,8780,10187,20200310,18967
20200307,3,녹번,6224,5349,20200310,11573
20200307,3,홍제,8818,8284,20200310,17102
20200307,3,무악재,1665,1743,20200310,3408
20200307,3,독립문,3622,3722,20200310,7344
20200307,3,경복궁,6928,7040,20200310,13968
20200307,3,안국,5847,6984,20200310,12831
20200307,3,종로3가,3918,5153,20200310,9071
20200307,3,을지로3가,3006,3466,20200310,6472
20200307,3,동대입구,3627,4038,20200310,7665
20200307,3,약수,6326,5979,20200310,12305
20200307,3,금호,4107,3762,20200310,7869
20200307,3,옥수,4413,4356,20200310,8769
20200307,3,압구정,16006,17073,20200310,33079
20200307,3,신사,15986,16720,20200310,32706
20200307,3,잠원,2335,2231,20200310,4566
20200307,3,고속터미널,23070,23475,20200310,46545
20200307,3,교대,3952,2535,20200310,6487
20200307,3,남부터미널,11740,11974,20200310,23714
20200307,3,양재,12420,13155,20200310,25575
20200307,3,매봉,3468,3268,20200310,6736
20200307,3,도곡,2123,2072,20200310,4195
20200307,3,대치,4636,4344,20200310,8980
20200307,3,학여울,611,591,20200310,1202
20200307,3,대청,3757,3401,20200310,7158
20200307,3,일원,2651,2574,20200310,5225
20200307,3,수서,6354,6519,20200310,12873
20200307,3,가락시장,4029,3678,20200310,7707
20200307,3,경찰병원,2517,2377,20200310,4894
20200307,3,오금,2309,2112,20200310,4421
20200308,3,지축,917,893,20200311,1810
20200308,3,구파발,6808,6941,20200311,13749
20200308,3,연신내,15155,14154,20200311,29309
20200308,3,불광,6474,7828,20200311,14302
20200308,3,녹번,3935,3492,20200311,7427
20200308,3,홍제,5967,5766,20200311,11733
20200308,3,무악재,1161,1246,20200311,2407
20200308,3,독립문,2475,2678,20200311,5153
20200308,3,경복궁,5196,5548,20200311,10744
20200308,3,안국,4475,5058,20200311,9533
20200308,3,종로3가,2305,2953,20200311,5258
20200308,3,을지로3가,1305,1403,20200311,2708
20200308,3,동대입구,2912,3407,20200311,6319
20200308,3,약수,4284,4121,20200311,8405
20200308,3,금호,2807,2629,20200311,5436
20200308,3,옥수,3172,3305,20200311,6477
20200308,3,압구정,8233,8641,20200311,16874
20200308,3,신사,8588,9001,20200311,17589
20200308,3,잠원,1557,1560,20200311,3117
20200308,3,고속터미널,20697,19736,20200311,40433
20200308,3,교대,2385,1522,20200311,3907
20200308,3,남부터미널,8265,8747,20200311,17012
20200308,3,양재,7279,8572,20200311,15851
20200308,3,매봉,2220,2181,20200311,4401
20200308,3,도곡,1116,1091,20200311,2207
20200308,3,대치,2832,2664,20200311,5496
20200308,3,학여울,432,435,20200311,867
20200308,3,대청,2491,2273,20200311,4764
20200308,3,일원,1778,1836,20200311,3614
20200308,3,수서,5003,5051,20200311,10054
20200308,3,가락시장,2194,2399,20200311,4593
20200308,3,경찰병원,1629,1681,20200311,3310
20200308,3,오금,1732,1581,20200311,3313
20200309,3,지축,2525,2617,20200312,5142
20200309,3,구파발,15945,14562,20200312,30507
20200309,3,연신내,31872,30169,20200312,62041
20200309,3,불광,13250,14144,20200312,27394
20200309,3,녹번,11125,10080,20200312,21205
20200309,3,홍제,14365,13642,20200312,28007
20200309,3,무악재,3185,3202,20200312,6387
20200309,3,독립문,5377,5494,20200312,10871
20200309,3,경복궁,13770,13608,20200312,27378
20200309,3,안국,14178,14844,20200312,29022
20200309,3,종로3가,8945,10255,20200312,19200
20200309,3,을지로3가,9070,9659,20200312,18729
20200309,3,충무로,2,0,20200312,2
20200309,3,동대입구,5726,6216,20200312,11942
20200309,3,약수,10848,10598,20200312,21446
20200309,3,금호,6688,6295,20200312,12983
20200309,3,옥수,7170,7421,20200312,14591
20200309,3,압구정,24752,26649,20200312,51401
20200309,3,신사,24976,26561,20200312,51537
20200309,3,잠원,4479,4374,20200312,8853
20200309,3,고속터미널,26485,24789,20200312,51274
20200309,3,교대,11664,7838,20200312,19502
20200309,3,남부터미널,22558,23270,20200312,45828
20200309,3,양재,31429,34354,20200312,65783
20200309,3,매봉,9648,9292,20200312,18940
20200309,3,도곡,4123,4122,20200312,8245
20200309,3,대치,7553,7523,20200312,15076
20200309,3,학여울,1287,1291,20200312,2578
20200309,3,대청,7698,7190,20200312,14888
20200309,3,일원,7192,7059,20200312,14251
20200309,3,수서,11796,11948,20200312,23744
20200309,3,가락시장,7230,7129,20200312,14359
20200309,3,경찰병원,6294,6264,20200312,12558
20200309,3,오금,5363,4692,20200312,10055
20200310,3,지축,2345,2405,20200313,4750
20200310,3,구파발,15272,13953,20200313,29225
20200310,3,연신내,29910,28509,20200313,58419
20200310,3,불광,12242,12984,20200313,25226
20200310,3,녹번,10858,9718,20200313,20576
20200310,3,홍제,13544,12928,20200313,26472
20200310,3,무악재,3074,3135,20200313,6209
20200310,3,독립문,4871,5024,20200313,9895
20200310,3,경복궁,13329,13244,20200313,26573
20200310,3,안국,14132,14402,20200313,28534
20200310,3,종로3가,8969,9918,20200313,18887
20200310,3,을지로3가,9157,9541,20200313,18698
20200310,3,충무로,2,0,20200313,2
20200310,3,동대입구,5717,6051,20200313,11768
20200310,3,약수,10404,10185,20200313,20589
20200310,3,금호,6407,6014,20200313,12421
20200310,3,옥수,6590,6829,20200313,13419
20200310,3,압구정,24147,26029,20200313,50176
20200310,3,신사,24748,26298,20200313,51046
20200310,3,잠원,4160,4123,20200313,8283
20200310,3,고속터미널,23095,22683,20200313,45778
20200310,3,교대,11242,7641,20200313,18883
20200310,3,남부터미널,22344,22866,20200313,45210
20200310,3,양재,31271,33626,20200313,64897
20200310,3,매봉,9580,9216,20200313,18796
20200310,3,도곡,3900,3857,20200313,7757
20200310,3,대치,7294,7247,20200313,14541
20200310,3,학여울,1179,1240,20200313,2419
20200310,3,대청,7409,6833,20200313,14242
20200310,3,일원,6851,6830,20200313,13681
20200310,3,수서,11149,11310,20200313,22459
20200310,3,가락시장,6954,6708,20200313,13662
20200310,3,경찰병원,6234,6340,20200313,12574
20200310,3,오금,5159,4388,20200313,9547
20200311,3,지축,2521,2580,20200314,5101
20200311,3,구파발,16077,14675,20200314,30752
20200311,3,연신내,31867,30030,20200314,61897
20200311,3,불광,13375,14233,20200314,27608
20200311,3,녹번,11200,9997,20200314,21197
20200311,3,홍제,14222,13606,20200314,27828
20200311,3,무악재,3155,3139,20200314,6294
20200311,3,독립문,5296,5509,20200314,10805
20200311,3,경복궁,13919,13887,20200314,27806
20200311,3,안국,14420,15295,20200314,29715
20200311,3,종로3가,8935,9985,20200314,18920
20200311,3,을지로3가,9063,9704,20200314,18767
20200311,3,동대입구,6032,6416,20200314,12448
20200311,3,약수,10724,10485,20200314,21209
20200311,3,금호,6559,6243,20200314,12802
20200311,3,옥수,7036,7145,20200314,14181
20200311,3,압구정,24700,26707,20200314,51407
20200311,3,신사,25801,27326,20200314,53127
20200311,3,잠원,4406,4279,20200314,8685
20200311,3,고속터미널,24888,23965,20200314,48853
20200311,3,교대,11702,7811,20200314,19513
20200311,3,남부터미널,22430,23210,20200314,45640
20200311,3,양재,31324,34049,20200314,65373
20200311,3,매봉,9608,9192,20200314,18800
20200311,3,도곡,3979,4038,20200314,8017
20200311,3,대치,7300,7194,20200314,14494
20200311,3,학여울,1293,1256,20200314,2549
20200311,3,대청,7480,6843,20200314,14323
20200311,3,일원,6852,6745,20200314,13597
20200311,3,수서,11380,11685,20200314,23065
20200311,3,가락시장,7373,7134,20200314,14507
20200311,3,경찰병원,6252,6334,20200314,12586
20200311,3,오금,5250,4453,20200314,9703
20200312,3,지축,2427,2520,20200315,4947
20200312,3,구파발,15806,14246,20200315,30052
20200312,3,연신내,31182,29462,20200315,60644
20200312,3,불광,12971,13749,20200315,26720
20200312,3,녹번,10966,9750,20200315,20716
20200312,3,홍제,13595,12963,20200315,26558
20200312,3,무악재,3069,3101,20200315,6170
20200312,3,독립문,5222,5351,20200315,10573
20200312,3,경복궁,13784,13731,20200315,27515
20200312,3,안국,14169,14832,20200315,29001
20200312,3,종로3가,8727,10041,20200315,18768
20200312,3,을지로3가,8902,9338,20200315,18240
20200312,3,동대입구,5843,6289,20200315,12132
20200312,3,약수,10539,10176,20200315,20715
20200312,3,금호,6543,6196,20200315,12739
20200312,3,옥수,6894,7087,20200315,13981
20200312,3,압구정,24091,25946,20200315,50037
20200312,3,신사,25385,27183,20200315,52568
20200312,3,잠원,4171,4173,20200315,8344
20200312,3,고속터미널,25076,24314,20200315,49390
20200312,3,교대,11477,7785,20200315,19262
20200312,3,남부터미널,22105,22617,20200315,44722
20200312,3,양재,31204,33743,20200315,64947
20200312,3,매봉,9450,9057,20200315,18507
20200312,3,도곡,3886,3904,20200315,7790
20200312,3,대치,7240,7181,20200315,14421
20200312,3,학여울,1246,1239,20200315,2485
20200312,3,대청,7334,6678,20200315,14012
20200312,3,일원,6971,6921,20200315,13892
20200312,3,수서,11449,11670,20200315,23119
20200312,3,가락시장,7267,7018,20200315,14285
20200312,3,경찰병원,6145,6190,20200315,12335
20200312,3,오금,5191,4432,20200315,9623
20200313,3,지축,2484,2477,20200316,4961
20200313,3,구파발,15817,14222,20200316,30039
20200313,3,연신내,32074,30489,20200316,62563
20200313,3,불광,13123,14013,20200316,27136
20200313,3,녹번,11100,9742,20200316,20842
20200313,3,홍제,14099,13269,20200316,27368
20200313,3,무악재,3124,3137,20200316,6261
20200313,3,독립문,5244,5327,20200316,10571
20200313,3,경복궁,13960,13824,20200316,27784
20200313,3,안국,14276,14783,20200316,29059
20200313,3,종로3가,8420,9813,20200316,18233
20200313,3,을지로3가,9007,9677,20200316,18684
20200313,3,충무로,1,0,20200316,1
20200313,3,동대입구,5961,6264,20200316,12225
20200313,3,약수,10905,10656,20200316,21561
20200313,3,금호,6700,6150,20200316,12850
20200313,3,옥수,7179,7297,20200316,14476
20200313,3,압구정,26044,28061,20200316,54105
20200313,3,신사,26561,28908,20200316,55469
20200313,3,잠원,4393,4232,20200316,8625
20200313,3,고속터미널,29475,30530,20200316,60005
20200313,3,교대,11582,7943,20200316,19525
20200313,3,남부터미널,23483,24019,20200316,47502
20200313,3,양재,32762,33944,20200316,66706
20200313,3,매봉,9443,9045,20200316,18488
20200313,3,도곡,4123,3999,20200316,8122
20200313,3,대치,7473,7330,20200316,14803
20200313,3,학여울,1272,1297,20200316,2569
20200313,3,대청,7451,6811,20200316,14262
20200313,3,일원,6912,6586,20200316,13498
20200313,3,수서,12658,12714,20200316,25372
20200313,3,가락시장,7372,7146,20200316,14518
20200313,3,경찰병원,6236,6273,20200316,12509
20200313,3,오금,5287,4523,20200316,9810
20200314,3,지축,1376,1428,20200317,2804
20200314,3,구파발,9686,9627,20200317,19313
20200314,3,연신내,22181,20619,20200317,42800
20200314,3,불광,9180,10524,20200317,19704
20200314,3,녹번,6410,5478,20200317,11888
20200314,3,홍제,9107,8459,20200317,17566
20200314,3,무악재,1789,1847,20200317,3636
20200314,3,독립문,3756,3870,20200317,7626
20200314,3,경복궁,7631,7882,20200317,15513
20200314,3,안국,6649,7804,20200317,14453
20200314,3,종로3가,4126,5375,20200317,9501
20200314,3,을지로3가,3161,3473,20200317,6634
20200314,3,동대입구,3717,4311,20200317,8028
20200314,3,약수,6483,6179,20200317,12662
20200314,3,금호,4283,3927,20200317,8210
20200314,3,옥수,4462,4434,20200317,8896
20200314,3,압구정,16736,17468,20200317,34204
20200314,3,신사,17373,18770,20200317,36143
20200314,3,잠원,2548,2433,20200317,4981
20200314,3,고속터미널,26297,26576,20200317,52873
20200314,3,교대,4063,2678,20200317,6741
20200314,3,남부터미널,12443,12399,20200317,24842
20200314,3,양재,12566,13625,20200317,26191
20200314,3,매봉,3584,3463,20200317,7047
20200314,3,도곡,2167,2077,20200317,4244
20200314,3,대치,4719,4421,20200317,9140
20200314,3,학여울,651,676,20200317,1327
20200314,3,대청,3874,3527,20200317,7401
20200314,3,일원,2791,2662,20200317,5453
20200314,3,수서,6777,6814,20200317,13591
20200314,3,가락시장,4137,3873,20200317,8010
20200314,3,경찰병원,2654,2499,20200317,5153
20200314,3,오금,2598,2265,20200317,4863
20200315,3,지축,1017,954,20200318,1971
20200315,3,구파발,7022,7184,20200318,14206
20200315,3,연신내,14977,14149,20200318,29126
20200315,3,불광,6649,7830,20200318,14479
20200315,3,녹번,3900,3456,20200318,7356
20200315,3,홍제,5782,5482,20200318,11264
20200315,3,무악재,1150,1274,20200318,2424
20200315,3,독립문,2509,2680,20200318,5189
20200315,3,경복궁,5076,5222,20200318,10298
20200315,3,안국,4527,4937,20200318,9464
20200315,3,종로3가,2421,3218,20200318,5639
20200315,3,을지로3가,1280,1437,20200318,2717
20200315,3,동대입구,2984,3298,20200318,6282
20200315,3,약수,4202,3993,20200318,8195
20200315,3,금호,2747,2741,20200318,5488
20200315,3,옥수,2990,3248,20200318,6238
20200315,3,압구정,7847,8331,20200318,16178
20200315,3,신사,8456,8604,20200318,17060
20200315,3,잠원,1547,1527,20200318,3074
20200315,3,고속터미널,21618,20548,20200318,42166
20200315,3,교대,2390,1513,20200318,3903
20200315,3,남부터미널,8242,8558,20200318,16800
20200315,3,양재,7228,8573,20200318,15801
20200315,3,매봉,2121,2098,20200318,4219
20200315,3,도곡,1107,1202,20200318,2309
20200315,3,대치,2626,2479,20200318,5105
20200315,3,학여울,446,460,20200318,906
20200315,3,대청,2482,2392,20200318,4874
20200315,3,일원,1754,1898,20200318,3652
20200315,3,수서,5209,5479,20200318,10688
20200315,3,가락시장,2335,2502,20200318,4837
20200315,3,경찰병원,1702,1768,20200318,3470
20200315,3,오금,1704,1660,20200318,3364
20200316,3,지축,2560,2644,20200319,5204
20200316,3,구파발,16023,14642,20200319,30665
20200316,3,연신내,31688,30062,20200319,61750
20200316,3,불광,13158,14123,20200319,27281
20200316,3,녹번,11121,9996,20200319,21117
20200316,3,홍제,14070,13686,20200319,27756
20200316,3,무악재,3154,3151,20200319,6305
20200316,3,독립문,5242,5330,20200319,10572
20200316,3,경복궁,13564,13332,20200319,26896
20200316,3,안국,14036,14645,20200319,28681
20200316,3,종로3가,8887,10019,20200319,18906
20200316,3,을지로3가,8989,9463,20200319,18452
20200316,3,충무로,1,0,20200319,1
20200316,3,동대입구,5851,6254,20200319,12105
20200316,3,약수,10547,10428,20200319,20975
20200316,3,금호,6561,6216,20200319,12777
20200316,3,옥수,6857,7242,20200319,14099
20200316,3,압구정,23054,24899,20200319,47953
20200316,3,신사,23802,25297,20200319,49099
20200316,3,잠원,4363,4257,20200319,8620
20200316,3,고속터미널,25428,23489,20200319,48917
20200316,3,교대,11760,7901,20200319,19661
20200316,3,남부터미널,22947,23328,20200319,46275
20200316,3,양재,31164,33862,20200319,65026
20200316,3,매봉,9524,9181,20200319,18705
20200316,3,도곡,4146,4087,20200319,8233
20200316,3,대치,7691,7556,20200319,15247
20200316,3,학여울,1317,1369,20200319,2686
20200316,3,대청,7485,6897,20200319,14382
20200316,3,일원,7030,7054,20200319,14084
20200316,3,수서,11839,12032,20200319,23871
20200316,3,가락시장,7097,6995,20200319,14092
20200316,3,경찰병원,6373,6454,20200319,12827
20200316,3,오금,5350,4684,20200319,10034
20200317,3,지축,2566,2563,20200320,5129
20200317,3,구파발,15932,14712,20200320,30644
20200317,3,연신내,31370,29481,20200320,60851
20200317,3,불광,12849,13932,20200320,26781
20200317,3,녹번,11158,10086,20200320,21244
20200317,3,홍제,13844,13292,20200320,27136
20200317,3,무악재,3145,3166,20200320,6311
20200317,3,독립문,5226,5260,20200320,10486
20200317,3,경복궁,13300,13179,20200320,26479
20200317,3,안국,14038,14553,20200320,28591
20200317,3,종로3가,8901,10024,20200320,18925
20200317,3,을지로3가,8961,9419,20200320,18380
20200317,3,충무로,1,0,20200320,1
20200317,3,동대입구,5873,6256,20200320,12129
20200317,3,약수,10400,10358,20200320,20758
20200317,3,금호,6573,6222,20200320,12795
20200317,3,옥수,6895,7206,20200320,14101
20200317,3,압구정,25001,26841,20200320,51842
20200317,3,신사,24253,25902,20200320,50155
20200317,3,잠원,4241,4096,20200320,8337
20200317,3,고속터미널,25114,24189,20200320,49303
20200317,3,교대,11741,7882,20200320,19623
20200317,3,남부터미널,22394,23047,20200320,45441
20200317,3,양재,31479,33873,20200320,65352
20200317,3,매봉,9501,9055,20200320,18556
20200317,3,도곡,3941,3986,20200320,7927
20200317,3,대치,7630,7491,20200320,15121
20200317,3,학여울,1292,1265,20200320,2557
20200317,3,대청,7515,6857,20200320,14372
20200317,3,일원,7010,6928,20200320,13938
20200317,3,수서,11653,11754,20200320,23407
20200317,3,가락시장,7162,6924,20200320,14086
20200317,3,경찰병원,6201,6288,20200320,12489
20200317,3,오금,5224,4496,20200320,9720
20200318,3,지축,2688,2698,20200321,5386
20200318,3,구파발,16509,15082,20200321,31591
20200318,3,연신내,32720,30862,20200321,63582
20200318,3,불광,13257,14545,20200321,27802
20200318,3,녹번,11462,10308,20200321,21770
20200318,3,홍제,14460,13714,20200321,28174
20200318,3,무악재,3294,3299,20200321,6593
20200318,3,독립문,5457,5543,20200321,11000
20200318,3,경복궁,14162,14203,20200321,28365
20200318,3,안국,14485,15250,20200321,29735
20200318,3,종로3가,9001,10308,20200321,19309
20200318,3,을지로3가,9109,9705,20200321,18814
20200318,3,동대입구,6148,6696,20200321,12844
20200318,3,약수,10786,10568,20200321,21354
20200318,3,금호,6842,6374,20200321,13216
20200318,3,옥수,7241,7502,20200321,14743
20200318,3,압구정,24932,26789,20200321,51721
20200318,3,신사,24471,26436,20200321,50907
20200318,3,잠원,4513,4375,20200321,8888
20200318,3,고속터미널,26556,25360,20200321,51916
20200318,3,교대,11864,8064,20200321,19928
20200318,3,남부터미널,22784,23404,20200321,46188
20200318,3,양재,31551,34234,20200321,65785
20200318,3,매봉,9683,9306,20200321,18989
20200318,3,도곡,4016,4073,20200321,8089
20200318,3,대치,7875,7643,20200321,15518
20200318,3,학여울,1387,1372,20200321,2759
20200318,3,대청,7726,7010,20200321,14736
20200318,3,일원,7308,7098,20200321,14406
20200318,3,수서,11693,11897,20200321,23590
20200318,3,가락시장,7335,7301,20200321,14636
20200318,3,경찰병원,6378,6342,20200321,12720
20200318,3,오금,5308,4704,20200321,10012
20200319,3,지축,2497,2554,20200322,5051
20200319,3,구파발,15658,14272,20200322,29930
20200319,3,연신내,30461,28909,20200322,59370
20200319,3,불광,12586,13429,20200322,26015
20200319,3,녹번,10955,9742,20200322,20697
20200319,3,홍제,13624,12914,20200322,26538
20200319,3,무악재,3047,3055,20200322,6102
20200319,3,독립문,5008,5136,20200322,10144
20200319,3,경복궁,13101,12920,20200322,26021
20200319,3,안국,13668,14148,20200322,27816
20200319,3,종로3가,8888,9855,20200322,18743
20200319,3,을지로3가,8790,9355,20200322,18145
20200319,3,충무로,4,0,20200322,4
20200319,3,동대입구,5847,6182,20200322,12029
20200319,3,약수,10322,9991,20200322,20313
20200319,3,금호,6310,5965,20200322,12275
20200319,3,옥수,6762,7035,20200322,13797
20200319,3,압구정,23677,25479,20200322,49156
20200319,3,신사,23905,25456,20200322,49361
20200319,3,잠원,4209,4078,20200322,8287
20200319,3,고속터미널,24803,24393,20200322,49196
20200319,3,교대,11456,7750,20200322,19206
20200319,3,남부터미널,21761,22484,20200322,44245
20200319,3,양재,31333,33558,20200322,64891
20200319,3,매봉,9321,9033,20200322,18354
20200319,3,도곡,3890,3940,20200322,7830
20200319,3,대치,7543,7398,20200322,14941
20200319,3,학여울,1276,1240,20200322,2516
20200319,3,대청,7403,6801,20200322,14204
20200319,3,일원,6805,6735,20200322,13540
20200319,3,수서,11584,11734,20200322,23318
20200319,3,가락시장,6968,6807,20200322,13775
20200319,3,경찰병원,6051,6141,20200322,12192
20200319,3,오금,5113,4477,20200322,9590
20200320,3,지축,2670,2723,20200323,5393
20200320,3,구파발,16893,15315,20200323,32208
20200320,3,연신내,33912,32471,20200323,66383
20200320,3,불광,13789,14766,20200323,28555
20200320,3,녹번,11622,10042,20200323,21664
20200320,3,홍제,14777,13954,20200323,28731
20200320,3,무악재,3313,3239,20200323,6552
20200320,3,독립문,5645,5720,20200323,11365
20200320,3,경복궁,14404,14147,20200323,28551
20200320,3,안국,14377,15295,20200323,29672
20200320,3,종로3가,8561,10386,20200323,18947
20200320,3,을지로3가,9210,9872,20200323,19082
20200320,3,동대입구,6375,6809,20200323,13184
20200320,3,약수,11219,10855,20200323,22074
20200320,3,금호,7019,6574,20200323,13593
20200320,3,옥수,7563,7469,20200323,15032
20200320,3,압구정,26134,28313,20200323,54447
20200320,3,신사,26267,28812,20200323,55079
20200320,3,잠원,4600,4455,20200323,9055
20200320,3,고속터미널,31160,32782,20200323,63942
20200320,3,교대,12169,8156,20200323,20325
20200320,3,남부터미널,25768,26218,20200323,51986
20200320,3,양재,33467,34818,20200323,68285
20200320,3,매봉,9639,9237,20200323,18876
20200320,3,도곡,4092,4089,20200323,8181
20200320,3,대치,8190,8079,20200323,16269
20200320,3,학여울,1403,1353,20200323,2756
20200320,3,대청,7864,7008,20200323,14872
20200320,3,일원,7154,6816,20200323,13970
20200320,3,수서,13565,13597,20200323,27162
20200320,3,가락시장,7828,7601,20200323,15429
20200320,3,경찰병원,6344,6290,20200323,12634
20200320,3,오금,5497,4694,20200323,10191
20200321,3,지축,1558,1528,20200324,3086
20200321,3,구파발,10297,10191,20200324,20488
20200321,3,연신내,23329,21831,20200324,45160
20200321,3,불광,9376,10831,20200324,20207
20200321,3,녹번,6657,5715,20200324,12372
20200321,3,홍제,9449,8950,20200324,18399
20200321,3,무악재,1960,1997,20200324,3957
20200321,3,독립문,3898,4218,20200324,8116
20200321,3,경복궁,8012,8333,20200324,16345
20200321,3,안국,6902,8091,20200324,14993
20200321,3,종로3가,4204,5944,20200324,10148
20200321,3,을지로3가,3182,3655,20200324,6837
20200321,3,동대입구,3906,4365,20200324,8271
20200321,3,약수,6704,6395,20200324,13099
20200321,3,금호,4252,4009,20200324,8261
20200321,3,옥수,4980,4992,20200324,9972
20200321,3,압구정,16767,17631,20200324,34398
20200321,3,신사,16278,17555,20200324,33833
20200321,3,잠원,2634,2527,20200324,5161
20200321,3,고속터미널,28747,28841,20200324,57588
20200321,3,교대,4344,2814,20200324,7158
20200321,3,남부터미널,13647,13852,20200324,27499
20200321,3,양재,12795,14042,20200324,26837
20200321,3,매봉,3688,3491,20200324,7179
20200321,3,도곡,2042,2049,20200324,4091
20200321,3,대치,5231,4756,20200324,9987
20200321,3,학여울,732,688,20200324,1420
20200321,3,대청,4025,3657,20200324,7682
20200321,3,일원,2803,2795,20200324,5598
20200321,3,수서,6971,7155,20200324,14126
20200321,3,가락시장,4310,3882,20200324,8192
20200321,3,경찰병원,2706,2561,20200324,5267
20200321,3,오금,2632,2382,20200324,5014
20200322,3,지축,1110,1039,20200325,2149
20200322,3,구파발,7494,7577,20200325,15071
20200322,3,연신내,16186,15335,20200325,31521
20200322,3,불광,7162,8722,20200325,15884
20200322,3,녹번,4210,3788,20200325,7998
20200322,3,홍제,6187,5798,20200325,11985
20200322,3,무악재,1222,1273,20200325,2495
20200322,3,독립문,2790,3069,20200325,5859
20200322,3,경복궁,5809,6234,20200325,12043
20200322,3,안국,4783,5654,20200325,10437
20200322,3,종로3가,2282,3156,20200325,5438
20200322,3,을지로3가,1392,1483,20200325,2875
20200322,3,동대입구,3173,3874,20200325,7047
20200322,3,약수,4446,4226,20200325,8672
20200322,3,금호,2966,2760,20200325,5726
20200322,3,옥수,3413,3559,20200325,6972
20200322,3,압구정,7971,8500,20200325,16471
20200322,3,신사,9039,9215,20200325,18254
20200322,3,잠원,1795,1800,20200325,3595
20200322,3,고속터미널,24746,22861,20200325,47607
20200322,3,교대,2482,1675,20200325,4157
20200322,3,남부터미널,9952,10146,20200325,20098
20200322,3,양재,7689,9148,20200325,16837
20200322,3,매봉,2246,2320,20200325,4566
20200322,3,도곡,1082,1176,20200325,2258
20200322,3,대치,3095,2773,20200325,5868
20200322,3,학여울,449,498,20200325,947
20200322,3,대청,2635,2572,20200325,5207
20200322,3,일원,1960,2013,20200325,3973
20200322,3,수서,5678,5782,20200325,11460
20200322,3,가락시장,2380,2526,20200325,4906
20200322,3,경찰병원,1726,1758,20200325,3484
20200322,3,오금,1772,1706,20200325,3478
20200323,3,지축,2626,2705,20200326,5331
20200323,3,구파발,16600,15230,20200326,31830
20200323,3,연신내,32318,30591,20200326,62909
20200323,3,불광,13411,14445,20200326,27856
20200323,3,녹번,11355,10127,20200326,21482
20200323,3,홍제,14296,13682,20200326,27978
20200323,3,무악재,3237,3247,20200326,6484
20200323,3,독립문,5468,5583,20200326,11051
20200323,3,경복궁,13623,13509,20200326,27132
20200323,3,안국,14779,15328,20200326,30107
20200323,3,종로3가,8907,10145,20200326,19052
20200323,3,을지로3가,9059,9506,20200326,18565
20200323,3,충무로,2,0,20200326,2
20200323,3,동대입구,5983,6423,20200326,12406
20200323,3,약수,10765,10494,20200326,21259
20200323,3,금호,6657,6311,20200326,12968
20200323,3,옥수,7028,7352,20200326,14380
20200323,3,압구정,25180,27165,20200326,52345
20200323,3,신사,24438,25820,20200326,50258
20200323,3,잠원,4443,4449,20200326,8892
20200323,3,고속터미널,27618,25642,20200326,53260
20200323,3,교대,12107,8276,20200326,20383
20200323,3,남부터미널,23432,24110,20200326,47542
20200323,3,양재,31689,34459,20200326,66148
20200323,3,매봉,9668,9131,20200326,18799
20200323,3,도곡,4037,4085,20200326,8122
20200323,3,대치,8106,7969,20200326,16075
20200323,3,학여울,1406,1407,20200326,2813
20200323,3,대청,7687,7111,20200326,14798
20200323,3,일원,7173,7171,20200326,14344
20200323,3,수서,12226,12486,20200326,24712
20200323,3,가락시장,7351,7345,20200326,14696
20200323,3,경찰병원,6472,6443,20200326,12915
20200323,3,오금,5444,4752,20200326,10196
20200324,3,지축,2647,2693,20200327,5340
20200324,3,구파발,16769,15523,20200327,32292
20200324,3,연신내,32474,30602,20200327,63076
20200324,3,불광,13404,14397,20200327,27801
20200324,3,녹번,11376,10235,20200327,21611
20200324,3,홍제,14175,13547,20200327,27722
20200324,3,무악재,3198,3226,20200327,6424
20200324,3,독립문,5637,5832,20200327,11469
20200324,3,경복궁,13846,13707,20200327,27553
20200324,3,안국,15512,16067,20200327,31579
20200324,3,종로3가,8987,10238,20200327,19225
20200324,3,을지로3가,8997,9611,20200327,18608
20200324,3,동대입구,5998,6581,20200327,12579
20200324,3,약수,10809,10440,20200327,21249
20200324,3,금호,6746,6347,20200327,13093
20200324,3,옥수,7193,7453,20200327,14646
20200324,3,압구정,25333,27051,20200327,52384
20200324,3,신사,24639,25947,20200327,50586
20200324,3,잠원,4448,4464,20200327,8912
20200324,3,고속터미널,26348,25124,20200327,51472
20200324,3,교대,12439,8388,20200327,20827
20200324,3,남부터미널,23132,23842,20200327,46974
20200324,3,양재,32140,34524,20200327,66664
20200324,3,매봉,9661,9325,20200327,18986
20200324,3,도곡,4094,4028,20200327,8122
20200324,3,대치,7875,7831,20200327,15706
20200324,3,학여울,1368,1353,20200327,2721
20200324,3,대청,7647,7034,20200327,14681
20200324,3,일원,7285,7186,20200327,14471
20200324,3,수서,12033,12208,20200327,24241
20200324,3,가락시장,7431,7326,20200327,14757
20200324,3,경찰병원,6325,6355,20200327,12680
20200324,3,오금,5460,4694,20200327,10154
20200325,3,지축,2741,2781,20200328,5522
20200325,3,구파발,16830,15536,20200328,32366
20200325,3,연신내,32970,31472,20200328,64442
20200325,3,불광,13867,14974,20200328,28841
20200325,3,녹번,11629,10456,20200328,22085
20200325,3,홍제,14549,13784,20200328,28333
20200325,3,무악재,3250,3274,20200328,6524
20200325,3,독립문,5577,5823,20200328,11400
20200325,3,경복궁,14407,14251,20200328,28658
20200325,3,안국,15061,15914,20200328,30975
20200325,3,종로3가,9035,10334,20200328,19369
20200325,3,을지로3가,9204,9812,20200328,19016
20200325,3,동대입구,6287,6738,20200328,13025
20200325,3,약수,10876,10577,20200328,21453
20200325,3,금호,6821,6533,20200328,13354
20200325,3,옥수,7275,7409,20200328,14684
20200325,3,압구정,24970,26926,20200328,51896
20200325,3,신사,24825,26442,20200328,51267
20200325,3,잠원,4557,4505,20200328,9062
20200325,3,고속터미널,27247,25889,20200328,53136
20200325,3,교대,12750,8428,20200328,21178
20200325,3,남부터미널,23139,23858,20200328,46997
20200325,3,양재,31874,34454,20200328,66328
20200325,3,매봉,9686,9240,20200328,18926
20200325,3,도곡,3900,4100,20200328,8000
20200325,3,대치,8067,7878,20200328,15945
20200325,3,학여울,1398,1370,20200328,2768
20200325,3,대청,7875,7089,20200328,14964
20200325,3,일원,7113,7129,20200328,14242
20200325,3,수서,12187,12372,20200328,24559
20200325,3,가락시장,7516,7238,20200328,14754
20200325,3,경찰병원,6360,6444,20200328,12804
20200325,3,오금,5420,4653,20200328,10073
20200326,3,지축,2744,2716,20200329,5460
20200326,3,구파발,16545,15191,20200329,31736
20200326,3,연신내,31973,30199,20200329,62172
20200326,3,불광,13172,14211,20200329,27383
20200326,3,녹번,11415,10201,20200329,21616
20200326,3,홍제,14182,13611,20200329,27793
20200326,3,무악재,3216,3251,20200329,6467
20200326,3,독립문,5482,5715,20200329,11197
20200326,3,경복궁,13499,13519,20200329,27018
20200326,3,안국,14819,15354,20200329,30173
20200326,3,종로3가,8986,10204,20200329,19190
20200326,3,을지로3가,9009,9542,20200329,18551
20200326,3,동대입구,6038,6446,20200329,12484
20200326,3,약수,10689,10345,20200329,21034
20200326,3,금호,6644,6276,20200329,12920
20200326,3,옥수,7060,7348,20200329,14408
20200326,3,압구정,24409,26421,20200329,50830
20200326,3,신사,24126,25711,20200329,49837
20200326,3,잠원,4368,4295,20200329,8663
20200326,3,고속터미널,26722,26072,20200329,52794
20200326,3,교대,12199,8274,20200329,20473
20200326,3,남부터미널,22862,23725,20200329,46587
20200326,3,양재,31963,34343,20200329,66306
20200326,3,매봉,9524,9128,20200329,18652
20200326,3,도곡,3943,4049,20200329,7992
20200326,3,대치,7962,7817,20200329,15779
20200326,3,학여울,1334,1333,20200329,2667
20200326,3,대청,7652,7062,20200329,14714
20200326,3,일원,7168,7267,20200329,14435
20200326,3,수서,12088,12338,20200329,24426
20200326,3,가락시장,7455,7215,20200329,14670
20200326,3,경찰병원,6353,6341,20200329,12694
20200326,3,오금,5336,4660,20200329,9996
20200327,3,지축,2720,2734,20200330,5454
20200327,3,구파발,16978,15288,20200330,32266
20200327,3,연신내,33284,31845,20200330,65129
20200327,3,불광,13761,14658,20200330,28419
20200327,3,녹번,11498,9940,20200330,21438
20200327,3,홍제,14723,13686,20200330,28409
20200327,3,무악재,3222,3202,20200330,6424
20200327,3,독립문,5532,5565,20200330,11097
20200327,3,경복궁,14138,13845,20200330,27983
20200327,3,안국,15052,15689,20200330,30741
20200327,3,종로3가,8805,10285,20200330,19090
20200327,3,을지로3가,9122,9858,20200330,18980
20200327,3,동대입구,6494,6915,20200330,13409
20200327,3,약수,11091,10941,20200330,22032
20200327,3,금호,6970,6367,20200330,13337
20200327,3,옥수,7501,7531,20200330,15032
20200327,3,압구정,26186,28537,20200330,54723
20200327,3,신사,26337,28725,20200330,55062
20200327,3,잠원,4670,4566,20200330,9236
20200327,3,고속터미널,31784,33525,20200330,65309
20200327,3,교대,12543,8335,20200330,20878
20200327,3,남부터미널,24902,25722,20200330,50624
20200327,3,양재,33670,34886,20200330,68556
20200327,3,매봉,9702,9315,20200330,19017
20200327,3,도곡,4154,4153,20200330,8307
20200327,3,대치,8432,8194,20200330,16626
20200327,3,학여울,1407,1401,20200330,2808
20200327,3,대청,7879,7190,20200330,15069
20200327,3,일원,7241,7118,20200330,14359
20200327,3,수서,13446,13708,20200330,27154
20200327,3,가락시장,7707,7491,20200330,15198
20200327,3,경찰병원,6378,6332,20200330,12710
20200327,3,오금,5412,4712,20200330,10124
20200328,3,지축,1627,1609,20200331,3236
20200328,3,구파발,10650,10731,20200331,21381
20200328,3,연신내,24004,22469,20200331,46473
20200328,3,불광,10020,11355,20200331,21375
20200328,3,녹번,6792,5725,20200331,12517
20200328,3,홍제,9747,9166,20200331,18913
20200328,3,무악재,1888,2015,20200331,3903
20200328,3,독립문,4079,4481,20200331,8560
20200328,3,경복궁,8172,8719,20200331,16891
20200328,3,안국,6949,8150,20200331,15099
20200328,3,종로3가,3757,5228,20200331,8985
20200328,3,을지로3가,3312,3813,20200331,7125
20200328,3,동대입구,3746,4480,20200331,8226
20200328,3,약수,6935,6485,20200331,13420
20200328,3,금호,4448,4179,20200331,8627
20200328,3,옥수,5185,5108,20200331,10293
20200328,3,압구정,16926,17898,20200331,34824
20200328,3,신사,16743,17703,20200331,34446
20200328,3,잠원,2749,2673,20200331,5422
20200328,3,고속터미널,29535,27954,20200331,57489
20200328,3,교대,4494,2867,20200331,7361
20200328,3,남부터미널,13475,13558,20200331,27033
20200328,3,양재,12939,13728,20200331,26667
20200328,3,매봉,3907,3703,20200331,7610
20200328,3,도곡,2118,2133,20200331,4251
20200328,3,대치,5436,4818,20200331,10254
20200328,3,학여울,746,830,20200331,1576
20200328,3,대청,4031,3592,20200331,7623
20200328,3,일원,2749,2698,20200331,5447
20200328,3,수서,7247,7482,20200331,14729
20200328,3,가락시장,4382,3976,20200331,8358
20200328,3,경찰병원,2771,2657,20200331,5428
20200328,3,오금,2595,2356,20200331,4951
20200329,3,지축,1229,1194,20200401,2423
20200329,3,구파발,8009,8178,20200401,16187
20200329,3,연신내,16882,15668,20200401,32550
20200329,3,불광,6950,8284,20200401,15234
20200329,3,녹번,4203,3776,20200401,7979
20200329,3,홍제,6464,6049,20200401,12513
20200329,3,무악재,1254,1408,20200401,2662
20200329,3,독립문,2789,3260,20200401,6049
20200329,3,경복궁,5784,6036,20200401,11820
20200329,3,안국,4880,5674,20200401,10554
20200329,3,종로3가,2315,3146,20200401,5461
20200329,3,을지로3가,1408,1628,20200401,3036
20200329,3,동대입구,3148,3843,20200401,6991
20200329,3,약수,4408,4320,20200401,8728
20200329,3,금호,3119,2982,20200401,6101
20200329,3,옥수,3603,3838,20200401,7441
20200329,3,압구정,8055,8531,20200401,16586
20200329,3,신사,8653,8790,20200401,17443
20200329,3,잠원,1836,1884,20200401,3720
20200329,3,고속터미널,25047,22912,20200401,47959
20200329,3,교대,2756,1808,20200401,4564
20200329,3,남부터미널,9783,9879,20200401,19662
20200329,3,양재,8061,9630,20200401,17691
20200329,3,매봉,2584,2531,20200401,5115
20200329,3,도곡,1189,1397,20200401,2586
20200329,3,대치,3262,2939,20200401,6201
20200329,3,학여울,503,505,20200401,1008
20200329,3,대청,2736,2600,20200401,5336
20200329,3,일원,1938,2083,20200401,4021
20200329,3,수서,5986,5981,20200401,11967
20200329,3,가락시장,2601,2688,20200401,5289
20200329,3,경찰병원,1772,1882,20200401,3654
20200329,3,오금,1852,1739,20200401,3591
20200330,3,지축,2790,2797,20200402,5587
20200330,3,구파발,17196,15874,20200402,33070
20200330,3,연신내,32727,31206,20200402,63933
20200330,3,불광,13618,14727,20200402,28345
20200330,3,녹번,11467,10386,20200402,21853
20200330,3,홍제,14966,14473,20200402,29439
20200330,3,무악재,3215,3254,20200402,6469
20200330,3,독립문,5702,5876,20200402,11578
20200330,3,경복궁,13652,13723,20200402,27375
20200330,3,안국,15145,15501,20200402,30646
20200330,3,종로3가,8900,10266,20200402,19166
20200330,3,을지로3가,9194,9699,20200402,18893
20200330,3,동대입구,6160,6703,20200402,12863
20200330,3,약수,10801,10625,20200402,21426
20200330,3,금호,6720,6316,20200402,13036
20200330,3,옥수,7337,7570,20200402,14907
20200330,3,압구정,24970,26780,20200402,51750
20200330,3,신사,24201,25634,20200402,49835
20200330,3,잠원,4517,4459,20200402,8976
20200330,3,고속터미널,28107,26052,20200402,54159
20200330,3,교대,11973,8139,20200402,20112
20200330,3,남부터미널,23369,24069,20200402,47438
20200330,3,양재,31772,34574,20200402,66346
20200330,3,매봉,9872,9514,20200402,19386
20200330,3,도곡,4098,4118,20200402,8216
20200330,3,대치,8216,7993,20200402,16209
20200330,3,학여울,1416,1412,20200402,2828
20200330,3,대청,7624,7024,20200402,14648
20200330,3,일원,7136,7027,20200402,14163
20200330,3,수서,12435,12733,20200402,25168
20200330,3,가락시장,7328,7136,20200402,14464
20200330,3,경찰병원,6481,6507,20200402,12988
20200330,3,오금,5504,4774,20200402,10278
20200331,3,지축,2781,2837,20200403,5618
20200331,3,구파발,17296,15727,20200403,33023
20200331,3,연신내,32923,31320,20200403,64243
20200331,3,불광,13674,14723,20200403,28397
20200331,3,녹번,11600,10368,20200403,21968
20200331,3,홍제,14912,14276,20200403,29188
20200331,3,무악재,3177,3170,20200403,6347
20200331,3,독립문,5909,6016,20200403,11925
20200331,3,경복궁,14088,14145,20200403,28233
20200331,3,안국,15263,16079,20200403,31342
20200331,3,종로3가,9009,10278,20200403,19287
20200331,3,을지로3가,9192,9817,20200403,19009
20200331,3,동대입구,6225,6773,20200403,12998
20200331,3,약수,10982,10774,20200403,21756
20200331,3,금호,6813,6417,20200403,13230
20200331,3,옥수,7373,7525,20200403,14898
20200331,3,압구정,25464,27339,20200403,52803
20200331,3,신사,24722,26271,20200403,50993
20200331,3,잠원,4468,4420,20200403,8888
20200331,3,고속터미널,27171,26078,20200403,53249
20200331,3,교대,12259,8206,20200403,20465
20200331,3,남부터미널,23085,23687,20200403,46772
20200331,3,양재,32345,34754,20200403,67099
20200331,3,매봉,9882,9583,20200403,19465
20200331,3,도곡,3968,4173,20200403,8141
20200331,3,대치,7989,7830,20200403,15819
20200331,3,학여울,1385,1371,20200403,2756
20200331,3,대청,7863,7063,20200403,14926
20200331,3,일원,7190,7222,20200403,14412
20200331,3,수서,12195,12331,20200403,24526
20200331,3,가락시장,7498,7387,20200403,14885
20200331,3,경찰병원,6416,6400,20200403,12816
20200331,3,오금,5438,4788,20200403,10226
20200401,3,지축,2823,2762,20200404,5585
20200401,3,구파발,17084,15923,20200404,33007
20200401,3,연신내,33123,31183,20200404,64306
20200401,3,불광,13640,14717,20200404,28357
20200401,3,녹번,11631,10387,20200404,22018
20200401,3,홍제,15054,14368,20200404,29422
20200401,3,무악재,3267,3226,20200404,6493
20200401,3,독립문,5819,6163,20200404,11982
20200401,3,경복궁,14337,14292,20200404,28629
20200401,3,안국,15323,15897,20200404,31220
20200401,3,종로3가,9012,10328,20200404,19340
20200401,3,을지로3가,9215,9694,20200404,18909
20200401,3,충무로,1,0,20200404,1
20200401,3,동대입구,6203,6833,20200404,13036
20200401,3,약수,11087,10856,20200404,21943
20200401,3,금호,6774,6360,20200404,13134
20200401,3,옥수,7318,7509,20200404,14827
20200401,3,압구정,25103,27025,20200404,52128
20200401,3,신사,24391,25825,20200404,50216
20200401,3,잠원,4588,4492,20200404,9080
20200401,3,고속터미널,26876,25858,20200404,52734
20200401,3,교대,12349,8385,20200404,20734
20200401,3,남부터미널,23039,23771,20200404,46810
20200401,3,양재,32328,34986,20200404,67314
20200401,3,매봉,10094,9688,20200404,19782
20200401,3,도곡,4029,4322,20200404,8351
20200401,3,대치,8006,7842,20200404,15848
20200401,3,학여울,1387,1431,20200404,2818
20200401,3,대청,7720,7135,20200404,14855
20200401,3,일원,7386,7168,20200404,14554
20200401,3,수서,11943,12211,20200404,24154
20200401,3,가락시장,7506,7251,20200404,14757
20200401,3,경찰병원,6402,6429,20200404,12831
20200401,3,오금,5410,4719,20200404,10129
20200402,3,지축,2843,2814,20200405,5657
20200402,3,구파발,17351,16141,20200405,33492
20200402,3,연신내,33003,31088,20200405,64091
20200402,3,불광,13686,14647,20200405,28333
20200402,3,녹번,11689,10379,20200405,22068
20200402,3,홍제,14790,14169,20200405,28959
20200402,3,무악재,3339,3309,20200405,6648
20200402,3,독립문,5694,6058,20200405,11752
20200402,3,경복궁,14351,14457,20200405,28808
20200402,3,안국,15110,15758,20200405,30868
20200402,3,종로3가,8837,10209,20200405,19046
20200402,3,을지로3가,9098,9721,20200405,18819
20200402,3,충무로,2,0,20200405,2
20200402,3,동대입구,6218,6741,20200405,12959
20200402,3,약수,11068,10772,20200405,21840
20200402,3,금호,6891,6445,20200405,13336
20200402,3,옥수,7305,7549,20200405,14854
20200402,3,압구정,25107,26886,20200405,51993
20200402,3,신사,24714,26258,20200405,50972
20200402,3,잠원,4637,4547,20200405,9184
20200402,3,고속터미널,27359,26829,20200405,54188
20200402,3,교대,12306,8304,20200405,20610
20200402,3,남부터미널,22755,23485,20200405,46240
20200402,3,양재,32755,35202,20200405,67957
20200402,3,매봉,9895,9538,20200405,19433
20200402,3,도곡,3987,4229,20200405,8216
20200402,3,대치,8148,7939,20200405,16087
20200402,3,학여울,1430,1458,20200405,2888
20200402,3,대청,7661,6923,20200405,14584
20200402,3,일원,7374,7260,20200405,14634
20200402,3,수서,12267,12561,20200405,24828
20200402,3,가락시장,7514,7435,20200405,14949
20200402,3,경찰병원,6352,6378,20200405,12730
20200402,3,오금,5415,4725,20200405,10140
20200403,3,지축,2926,2773,20200406,5699
20200403,3,구파발,17444,16019,20200406,33463
20200403,3,연신내,34222,32636,20200406,66858
20200403,3,불광,13876,14779,20200406,28655
20200403,3,녹번,11696,10249,20200406,21945
20200403,3,홍제,15332,14327,20200406,29659
20200403,3,무악재,3332,3251,20200406,6583
20200403,3,독립문,6052,6418,20200406,12470
20200403,3,경복궁,14804,14636,20200406,29440
20200403,3,안국,15576,16162,20200406,31738
20200403,3,종로3가,8545,10202,20200406,18747
20200403,3,을지로3가,9267,10025,20200406,19292
20200403,3,충무로,1,0,20200406,1
20200403,3,동대입구,6382,7002,20200406,13384
20200403,3,약수,11257,11140,20200406,22397
20200403,3,금호,7154,6506,20200406,13660
20200403,3,옥수,7730,7871,20200406,15601
20200403,3,압구정,26410,28583,20200406,54993
20200403,3,신사,26500,28887,20200406,55387
20200403,3,잠원,4817,4707,20200406,9524
20200403,3,고속터미널,33117,34869,20200406,67986
20200403,3,교대,12762,8605,20200406,21367
20200403,3,남부터미널,25284,25996,20200406,51280
20200403,3,양재,34413,35938,20200406,70351
20200403,3,매봉,10264,9785,20200406,20049
20200403,3,도곡,4196,4416,20200406,8612
20200403,3,대치,8336,8159,20200406,16495
20200403,3,학여울,1475,1507,20200406,2982
20200403,3,대청,7907,7145,20200406,15052
20200403,3,일원,7431,7314,20200406,14745
20200403,3,수서,13818,13909,20200406,27727
20200403,3,가락시장,7792,7710,20200406,15502
20200403,3,경찰병원,6500,6461,20200406,12961
20200403,3,오금,5574,4776,20200406,10350
20200404,3,지축,1668,1654,20200407,3322
20200404,3,구파발,11035,11031,20200407,22066
20200404,3,연신내,24079,22595,20200407,46674
20200404,3,불광,9733,11076,20200407,20809
20200404,3,녹번,6754,5925,20200407,12679
20200404,3,홍제,9902,9363,20200407,19265
20200404,3,무악재,1959,2065,20200407,4024
20200404,3,독립문,4176,4580,20200407,8756
20200404,3,경복궁,8771,9150,20200407,17921
20200404,3,안국,7607,8742,20200407,16349
20200404,3,종로3가,3852,5427,20200407,9279
20200404,3,을지로3가,3262,3645,20200407,6907
20200404,3,동대입구,4312,5226,20200407,9538
20200404,3,약수,7029,6559,20200407,13588
20200404,3,금호,4621,4305,20200407,8926
20200404,3,옥수,5101,5155,20200407,10256
20200404,3,압구정,16760,17769,20200407,34529
20200404,3,신사,16543,17612,20200407,34155
20200404,3,잠원,2824,2759,20200407,5583
20200404,3,고속터미널,30623,30913,20200407,61536
20200404,3,교대,4365,2816,20200407,7181
20200404,3,남부터미널,13368,13647,20200407,27015
20200404,3,양재,12866,13880,20200407,26746
20200404,3,매봉,3849,3596,20200407,7445
20200404,3,도곡,2029,1964,20200407,3993
20200404,3,대치,5508,5129,20200407,10637
20200404,3,학여울,756,747,20200407,1503
20200404,3,대청,4267,3912,20200407,8179
20200404,3,일원,2885,2916,20200407,5801
20200404,3,수서,7676,7763,20200407,15439
20200404,3,가락시장,4340,4152,20200407,8492
20200404,3,경찰병원,2771,2660,20200407,5431
20200404,3,오금,2638,2420,20200407,5058
20200405,3,지축,1165,1117,20200408,2282
20200405,3,구파발,8184,8454,20200408,16638
20200405,3,연신내,17067,15773,20200408,32840
20200405,3,불광,7005,8662,20200408,15667
20200405,3,녹번,4435,4043,20200408,8478
20200405,3,홍제,6527,6335,20200408,12862
20200405,3,무악재,1310,1349,20200408,2659
20200405,3,독립문,2921,3369,20200408,6290
20200405,3,경복궁,5959,6425,20200408,12384
20200405,3,안국,5095,5722,20200408,10817
20200405,3,종로3가,2315,2996,20200408,5311
20200405,3,을지로3가,1428,1526,20200408,2954
20200405,3,동대입구,3368,4232,20200408,7600
20200405,3,약수,4527,4396,20200408,8923
20200405,3,금호,3011,2938,20200408,5949
20200405,3,옥수,3387,3647,20200408,7034
20200405,3,압구정,8084,8360,20200408,16444
20200405,3,신사,8723,8694,20200408,17417
20200405,3,잠원,1733,1805,20200408,3538
20200405,3,고속터미널,25173,23223,20200408,48396
20200405,3,교대,2617,1731,20200408,4348
20200405,3,남부터미널,9585,9861,20200408,19446
20200405,3,양재,7920,9264,20200408,17184
20200405,3,매봉,2265,2299,20200408,4564
20200405,3,도곡,1138,1324,20200408,2462
20200405,3,대치,3394,3048,20200408,6442
20200405,3,학여울,491,487,20200408,978
20200405,3,대청,2811,2689,20200408,5500
20200405,3,일원,1859,2042,20200408,3901
20200405,3,수서,6154,5974,20200408,12128
20200405,3,가락시장,2533,2861,20200408,5394
20200405,3,경찰병원,1877,1879,20200408,3756
20200405,3,오금,1923,1816,20200408,3739
20200406,3,지축,2942,2931,20200409,5873
20200406,3,구파발,18085,16682,20200409,34767
20200406,3,연신내,33779,31916,20200409,65695
20200406,3,불광,14080,15237,20200409,29317
20200406,3,녹번,11815,10577,20200409,22392
20200406,3,홍제,15295,14687,20200409,29982
20200406,3,무악재,3382,3400,20200409,6782
20200406,3,독립문,5960,6247,20200409,12207
20200406,3,경복궁,14625,14277,20200409,28902
20200406,3,안국,15681,16144,20200409,31825
20200406,3,종로3가,8920,10256,20200409,19176
20200406,3,을지로3가,9576,10066,20200409,19642
20200406,3,동대입구,6245,6754,20200409,12999
20200406,3,약수,11073,11109,20200409,22182
20200406,3,금호,6991,6683,20200409,13674
20200406,3,옥수,7400,7810,20200409,15210
20200406,3,압구정,26367,28305,20200409,54672
20200406,3,신사,24890,26412,20200409,51302
20200406,3,잠원,4681,4583,20200409,9264
20200406,3,고속터미널,28849,26740,20200409,55589
20200406,3,교대,12252,8395,20200409,20647
20200406,3,남부터미널,24028,24712,20200409,48740
20200406,3,양재,33416,36196,20200409,69612
20200406,3,매봉,9961,9579,20200409,19540
20200406,3,도곡,4352,4442,20200409,8794
20200406,3,대치,8484,8229,20200409,16713
20200406,3,학여울,1436,1415,20200409,2851
20200406,3,대청,8161,7527,20200409,15688
20200406,3,일원,7664,7625,20200409,15289
20200406,3,수서,12943,13160,20200409,26103
20200406,3,가락시장,7674,7362,20200409,15036
20200406,3,경찰병원,6789,6750,20200409,13539
20200406,3,오금,5548,4936,20200409,10484
20200407,3,지축,2999,2941,20200410,5940
20200407,3,구파발,18049,16766,20200410,34815
20200407,3,연신내,33655,32087,20200410,65742
20200407,3,불광,14040,15176,20200410,29216
20200407,3,녹번,12013,10765,20200410,22778
20200407,3,홍제,15323,14455,20200410,29778
20200407,3,무악재,3434,3371,20200410,6805
20200407,3,독립문,5989,6184,20200410,12173
20200407,3,경복궁,14790,14654,20200410,29444
20200407,3,안국,15612,16267,20200410,31879
20200407,3,종로3가,9109,10389,20200410,19498
20200407,3,을지로3가,9406,10134,20200410,19540
20200407,3,충무로,2,0,20200410,2
20200407,3,동대입구,6423,6937,20200410,13360
20200407,3,약수,11173,11066,20200410,22239
20200407,3,금호,7125,6665,20200410,13790
20200407,3,옥수,7684,7889,20200410,15573
20200407,3,압구정,26776,28776,20200410,55552
20200407,3,신사,25551,27183,20200410,52734
20200407,3,잠원,4810,4629,20200410,9439
20200407,3,고속터미널,27507,26527,20200410,54034
20200407,3,교대,12459,8575,20200410,21034
20200407,3,남부터미널,23746,24166,20200410,47912
20200407,3,양재,33998,36679,20200410,70677
20200407,3,매봉,9961,9648,20200410,19609
20200407,3,도곡,4200,4287,20200410,8487
20200407,3,대치,8377,8123,20200410,16500
20200407,3,학여울,1436,1463,20200410,2899
20200407,3,대청,8280,7563,20200410,15843
20200407,3,일원,7814,7885,20200410,15699
20200407,3,수서,12912,12980,20200410,25892
20200407,3,가락시장,7853,7566,20200410,15419
20200407,3,경찰병원,6746,6630,20200410,13376
20200407,3,오금,5644,5010,20200410,10654
20200408,3,지축,2984,2934,20200411,5918
20200408,3,구파발,18039,16883,20200411,34922
20200408,3,연신내,33881,32113,20200411,65994
20200408,3,불광,13916,14993,20200411,28909
20200408,3,녹번,12042,10855,20200411,22897
20200408,3,홍제,15375,14557,20200411,29932
20200408,3,무악재,3383,3383,20200411,6766
20200408,3,독립문,5942,6331,20200411,12273
20200408,3,경복궁,15373,15058,20200411,30431
20200408,3,안국,15615,16478,20200411,32093
20200408,3,종로3가,9182,10460,20200411,19642
20200408,3,을지로3가,9615,10078,20200411,19693
20200408,3,동대입구,6394,6948,20200411,13342
20200408,3,약수,11196,11081,20200411,22277
20200408,3,금호,7192,6737,20200411,13929
20200408,3,옥수,7701,7904,20200411,15605
20200408,3,압구정,26242,28384,20200411,54626
20200408,3,신사,25759,27309,20200411,53068
20200408,3,잠원,4850,4760,20200411,9610
20200408,3,고속터미널,28127,26934,20200411,55061
20200408,3,교대,12802,8594,20200411,21396
20200408,3,남부터미널,23736,24529,20200411,48265
20200408,3,양재,33984,36425,20200411,70409
20200408,3,매봉,10002,9590,20200411,19592
20200408,3,도곡,4217,4375,20200411,8592
20200408,3,대치,8391,8180,20200411,16571
20200408,3,학여울,1434,1475,20200411,2909
20200408,3,대청,8308,7629,20200411,15937
20200408,3,일원,7822,7685,20200411,15507
20200408,3,수서,13045,13105,20200411,26150
20200408,3,가락시장,7757,7632,20200411,15389
20200408,3,경찰병원,6620,6612,20200411,13232
20200408,3,오금,5706,4990,20200411,10696
20200409,3,지축,2990,2919,20200412,5909
20200409,3,구파발,18061,16783,20200412,34844
20200409,3,연신내,33652,31678,20200412,65330
20200409,3,불광,14029,15094,20200412,29123
20200409,3,녹번,11944,10674,20200412,22618
20200409,3,홍제,15391,14580,20200412,29971
20200409,3,무악재,3429,3355,20200412,6784
20200409,3,독립문,5967,6391,20200412,12358
20200409,3,경복궁,15163,14896,20200412,30059
20200409,3,안국,15712,16309,20200412,32021
20200409,3,종로3가,8944,10361,20200412,19305
20200409,3,을지로3가,9502,10149,20200412,19651
20200409,3,충무로,1,0,20200412,1
20200409,3,동대입구,6374,7057,20200412,13431
20200409,3,약수,11206,11198,20200412,22404
20200409,3,금호,7109,6623,20200412,13732
20200409,3,옥수,7687,7815,20200412,15502
20200409,3,압구정,25956,28027,20200412,53983
20200409,3,신사,25620,27313,20200412,52933
20200409,3,잠원,4749,4630,20200412,9379
20200409,3,고속터미널,27765,27477,20200412,55242
20200409,3,교대,12784,8653,20200412,21437
20200409,3,남부터미널,24014,24471,20200412,48485
20200409,3,양재,33737,36665,20200412,70402
20200409,3,매봉,9963,9543,20200412,19506
20200409,3,도곡,4204,4272,20200412,8476
20200409,3,대치,8451,8269,20200412,16720
20200409,3,학여울,1437,1420,20200412,2857
20200409,3,대청,8128,7386,20200412,15514
20200409,3,일원,7833,7560,20200412,15393
20200409,3,수서,12866,13104,20200412,25970
20200409,3,가락시장,7829,7635,20200412,15464
20200409,3,경찰병원,6639,6636,20200412,13275
20200409,3,오금,5588,4974,20200412,10562
20200410,3,지축,3098,2934,20200413,6032
20200410,3,구파발,18440,17054,20200413,35494
20200410,3,연신내,34708,33187,20200413,67895
20200410,3,불광,14571,15338,20200413,29909
20200410,3,녹번,12324,10742,20200413,23066
20200410,3,홍제,15849,14773,20200413,30622
20200410,3,무악재,3475,3426,20200413,6901
20200410,3,독립문,6193,6311,20200413,12504
20200410,3,경복궁,15581,15371,20200413,30952
20200410,3,안국,15962,16516,20200413,32478
20200410,3,종로3가,8611,10380,20200413,18991
20200410,3,을지로3가,9720,10514,20200413,20234
20200410,3,충무로,1,0,20200413,1
20200410,3,동대입구,6439,6999,20200413,13438
20200410,3,약수,11703,11549,20200413,23252
20200410,3,금호,7266,6665,20200413,13931
20200410,3,옥수,8191,8230,20200413,16421
20200410,3,압구정,28371,30871,20200413,59242
20200410,3,신사,27391,30006,20200413,57397
20200410,3,잠원,4977,4788,20200413,9765
20200410,3,고속터미널,33381,35917,20200413,69298
20200410,3,교대,13102,8733,20200413,21835
20200410,3,남부터미널,26790,27412,20200413,54202
20200410,3,양재,35165,36653,20200413,71818
20200410,3,매봉,10163,9737,20200413,19900
20200410,3,도곡,4427,4433,20200413,8860
20200410,3,대치,8720,8546,20200413,17266
20200410,3,학여울,1538,1495,20200413,3033
20200410,3,대청,8273,7497,20200413,15770
20200410,3,일원,7972,7573,20200413,15545
20200410,3,수서,14528,14795,20200413,29323
20200410,3,가락시장,8201,7925,20200413,16126
20200410,3,경찰병원,6745,6637,20200413,13382
20200410,3,오금,5766,5027,20200413,10793
20200411,3,지축,1781,1794,20200414,3575
20200411,3,구파발,11986,11716,20200414,23702
20200411,3,연신내,24988,23490,20200414,48478
20200411,3,불광,9979,11865,20200414,21844
20200411,3,녹번,7228,6241,20200414,13469
20200411,3,홍제,10231,9691,20200414,19922
20200411,3,무악재,2126,2072,20200414,4198
20200411,3,독립문,4597,5028,20200414,9625
20200411,3,경복궁,9166,9605,20200414,18771
20200411,3,안국,7613,9057,20200414,16670
20200411,3,종로3가,4016,5549,20200414,9565
20200411,3,을지로3가,3392,3795,20200414,7187
20200411,3,동대입구,4378,5309,20200414,9687
20200411,3,약수,7400,6865,20200414,14265
20200411,3,금호,4679,4381,20200414,9060
20200411,3,옥수,5417,5324,20200414,10741
20200411,3,압구정,17814,18802,20200414,36616
20200411,3,신사,17690,18830,20200414,36520
20200411,3,잠원,2980,2849,20200414,5829
20200411,3,고속터미널,31676,32299,20200414,63975
20200411,3,교대,4813,3085,20200414,7898
20200411,3,남부터미널,14396,14495,20200414,28891
20200411,3,양재,14033,14974,20200414,29007
20200411,3,매봉,4033,3771,20200414,7804
20200411,3,도곡,2259,2196,20200414,4455
20200411,3,대치,6248,5712,20200414,11960
20200411,3,학여울,808,802,20200414,1610
20200411,3,대청,4386,3995,20200414,8381
20200411,3,일원,3063,3041,20200414,6104
20200411,3,수서,8032,8083,20200414,16115
20200411,3,가락시장,4768,4481,20200414,9249
20200411,3,경찰병원,3009,2835,20200414,5844
20200411,3,오금,2838,2517,20200414,5355
20200412,3,지축,1175,1172,20200415,2347
20200412,3,구파발,8207,8424,20200415,16631
20200412,3,연신내,17393,16063,20200415,33456
20200412,3,불광,7394,9172,20200415,16566
20200412,3,녹번,4502,4039,20200415,8541
20200412,3,홍제,6845,6616,20200415,13461
20200412,3,무악재,1350,1508,20200415,2858
20200412,3,독립문,3295,3513,20200415,6808
20200412,3,경복궁,6374,6502,20200415,12876
20200412,3,안국,5109,5732,20200415,10841
20200412,3,종로3가,2353,3139,20200415,5492
20200412,3,을지로3가,1716,1832,20200415,3548
20200412,3,충무로,1,0,20200415,1
20200412,3,동대입구,3301,3957,20200415,7258
20200412,3,약수,4764,4539,20200415,9303
20200412,3,금호,3311,3155,20200415,6466
20200412,3,옥수,3609,3862,20200415,7471
20200412,3,압구정,8619,9275,20200415,17894
20200412,3,신사,9104,9183,20200415,18287
20200412,3,잠원,1727,1738,20200415,3465
20200412,3,고속터미널,26196,24399,20200415,50595
20200412,3,교대,2724,1834,20200415,4558
20200412,3,남부터미널,10439,10816,20200415,21255
20200412,3,양재,8306,9691,20200415,17997
20200412,3,매봉,2529,2482,20200415,5011
20200412,3,도곡,1177,1254,20200415,2431
20200412,3,대치,3994,3474,20200415,7468
20200412,3,학여울,503,517,20200415,1020
20200412,3,대청,2847,2760,20200415,5607
20200412,3,일원,1961,2161,20200415,4122
20200412,3,수서,6499,6302,20200415,12801
20200412,3,가락시장,2519,2798,20200415,5317
20200412,3,경찰병원,1901,1985,20200415,3886
20200412,3,오금,1979,1897,20200415,3876
20200413,3,지축,2973,2953,20200416,5926
20200413,3,구파발,18186,17051,20200416,35237
20200413,3,연신내,33951,32093,20200416,66044
20200413,3,불광,14342,15501,20200416,29843
20200413,3,녹번,12261,10982,20200416,23243
20200413,3,홍제,15648,14916,20200416,30564
20200413,3,무악재,3421,3493,20200416,6914
20200413,3,독립문,6086,6271,20200416,12357
20200413,3,경복궁,15123,15076,20200416,30199
20200413,3,안국,15741,16282,20200416,32023
20200413,3,종로3가,9070,10459,20200416,19529
20200413,3,을지로3가,9569,10162,20200416,19731
20200413,3,동대입구,6128,6677,20200416,12805
20200413,3,약수,11339,11047,20200416,22386
20200413,3,금호,7200,6766,20200416,13966
20200413,3,옥수,7745,8041,20200416,15786
20200413,3,압구정,26936,28961,20200416,55897
20200413,3,신사,25521,27240,20200416,52761
20200413,3,잠원,4909,4734,20200416,9643
20200413,3,고속터미널,29678,27800,20200416,57478
20200413,3,교대,12516,8581,20200416,21097
20200413,3,남부터미널,24815,25449,20200416,50264
20200413,3,양재,33191,36383,20200416,69574
20200413,3,매봉,10004,9626,20200416,19630
20200413,3,도곡,4334,4462,20200416,8796
20200413,3,대치,8645,8422,20200416,17067
20200413,3,학여울,1464,1505,20200416,2969
20200413,3,대청,8156,7424,20200416,15580
20200413,3,일원,8316,8218,20200416,16534
20200413,3,수서,13451,13602,20200416,27053
20200413,3,가락시장,7837,7699,20200416,15536
20200413,3,경찰병원,6896,6949,20200416,13845
20200413,3,오금,5810,5002,20200416,10812
20200414,3,지축,3044,2902,20200417,5946
20200414,3,구파발,18820,17236,20200417,36056
20200414,3,연신내,35369,33453,20200417,68822
20200414,3,불광,14979,15864,20200417,30843
20200414,3,녹번,12502,10963,20200417,23465
20200414,3,홍제,15987,14761,20200417,30748
20200414,3,무악재,3500,3425,20200417,6925
20200414,3,독립문,6323,6641,20200417,12964
20200414,3,경복궁,15886,15714,20200417,31600
20200414,3,안국,16108,17246,20200417,33354
20200414,3,종로3가,9375,10151,20200417,19526
20200414,3,을지로3가,9877,10504,20200417,20381
20200414,3,동대입구,6399,6773,20200417,13172
20200414,3,약수,11692,11638,20200417,23330
20200414,3,금호,7481,6874,20200417,14355
20200414,3,옥수,8159,8147,20200417,16306
20200414,3,압구정,27963,30416,20200417,58379
20200414,3,신사,27121,29664,20200417,56785
20200414,3,잠원,5077,4828,20200417,9905
20200414,3,고속터미널,31301,31311,20200417,62612
20200414,3,교대,13185,8975,20200417,22160
20200414,3,남부터미널,25540,26084,20200417,51624
20200414,3,양재,34678,37911,20200417,72589
20200414,3,매봉,10433,10069,20200417,20502
20200414,3,도곡,4498,4627,20200417,9125
20200414,3,대치,8772,8489,20200417,17261
20200414,3,학여울,1495,1525,20200417,3020
20200414,3,대청,8415,7607,20200417,16022
20200414,3,일원,8125,7944,20200417,16069
20200414,3,수서,14018,13904,20200417,27922
20200414,3,가락시장,8323,8126,20200417,16449
20200414,3,경찰병원,7023,7031,20200417,14054
20200414,3,오금,5779,5097,20200417,10876
20200415,3,지축,1684,1568,20200418,3252
20200415,3,구파발,10180,10145,20200418,20325
20200415,3,연신내,22285,20653,20200418,42938
20200415,3,불광,8592,10173,20200418,18765
20200415,3,녹번,6451,5613,20200418,12064
20200415,3,홍제,9093,8784,20200418,17877
20200415,3,무악재,1831,1994,20200418,3825
20200415,3,독립문,3856,4093,20200418,7949
20200415,3,경복궁,7854,8636,20200418,16490
20200415,3,안국,6590,7931,20200418,14521
20200415,3,종로3가,4903,6364,20200418,11267
20200415,3,을지로3가,3046,3359,20200418,6405
20200415,3,동대입구,3703,4254,20200418,7957
20200415,3,약수,6540,6209,20200418,12749
20200415,3,금호,4318,3957,20200418,8275
20200415,3,옥수,5010,5017,20200418,10027
20200415,3,압구정,13670,14531,20200418,28201
20200415,3,신사,13339,14035,20200418,27374
20200415,3,잠원,2634,2534,20200418,5168
20200415,3,고속터미널,25804,24473,20200418,50277
20200415,3,교대,3885,2404,20200418,6289
20200415,3,남부터미널,11120,11455,20200418,22575
20200415,3,양재,11021,12325,20200418,23346
20200415,3,매봉,3625,3398,20200418,7023
20200415,3,도곡,1873,1903,20200418,3776
20200415,3,대치,4936,4600,20200418,9536
20200415,3,학여울,781,874,20200418,1655
20200415,3,대청,3943,3603,20200418,7546
20200415,3,일원,2637,2693,20200418,5330
20200415,3,수서,6641,6790,20200418,13431
20200415,3,가락시장,4073,3960,20200418,8033
20200415,3,경찰병원,2548,2721,20200418,5269
20200415,3,오금,2404,2268,20200418,4672
20200416,3,지축,2968,2977,20200419,5945
20200416,3,구파발,18303,17107,20200419,35410
20200416,3,연신내,34734,32618,20200419,67352
20200416,3,불광,14644,15710,20200419,30354
20200416,3,녹번,12255,10832,20200419,23087
20200416,3,홍제,15854,14902,20200419,30756
20200416,3,무악재,3467,3500,20200419,6967
20200416,3,독립문,6158,6459,20200419,12617
20200416,3,경복궁,15712,15521,20200419,31233
20200416,3,안국,16308,17096,20200419,33404
20200416,3,종로3가,9384,10933,20200419,20317
20200416,3,을지로3가,9487,10212,20200419,19699
20200416,3,충무로,1,0,20200419,1
20200416,3,동대입구,6338,6914,20200419,13252
20200416,3,약수,11511,11238,20200419,22749
20200416,3,금호,7309,6847,20200419,14156
20200416,3,옥수,8030,8254,20200419,16284
20200416,3,압구정,26800,29143,20200419,55943
20200416,3,신사,26372,28315,20200419,54687
20200416,3,잠원,4861,4782,20200419,9643
20200416,3,고속터미널,30195,28881,20200419,59076
20200416,3,교대,13042,8803,20200419,21845
20200416,3,남부터미널,25347,25792,20200419,51139
20200416,3,양재,33886,36700,20200419,70586
20200416,3,매봉,10170,9832,20200419,20002
20200416,3,도곡,4430,4567,20200419,8997
20200416,3,대치,8670,8508,20200419,17178
20200416,3,학여울,1700,1517,20200419,3217
20200416,3,대청,8202,7460,20200419,15662
20200416,3,일원,8155,8044,20200419,16199
20200416,3,수서,13488,13674,20200419,27162
20200416,3,가락시장,8053,7911,20200419,15964
20200416,3,경찰병원,6958,6938,20200419,13896
20200416,3,오금,5663,5018,20200419,10681
20200417,3,지축,2908,2756,20200420,5664
20200417,3,구파발,18064,16433,20200420,34497
20200417,3,연신내,33796,32234,20200420,66030
20200417,3,불광,13918,14838,20200420,28756
20200417,3,녹번,12145,10532,20200420,22677
20200417,3,홍제,15402,14423,20200420,29825
20200417,3,무악재,3341,3239,20200420,6580
20200417,3,독립문,5677,5941,20200420,11618
20200417,3,경복궁,15138,15051,20200420,30189
20200417,3,안국,15660,16324,20200420,31984
20200417,3,종로3가,8709,10402,20200420,19111
20200417,3,을지로3가,9619,10478,20200420,20097
20200417,3,충무로,1,0,20200420,1
20200417,3,동대입구,6111,6437,20200420,12548
20200417,3,약수,11507,11243,20200420,22750
20200417,3,금호,7214,6532,20200420,13746
20200417,3,옥수,7936,8055,20200420,15991
20200417,3,압구정,27546,30035,20200420,57581
20200417,3,신사,26519,29139,20200420,55658
20200417,3,잠원,4992,4812,20200420,9804
20200417,3,고속터미널,34187,36347,20200420,70534
20200417,3,교대,12786,8683,20200420,21469
20200417,3,남부터미널,26641,26988,20200420,53629
20200417,3,양재,35593,37069,20200420,72662
20200417,3,매봉,10075,9632,20200420,19707
20200417,3,도곡,4481,4506,20200420,8987
20200417,3,대치,9085,8798,20200420,17883
20200417,3,학여울,1490,1462,20200420,2952
20200417,3,대청,8442,7498,20200420,15940
20200417,3,일원,8073,7850,20200420,15923
20200417,3,수서,14677,14657,20200420,29334
20200417,3,가락시장,8184,7896,20200420,16080
20200417,3,경찰병원,6900,6910,20200420,13810
20200417,3,오금,5700,4968,20200420,10668
20200418,3,지축,1995,1889,20200421,3884
20200418,3,구파발,12933,13223,20200421,26156
20200418,3,연신내,26992,25193,20200421,52185
20200418,3,불광,11169,12957,20200421,24126
20200418,3,녹번,7877,6759,20200421,14636
20200418,3,홍제,11110,10381,20200421,21491
20200418,3,무악재,2196,2225,20200421,4421
20200418,3,독립문,4814,5145,20200421,9959
20200418,3,경복궁,10467,11240,20200421,21707
20200418,3,안국,8514,10277,20200421,18791
20200418,3,종로3가,4410,6291,20200421,10701
20200418,3,을지로3가,3763,4435,20200421,8198
20200418,3,동대입구,4608,5540,20200421,10148
20200418,3,약수,7702,7275,20200421,14977
20200418,3,금호,5094,4640,20200421,9734
20200418,3,옥수,6040,6008,20200421,12048
20200418,3,압구정,19068,19945,20200421,39013
20200418,3,신사,19594,21098,20200421,40692
20200418,3,잠원,3257,3085,20200421,6342
20200418,3,고속터미널,36187,36178,20200421,72365
20200418,3,교대,5035,3153,20200421,8188
20200418,3,남부터미널,15904,16165,20200421,32069
20200418,3,양재,15016,16154,20200421,31170
20200418,3,매봉,4405,4113,20200421,8518
20200418,3,도곡,2404,2381,20200421,4785
20200418,3,대치,6997,6355,20200421,13352
20200418,3,학여울,863,859,20200421,1722
20200418,3,대청,4689,4343,20200421,9032
20200418,3,일원,3547,3406,20200421,6953
20200418,3,수서,8907,8946,20200421,17853
20200418,3,가락시장,5217,4908,20200421,10125
20200418,3,경찰병원,3190,3030,20200421,6220
20200418,3,오금,2986,2776,20200421,5762
20200419,3,지축,1289,1176,20200422,2465
20200419,3,구파발,8607,8785,20200422,17392
20200419,3,연신내,17510,16306,20200422,33816
20200419,3,불광,7448,8762,20200422,16210
20200419,3,녹번,4910,4513,20200422,9423
20200419,3,홍제,6693,6572,20200422,13265
20200419,3,무악재,1355,1560,20200422,2915
20200419,3,독립문,3048,3258,20200422,6306
20200419,3,경복궁,6206,6422,20200422,12628
20200419,3,안국,5200,5499,20200422,10699
20200419,3,종로3가,2586,3130,20200422,5716
20200419,3,을지로3가,1681,1774,20200422,3455
20200419,3,동대입구,3183,3524,20200422,6707
20200419,3,약수,4640,4553,20200422,9193
20200419,3,금호,3180,3146,20200422,6326
20200419,3,옥수,3496,3816,20200422,7312
20200419,3,압구정,8485,9057,20200422,17542
20200419,3,신사,8989,9437,20200422,18426
20200419,3,잠원,1908,1900,20200422,3808
20200419,3,고속터미널,28269,26288,20200422,54557
20200419,3,교대,2858,1894,20200422,4752
20200419,3,남부터미널,10207,10651,20200422,20858
20200419,3,양재,8893,10472,20200422,19365
20200419,3,매봉,2646,2669,20200422,5315
20200419,3,도곡,1256,1327,20200422,2583
20200419,3,대치,4247,3794,20200422,8041
20200419,3,학여울,521,555,20200422,1076
20200419,3,대청,2929,2750,20200422,5679
20200419,3,일원,2154,2290,20200422,4444
20200419,3,수서,6797,6863,20200422,13660
20200419,3,가락시장,2825,3077,20200422,5902
20200419,3,경찰병원,2067,2199,20200422,4266
20200419,3,오금,2008,1912,20200422,3920
20200420,3,지축,3045,2961,20200423,6006
20200420,3,구파발,18714,17329,20200423,36043
20200420,3,연신내,34700,32878,20200423,67578
20200420,3,불광,14837,15925,20200423,30762
20200420,3,녹번,12541,11340,20200423,23881
20200420,3,홍제,15828,15137,20200423,30965
20200420,3,무악재,3507,3490,20200423,6997
20200420,3,독립문,5941,6279,20200423,12220
20200420,3,경복궁,15075,14951,20200423,30026
20200420,3,안국,16388,16728,20200423,33116
20200420,3,종로3가,9339,10601,20200423,19940
20200420,3,을지로3가,9970,10373,20200423,20343
20200420,3,충무로,1,0,20200423,1
20200420,3,동대입구,6175,6528,20200423,12703
20200420,3,약수,11658,11482,20200423,23140
20200420,3,금호,7226,6773,20200423,13999
20200420,3,옥수,7900,8225,20200423,16125
20200420,3,압구정,26796,28897,20200423,55693
20200420,3,신사,26150,27883,20200423,54033
20200420,3,잠원,5112,5014,20200423,10126
20200420,3,고속터미널,30671,28461,20200423,59132
20200420,3,교대,12878,8919,20200423,21797
20200420,3,남부터미널,25825,26431,20200423,52256
20200420,3,양재,34901,37857,20200423,72758
20200420,3,매봉,10489,10113,20200423,20602
20200420,3,도곡,4544,4595,20200423,9139
20200420,3,대치,8910,8698,20200423,17608
20200420,3,학여울,1519,1601,20200423,3120
20200420,3,대청,8558,7826,20200423,16384
20200420,3,일원,8352,8241,20200423,16593
20200420,3,수서,14109,14260,20200423,28369
20200420,3,가락시장,8165,7973,20200423,16138
20200420,3,경찰병원,7168,7271,20200423,14439
20200420,3,오금,5851,5180,20200423,11031
20200421,3,지축,3076,3036,20200424,6112
20200421,3,구파발,19208,17969,20200424,37177
20200421,3,연신내,35573,33870,20200424,69443
20200421,3,불광,15239,16179,20200424,31418
20200421,3,녹번,12752,11542,20200424,24294
20200421,3,홍제,16201,15476,20200424,31677
20200421,3,무악재,3618,3634,20200424,7252
20200421,3,독립문,6309,6527,20200424,12836
20200421,3,경복궁,15929,15685,20200424,31614
20200421,3,안국,17135,17497,20200424,34632
20200421,3,종로3가,9857,11112,20200424,20969
20200421,3,을지로3가,10041,10573,20200424,20614
20200421,3,충무로,1,0,20200424,1
20200421,3,동대입구,6327,6801,20200424,13128
20200421,3,약수,11978,11760,20200424,23738
20200421,3,금호,7429,7007,20200424,14436
20200421,3,옥수,8115,8371,20200424,16486
20200421,3,압구정,27543,29622,20200424,57165
20200421,3,신사,27575,29221,20200424,56796
20200421,3,잠원,5255,5154,20200424,10409
20200421,3,고속터미널,31214,29801,20200424,61015
20200421,3,교대,13319,8894,20200424,22213
20200421,3,남부터미널,26073,26640,20200424,52713
20200421,3,양재,35877,38528,20200424,74405
20200421,3,매봉,10735,10325,20200424,21060
20200421,3,도곡,4640,4682,20200424,9322
20200421,3,대치,9083,9054,20200424,18137
20200421,3,학여울,1539,1588,20200424,3127
20200421,3,대청,8656,7989,20200424,16645
20200421,3,일원,8422,8270,20200424,16692
20200421,3,수서,14090,14206,20200424,28296
20200421,3,가락시장,8395,8089,20200424,16484
20200421,3,경찰병원,7158,7094,20200424,14252
20200421,3,오금,5852,5236,20200424,11088
20200422,3,지축,2967,2891,20200425,5858
20200422,3,구파발,18776,17529,20200425,36305
20200422,3,연신내,35018,33114,20200425,68132
20200422,3,불광,15158,16381,20200425,31539
20200422,3,녹번,12409,11067,20200425,23476
20200422,3,홍제,16011,15203,20200425,31214
20200422,3,무악재,3467,3491,20200425,6958
20200422,3,독립문,6178,6452,20200425,12630
20200422,3,경복궁,16105,15705,20200425,31810
20200422,3,안국,16819,17226,20200425,34045
20200422,3,종로3가,9522,11000,20200425,20522
20200422,3,을지로3가,10089,10785,20200425,20874
20200422,3,동대입구,6141,6679,20200425,12820
20200422,3,약수,11606,11509,20200425,23115
20200422,3,금호,7408,6983,20200425,14391
20200422,3,옥수,8125,8325,20200425,16450
20200422,3,압구정,27003,29195,20200425,56198
20200422,3,신사,27213,28726,20200425,55939
20200422,3,잠원,5190,5190,20200425,10380
20200422,3,고속터미널,31581,30396,20200425,61977
20200422,3,교대,13405,9044,20200425,22449
20200422,3,남부터미널,26723,27408,20200425,54131
20200422,3,양재,35834,38571,20200425,74405
20200422,3,매봉,10682,10283,20200425,20965
20200422,3,도곡,4544,4581,20200425,9125
20200422,3,대치,8938,8853,20200425,17791
20200422,3,학여울,1497,1529,20200425,3026
20200422,3,대청,8528,7757,20200425,16285
20200422,3,일원,8301,8211,20200425,16512
20200422,3,수서,14041,13960,20200425,28001
20200422,3,가락시장,8291,8149,20200425,16440
20200422,3,경찰병원,7181,7234,20200425,14415
20200422,3,오금,5816,5218,20200425,11034
20200423,3,지축,3037,2948,20200426,5985
20200423,3,구파발,19503,18265,20200426,37768
20200423,3,연신내,36191,34117,20200426,70308
20200423,3,불광,15683,16706,20200426,32389
20200423,3,녹번,12524,11157,20200426,23681
20200423,3,홍제,16385,15543,20200426,31928
20200423,3,무악재,3616,3640,20200426,7256
20200423,3,독립문,6422,6680,20200426,13102
20200423,3,경복궁,16378,16263,20200426,32641
20200423,3,안국,17190,18077,20200426,35267
20200423,3,종로3가,9792,11257,20200426,21049
20200423,3,을지로3가,10372,10927,20200426,21299
20200423,3,동대입구,6295,6977,20200426,13272
20200423,3,약수,12079,11704,20200426,23783
20200423,3,금호,7526,7076,20200426,14602
20200423,3,옥수,8441,8521,20200426,16962
20200423,3,압구정,27224,29632,20200426,56856
20200423,3,신사,27687,29369,20200426,57056
20200423,3,잠원,5186,5078,20200426,10264
20200423,3,고속터미널,32060,31297,20200426,63357
20200423,3,교대,13699,9253,20200426,22952
20200423,3,남부터미널,26447,26940,20200426,53387
20200423,3,양재,36135,39213,20200426,75348
20200423,3,매봉,10833,10409,20200426,21242
20200423,3,도곡,4616,4679,20200426,9295
20200423,3,대치,9108,9015,20200426,18123
20200423,3,학여울,1523,1534,20200426,3057
20200423,3,대청,8682,7905,20200426,16587
20200423,3,일원,8552,8382,20200426,16934
20200423,3,수서,14687,14661,20200426,29348
20200423,3,가락시장,8506,8478,20200426,16984
20200423,3,경찰병원,7081,6941,20200426,14022
20200423,3,오금,6006,5278,20200426,11284
20200424,3,지축,3201,3050,20200427,6251
20200424,3,구파발,19861,18121,20200427,37982
20200424,3,연신내,37489,35537,20200427,73026
20200424,3,불광,15953,17074,20200427,33027
20200424,3,녹번,12953,11129,20200427,24082
20200424,3,홍제,17068,15666,20200427,32734
20200424,3,무악재,3648,3598,20200427,7246
20200424,3,독립문,6788,7048,20200427,13836
20200424,3,경복궁,17294,16974,20200427,34268
20200424,3,안국,17655,18524,20200427,36179
20200424,3,종로3가,9301,11366,20200427,20667
20200424,3,을지로3가,10383,11397,20200427,21780
20200424,3,충무로,1,0,20200427,1
20200424,3,동대입구,6700,7188,20200427,13888
20200424,3,약수,12332,12080,20200427,24412
20200424,3,금호,7942,7210,20200427,15152
20200424,3,옥수,8682,8713,20200427,17395
20200424,3,압구정,29800,32588,20200427,62388
20200424,3,신사,30091,33360,20200427,63451
20200424,3,잠원,5519,5342,20200427,10861
20200424,3,고속터미널,38569,40703,20200427,79272
20200424,3,교대,14197,9543,20200427,23740
20200424,3,남부터미널,29221,29517,20200427,58738
20200424,3,양재,38648,40371,20200427,79019
20200424,3,매봉,11028,10623,20200427,21651
20200424,3,도곡,5018,5080,20200427,10098
20200424,3,대치,9675,9608,20200427,19283
20200424,3,학여울,1579,1681,20200427,3260
20200424,3,대청,9284,8339,20200427,17623
20200424,3,일원,8831,8464,20200427,17295
20200424,3,수서,16317,16024,20200427,32341
20200424,3,가락시장,9048,8945,20200427,17993
20200424,3,경찰병원,7434,7263,20200427,14697
20200424,3,오금,6132,5361,20200427,11493
20200425,3,지축,2101,2046,20200428,4147
20200425,3,구파발,13320,13311,20200428,26631
20200425,3,연신내,28178,26517,20200428,54695
20200425,3,불광,11501,13276,20200428,24777
20200425,3,녹번,7908,6480,20200428,14388
20200425,3,홍제,11685,10680,20200428,22365
20200425,3,무악재,2355,2351,20200428,4706
20200425,3,독립문,4902,5270,20200428,10172
20200425,3,경복궁,11097,12244,20200428,23341
20200425,3,안국,9564,11520,20200428,21084
20200425,3,종로3가,4688,6875,20200428,11563
20200425,3,을지로3가,3970,4673,20200428,8643
20200425,3,동대입구,4696,5593,20200428,10289
20200425,3,약수,7917,7540,20200428,15457
20200425,3,금호,5354,4918,20200428,10272
20200425,3,옥수,6300,6240,20200428,12540
20200425,3,압구정,19919,21207,20200428,41126
20200425,3,신사,21417,22742,20200428,44159
20200425,3,잠원,3540,3328,20200428,6868
20200425,3,고속터미널,39321,39355,20200428,78676
20200425,3,교대,5528,3530,20200428,9058
20200425,3,남부터미널,17496,17705,20200428,35201
20200425,3,양재,17319,18511,20200428,35830
20200425,3,매봉,4406,4275,20200428,8681
20200425,3,도곡,2690,2634,20200428,5324
20200425,3,대치,7152,6519,20200428,13671
20200425,3,학여울,924,937,20200428,1861
20200425,3,대청,4920,4434,20200428,9354
20200425,3,일원,3807,3708,20200428,7515
20200425,3,수서,9763,9917,20200428,19680
20200425,3,가락시장,5582,5296,20200428,10878
20200425,3,경찰병원,3425,3329,20200428,6754
20200425,3,오금,3199,2926,20200428,6125
20200426,3,지축,1422,1371,20200429,2793
20200426,3,구파발,10117,10183,20200429,20300
20200426,3,연신내,20085,18709,20200429,38794
20200426,3,불광,8823,10644,20200429,19467
20200426,3,녹번,5067,4672,20200429,9739
20200426,3,홍제,7856,7676,20200429,15532
20200426,3,무악재,1572,1684,20200429,3256
20200426,3,독립문,3621,4190,20200429,7811
20200426,3,경복궁,8194,8792,20200429,16986
20200426,3,안국,6714,7657,20200429,14371
20200426,3,종로3가,2927,4071,20200429,6998
20200426,3,을지로3가,2177,2317,20200429,4494
20200426,3,충무로,1,0,20200429,1
20200426,3,동대입구,3778,4597,20200429,8375
20200426,3,약수,5343,5190,20200429,10533
20200426,3,금호,3746,3562,20200429,7308
20200426,3,옥수,4373,4668,20200429,9041
20200426,3,압구정,9969,10431,20200429,20400
20200426,3,신사,11520,11430,20200429,22950
20200426,3,잠원,2425,2404,20200429,4829
20200426,3,고속터미널,31898,30292,20200429,62190
20200426,3,교대,3260,2044,20200429,5304
20200426,3,남부터미널,11758,12366,20200429,24124
20200426,3,양재,10416,12012,20200429,22428
20200426,3,매봉,2995,2916,20200429,5911
20200426,3,도곡,1367,1453,20200429,2820
20200426,3,대치,4672,4167,20200429,8839
20200426,3,학여울,562,558,20200429,1120
20200426,3,대청,3249,3118,20200429,6367
20200426,3,일원,2468,2528,20200429,4996
20200426,3,수서,7724,7760,20200429,15484
20200426,3,가락시장,3302,3422,20200429,6724
20200426,3,경찰병원,2237,2272,20200429,4509
20200426,3,오금,2296,2201,20200429,4497
20200427,3,지축,3199,3165,20200430,6364
20200427,3,구파발,20019,18416,20200430,38435
20200427,3,연신내,36444,34616,20200430,71060
20200427,3,불광,15605,16751,20200430,32356
20200427,3,녹번,12882,11498,20200430,24380
20200427,3,홍제,17068,16016,20200430,33084
20200427,3,무악재,3672,3747,20200430,7419
20200427,3,독립문,6643,6796,20200430,13439
20200427,3,경복궁,16030,16147,20200430,32177
20200427,3,안국,17341,18101,20200430,35442
20200427,3,종로3가,9768,11293,20200430,21061
20200427,3,을지로3가,10223,10810,20200430,21033
20200427,3,동대입구,6405,6867,20200430,13272
20200427,3,약수,12328,12023,20200430,24351
20200427,3,금호,7886,7300,20200430,15186
20200427,3,옥수,8393,8804,20200430,17197
20200427,3,압구정,28290,30567,20200430,58857
20200427,3,신사,27991,29801,20200430,57792
20200427,3,잠원,5478,5311,20200430,10789
20200427,3,고속터미널,34336,32434,20200430,66770
20200427,3,교대,13577,9140,20200430,22717
20200427,3,남부터미널,26903,27854,20200430,54757
20200427,3,양재,36382,39511,20200430,75893
20200427,3,매봉,11012,10479,20200430,21491
20200427,3,도곡,4874,5005,20200430,9879
20200427,3,대치,9585,9404,20200430,18989
20200427,3,학여울,1572,1608,20200430,3180
20200427,3,대청,8911,8189,20200430,17100
20200427,3,일원,8866,8767,20200430,17633
20200427,3,수서,14865,15101,20200430,29966
20200427,3,가락시장,8662,8508,20200430,17170
20200427,3,경찰병원,7305,7391,20200430,14696
20200427,3,오금,6167,5405,20200430,11572
20200428,3,지축,3205,3167,20200501,6372
20200428,3,구파발,19945,18505,20200501,38450
20200428,3,연신내,37285,35060,20200501,72345
20200428,3,불광,15951,16991,20200501,32942
20200428,3,녹번,13071,11681,20200501,24752
20200428,3,홍제,17179,16015,20200501,33194
20200428,3,무악재,3698,3758,20200501,7456
20200428,3,독립문,6763,7070,20200501,13833
20200428,3,경복궁,16939,16799,20200501,33738
20200428,3,안국,17711,18802,20200501,36513
20200428,3,종로3가,10063,11719,20200501,21782
20200428,3,을지로3가,10617,11122,20200501,21739
20200428,3,충무로,1,0,20200501,1
20200428,3,동대입구,6488,7131,20200501,13619
20200428,3,약수,12516,12178,20200501,24694
20200428,3,금호,7836,7321,20200501,15157
20200428,3,옥수,8772,8909,20200501,17681
20200428,3,압구정,29196,31875,20200501,61071
20200428,3,신사,29572,31350,20200501,60922
20200428,3,잠원,5624,5381,20200501,11005
20200428,3,고속터미널,34707,34227,20200501,68934
20200428,3,교대,14275,9529,20200501,23804
20200428,3,남부터미널,27314,28157,20200501,55471
20200428,3,양재,37343,40639,20200501,77982
20200428,3,매봉,11189,10922,20200501,22111
20200428,3,도곡,5034,5163,20200501,10197
20200428,3,대치,9667,9440,20200501,19107
20200428,3,학여울,1591,1633,20200501,3224
20200428,3,대청,9023,8267,20200501,17290
20200428,3,일원,9189,8976,20200501,18165
20200428,3,수서,15162,15335,20200501,30497
20200428,3,가락시장,8859,8706,20200501,17565
20200428,3,경찰병원,7468,7490,20200501,14958
20200428,3,오금,6246,5498,20200501,11744
20200429,3,지축,3270,3080,20200502,6350
20200429,3,구파발,20447,18670,20200502,39117
20200429,3,연신내,38352,36209,20200502,74561
20200429,3,불광,16328,17307,20200502,33635
20200429,3,녹번,13714,11627,20200502,25341
20200429,3,홍제,17665,16459,20200502,34124
20200429,3,무악재,3835,3837,20200502,7672
20200429,3,독립문,6912,7128,20200502,14040
20200429,3,경복궁,17863,18021,20200502,35884
20200429,3,안국,18356,19357,20200502,37713
20200429,3,종로3가,10366,12752,20200502,23118
20200429,3,을지로3가,10828,11785,20200502,22613
20200429,3,동대입구,6859,7363,20200502,14222
20200429,3,약수,12916,12554,20200502,25470
20200429,3,금호,8326,7520,20200502,15846
20200429,3,옥수,9158,9202,20200502,18360
20200429,3,압구정,30282,33232,20200502,63514
20200429,3,신사,30330,33610,20200502,63940
20200429,3,잠원,5772,5482,20200502,11254
20200429,3,고속터미널,39340,47621,20200502,86961
20200429,3,교대,14681,9720,20200502,24401
20200429,3,남부터미널,29544,31736,20200502,61280
20200429,3,양재,39432,41206,20200502,80638
20200429,3,매봉,11529,10967,20200502,22496
20200429,3,도곡,5160,5266,20200502,10426
20200429,3,대치,9948,9513,20200502,19461
20200429,3,학여울,1670,1621,20200502,3291
20200429,3,대청,9354,8363,20200502,17717
20200429,3,일원,9173,8856,20200502,18029
20200429,3,수서,16511,17411,20200502,33922
20200429,3,가락시장,9335,9074,20200502,18409
20200429,3,경찰병원,7628,7539,20200502,15167
20200429,3,오금,6435,5493,20200502,11928
20200430,3,지축,1891,1763,20200503,3654
20200430,3,구파발,13022,12836,20200503,25858
20200430,3,연신내,25693,23439,20200503,49132
20200430,3,불광,10435,11676,20200503,22111
20200430,3,녹번,7105,5879,20200503,12984
20200430,3,홍제,10529,9569,20200503,20098
20200430,3,무악재,2233,2294,20200503,4527
20200430,3,독립문,4588,5267,20200503,9855
20200430,3,경복궁,10896,11960,20200503,22856
20200430,3,안국,11059,13908,20200503,24967
20200430,3,종로3가,3994,6189,20200503,10183
20200430,3,을지로3가,3560,3947,20200503,7507
20200430,3,동대입구,4687,5728,20200503,10415
20200430,3,약수,7208,6626,20200503,13834
20200430,3,금호,4876,4316,20200503,9192
20200430,3,옥수,5881,5711,20200503,11592
20200430,3,압구정,13749,15016,20200503,28765
20200430,3,신사,15204,16421,20200503,31625
20200430,3,잠원,3007,2824,20200503,5831
20200430,3,고속터미널,36539,43899,20200503,80438
20200430,3,교대,4158,2651,20200503,6809
20200430,3,남부터미널,14745,16925,20200503,31670
20200430,3,양재,12963,13830,20200503,26793
20200430,3,매봉,3906,3705,20200503,7611
20200430,3,도곡,2021,2034,20200503,4055
20200430,3,대치,5646,5174,20200503,10820
20200430,3,학여울,735,729,20200503,1464
20200430,3,대청,4315,3763,20200503,8078
20200430,3,일원,3306,3264,20200503,6570
20200430,3,수서,8409,10212,20200503,18621
20200430,3,가락시장,4776,4534,20200503,9310
20200430,3,경찰병원,2872,2750,20200503,5622
20200430,3,오금,2744,2453,20200503,5197
20200501,3,오금,3277,2938,20200504,6215
20200501,3,경찰병원,3775,3721,20200504,7496
20200501,3,가락시장,5581,5322,20200504,10903
20200501,3,수서,9796,10667,20200504,20463
20200501,3,일원,3726,3668,20200504,7394
20200501,3,대청,5092,4551,20200504,9643
20200501,3,학여울,947,974,20200504,1921
20200501,3,대치,6920,6557,20200504,13477
20200501,3,도곡,2721,2759,20200504,5480
20200501,3,매봉,4598,4337,20200504,8935
20200501,3,양재,15487,16888,20200504,32375
20200501,3,남부터미널,16588,17528,20200504,34116
20200501,3,교대,6848,4279,20200504,11127
20200501,3,고속터미널,39568,42273,20200504,81841
20200501,3,잠원,3699,3514,20200504,7213
20200501,3,신사,18429,20751,20200504,39180
20200501,3,압구정,19403,20814,20200504,40217
20200501,3,옥수,6140,5994,20200504,12134
20200501,3,금호,5371,4830,20200504,10201
20200501,3,약수,8367,7799,20200504,16166
20200501,3,동대입구,4452,5156,20200504,9608
20200501,3,충무로,1,0,20200504,1
20200501,3,을지로3가,4706,5219,20200504,9925
20200501,3,종로3가,4651,6749,20200504,11400
20200501,3,안국,10737,12482,20200504,23219
20200501,3,경복궁,12432,13290,20200504,25722
20200501,3,독립문,4736,5120,20200504,9856
20200501,3,무악재,2328,2437,20200504,4765
20200501,3,홍제,12035,11110,20200504,23145
20200501,3,녹번,7855,6775,20200504,14630
20200501,3,불광,11133,12567,20200504,23700
20200501,3,연신내,27469,25282,20200504,52751
20200501,3,구파발,13058,12596,20200504,25654
20200501,3,지축,2104,1931,20200504,4035
20200502,3,지축,1839,1778,20200505,3617
20200502,3,구파발,12082,12253,20200505,24335
20200502,3,연신내,25380,24355,20200505,49735
20200502,3,불광,10645,12173,20200505,22818
20200502,3,녹번,7185,6128,20200505,13313
20200502,3,홍제,10965,9938,20200505,20903
20200502,3,무악재,2210,2290,20200505,4500
20200502,3,독립문,4677,5054,20200505,9731
20200502,3,경복궁,10516,11376,20200505,21892
20200502,3,안국,9587,11497,20200505,21084
20200502,3,종로3가,4420,6780,20200505,11200
20200502,3,을지로3가,3698,4351,20200505,8049
20200502,3,동대입구,4476,5395,20200505,9871
20200502,3,약수,7445,7062,20200505,14507
20200502,3,금호,4984,4499,20200505,9483
20200502,3,옥수,5992,6026,20200505,12018
20200502,3,압구정,19008,19737,20200505,38745
20200502,3,신사,18847,20293,20200505,39140
20200502,3,잠원,3372,3295,20200505,6667
20200502,3,고속터미널,41635,41852,20200505,83487
20200502,3,교대,4855,3119,20200505,7974
20200502,3,남부터미널,16664,16810,20200505,33474
20200502,3,양재,14758,16195,20200505,30953
20200502,3,매봉,4093,3992,20200505,8085
20200502,3,도곡,2495,2470,20200505,4965
20200502,3,대치,7223,6553,20200505,13776
20200502,3,학여울,908,886,20200505,1794
20200502,3,대청,4618,4211,20200505,8829
20200502,3,일원,3302,3204,20200505,6506
20200502,3,수서,10294,10052,20200505,20346
20200502,3,가락시장,5229,5005,20200505,10234
20200502,3,경찰병원,3179,3078,20200505,6257
20200502,3,오금,3058,2820,20200505,5878
20200503,3,오금,2373,2495,20200506,4868
20200503,3,경찰병원,2235,2405,20200506,4640
20200503,3,가락시장,3416,3684,20200506,7100
20200503,3,수서,9086,7850,20200506,16936
20200503,3,일원,2433,2657,20200506,5090
20200503,3,대청,3352,3205,20200506,6557
20200503,3,학여울,585,611,20200506,1196
20200503,3,대치,4740,4153,20200506,8893
20200503,3,도곡,1473,1619,20200506,3092
20200503,3,매봉,3088,3069,20200506,6157
20200503,3,양재,10035,11771,20200506,21806
20200503,3,남부터미널,13198,12017,20200506,25215
20200503,3,교대,3243,2028,20200506,5271
20200503,3,고속터미널,38270,32761,20200506,71031
20200503,3,잠원,2371,2347,20200506,4718
20200503,3,신사,11059,11442,20200506,22501
20200503,3,압구정,10294,10832,20200506,21126
20200503,3,옥수,4457,4566,20200506,9023
20200503,3,금호,3768,3575,20200506,7343
20200503,3,약수,5553,5428,20200506,10981
20200503,3,동대입구,3694,4233,20200506,7927
20200503,3,충무로,1,0,20200506,1
20200503,3,을지로3가,2262,2363,20200506,4625
20200503,3,종로3가,3058,4324,20200506,7382
20200503,3,안국,7065,8491,20200506,15556
20200503,3,경복궁,7427,8153,20200506,15580
20200503,3,독립문,3574,3877,20200506,7451
20200503,3,무악재,1561,1713,20200506,3274
20200503,3,홍제,7858,7521,20200506,15379
20200503,3,녹번,5148,4772,20200506,9920
20200503,3,불광,8421,9889,20200506,18310
20200503,3,연신내,19812,18932,20200506,38744
20200503,3,구파발,9531,9909,20200506,19440
20200503,3,지축,1440,1448,20200506,2888
20200504,3,오금,4911,4323,20200507,9234
20200504,3,경찰병원,6102,6032,20200507,12134
20200504,3,가락시장,7504,7212,20200507,14716
20200504,3,수서,13281,12440,20200507,25721
20200504,3,일원,7921,7679,20200507,15600
20200504,3,대청,7833,7042,20200507,14875
20200504,3,학여울,1295,1297,20200507,2592
20200504,3,대치,8916,8572,20200507,17488
20200504,3,도곡,4204,4122,20200507,8326
20200504,3,매봉,8770,8334,20200507,17104
20200504,3,양재,27302,29977,20200507,57279
20200504,3,남부터미널,23346,22980,20200507,46326
20200504,3,교대,10886,7086,20200507,17972
20200504,3,고속터미널,40935,38221,20200507,79156
20200504,3,잠원,5025,4794,20200507,9819
20200504,3,신사,24587,27013,20200507,51600
20200504,3,압구정,25201,27224,20200507,52425
20200504,3,옥수,7862,8127,20200507,15989
20200504,3,금호,7067,6563,20200507,13630
20200504,3,약수,11102,10847,20200507,21949
20200504,3,동대입구,5399,5918,20200507,11317
20200504,3,충무로,1,0,20200507,1
20200504,3,을지로3가,8523,9606,20200507,18129
20200504,3,종로3가,8733,11066,20200507,19799
20200504,3,안국,12221,13742,20200507,25963
20200504,3,경복궁,14639,15110,20200507,29749
20200504,3,독립문,6371,6494,20200507,12865
20200504,3,무악재,3218,3234,20200507,6452
20200504,3,홍제,15823,14663,20200507,30486
20200504,3,녹번,11468,9979,20200507,21447
20200504,3,불광,14583,15773,20200507,30356
20200504,3,연신내,34643,32993,20200507,67636
20200504,3,구파발,17958,16902,20200507,34860
20200504,3,지축,2824,2684,20200507,5508
20200505,3,지축,1719,1661,20200508,3380
20200505,3,구파발,10902,11004,20200508,21906
20200505,3,연신내,22152,21395,20200508,43547
20200505,3,불광,9169,10732,20200508,19901
20200505,3,녹번,6061,5472,20200508,11533
20200505,3,홍제,9023,8711,20200508,17734
20200505,3,무악재,1854,1938,20200508,3792
20200505,3,독립문,4048,4226,20200508,8274
20200505,3,경복궁,8189,8830,20200508,17019
20200505,3,안국,8190,9911,20200508,18101
20200505,3,종로3가,3478,5130,20200508,8608
20200505,3,을지로3가,3038,3152,20200508,6190
20200505,3,동대입구,4166,4919,20200508,9085
20200505,3,약수,6252,6014,20200508,12266
20200505,3,금호,4242,3976,20200508,8218
20200505,3,옥수,4874,4949,20200508,9823
20200505,3,압구정,11589,12473,20200508,24062
20200505,3,신사,12472,12911,20200508,25383
20200505,3,잠원,2606,2516,20200508,5122
20200505,3,고속터미널,36367,32329,20200508,68696
20200505,3,교대,3765,2477,20200508,6242
20200505,3,남부터미널,13169,13175,20200508,26344
20200505,3,양재,10561,12030,20200508,22591
20200505,3,매봉,3708,3617,20200508,7325
20200505,3,도곡,1833,1800,20200508,3633
20200505,3,대치,4840,4607,20200508,9447
20200505,3,학여울,590,688,20200508,1278
20200505,3,대청,3908,3675,20200508,7583
20200505,3,일원,2837,3022,20200508,5859
20200505,3,수서,8711,7792,20200508,16503
20200505,3,가락시장,4208,4163,20200508,8371
20200505,3,경찰병원,2605,2557,20200508,5162
20200505,3,오금,2351,2227,20200508,4578
20200506,3,오금,6368,5717,20200509,12085
20200506,3,경찰병원,7732,7772,20200509,15504
20200506,3,가락시장,8827,8707,20200509,17534
20200506,3,수서,15645,15506,20200509,31151
20200506,3,일원,9128,9079,20200509,18207
20200506,3,대청,9362,8595,20200509,17957
20200506,3,학여울,1667,1699,20200509,3366
20200506,3,대치,10226,10026,20200509,20252
20200506,3,도곡,5071,5222,20200509,10293
20200506,3,매봉,11476,11033,20200509,22509
20200506,3,양재,37821,41341,20200509,79162
20200506,3,남부터미널,28778,29303,20200509,58081
20200506,3,교대,14202,9539,20200509,23741
20200506,3,고속터미널,38442,36540,20200509,74982
20200506,3,잠원,5863,5619,20200509,11482
20200506,3,신사,29941,32063,20200509,62004
20200506,3,압구정,30730,33207,20200509,63937
20200506,3,옥수,9080,9361,20200509,18441
20200506,3,금호,8209,7704,20200509,15913
20200506,3,약수,12554,12551,20200509,25105
20200506,3,동대입구,6644,7095,20200509,13739
20200506,3,을지로3가,10785,11644,20200509,22429
20200506,3,종로3가,10154,12178,20200509,22332
20200506,3,안국,18881,19592,20200509,38473
20200506,3,경복궁,18019,17776,20200509,35795
20200506,3,독립문,7090,7443,20200509,14533
20200506,3,무악재,3781,3869,20200509,7650
20200506,3,홍제,17891,16740,20200509,34631
20200506,3,녹번,13718,12082,20200509,25800
20200506,3,불광,16744,18005,20200509,34749
20200506,3,연신내,38144,35847,20200509,73991
20200506,3,구파발,20508,19276,20200509,39784
20200506,3,지축,3357,3309,20200509,6666
20200507,3,지축,3372,3249,20200510,6621
20200507,3,구파발,21096,19585,20200510,40681
20200507,3,연신내,38592,36746,20200510,75338
20200507,3,불광,16371,17912,20200510,34283
20200507,3,녹번,13520,12053,20200510,25573
20200507,3,홍제,17808,16835,20200510,34643
20200507,3,무악재,3896,3872,20200510,7768
20200507,3,독립문,7186,7571,20200510,14757
20200507,3,경복궁,18115,18138,20200510,36253
20200507,3,안국,18811,19851,20200510,38662
20200507,3,종로3가,10167,12023,20200510,22190
20200507,3,을지로3가,10995,11638,20200510,22633
20200507,3,충무로,1,0,20200510,1
20200507,3,동대입구,6736,7219,20200510,13955
20200507,3,약수,12940,12678,20200510,25618
20200507,3,금호,8378,7710,20200510,16088
20200507,3,옥수,9199,9399,20200510,18598
20200507,3,압구정,30725,33117,20200510,63842
20200507,3,신사,30319,32458,20200510,62777
20200507,3,잠원,5875,5526,20200510,11401
20200507,3,고속터미널,39778,39966,20200510,79744
20200507,3,교대,14951,9843,20200510,24794
20200507,3,남부터미널,28777,29825,20200510,58602
20200507,3,양재,39002,42519,20200510,81521
20200507,3,매봉,11759,11293,20200510,23052
20200507,3,도곡,5303,5250,20200510,10553
20200507,3,대치,10531,10361,20200510,20892
20200507,3,학여울,1731,1723,20200510,3454
20200507,3,대청,9472,8751,20200510,18223
20200507,3,일원,9747,9571,20200510,19318
20200507,3,수서,16351,16509,20200510,32860
20200507,3,가락시장,9168,8960,20200510,18128
20200507,3,경찰병원,7551,7565,20200510,15116
20200507,3,오금,6367,5572,20200510,11939
20200508,3,지축,3398,3310,20200511,6708
20200508,3,구파발,21448,19803,20200511,41251
20200508,3,연신내,39302,37556,20200511,76858
20200508,3,불광,16718,18152,20200511,34870
20200508,3,녹번,13867,12492,20200511,26359
20200508,3,홍제,17995,17641,20200511,35636
20200508,3,무악재,3934,4133,20200511,8067
20200508,3,독립문,7205,7388,20200511,14593
20200508,3,경복궁,18886,18230,20200511,37116
20200508,3,안국,19599,19686,20200511,39285
20200508,3,종로3가,9809,11629,20200511,21438
20200508,3,을지로3가,11457,11486,20200511,22943
20200508,3,충무로,2,0,20200511,2
20200508,3,동대입구,6841,6947,20200511,13788
20200508,3,약수,13382,13288,20200511,26670
20200508,3,금호,8618,8152,20200511,16770
20200508,3,옥수,9554,10077,20200511,19631
20200508,3,압구정,32739,35075,20200511,67814
20200508,3,신사,32039,33604,20200511,65643
20200508,3,잠원,6165,5997,20200511,12162
20200508,3,고속터미널,45570,51509,20200511,97079
20200508,3,교대,15206,9769,20200511,24975
20200508,3,남부터미널,32401,33494,20200511,65895
20200508,3,양재,42389,42992,20200511,85381
20200508,3,매봉,12076,11651,20200511,23727
20200508,3,대치,11002,10893,20200511,21895
20200508,3,학여울,1823,1840,20200511,3663
20200508,3,대청,9824,9048,20200511,18872
20200508,3,일원,9729,9504,20200511,19233
20200508,3,수서,17813,18369,20200511,36182
20200508,3,가락시장,9578,9447,20200511,19025
20200508,3,경찰병원,7997,7983,20200511,15980
20200508,3,오금,6464,5793,20200511,12257
20200508,3,도곡,5490,5592,20200511,11082
20200509,3,대치,7717,6811,20200512,14528
20200509,3,학여울,922,938,20200512,1860
20200509,3,대청,4821,4376,20200512,9197
20200509,3,일원,3760,3751,20200512,7511
20200509,3,수서,10757,10762,20200512,21519
20200509,3,가락시장,5251,4925,20200512,10176
20200509,3,경찰병원,3511,3387,20200512,6898
20200509,3,오금,3439,3225,20200512,6664
20200509,3,지축,1767,1721,20200512,3488
20200509,3,구파발,11728,11252,20200512,22980
20200509,3,연신내,25099,24381,20200512,49480
20200509,3,불광,10190,11069,20200512,21259
20200509,3,녹번,7620,6474,20200512,14094
20200509,3,홍제,10528,9946,20200512,20474
20200509,3,무악재,2225,2203,20200512,4428
20200509,3,독립문,4179,4029,20200512,8208
20200509,3,경복궁,9011,9015,20200512,18026
20200509,3,안국,8438,9781,20200512,18219
20200509,3,종로3가,4429,6091,20200512,10520
20200509,3,을지로3가,3783,4374,20200512,8157
20200509,3,동대입구,4583,4968,20200512,9551
20200509,3,약수,7583,7149,20200512,14732
20200509,3,금호,5306,4663,20200512,9969
20200509,3,옥수,5526,5510,20200512,11036
20200509,3,압구정,20527,21448,20200512,41975
20200509,3,신사,20418,21723,20200512,42141
20200509,3,잠원,3302,3116,20200512,6418
20200509,3,고속터미널,42915,43287,20200512,86202
20200509,3,교대,6179,3761,20200512,9940
20200509,3,남부터미널,18547,18789,20200512,37336
20200509,3,양재,17810,19133,20200512,36943
20200509,3,매봉,4753,4506,20200512,9259
20200509,3,도곡,3056,2952,20200512,6008
20200510,3,지축,1483,1480,20200513,2963
20200510,3,구파발,10267,10558,20200513,20825
20200510,3,연신내,20843,19891,20200513,40734
20200510,3,불광,9073,10988,20200513,20061
20200510,3,녹번,5674,5111,20200513,10785
20200510,3,홍제,8732,8155,20200513,16887
20200510,3,무악재,1735,1797,20200513,3532
20200510,3,독립문,3807,4364,20200513,8171
20200510,3,경복궁,8180,8501,20200513,16681
20200510,3,안국,7688,8731,20200513,16419
20200510,3,종로3가,2884,3955,20200513,6839
20200510,3,을지로3가,2386,2536,20200513,4922
20200510,3,동대입구,3468,4080,20200513,7548
20200510,3,약수,5946,5707,20200513,11653
20200510,3,금호,3936,3770,20200513,7706
20200510,3,옥수,4542,4816,20200513,9358
20200510,3,압구정,11125,11576,20200513,22701
20200510,3,신사,11980,12393,20200513,24373
20200510,3,잠원,2404,2512,20200513,4916
20200510,3,고속터미널,37797,34252,20200513,72049
20200510,3,교대,4007,2449,20200513,6456
20200510,3,남부터미널,14361,14326,20200513,28687
20200510,3,양재,12298,14319,20200513,26617
20200510,3,매봉,3262,3263,20200513,6525
20200510,3,도곡,1663,1735,20200513,3398
20200510,3,대치,5155,4442,20200513,9597
20200510,3,학여울,646,652,20200513,1298
20200510,3,대청,3458,3309,20200513,6767
20200510,3,일원,2756,2864,20200513,5620
20200510,3,수서,9327,8386,20200513,17713
20200510,3,가락시장,3437,3639,20200513,7076
20200510,3,경찰병원,2447,2565,20200513,5012
20200510,3,오금,2423,2343,20200513,4766
20200511,3,가락시장,8994,8568,20200514,17562
20200511,3,경찰병원,7626,7678,20200514,15304
20200511,3,오금,6223,5517,20200514,11740
20200511,3,지축,3380,3224,20200514,6604
20200511,3,구파발,19996,18558,20200514,38554
20200511,3,연신내,37687,35745,20200514,73432
20200511,3,불광,16301,17427,20200514,33728
20200511,3,녹번,13585,12245,20200514,25830
20200511,3,홍제,17485,16746,20200514,34231
20200511,3,무악재,3735,3887,20200514,7622
20200511,3,독립문,6795,7011,20200514,13806
20200511,3,경복궁,16870,16892,20200514,33762
20200511,3,안국,18283,18933,20200514,37216
20200511,3,종로3가,9740,11400,20200514,21140
20200511,3,을지로3가,10828,11171,20200514,21999
20200511,3,충무로,2,0,20200514,2
20200511,3,동대입구,7178,7717,20200514,14895
20200511,3,약수,12620,12563,20200514,25183
20200511,3,금호,8027,7577,20200514,15604
20200511,3,옥수,8748,9125,20200514,17873
20200511,3,압구정,29539,31867,20200514,61406
20200511,3,신사,28682,30578,20200514,59260
20200511,3,잠원,5887,5790,20200514,11677
20200511,3,고속터미널,36677,34405,20200514,71082
20200511,3,교대,14320,9506,20200514,23826
20200511,3,남부터미널,28387,29446,20200514,57833
20200511,3,양재,37964,41597,20200514,79561
20200511,3,매봉,11203,10739,20200514,21942
20200511,3,도곡,5209,5312,20200514,10521
20200511,3,대치,10256,10077,20200514,20333
20200511,3,학여울,1652,1678,20200514,3330
20200511,3,대청,9295,8610,20200514,17905
20200511,3,일원,9370,9280,20200514,18650
20200511,3,수서,16069,16119,20200514,32188
20200512,3,지축,3290,3215,20200515,6505
20200512,3,구파발,20588,19182,20200515,39770
20200512,3,연신내,37555,35453,20200515,73008
20200512,3,불광,15982,17466,20200515,33448
20200512,3,녹번,13469,12134,20200515,25603
20200512,3,홍제,17092,16130,20200515,33222
20200512,3,무악재,3732,3840,20200515,7572
20200512,3,독립문,6751,7061,20200515,13812
20200512,3,경복궁,17392,17263,20200515,34655
20200512,3,안국,18634,19183,20200515,37817
20200512,3,종로3가,9923,11436,20200515,21359
20200512,3,을지로3가,10554,11192,20200515,21746
20200512,3,충무로,1,0,20200515,1
20200512,3,동대입구,7084,7443,20200515,14527
20200512,3,약수,12411,12345,20200515,24756
20200512,3,금호,8168,7605,20200515,15773
20200512,3,옥수,9015,9213,20200515,18228
20200512,3,압구정,29855,32147,20200515,62002
20200512,3,신사,28638,30272,20200515,58910
20200512,3,잠원,5767,5579,20200515,11346
20200512,3,고속터미널,35050,33825,20200515,68875
20200512,3,교대,14438,9499,20200515,23937
20200512,3,남부터미널,28359,29205,20200515,57564
20200512,3,양재,38545,41873,20200515,80418
20200512,3,매봉,11329,10893,20200515,22222
20200512,3,도곡,5190,5200,20200515,10390
20200512,3,대치,10027,9943,20200515,19970
20200512,3,학여울,1777,1771,20200515,3548
20200512,3,대청,9271,8529,20200515,17800
20200512,3,일원,9379,9132,20200515,18511
20200512,3,수서,15667,15675,20200515,31342
20200512,3,가락시장,8957,8812,20200515,17769
20200512,3,경찰병원,7590,7571,20200515,15161
20200512,3,오금,6159,5586,20200515,11745
20200513,3,지축,3402,3291,20200516,6693
20200513,3,구파발,20688,19492,20200516,40180
20200513,3,연신내,37690,35985,20200516,73675
20200513,3,불광,16317,17543,20200516,33860
20200513,3,녹번,13729,12281,20200516,26010
20200513,3,홍제,17327,16550,20200516,33877
20200513,3,무악재,3817,3811,20200516,7628
20200513,3,독립문,7205,7516,20200516,14721
20200513,3,경복궁,18228,18103,20200516,36331
20200513,3,안국,18810,19706,20200516,38516
20200513,3,종로3가,10044,11570,20200516,21614
20200513,3,을지로3가,10648,11289,20200516,21937
20200513,3,충무로,1,0,20200516,1
20200513,3,동대입구,6970,7567,20200516,14537
20200513,3,약수,12606,12501,20200516,25107
20200513,3,금호,7995,7553,20200516,15548
20200513,3,옥수,9135,9185,20200516,18320
20200513,3,압구정,29379,31683,20200516,61062
20200513,3,신사,28410,30422,20200516,58832
20200513,3,잠원,5849,5682,20200516,11531
20200513,3,고속터미널,35585,34216,20200516,69801
20200513,3,교대,14762,9660,20200516,24422
20200513,3,남부터미널,28331,28902,20200516,57233
20200513,3,양재,38607,41558,20200516,80165
20200513,3,매봉,11477,10936,20200516,22413
20200513,3,도곡,5127,5162,20200516,10289
20200513,3,대치,10050,9910,20200516,19960
20200513,3,학여울,1609,1645,20200516,3254
20200513,3,대청,9135,8426,20200516,17561
20200513,3,일원,9200,9058,20200516,18258
20200513,3,수서,15710,15946,20200516,31656
20200513,3,가락시장,8998,8900,20200516,17898
20200513,3,경찰병원,7545,7577,20200516,15122
20200513,3,오금,6371,5642,20200516,12013
20200514,3,오금,6322,5655,20200517,11977
20200514,3,경찰병원,7538,7542,20200517,15080
20200514,3,가락시장,8724,8634,20200517,17358
20200514,3,수서,15977,15933,20200517,31910
20200514,3,일원,9438,9232,20200517,18670
20200514,3,대청,9180,8444,20200517,17624
20200514,3,학여울,1789,1780,20200517,3569
20200514,3,대치,10186,9958,20200517,20144
20200514,3,도곡,5154,5199,20200517,10353
20200514,3,매봉,11434,10946,20200517,22380
20200514,3,양재,38604,41922,20200517,80526
20200514,3,남부터미널,27870,28318,20200517,56188
20200514,3,교대,14601,9680,20200517,24281
20200514,3,고속터미널,35649,34500,20200517,70149
20200514,3,잠원,5710,5494,20200517,11204
20200514,3,신사,28353,30575,20200517,58928
20200514,3,압구정,28963,31459,20200517,60422
20200514,3,옥수,9011,9133,20200517,18144
20200514,3,약수,12504,12233,20200517,24737
20200514,3,동대입구,6882,7439,20200517,14321
20200514,3,충무로,1,0,20200517,1
20200514,3,을지로3가,10501,11209,20200517,21710
20200514,3,종로3가,9476,11051,20200517,20527
20200514,3,안국,18208,19253,20200517,37461
20200514,3,경복궁,17961,17807,20200517,35768
20200514,3,독립문,7007,7487,20200517,14494
20200514,3,금호,7925,7367,20200517,15292
20200514,3,불광,16200,17273,20200517,33473
20200514,3,연신내,37413,35577,20200517,72990
20200514,3,구파발,20589,19196,20200517,39785
20200514,3,지축,3440,3266,20200517,6706
20200514,3,무악재,3787,3795,20200517,7582
20200514,3,홍제,17259,16172,20200517,33431
20200514,3,녹번,13413,11941,20200517,25354
20200515,3,오금,6157,5512,20200518,11669
20200515,3,경찰병원,7408,7393,20200518,14801
20200515,3,가락시장,8856,8646,20200518,17502
20200515,3,수서,17301,17179,20200518,34480
20200515,3,일원,8922,8679,20200518,17601
20200515,3,대청,9295,8433,20200518,17728
20200515,3,학여울,1712,1700,20200518,3412
20200515,3,대치,10327,10256,20200518,20583
20200515,3,도곡,5232,5177,20200518,10409
20200515,3,매봉,11402,10907,20200518,22309
20200515,3,지축,3116,2974,20200518,6090
20200515,3,구파발,19821,18043,20200518,37864
20200515,3,연신내,36167,35014,20200518,71181
20200515,3,불광,15460,16428,20200518,31888
20200515,3,녹번,13267,11703,20200518,24970
20200515,3,홍제,16664,15841,20200518,32505
20200515,3,무악재,3686,3655,20200518,7341
20200515,3,독립문,6364,6537,20200518,12901
20200515,3,경복궁,17653,17194,20200518,34847
20200515,3,안국,18491,18617,20200518,37108
20200515,3,종로3가,8980,10482,20200518,19462
20200515,3,을지로3가,10781,11315,20200518,22096
20200515,3,충무로,1,0,20200518,1
20200515,3,동대입구,6588,6847,20200518,13435
20200515,3,약수,12350,12224,20200518,24574
20200515,3,금호,7965,7394,20200518,15359
20200515,3,옥수,8674,8915,20200518,17589
20200515,3,압구정,30273,32746,20200518,63019
20200515,3,신사,29262,32227,20200518,61489
20200515,3,잠원,5754,5629,20200518,11383
20200515,3,고속터미널,39895,42659,20200518,82554
20200515,3,교대,14428,9619,20200518,24047
20200515,3,남부터미널,29887,30208,20200518,60095
20200515,3,양재,40336,41914,20200518,82250
20200516,3,지축,2049,1896,20200519,3945
20200516,3,구파발,13252,13128,20200519,26380
20200516,3,연신내,27808,26481,20200519,54289
20200516,3,불광,11363,12635,20200519,23998
20200516,3,녹번,8291,7167,20200519,15458
20200516,3,홍제,12191,11346,20200519,23537
20200516,3,무악재,2396,2483,20200519,4879
20200516,3,독립문,5152,5565,20200519,10717
20200516,3,경복궁,10544,10851,20200519,21395
20200516,3,안국,9681,11598,20200519,21279
20200516,3,종로3가,4804,6439,20200519,11243
20200516,3,을지로3가,4093,4781,20200519,8874
20200516,3,충무로,1,0,20200519,1
20200516,3,동대입구,5126,5794,20200519,10920
20200516,3,약수,8275,7934,20200519,16209
20200516,3,금호,5378,4909,20200519,10287
20200516,3,옥수,6598,6430,20200519,13028
20200516,3,압구정,21105,22020,20200519,43125
20200516,3,신사,20931,22799,20200519,43730
20200516,3,잠원,3845,3591,20200519,7436
20200516,3,고속터미널,39789,40889,20200519,80678
20200516,3,교대,6216,3917,20200519,10133
20200516,3,남부터미널,18087,18733,20200519,36820
20200516,3,양재,19255,20869,20200519,40124
20200516,3,매봉,4959,4699,20200519,9658
20200516,3,도곡,2995,3029,20200519,6024
20200516,3,대치,7834,7056,20200519,14890
20200516,3,학여울,1030,993,20200519,2023
20200516,3,대청,5085,4669,20200519,9754
20200516,3,일원,3950,3812,20200519,7762
20200516,3,수서,10862,11233,20200519,22095
20200516,3,가락시장,5872,5589,20200519,11461
20200516,3,경찰병원,3670,3428,20200519,7098
20200516,3,오금,3689,3528,20200519,7217
20200517,3,오금,2738,2672,20200520,5410
20200517,3,경찰병원,2407,2537,20200520,4944
20200517,3,가락시장,3630,3800,20200520,7430
20200517,3,수서,8840,8480,20200520,17320
20200517,3,일원,2778,2935,20200520,5713
20200517,3,대청,3574,3359,20200520,6933
20200517,3,학여울,701,696,20200520,1397
20200517,3,대치,4992,4356,20200520,9348
20200517,3,도곡,1565,1587,20200520,3152
20200517,3,매봉,3351,3336,20200520,6687
20200517,3,양재,12051,13894,20200520,25945
20200517,3,남부터미널,12053,12660,20200520,24713
20200517,3,교대,3797,2358,20200520,6155
20200517,3,고속터미널,33315,31334,20200520,64649
20200517,3,잠원,2672,2685,20200520,5357
20200517,3,신사,11678,12108,20200520,23786
20200517,3,압구정,11015,11679,20200520,22694
20200517,3,옥수,4698,4994,20200520,9692
20200517,3,금호,4014,3804,20200520,7818
20200517,3,약수,5944,5686,20200520,11630
20200517,3,동대입구,3997,4523,20200520,8520
20200517,3,을지로3가,2227,2337,20200520,4564
20200517,3,종로3가,2857,3896,20200520,6753
20200517,3,안국,6866,8108,20200520,14974
20200517,3,경복궁,8062,8394,20200520,16456
20200517,3,독립문,4041,4517,20200520,8558
20200517,3,무악재,1680,1812,20200520,3492
20200517,3,홍제,8543,8149,20200520,16692
20200517,3,녹번,5608,5126,20200520,10734
20200517,3,불광,8879,10687,20200520,19566
20200517,3,연신내,20809,19291,20200520,40100
20200517,3,구파발,10428,10683,20200520,21111
20200517,3,지축,1528,1537,20200520,3065
20200518,3,오금,6108,5429,20200521,11537
20200518,3,경찰병원,7711,7877,20200521,15588
20200518,3,가락시장,8630,8378,20200521,17008
20200518,3,수서,15077,15480,20200521,30557
20200518,3,일원,9064,8978,20200521,18042
20200518,3,대청,9124,8459,20200521,17583
20200518,3,학여울,1579,1674,20200521,3253
20200518,3,대치,9887,9820,20200521,19707
20200518,3,도곡,5055,5121,20200521,10176
20200518,3,매봉,11431,11021,20200521,22452
20200518,3,양재,37113,40308,20200521,77421
20200518,3,남부터미널,26989,27721,20200521,54710
20200518,3,교대,13538,8923,20200521,22461
20200518,3,고속터미널,34099,32244,20200521,66343
20200518,3,잠원,5561,5546,20200521,11107
20200518,3,신사,27207,28743,20200521,55950
20200518,3,압구정,28497,30503,20200521,59000
20200518,3,옥수,8301,8642,20200521,16943
20200518,3,금호,7670,7290,20200521,14960
20200518,3,약수,12153,11990,20200521,24143
20200518,3,동대입구,6696,6996,20200521,13692
20200518,3,을지로3가,10765,10680,20200521,21445
20200518,3,종로3가,10083,11125,20200521,21208
20200518,3,안국,18272,18106,20200521,36378
20200518,3,경복궁,16284,16132,20200521,32416
20200518,3,독립문,6489,6881,20200521,13370
20200518,3,무악재,3601,3743,20200521,7344
20200518,3,홍제,16501,16139,20200521,32640
20200518,3,녹번,12944,11846,20200521,24790
20200518,3,불광,15453,16289,20200521,31742
20200518,3,연신내,35864,33730,20200521,69594
20200518,3,구파발,19289,17973,20200521,37262
20200518,3,지축,3214,3143,20200521,6357
20200519,3,오금,6152,5445,20200522,11597
20200519,3,경찰병원,7513,7428,20200522,14941
20200519,3,가락시장,8679,8486,20200522,17165
20200519,3,수서,14882,15122,20200522,30004
20200519,3,일원,8822,8632,20200522,17454
20200519,3,대청,8993,8264,20200522,17257
20200519,3,학여울,1605,1644,20200522,3249
20200519,3,대치,9910,9799,20200522,19709
20200519,3,도곡,5070,5079,20200522,10149
20200519,3,매봉,11391,10927,20200522,22318
20200519,3,양재,37510,40476,20200522,77986
20200519,3,남부터미널,26924,27779,20200522,54703
20200519,3,교대,13898,9316,20200522,23214
20200519,3,고속터미널,33480,32565,20200522,66045
20200519,3,잠원,5742,5500,20200522,11242
20200519,3,신사,28309,30177,20200522,58486
20200519,3,압구정,29022,31277,20200522,60299
20200519,3,옥수,8726,8978,20200522,17704
20200519,3,금호,7858,7213,20200522,15071
20200519,3,약수,12024,12005,20200522,24029
20200519,3,동대입구,6774,7057,20200522,13831
20200519,3,충무로,1,0,20200522,1
20200519,3,을지로3가,10449,11018,20200522,21467
20200519,3,종로3가,9906,11304,20200522,21210
20200519,3,안국,17959,18596,20200522,36555
20200519,3,경복궁,16985,16665,20200522,33650
20200519,3,독립문,6484,6644,20200522,13128
20200519,3,무악재,3772,3798,20200522,7570
20200519,3,홍제,16723,15836,20200522,32559
20200519,3,녹번,13024,11813,20200522,24837
20200519,3,불광,15407,16304,20200522,31711
20200519,3,연신내,36257,34277,20200522,70534
20200519,3,구파발,19920,18365,20200522,38285
20200519,3,지축,3198,3146,20200522,6344
20200520,3,오금,6437,5653,20200523,12090
20200520,3,경찰병원,7731,7547,20200523,15278
20200520,3,가락시장,9416,9092,20200523,18508
20200520,3,수서,16263,16409,20200523,32672
20200520,3,일원,8458,8000,20200523,16458
20200520,3,대청,9459,8845,20200523,18304
20200520,3,학여울,1746,1717,20200523,3463
20200520,3,대치,10067,10068,20200523,20135
20200520,3,도곡,5219,5333,20200523,10552
20200520,3,매봉,11737,11248,20200523,22985
20200520,3,양재,39129,42627,20200523,81756
20200520,3,남부터미널,28136,28926,20200523,57062
20200520,3,교대,14972,9782,20200523,24754
20200520,3,고속터미널,35779,34530,20200523,70309
20200520,3,잠원,5948,5815,20200523,11763
20200520,3,신사,29392,31582,20200523,60974
20200520,3,압구정,30050,32241,20200523,62291
20200520,3,옥수,9361,9480,20200523,18841
20200520,3,금호,8235,7745,20200523,15980
20200520,3,약수,12944,12753,20200523,25697
20200520,3,동대입구,7197,7841,20200523,15038
20200520,3,을지로3가,10850,11488,20200523,22338
20200520,3,종로3가,10085,11720,20200523,21805
20200520,3,안국,19928,20499,20200523,40427
20200520,3,경복궁,18778,18566,20200523,37344
20200520,3,독립문,7323,7786,20200523,15109
20200520,3,무악재,3918,3853,20200523,7771
20200520,3,홍제,17943,17013,20200523,34956
20200520,3,녹번,13879,12374,20200523,26253
20200520,3,불광,16663,17934,20200523,34597
20200520,3,연신내,38829,36813,20200523,75642
20200520,3,구파발,21108,19754,20200523,40862
20200520,3,지축,3509,3442,20200523,6951
20200521,3,오금,6408,5705,20200524,12113
20200521,3,경찰병원,7689,7763,20200524,15452
20200521,3,가락시장,9392,9245,20200524,18637
20200521,3,수서,16295,16203,20200524,32498
20200521,3,일원,8707,8306,20200524,17013
20200521,3,대청,9416,8766,20200524,18182
20200521,3,학여울,1703,1762,20200524,3465
20200521,3,대치,10141,9950,20200524,20091
20200521,3,도곡,5359,5377,20200524,10736
20200521,3,매봉,11867,11209,20200524,23076
20200521,3,양재,39220,42867,20200524,82087
20200521,3,남부터미널,28392,28902,20200524,57294
20200521,3,교대,15005,9790,20200524,24795
20200521,3,고속터미널,36812,35438,20200524,72250
20200521,3,잠원,6016,5710,20200524,11726
20200521,3,신사,29691,31928,20200524,61619
20200521,3,압구정,29608,32018,20200524,61626
20200521,3,옥수,9375,9580,20200524,18955
20200521,3,금호,8155,7579,20200524,15734
20200521,3,약수,13054,12812,20200524,25866
20200521,3,동대입구,7152,7887,20200524,15039
20200521,3,을지로3가,10688,11420,20200524,22108
20200521,3,종로3가,9909,11691,20200524,21600
20200521,3,안국,19396,20556,20200524,39952
20200521,3,경복궁,18680,18685,20200524,37365
20200521,3,독립문,7481,7865,20200524,15346
20200521,3,무악재,3943,3910,20200524,7853
20200521,3,홍제,17761,16669,20200524,34430
20200521,3,녹번,13829,12310,20200524,26139
20200521,3,불광,16608,17845,20200524,34453
20200521,3,연신내,38616,36496,20200524,75112
20200521,3,구파발,21352,19924,20200524,41276
20200521,3,지축,3455,3343,20200524,6798
20200522,3,가락시장,9748,9542,20200525,19290
20200522,3,지축,3542,3290,20200525,6832
20200522,3,구파발,21403,19652,20200525,41055
20200522,3,연신내,39398,37391,20200525,76789
20200522,3,불광,16902,17746,20200525,34648
20200522,3,녹번,13988,12161,20200525,26149
20200522,3,홍제,18161,16732,20200525,34893
20200522,3,무악재,3850,3824,20200525,7674
20200522,3,독립문,7454,7733,20200525,15187
20200522,3,경복궁,19246,19194,20200525,38440
20200522,3,안국,19806,20776,20200525,40582
20200522,3,종로3가,9850,11861,20200525,21711
20200522,3,을지로3가,10860,11817,20200525,22677
20200522,3,충무로,1,0,20200525,1
20200522,3,동대입구,7302,7714,20200525,15016
20200522,3,약수,13378,12954,20200525,26332
20200522,3,금호,8622,7841,20200525,16463
20200522,3,옥수,9721,9806,20200525,19527
20200522,3,압구정,31502,34695,20200525,66197
20200522,3,신사,31595,35257,20200525,66852
20200522,3,잠원,6113,5839,20200525,11952
20200522,3,고속터미널,42725,45173,20200525,87898
20200522,3,교대,15220,10068,20200525,25288
20200522,3,남부터미널,30890,31641,20200525,62531
20200522,3,양재,41411,43361,20200525,84772
20200522,3,매봉,11861,11383,20200525,23244
20200522,3,도곡,5532,5559,20200525,11091
20200522,3,대치,10826,10768,20200525,21594
20200522,3,학여울,1825,1790,20200525,3615
20200522,3,대청,9581,8679,20200525,18260
20200522,3,일원,8643,8215,20200525,16858
20200522,3,수서,17870,18202,20200525,36072
20200522,3,경찰병원,7685,7680,20200525,15365
20200522,3,오금,6352,5844,20200525,12196
20200523,3,연신내,30626,28928,20200526,59554
20200523,3,지축,2306,2220,20200526,4526
20200523,3,구파발,15066,15146,20200526,30212
20200523,3,불광,12844,14791,20200526,27635
20200523,3,녹번,9077,7603,20200526,16680
20200523,3,홍제,13517,12410,20200526,25927
20200523,3,무악재,2686,2680,20200526,5366
20200523,3,독립문,5854,6416,20200526,12270
20200523,3,경복궁,12939,13790,20200526,26729
20200523,3,안국,11797,14434,20200526,26231
20200523,3,종로3가,4951,7139,20200526,12090
20200523,3,을지로3가,4422,5297,20200526,9719
20200523,3,충무로,1,0,20200526,1
20200523,3,동대입구,5445,6224,20200526,11669
20200523,3,약수,9018,8281,20200526,17299
20200523,3,금호,6032,5317,20200526,11349
20200523,3,옥수,7180,7160,20200526,14340
20200523,3,압구정,22115,23417,20200526,45532
20200523,3,신사,23749,25879,20200526,49628
20200523,3,잠원,4204,3977,20200526,8181
20200523,3,고속터미널,45315,45888,20200526,91203
20200523,3,교대,6876,4217,20200526,11093
20200523,3,남부터미널,19285,19186,20200526,38471
20200523,3,양재,20549,22012,20200526,42561
20200523,3,매봉,5268,5023,20200526,10291
20200523,3,도곡,3151,3059,20200526,6210
20200523,3,대치,8040,7282,20200526,15322
20200523,3,학여울,1070,1093,20200526,2163
20200523,3,대청,5460,5010,20200526,10470
20200523,3,일원,4398,4188,20200526,8586
20200523,3,수서,11652,11943,20200526,23595
20200523,3,가락시장,6313,6061,20200526,12374
20200523,3,경찰병원,3979,3862,20200526,7841
20200523,3,오금,3837,3664,20200526,7501
20200524,3,오금,2750,2762,20200527,5512
20200524,3,경찰병원,2506,2674,20200527,5180
20200524,3,가락시장,3157,3436,20200527,6593
20200524,3,수서,8728,8284,20200527,17012
20200524,3,일원,2555,2661,20200527,5216
20200524,3,대청,3459,3257,20200527,6716
20200524,3,학여울,639,699,20200527,1338
20200524,3,대치,4722,4148,20200527,8870
20200524,3,도곡,1675,1764,20200527,3439
20200524,3,매봉,3271,3216,20200527,6487
20200524,3,양재,11478,13424,20200527,24902
20200524,3,남부터미널,12626,13182,20200527,25808
20200524,3,교대,3871,2401,20200527,6272
20200524,3,고속터미널,34019,32146,20200527,66165
20200524,3,잠원,2320,2326,20200527,4646
20200524,3,신사,12082,12470,20200527,24552
20200524,3,압구정,11146,11605,20200527,22751
20200524,3,옥수,4379,4685,20200527,9064
20200524,3,금호,4003,3798,20200527,7801
20200524,3,약수,5856,5617,20200527,11473
20200524,3,동대입구,3971,4308,20200527,8279
20200524,3,을지로3가,2384,2484,20200527,4868
20200524,3,종로3가,2861,4002,20200527,6863
20200524,3,안국,7060,8069,20200527,15129
20200524,3,경복궁,7732,8123,20200527,15855
20200524,3,독립문,3606,3825,20200527,7431
20200524,3,무악재,1597,1720,20200527,3317
20200524,3,홍제,8297,7820,20200527,16117
20200524,3,녹번,5374,4941,20200527,10315
20200524,3,불광,8215,9454,20200527,17669
20200524,3,연신내,19917,18784,20200527,38701
20200524,3,구파발,9597,9862,20200527,19459
20200524,3,지축,1472,1332,20200527,2804
20200525,3,오금,6430,5678,20200528,12108
20200525,3,경찰병원,7569,7635,20200528,15204
20200525,3,가락시장,9351,9111,20200528,18462
20200525,3,수서,16014,16287,20200528,32301
20200525,3,일원,9015,8735,20200528,17750
20200525,3,대청,9590,8801,20200528,18391
20200525,3,학여울,1780,1824,20200528,3604
20200525,3,대치,10303,10344,20200528,20647
20200525,3,도곡,5313,5400,20200528,10713
20200525,3,매봉,11661,11244,20200528,22905
20200525,3,양재,38067,41766,20200528,79833
20200525,3,남부터미널,28297,29251,20200528,57548
20200525,3,교대,14360,9529,20200528,23889
20200525,3,고속터미널,37042,34927,20200528,71969
20200525,3,잠원,5918,5737,20200528,11655
20200525,3,신사,28710,30786,20200528,59496
20200525,3,압구정,29808,32420,20200528,62228
20200525,3,옥수,8923,9232,20200528,18155
20200525,3,금호,8291,7785,20200528,16076
20200525,3,약수,12973,12862,20200528,25835
20200525,3,동대입구,7001,7420,20200528,14421
20200525,3,충무로,1,0,20200528,1
20200525,3,을지로3가,10714,11097,20200528,21811
20200525,3,종로3가,10016,11714,20200528,21730
20200525,3,안국,18910,19614,20200528,38524
20200525,3,경복궁,17303,17261,20200528,34564
20200525,3,독립문,7180,7338,20200528,14518
20200525,3,무악재,3855,3924,20200528,7779
20200525,3,홍제,17697,16902,20200528,34599
20200525,3,녹번,13795,12424,20200528,26219
20200525,3,불광,16317,17741,20200528,34058
20200525,3,연신내,38468,36339,20200528,74807
20200525,3,구파발,20873,19369,20200528,40242
20200525,3,지축,3499,3393,20200528,6892
20200526,3,매봉,11950,11509,20200529,23459
20200526,3,양재,39088,42291,20200529,81379
20200526,3,남부터미널,28202,29131,20200529,57333
20200526,3,교대,14629,9509,20200529,24138
20200526,3,고속터미널,35228,34272,20200529,69500
20200526,3,잠원,5871,5649,20200529,11520
20200526,3,신사,29254,31280,20200529,60534
20200526,3,압구정,30322,32955,20200529,63277
20200526,3,옥수,9156,9468,20200529,18624
20200526,3,금호,8048,7414,20200529,15462
20200526,3,약수,13013,12802,20200529,25815
20200526,3,동대입구,7244,7643,20200529,14887
20200526,3,충무로,2,0,20200529,2
20200526,3,을지로3가,11165,11373,20200529,22538
20200526,3,종로3가,10260,11692,20200529,21952
20200526,3,안국,19344,19931,20200529,39275
20200526,3,경복궁,18107,17906,20200529,36013
20200526,3,독립문,7161,7576,20200529,14737
20200526,3,무악재,3848,3981,20200529,7829
20200526,3,홍제,17481,16498,20200529,33979
20200526,3,녹번,13828,12567,20200529,26395
20200526,3,불광,16463,17465,20200529,33928
20200526,3,연신내,38116,35948,20200529,74064
20200526,3,구파발,20889,19364,20200529,40253
20200526,3,지축,3401,3331,20200529,6732
20200526,3,대치,10300,10182,20200529,20482
20200526,3,도곡,5425,5438,20200529,10863
20200526,3,학여울,1728,1768,20200529,3496
20200526,3,오금,6505,5734,20200529,12239
20200526,3,경찰병원,7820,7800,20200529,15620
20200526,3,가락시장,9345,9217,20200529,18562
20200526,3,수서,16030,16140,20200529,32170
20200526,3,일원,9057,8956,20200529,18013
20200526,3,대청,9686,8906,20200529,18592
20200527,3,오금,6445,5793,20200530,12238
20200527,3,경찰병원,7663,7803,20200530,15466
20200527,3,가락시장,9540,9181,20200530,18721
20200527,3,수서,16399,16419,20200530,32818
20200527,3,일원,9163,8922,20200530,18085
20200527,3,대청,9925,8974,20200530,18899
20200527,3,학여울,1780,1743,20200530,3523
20200527,3,대치,10354,10483,20200530,20837
20200527,3,도곡,5291,5418,20200530,10709
20200527,3,매봉,11987,11479,20200530,23466
20200527,3,양재,39443,42871,20200530,82314
20200527,3,남부터미널,28519,29458,20200530,57977
20200527,3,교대,14972,9764,20200530,24736
20200527,3,고속터미널,36878,35361,20200530,72239
20200527,3,잠원,6059,5906,20200530,11965
20200527,3,신사,29694,31525,20200530,61219
20200527,3,압구정,29985,32193,20200530,62178
20200527,3,옥수,9220,9514,20200530,18734
20200527,3,금호,8197,7506,20200530,15703
20200527,3,약수,13259,13129,20200530,26388
20200527,3,동대입구,7456,8037,20200530,15493
20200527,3,충무로,3,0,20200530,3
20200527,3,을지로3가,10967,11648,20200530,22615
20200527,3,종로3가,10381,11876,20200530,22257
20200527,3,안국,20517,21555,20200530,42072
20200527,3,경복궁,19397,19406,20200530,38803
20200527,3,독립문,7373,7787,20200530,15160
20200527,3,무악재,3909,3915,20200530,7824
20200527,3,홍제,17921,16890,20200530,34811
20200527,3,녹번,14276,12611,20200530,26887
20200527,3,불광,16882,18305,20200530,35187
20200527,3,연신내,39198,37000,20200530,76198
20200527,3,구파발,21202,19914,20200530,41116
20200527,3,지축,3571,3482,20200530,7053
20200528,3,오금,6431,5731,20200531,12162
20200528,3,경찰병원,7627,7684,20200531,15311
20200528,3,가락시장,9268,9137,20200531,18405
20200528,3,수서,16577,16627,20200531,33204
20200528,3,일원,9113,8866,20200531,17979
20200528,3,대청,9828,9024,20200531,18852
20200528,3,학여울,1782,1844,20200531,3626
20200528,3,대치,10288,10301,20200531,20589
20200528,3,도곡,5300,5469,20200531,10769
20200528,3,매봉,11646,11165,20200531,22811
20200528,3,양재,39308,43044,20200531,82352
20200528,3,남부터미널,28076,29139,20200531,57215
20200528,3,교대,14701,9767,20200531,24468
20200528,3,고속터미널,36591,35460,20200531,72051
20200528,3,잠원,6006,5747,20200531,11753
20200528,3,신사,29114,31416,20200531,60530
20200528,3,압구정,29654,32329,20200531,61983
20200528,3,옥수,9090,9226,20200531,18316
20200528,3,금호,8193,7417,20200531,15610
20200528,3,약수,13194,12899,20200531,26093
20200528,3,동대입구,6963,7512,20200531,14475
20200528,3,충무로,1,0,20200531,1
20200528,3,을지로3가,10745,11534,20200531,22279
20200528,3,종로3가,9966,11730,20200531,21696
20200528,3,안국,19893,20928,20200531,40821
20200528,3,경복궁,19000,18912,20200531,37912
20200528,3,독립문,7240,7735,20200531,14975
20200528,3,무악재,3975,4013,20200531,7988
20200528,3,홍제,17881,16634,20200531,34515
20200528,3,녹번,13967,12318,20200531,26285
20200528,3,불광,16739,17972,20200531,34711
20200528,3,연신내,38212,36028,20200531,74240
20200528,3,구파발,21064,19794,20200531,40858
20200528,3,지축,3463,3332,20200531,6795
20200529,3,지축,3533,3393,20200601,6926
20200529,3,구파발,21227,19558,20200601,40785
20200529,3,연신내,39323,37122,20200601,76445
20200529,3,불광,16933,17920,20200601,34853
20200529,3,녹번,14137,12227,20200601,26364
20200529,3,홍제,17937,16702,20200601,34639
20200529,3,무악재,3984,3859,20200601,7843
20200529,3,독립문,7473,7600,20200601,15073
20200529,3,경복궁,19496,19196,20200601,38692
20200529,3,안국,20066,20801,20200601,40867
20200529,3,종로3가,9662,11787,20200601,21449
20200529,3,을지로3가,10977,11970,20200601,22947
20200529,3,충무로,4,0,20200601,4
20200529,3,동대입구,7027,7385,20200601,14412
20200529,3,약수,13222,12988,20200601,26210
20200529,3,금호,8287,7428,20200601,15715
20200529,3,옥수,9478,9678,20200601,19156
20200529,3,압구정,31609,34650,20200601,66259
20200529,3,신사,30730,34732,20200601,65462
20200529,3,잠원,6204,5937,20200601,12141
20200529,3,고속터미널,42526,45925,20200601,88451
20200529,3,교대,15001,10018,20200601,25019
20200529,3,남부터미널,30953,31648,20200601,62601
20200529,3,양재,41404,43490,20200601,84894
20200529,3,매봉,11724,11246,20200601,22970
20200529,3,도곡,5624,5502,20200601,11126
20200529,3,대치,10701,10714,20200601,21415
20200529,3,학여울,1825,1779,20200601,3604
20200529,3,대청,10345,9438,20200601,19783
20200529,3,일원,9297,8812,20200601,18109
20200529,3,수서,18126,18560,20200601,36686
20200529,3,가락시장,9555,9531,20200601,19086
20200529,3,경찰병원,7649,7483,20200601,15132
20200529,3,오금,6551,5747,20200601,12298
20200530,3,지축,2153,2030,20200602,4183
20200530,3,구파발,15173,15278,20200602,30451
20200530,3,연신내,29465,27612,20200602,57077
20200530,3,불광,12367,13884,20200602,26251
20200530,3,녹번,8798,7482,20200602,16280
20200530,3,홍제,12726,11591,20200602,24317
20200530,3,무악재,2496,2701,20200602,5197
20200530,3,독립문,5314,5703,20200602,11017
20200530,3,경복궁,11820,12415,20200602,24235
20200530,3,안국,10884,12862,20200602,23746
20200530,3,종로3가,4698,6647,20200602,11345
20200530,3,을지로3가,4301,5233,20200602,9534
20200530,3,동대입구,5231,5722,20200602,10953
20200530,3,약수,8503,7947,20200602,16450
20200530,3,금호,5553,4944,20200602,10497
20200530,3,옥수,6866,6792,20200602,13658
20200530,3,압구정,21865,23435,20200602,45300
20200530,3,신사,22595,24456,20200602,47051
20200530,3,잠원,4092,3896,20200602,7988
20200530,3,고속터미널,42506,43237,20200602,85743
20200530,3,교대,6617,4031,20200602,10648
20200530,3,남부터미널,18401,18590,20200602,36991
20200530,3,양재,20169,21928,20200602,42097
20200530,3,매봉,5095,4768,20200602,9863
20200530,3,도곡,3034,3053,20200602,6087
20200530,3,대치,7620,6915,20200602,14535
20200530,3,학여울,1356,1370,20200602,2726
20200530,3,대청,5426,4907,20200602,10333
20200530,3,일원,4358,4193,20200602,8551
20200530,3,수서,11276,11368,20200602,22644
20200530,3,가락시장,5892,5718,20200602,11610
20200530,3,경찰병원,3569,3395,20200602,6964
20200530,3,오금,3594,3380,20200602,6974
20200531,3,오금,2488,2442,20200603,4930
20200531,3,경찰병원,2407,2557,20200603,4964
20200531,3,가락시장,3403,3587,20200603,6990
20200531,3,수서,8940,8463,20200603,17403
20200531,3,일원,2610,2727,20200603,5337
20200531,3,대청,3451,3310,20200603,6761
20200531,3,학여울,866,1012,20200603,1878
20200531,3,대치,4633,4091,20200603,8724
20200531,3,도곡,1699,1748,20200603,3447
20200531,3,매봉,3297,3199,20200603,6496
20200531,3,양재,11733,13743,20200603,25476
20200531,3,남부터미널,12463,12928,20200603,25391
20200531,3,교대,3811,2496,20200603,6307
20200531,3,고속터미널,34080,31763,20200603,65843
20200531,3,잠원,2486,2584,20200603,5070
20200531,3,신사,12386,12705,20200603,25091
20200531,3,압구정,11586,12314,20200603,23900
20200531,3,옥수,4489,4671,20200603,9160
20200531,3,금호,3743,3694,20200603,7437
20200531,3,약수,5844,5778,20200603,11622
20200531,3,동대입구,3858,4202,20200603,8060
20200531,3,충무로,1,0,20200603,1
20200531,3,을지로3가,2268,2403,20200603,4671
20200531,3,종로3가,2772,3893,20200603,6665
20200531,3,안국,6481,7552,20200603,14033
20200531,3,경복궁,8096,8448,20200603,16544
20200531,3,독립문,3904,4052,20200603,7956
20200531,3,무악재,1632,1738,20200603,3370
20200531,3,홍제,8455,8001,20200603,16456
20200531,3,녹번,5641,5130,20200603,10771
20200531,3,불광,8738,10289,20200603,19027
20200531,3,연신내,20448,19182,20200603,39630
20200531,3,구파발,10421,10875,20200603,21296
20200531,3,지축,1476,1375,20200603,2851
20200101,4,남태령,520,439,20200104,959
20200101,4,사당,13276,11928,20200104,25204
20200101,4,총신대입구,9089,9895,20200104,18984
20200101,4,동작,1407,1537,20200104,2944
20200101,4,이촌,2894,3238,20200104,6132
20200101,4,신용산,7217,7115,20200104,14332
20200101,4,삼각지,1778,2250,20200104,4028
20200101,4,숙대입구,6152,5855,20200104,12007
20200101,4,서울역,6182,14194,20200104,20376
20200101,4,회현,10063,10460,20200104,20523
20200101,4,명동,33575,35869,20200104,69444
20200101,4,충무로,12041,11366,20200104,23407
20200101,4,동대문역사문화공원,15484,11770,20200104,27254
20200101,4,동대문,9042,8577,20200104,17619
20200101,4,혜화,23671,24403,20200104,48074
20200101,4,한성대입구,6777,6979,20200104,13756
20200101,4,성신여대입구,12017,11870,20200104,23887
20200101,4,길음,9673,9730,20200104,19403
20200101,4,미아사거리,14738,14886,20200104,29624
20200101,4,미아,7422,7244,20200104,14666
20200101,4,수유,19290,19269,20200104,38559
20200101,4,쌍문,14507,13636,20200104,28143
20200101,4,창동,13293,14456,20200104,27749
20200101,4,노원,11762,12768,20200104,24530
20200101,4,상계,9156,8876,20200104,18032
20200101,4,당고개,7021,6731,20200104,13752
20200102,4,당고개,13778,12455,20200105,26233
20200102,4,상계,21818,19360,20200105,41178
20200102,4,노원,22559,26162,20200105,48721
20200102,4,창동,29761,31702,20200105,61463
20200102,4,쌍문,34373,30621,20200105,64994
20200102,4,수유,38918,38988,20200105,77906
20200102,4,미아,16959,16133,20200105,33092
20200102,4,미아사거리,32154,31386,20200105,63540
20200102,4,길음,23709,22456,20200105,46165
20200102,4,성신여대입구,23558,23118,20200105,46676
20200102,4,한성대입구,14929,14343,20200105,29272
20200102,4,혜화,39856,40950,20200105,80806
20200102,4,동대문,22215,23361,20200105,45576
20200102,4,동대문역사문화공원,23975,21396,20200105,45371
20200102,4,충무로,33606,34614,20200105,68220
20200102,4,명동,38792,41037,20200105,79829
20200102,4,회현,31605,33801,20200105,65406
20200102,4,서울역,15397,23785,20200105,39182
20200102,4,숙대입구,15912,15695,20200105,31607
20200102,4,삼각지,5193,5993,20200105,11186
20200102,4,신용산,18517,19138,20200105,37655
20200102,4,이촌,9102,9710,20200105,18812
20200102,4,동작,2498,2727,20200105,5225
20200102,4,총신대입구,22393,24693,20200105,47086
20200102,4,사당,28840,24227,20200105,53067
20200102,4,남태령,1599,1459,20200105,3058
20200103,4,당고개,14381,12931,20200106,27312
20200103,4,상계,23204,20692,20200106,43896
20200103,4,노원,24579,28917,20200106,53496
20200103,4,창동,32294,34073,20200106,66367
20200103,4,쌍문,36204,31956,20200106,68160
20200103,4,수유,41737,42277,20200106,84014
20200103,4,미아,18009,16833,20200106,34842
20200103,4,미아사거리,33837,32770,20200106,66607
20200103,4,길음,24881,23212,20200106,48093
20200103,4,성신여대입구,25367,23976,20200106,49343
20200103,4,한성대입구,16011,15247,20200106,31258
20200103,4,혜화,43045,44550,20200106,87595
20200103,4,동대문,24963,25520,20200106,50483
20200103,4,동대문역사문화공원,25665,22877,20200106,48542
20200103,4,충무로,35065,36338,20200106,71403
20200103,4,명동,38821,41290,20200106,80111
20200103,4,회현,33238,35682,20200106,68920
20200103,4,서울역,16192,26730,20200106,42922
20200103,4,숙대입구,16692,16463,20200106,33155
20200103,4,삼각지,5574,6404,20200106,11978
20200103,4,신용산,19970,20416,20200106,40386
20200103,4,이촌,9973,10940,20200106,20913
20200103,4,동작,2553,2769,20200106,5322
20200103,4,총신대입구,24245,26827,20200106,51072
20200103,4,사당,31954,27658,20200106,59612
20200103,4,남태령,1600,1325,20200106,2925
20200104,4,당고개,11392,10334,20200107,21726
20200104,4,상계,16355,14645,20200107,31000
20200104,4,노원,20004,22813,20200107,42817
20200104,4,창동,23759,25242,20200107,49001
20200104,4,쌍문,26287,22732,20200107,49019
20200104,4,수유,31363,30917,20200107,62280
20200104,4,미아,13227,12191,20200107,25418
20200104,4,미아사거리,26645,25841,20200107,52486
20200104,4,길음,17831,16604,20200107,34435
20200104,4,성신여대입구,20116,19323,20200107,39439
20200104,4,한성대입구,12277,11904,20200107,24181
20200104,4,혜화,40828,43048,20200107,83876
20200104,4,동대문,20278,19822,20200107,40100
20200104,4,동대문역사문화공원,19065,15588,20200107,34653
20200104,4,충무로,19734,20002,20200107,39736
20200104,4,명동,34847,38919,20200107,73766
20200104,4,회현,27723,29583,20200107,57306
20200104,4,서울역,8812,20649,20200107,29461
20200104,4,숙대입구,11574,10602,20200107,22176
20200104,4,삼각지,3385,4178,20200107,7563
20200104,4,신용산,11262,11910,20200107,23172
20200104,4,이촌,9168,9456,20200107,18624
20200104,4,동작,2041,2125,20200107,4166
20200104,4,총신대입구,18156,19687,20200107,37843
20200104,4,사당,26114,23011,20200107,49125
20200104,4,남태령,1262,821,20200107,2083
20200105,4,당고개,8785,8233,20200108,17018
20200105,4,상계,12027,11146,20200108,23173
20200105,4,노원,15336,16749,20200108,32085
20200105,4,창동,18530,19591,20200108,38121
20200105,4,쌍문,19943,17532,20200108,37475
20200105,4,수유,23673,22734,20200108,46407
20200105,4,미아,9877,9241,20200108,19118
20200105,4,미아사거리,19755,18792,20200108,38547
20200105,4,길음,12710,12303,20200108,25013
20200105,4,성신여대입구,15162,14275,20200108,29437
20200105,4,한성대입구,9074,9074,20200108,18148
20200105,4,혜화,31384,32505,20200108,63889
20200105,4,동대문,10544,10773,20200108,21317
20200105,4,동대문역사문화공원,14594,13285,20200108,27879
20200105,4,충무로,12119,11865,20200108,23984
20200105,4,명동,28472,31111,20200108,59583
20200105,4,회현,13768,14329,20200108,28097
20200105,4,서울역,6567,15715,20200108,22282
20200105,4,숙대입구,9860,9294,20200108,19154
20200105,4,삼각지,2586,3177,20200108,5763
20200105,4,신용산,8333,8528,20200108,16861
20200105,4,이촌,7493,8084,20200108,15577
20200105,4,동작,1447,1554,20200108,3001
20200105,4,총신대입구,12795,13975,20200108,26770
20200105,4,사당,18298,17166,20200108,35464
20200105,4,남태령,933,686,20200108,1619
20200106,4,당고개,13678,12571,20200109,26249
20200106,4,상계,22402,20282,20200109,42684
20200106,4,노원,23064,25936,20200109,49000
20200106,4,창동,30176,32074,20200109,62250
20200106,4,쌍문,35121,31976,20200109,67097
20200106,4,수유,39932,39941,20200109,79873
20200106,4,미아,17898,16872,20200109,34770
20200106,4,미아사거리,32298,31466,20200109,63764
20200106,4,길음,24139,23337,20200109,47476
20200106,4,성신여대입구,24549,23586,20200109,48135
20200106,4,한성대입구,15278,15039,20200109,30317
20200106,4,혜화,37120,37770,20200109,74890
20200106,4,동대문,25566,26057,20200109,51623
20200106,4,동대문역사문화공원,21685,19612,20200109,41297
20200106,4,충무로,33941,34733,20200109,68674
20200106,4,명동,33877,36301,20200109,70178
20200106,4,회현,32554,34136,20200109,66690
20200106,4,서울역,15150,23530,20200109,38680
20200106,4,숙대입구,16165,16044,20200109,32209
20200106,4,삼각지,5416,6057,20200109,11473
20200106,4,신용산,18916,19583,20200109,38499
20200106,4,이촌,8977,9853,20200109,18830
20200106,4,동작,2318,2475,20200109,4793
20200106,4,총신대입구,23280,25487,20200109,48767
20200106,4,사당,29803,25102,20200109,54905
20200106,4,남태령,1430,1310,20200109,2740
20200107,4,당고개,13294,12017,20200110,25311
20200107,4,상계,21739,19800,20200110,41539
20200107,4,노원,22070,25250,20200110,47320
20200107,4,창동,29476,31530,20200110,61006
20200107,4,쌍문,34149,31436,20200110,65585
20200107,4,수유,38297,38371,20200110,76668
20200107,4,미아,17163,16201,20200110,33364
20200107,4,미아사거리,31503,30535,20200110,62038
20200107,4,길음,23860,22960,20200110,46820
20200107,4,성신여대입구,23683,23010,20200110,46693
20200107,4,한성대입구,15304,14941,20200110,30245
20200107,4,혜화,39359,39992,20200110,79351
20200107,4,동대문,24099,24677,20200110,48776
20200107,4,동대문역사문화공원,21271,19215,20200110,40486
20200107,4,충무로,34211,34466,20200110,68677
20200107,4,명동,31482,33616,20200110,65098
20200107,4,회현,30766,31919,20200110,62685
20200107,4,서울역,15301,23591,20200110,38892
20200107,4,숙대입구,16054,15766,20200110,31820
20200107,4,삼각지,5578,6310,20200110,11888
20200107,4,신용산,18796,19420,20200110,38216
20200107,4,이촌,9507,10282,20200110,19789
20200107,4,동작,2071,2260,20200110,4331
20200107,4,총신대입구,22128,24234,20200110,46362
20200107,4,사당,29655,25244,20200110,54899
20200107,4,남태령,1406,1307,20200110,2713
20200108,4,당고개,14025,12936,20200111,26961
20200108,4,상계,22780,20533,20200111,43313
20200108,4,노원,24089,27093,20200111,51182
20200108,4,창동,31439,33512,20200111,64951
20200108,4,쌍문,35744,32156,20200111,67900
20200108,4,수유,40502,40348,20200111,80850
20200108,4,미아,18237,17309,20200111,35546
20200108,4,미아사거리,33304,32482,20200111,65786
20200108,4,길음,24799,23450,20200111,48249
20200108,4,성신여대입구,24752,23827,20200111,48579
20200108,4,한성대입구,15944,15341,20200111,31285
20200108,4,혜화,42844,43656,20200111,86500
20200108,4,동대문,26142,26713,20200111,52855
20200108,4,동대문역사문화공원,22946,20970,20200111,43916
20200108,4,충무로,34074,35104,20200111,69178
20200108,4,명동,34726,36702,20200111,71428
20200108,4,회현,32252,34245,20200111,66497
20200108,4,서울역,15588,23852,20200111,39440
20200108,4,숙대입구,16291,15953,20200111,32244
20200108,4,삼각지,5657,6313,20200111,11970
20200108,4,신용산,19863,20859,20200111,40722
20200108,4,이촌,9687,10541,20200111,20228
20200108,4,동작,2491,2524,20200111,5015
20200108,4,총신대입구,23714,25879,20200111,49593
20200108,4,사당,31238,26477,20200111,57715
20200108,4,남태령,1508,1442,20200111,2950
20200109,4,당고개,14236,13146,20200112,27382
20200109,4,상계,22743,20691,20200112,43434
20200109,4,노원,23973,27155,20200112,51128
20200109,4,창동,31575,33501,20200112,65076
20200109,4,쌍문,35939,32596,20200112,68535
20200109,4,수유,41075,41161,20200112,82236
20200109,4,미아,18187,17209,20200112,35396
20200109,4,미아사거리,33487,32676,20200112,66163
20200109,4,길음,24938,23760,20200112,48698
20200109,4,성신여대입구,25136,24201,20200112,49337
20200109,4,한성대입구,16114,15662,20200112,31776
20200109,4,혜화,42184,42832,20200112,85016
20200109,4,동대문,26563,26935,20200112,53498
20200109,4,동대문역사문화공원,23143,21124,20200112,44267
20200109,4,충무로,35730,36502,20200112,72232
20200109,4,명동,34426,37557,20200112,71983
20200109,4,회현,33108,35431,20200112,68539
20200109,4,서울역,15727,24805,20200112,40532
20200109,4,숙대입구,16710,16611,20200112,33321
20200109,4,삼각지,5883,6696,20200112,12579
20200109,4,신용산,19778,20686,20200112,40464
20200109,4,이촌,9703,10477,20200112,20180
20200109,4,동작,2519,2635,20200112,5154
20200109,4,총신대입구,23977,26307,20200112,50284
20200109,4,사당,31637,27159,20200112,58796
20200109,4,남태령,1449,1287,20200112,2736
20200110,4,당고개,14701,13251,20200113,27952
20200110,4,상계,23201,20780,20200113,43981
20200110,4,노원,24662,29375,20200113,54037
20200110,4,창동,33318,35203,20200113,68521
20200110,4,쌍문,37117,33018,20200113,70135
20200110,4,수유,42560,42708,20200113,85268
20200110,4,미아,18564,17357,20200113,35921
20200110,4,미아사거리,34470,33656,20200113,68126
20200110,4,길음,25318,23673,20200113,48991
20200110,4,성신여대입구,26244,25238,20200113,51482
20200110,4,한성대입구,16454,15945,20200113,32399
20200110,4,혜화,44977,46300,20200113,91277
20200110,4,동대문,26682,27329,20200113,54011
20200110,4,동대문역사문화공원,23930,21949,20200113,45879
20200110,4,충무로,35878,37292,20200113,73170
20200110,4,명동,35429,38048,20200113,73477
20200110,4,회현,33025,35040,20200113,68065
20200110,4,서울역,16448,27774,20200113,44222
20200110,4,숙대입구,17320,17263,20200113,34583
20200110,4,삼각지,5959,6801,20200113,12760
20200110,4,신용산,21089,21363,20200113,42452
20200110,4,이촌,10465,11321,20200113,21786
20200110,4,동작,2502,2681,20200113,5183
20200110,4,총신대입구,25228,27925,20200113,53153
20200110,4,사당,34479,30333,20200113,64812
20200110,4,남태령,1632,1354,20200113,2986
20200111,4,당고개,11981,10957,20200114,22938
20200111,4,상계,17332,15503,20200114,32835
20200111,4,노원,20764,23571,20200114,44335
20200111,4,창동,25295,26697,20200114,51992
20200111,4,쌍문,27411,24193,20200114,51604
20200111,4,수유,33008,32627,20200114,65635
20200111,4,미아,13832,12655,20200114,26487
20200111,4,미아사거리,28068,27426,20200114,55494
20200111,4,길음,18581,17405,20200114,35986
20200111,4,성신여대입구,21497,20376,20200114,41873
20200111,4,한성대입구,13331,12670,20200114,26001
20200111,4,혜화,46943,49012,20200114,95955
20200111,4,동대문,21998,21125,20200114,43123
20200111,4,동대문역사문화공원,19564,16684,20200114,36248
20200111,4,충무로,20063,21130,20200114,41193
20200111,4,명동,35367,40310,20200114,75677
20200111,4,회현,29587,30962,20200114,60549
20200111,4,서울역,9654,23514,20200114,33168
20200111,4,숙대입구,12128,11442,20200114,23570
20200111,4,삼각지,3444,4693,20200114,8137
20200111,4,신용산,12565,13244,20200114,25809
20200111,4,이촌,9744,10181,20200114,19925
20200111,4,동작,2080,2149,20200114,4229
20200111,4,총신대입구,19227,20711,20200114,39938
20200111,4,사당,29887,26716,20200114,56603
20200111,4,남태령,1437,804,20200114,2241
20200112,4,당고개,9053,8793,20200115,17846
20200112,4,상계,12490,11599,20200115,24089
20200112,4,노원,15495,16642,20200115,32137
20200112,4,창동,18817,19718,20200115,38535
20200112,4,쌍문,20275,18032,20200115,38307
20200112,4,수유,24636,23801,20200115,48437
20200112,4,미아,10270,9309,20200115,19579
20200112,4,미아사거리,20214,19425,20200115,39639
20200112,4,길음,12922,12649,20200115,25571
20200112,4,성신여대입구,16038,15183,20200115,31221
20200112,4,한성대입구,10034,9939,20200115,19973
20200112,4,혜화,34106,34937,20200115,69043
20200112,4,동대문,11756,12059,20200115,23815
20200112,4,동대문역사문화공원,16544,15412,20200115,31956
20200112,4,충무로,13420,12958,20200115,26378
20200112,4,명동,31735,33853,20200115,65588
20200112,4,회현,14333,14558,20200115,28891
20200112,4,서울역,7011,17558,20200115,24569
20200112,4,숙대입구,10140,9625,20200115,19765
20200112,4,삼각지,2598,3430,20200115,6028
20200112,4,신용산,9005,9334,20200115,18339
20200112,4,이촌,7916,8469,20200115,16385
20200112,4,동작,1380,1621,20200115,3001
20200112,4,총신대입구,13248,14319,20200115,27567
20200112,4,사당,19969,18404,20200115,38373
20200112,4,남태령,909,715,20200115,1624
20200113,4,당고개,14174,13001,20200116,27175
20200113,4,상계,22319,20140,20200116,42459
20200113,4,노원,22935,26107,20200116,49042
20200113,4,창동,31117,32965,20200116,64082
20200113,4,쌍문,35029,31873,20200116,66902
20200113,4,수유,39845,39447,20200116,79292
20200113,4,미아,17569,16612,20200116,34181
20200113,4,미아사거리,32532,31639,20200116,64171
20200113,4,길음,24188,23208,20200116,47396
20200113,4,성신여대입구,24531,23363,20200116,47894
20200113,4,한성대입구,15479,15111,20200116,30590
20200113,4,혜화,38901,39339,20200116,78240
20200113,4,동대문,26379,26678,20200116,53057
20200113,4,동대문역사문화공원,22416,20315,20200116,42731
20200113,4,충무로,34680,35566,20200116,70246
20200113,4,명동,36122,37595,20200116,73717
20200113,4,회현,32904,35193,20200116,68097
20200113,4,서울역,15619,24480,20200116,40099
20200113,4,숙대입구,15994,15809,20200116,31803
20200113,4,삼각지,5617,6236,20200116,11853
20200113,4,신용산,18993,19905,20200116,38898
20200113,4,이촌,9182,10157,20200116,19339
20200113,4,동작,2438,2483,20200116,4921
20200113,4,총신대입구,23402,25740,20200116,49142
20200113,4,사당,30534,25931,20200116,56465
20200113,4,남태령,1411,1222,20200116,2633
20200114,4,남태령,1397,1276,20200117,2673
20200114,4,사당,31213,26314,20200117,57527
20200114,4,총신대입구,23703,26096,20200117,49799
20200114,4,동작,2447,2563,20200117,5010
20200114,4,이촌,9756,10671,20200117,20427
20200114,4,신용산,19062,19688,20200117,38750
20200114,4,삼각지,5678,6419,20200117,12097
20200114,4,숙대입구,16554,16164,20200117,32718
20200114,4,서울역,15793,24716,20200117,40509
20200114,4,회현,33162,35367,20200117,68529
20200114,4,명동,35014,37067,20200117,72081
20200114,4,충무로,35168,35745,20200117,70913
20200114,4,동대문역사문화공원,23147,20790,20200117,43937
20200114,4,동대문,26759,27335,20200117,54094
20200114,4,혜화,41976,42540,20200117,84516
20200114,4,한성대입구,16788,16165,20200117,32953
20200114,4,성신여대입구,24923,23864,20200117,48787
20200114,4,길음,24701,23292,20200117,47993
20200114,4,미아사거리,33014,32209,20200117,65223
20200114,4,미아,17701,16952,20200117,34653
20200114,4,수유,40432,40398,20200117,80830
20200114,4,쌍문,35545,32342,20200117,67887
20200114,4,창동,31759,33901,20200117,65660
20200114,4,노원,23588,26892,20200117,50480
20200114,4,상계,22472,20299,20200117,42771
20200114,4,당고개,14205,12998,20200117,27203
20200115,4,당고개,14252,13084,20200118,27336
20200115,4,상계,22597,20311,20200118,42908
20200115,4,노원,23911,27189,20200118,51100
20200115,4,창동,32176,34140,20200118,66316
20200115,4,쌍문,35790,32661,20200118,68451
20200115,4,수유,40640,40374,20200118,81014
20200115,4,미아,17890,17207,20200118,35097
20200115,4,미아사거리,33177,32340,20200118,65517
20200115,4,길음,24681,23720,20200118,48401
20200115,4,성신여대입구,24912,23933,20200118,48845
20200115,4,한성대입구,15874,15270,20200118,31144
20200115,4,혜화,44185,45029,20200118,89214
20200115,4,동대문,26655,27025,20200118,53680
20200115,4,동대문역사문화공원,23187,20829,20200118,44016
20200115,4,충무로,34776,35585,20200118,70361
20200115,4,명동,34863,37378,20200118,72241
20200115,4,회현,32596,34583,20200118,67179
20200115,4,서울역,15920,24816,20200118,40736
20200115,4,숙대입구,16017,15724,20200118,31741
20200115,4,삼각지,5804,6591,20200118,12395
20200115,4,신용산,19364,20277,20200118,39641
20200115,4,이촌,10048,10767,20200118,20815
20200115,4,동작,2466,2489,20200118,4955
20200115,4,총신대입구,24267,26505,20200118,50772
20200115,4,사당,31699,27006,20200118,58705
20200115,4,남태령,1425,1249,20200118,2674
20200116,4,남태령,1528,1350,20200119,2878
20200116,4,사당,31947,27396,20200119,59343
20200116,4,총신대입구,24210,26406,20200119,50616
20200116,4,동작,2540,2635,20200119,5175
20200116,4,이촌,9770,10773,20200119,20543
20200116,4,신용산,19783,20299,20200119,40082
20200116,4,삼각지,5944,6877,20200119,12821
20200116,4,숙대입구,16222,16029,20200119,32251
20200116,4,서울역,16014,25657,20200119,41671
20200116,4,회현,32538,34803,20200119,67341
20200116,4,명동,36203,38533,20200119,74736
20200116,4,충무로,36019,36851,20200119,72870
20200116,4,동대문역사문화공원,23357,21137,20200119,44494
20200116,4,동대문,26424,26978,20200119,53402
20200116,4,혜화,43485,44155,20200119,87640
20200116,4,한성대입구,16068,15574,20200119,31642
20200116,4,성신여대입구,24926,23971,20200119,48897
20200116,4,길음,24680,23360,20200119,48040
20200116,4,미아사거리,33229,32483,20200119,65712
20200116,4,미아,17883,17027,20200119,34910
20200116,4,수유,40801,40623,20200119,81424
20200116,4,쌍문,35804,32516,20200119,68320
20200116,4,창동,31985,34035,20200119,66020
20200116,4,노원,23489,26600,20200119,50089
20200116,4,상계,22646,20300,20200119,42946
20200116,4,당고개,14276,13140,20200119,27416
20200117,4,당고개,14560,13287,20200120,27847
20200117,4,상계,23352,20908,20200120,44260
20200117,4,노원,24806,29000,20200120,53806
20200117,4,창동,33668,35832,20200120,69500
20200117,4,쌍문,37040,32750,20200120,69790
20200117,4,수유,42526,42642,20200120,85168
20200117,4,미아,18207,16943,20200120,35150
20200117,4,미아사거리,34223,33784,20200120,68007
20200117,4,길음,25119,23471,20200120,48590
20200117,4,성신여대입구,25763,24742,20200120,50505
20200117,4,한성대입구,16850,15938,20200120,32788
20200117,4,혜화,45536,46882,20200120,92418
20200117,4,동대문,26832,27790,20200120,54622
20200117,4,동대문역사문화공원,23919,22167,20200120,46086
20200117,4,충무로,35487,37221,20200120,72708
20200117,4,명동,37205,39767,20200120,76972
20200117,4,회현,33689,35704,20200120,69393
20200117,4,서울역,16687,28811,20200120,45498
20200117,4,숙대입구,16668,16482,20200120,33150
20200117,4,삼각지,6230,7247,20200120,13477
20200117,4,신용산,20631,21105,20200120,41736
20200117,4,이촌,10289,11181,20200120,21470
20200117,4,동작,2525,2713,20200120,5238
20200117,4,총신대입구,25318,27985,20200120,53303
20200117,4,사당,34600,30022,20200120,64622
20200117,4,남태령,1622,1277,20200120,2899
20200118,4,당고개,12005,11034,20200121,23039
20200118,4,상계,17222,15662,20200121,32884
20200118,4,노원,20524,23523,20200121,44047
20200118,4,창동,25714,27164,20200121,52878
20200118,4,쌍문,27295,23578,20200121,50873
20200118,4,수유,32574,32322,20200121,64896
20200118,4,미아,13648,12798,20200121,26446
20200118,4,미아사거리,27823,26757,20200121,54580
20200118,4,길음,18433,17444,20200121,35877
20200118,4,성신여대입구,21419,20058,20200121,41477
20200118,4,한성대입구,12757,12321,20200121,25078
20200118,4,혜화,45247,47452,20200121,92699
20200118,4,동대문,22397,21224,20200121,43621
20200118,4,동대문역사문화공원,19932,16787,20200121,36719
20200118,4,충무로,19728,20389,20200121,40117
20200118,4,명동,35140,39482,20200121,74622
20200118,4,회현,28456,30020,20200121,58476
20200118,4,서울역,9200,22453,20200121,31653
20200118,4,숙대입구,11842,11560,20200121,23402
20200118,4,삼각지,3547,4686,20200121,8233
20200118,4,신용산,12143,12940,20200121,25083
20200118,4,이촌,10014,10611,20200121,20625
20200118,4,동작,2077,2156,20200121,4233
20200118,4,총신대입구,19436,20940,20200121,40376
20200118,4,사당,28774,25829,20200121,54603
20200118,4,남태령,1396,870,20200121,2266
20200119,4,당고개,8878,8608,20200122,17486
20200119,4,상계,12214,11292,20200122,23506
20200119,4,노원,15451,16756,20200122,32207
20200119,4,창동,19230,20454,20200122,39684
20200119,4,쌍문,20094,17873,20200122,37967
20200119,4,수유,24392,23016,20200122,47408
20200119,4,미아,10582,9885,20200122,20467
20200119,4,미아사거리,20276,18943,20200122,39219
20200119,4,길음,13001,12478,20200122,25479
20200119,4,성신여대입구,15602,14707,20200122,30309
20200119,4,한성대입구,9633,9367,20200122,19000
20200119,4,혜화,32709,33909,20200122,66618
20200119,4,동대문,10512,10992,20200122,21504
20200119,4,동대문역사문화공원,15268,13502,20200122,28770
20200119,4,충무로,12130,11742,20200122,23872
20200119,4,명동,29043,31026,20200122,60069
20200119,4,회현,13362,13801,20200122,27163
20200119,4,서울역,6829,17376,20200122,24205
20200119,4,숙대입구,10216,9464,20200122,19680
20200119,4,삼각지,2640,3300,20200122,5940
20200119,4,신용산,8826,9489,20200122,18315
20200119,4,이촌,8340,8699,20200122,17039
20200119,4,동작,1358,1560,20200122,2918
20200119,4,총신대입구,13073,14326,20200122,27399
20200119,4,사당,19293,18036,20200122,37329
20200119,4,남태령,892,623,20200122,1515
20200120,4,남태령,1397,1237,20200123,2634
20200120,4,사당,30663,25934,20200123,56597
20200120,4,총신대입구,24149,26623,20200123,50772
20200120,4,동작,2522,2586,20200123,5108
20200120,4,이촌,9165,10207,20200123,19372
20200120,4,신용산,18735,19766,20200123,38501
20200120,4,삼각지,5573,6162,20200123,11735
20200120,4,숙대입구,16025,15659,20200123,31684
20200120,4,서울역,16059,25027,20200123,41086
20200120,4,회현,32312,34198,20200123,66510
20200120,4,명동,35464,37391,20200123,72855
20200120,4,충무로,34291,35291,20200123,69582
20200120,4,동대문역사문화공원,21622,19779,20200123,41401
20200120,4,동대문,26505,27022,20200123,53527
20200120,4,혜화,39740,39830,20200123,79570
20200120,4,한성대입구,15724,15160,20200123,30884
20200120,4,성신여대입구,24500,23662,20200123,48162
20200120,4,길음,24444,23097,20200123,47541
20200120,4,미아사거리,33027,32300,20200123,65327
20200120,4,미아,17926,16751,20200123,34677
20200120,4,수유,40804,40760,20200123,81564
20200120,4,쌍문,35724,32369,20200123,68093
20200120,4,창동,32275,34253,20200123,66528
20200120,4,노원,23826,26732,20200123,50558
20200120,4,상계,22860,20347,20200123,43207
20200120,4,당고개,14097,12961,20200123,27058
20200121,4,당고개,14178,13045,20200124,27223
20200121,4,상계,22640,20335,20200124,42975
20200121,4,노원,23738,26817,20200124,50555
20200121,4,창동,32032,34370,20200124,66402
20200121,4,쌍문,35745,32351,20200124,68096
20200121,4,수유,40714,40484,20200124,81198
20200121,4,미아,17821,16962,20200124,34783
20200121,4,미아사거리,33227,32318,20200124,65545
20200121,4,길음,24740,23319,20200124,48059
20200121,4,성신여대입구,24802,23640,20200124,48442
20200121,4,한성대입구,15767,15174,20200124,30941
20200121,4,혜화,41835,42089,20200124,83924
20200121,4,동대문,25484,25994,20200124,51478
20200121,4,동대문역사문화공원,21865,19545,20200124,41410
20200121,4,충무로,34027,34946,20200124,68973
20200121,4,명동,34040,35953,20200124,69993
20200121,4,회현,31547,33702,20200124,65249
20200121,4,서울역,15923,25945,20200124,41868
20200121,4,숙대입구,15877,15694,20200124,31571
20200121,4,삼각지,5771,6468,20200124,12239
20200121,4,신용산,19007,20096,20200124,39103
20200121,4,이촌,9744,10726,20200124,20470
20200121,4,동작,2587,2648,20200124,5235
20200121,4,총신대입구,24039,26322,20200124,50361
20200121,4,사당,31195,26371,20200124,57566
20200121,4,남태령,1498,1213,20200124,2711
20200122,4,당고개,14332,12971,20200125,27303
20200122,4,상계,22662,20163,20200125,42825
20200122,4,노원,23935,27468,20200125,51403
20200122,4,창동,32361,34653,20200125,67014
20200122,4,쌍문,35868,32057,20200125,67925
20200122,4,수유,41069,40795,20200125,81864
20200122,4,미아,18002,17004,20200125,35006
20200122,4,미아사거리,33719,32646,20200125,66365
20200122,4,길음,24756,23120,20200125,47876
20200122,4,성신여대입구,25390,23748,20200125,49138
20200122,4,한성대입구,15983,14996,20200125,30979
20200122,4,혜화,42832,43137,20200125,85969
20200122,4,동대문,24875,24878,20200125,49753
20200122,4,동대문역사문화공원,21724,19445,20200125,41169
20200122,4,충무로,33649,34378,20200125,68027
20200122,4,명동,32120,33801,20200125,65921
20200122,4,회현,30459,32526,20200125,62985
20200122,4,서울역,15589,26257,20200125,41846
20200122,4,숙대입구,15833,15650,20200125,31483
20200122,4,삼각지,5699,6401,20200125,12100
20200122,4,신용산,19375,20944,20200125,40319
20200122,4,이촌,9658,10586,20200125,20244
20200122,4,동작,2573,2704,20200125,5277
20200122,4,총신대입구,24883,27122,20200125,52005
20200122,4,사당,31197,25650,20200125,56847
20200122,4,남태령,1481,1193,20200125,2674
20200123,4,당고개,13670,12526,20200126,26196
20200123,4,상계,21850,19424,20200126,41274
20200123,4,노원,23468,27510,20200126,50978
20200123,4,창동,31274,33739,20200126,65013
20200123,4,쌍문,33802,29901,20200126,63703
20200123,4,수유,40092,39700,20200126,79792
20200123,4,미아,17553,16221,20200126,33774
20200123,4,미아사거리,32992,31830,20200126,64822
20200123,4,길음,23690,21480,20200126,45170
20200123,4,성신여대입구,24415,22738,20200126,47153
20200123,4,한성대입구,14945,13293,20200126,28238
20200123,4,혜화,39363,38739,20200126,78102
20200123,4,동대문,20418,20704,20200126,41122
20200123,4,동대문역사문화공원,19958,17824,20200126,37782
20200123,4,충무로,30053,30593,20200126,60646
20200123,4,명동,30844,33340,20200126,64184
20200123,4,회현,28388,30115,20200126,58503
20200123,4,서울역,14215,26133,20200126,40348
20200123,4,숙대입구,14717,14045,20200126,28762
20200123,4,삼각지,5194,5732,20200126,10926
20200123,4,신용산,17513,20145,20200126,37658
20200123,4,이촌,8668,9566,20200126,18234
20200123,4,동작,2559,2566,20200126,5125
20200123,4,총신대입구,23421,25401,20200126,48822
20200123,4,사당,29446,23587,20200126,53033
20200123,4,남태령,1297,1079,20200126,2376
20200124,4,남태령,663,474,20200127,1137
20200124,4,사당,12699,10141,20200127,22840
20200124,4,총신대입구,10158,10191,20200127,20349
20200124,4,동작,1243,1252,20200127,2495
20200124,4,이촌,4624,4749,20200127,9373
20200124,4,신용산,6021,8483,20200127,14504
20200124,4,삼각지,1457,1801,20200127,3258
20200124,4,숙대입구,5543,4637,20200127,10180
20200124,4,서울역,5099,15526,20200127,20625
20200124,4,회현,10728,11474,20200127,22202
20200124,4,명동,23974,26759,20200127,50733
20200124,4,충무로,9146,8630,20200127,17776
20200124,4,동대문역사문화공원,10728,9663,20200127,20391
20200124,4,동대문,6803,6450,20200127,13253
20200124,4,혜화,18928,18472,20200127,37400
20200124,4,한성대입구,6826,5828,20200127,12654
20200124,4,성신여대입구,11365,9586,20200127,20951
20200124,4,길음,9719,8677,20200127,18396
20200124,4,미아사거리,15512,14640,20200127,30152
20200124,4,미아,8041,7094,20200127,15135
20200124,4,수유,19300,17929,20200127,37229
20200124,4,쌍문,14918,13351,20200127,28269
20200124,4,창동,13870,14821,20200127,28691
20200124,4,노원,11018,11897,20200127,22915
20200124,4,상계,9693,8763,20200127,18456
20200124,4,당고개,6635,6664,20200127,13299
20200125,4,당고개,7023,6421,20200128,13444
20200125,4,상계,9592,8812,20200128,18404
20200125,4,노원,9012,10663,20200128,19675
20200125,4,창동,11769,12235,20200128,24004
20200125,4,쌍문,14947,13498,20200128,28445
20200125,4,수유,18083,18411,20200128,36494
20200125,4,미아,7828,7232,20200128,15060
20200125,4,미아사거리,14079,13547,20200128,27626
20200125,4,길음,9337,9013,20200128,18350
20200125,4,성신여대입구,8867,8767,20200128,17634
20200125,4,한성대입구,5999,5974,20200128,11973
20200125,4,혜화,13823,14933,20200128,28756
20200125,4,동대문,5486,4967,20200128,10453
20200125,4,동대문역사문화공원,9952,8864,20200128,18816
20200125,4,충무로,10186,10392,20200128,20578
20200125,4,명동,26850,29499,20200128,56349
20200125,4,회현,5795,6002,20200128,11797
20200125,4,서울역,5026,13578,20200128,18604
20200125,4,숙대입구,4200,4152,20200128,8352
20200125,4,삼각지,1179,1705,20200128,2884
20200125,4,신용산,6251,5877,20200128,12128
20200125,4,이촌,2399,2613,20200128,5012
20200125,4,동작,1356,1521,20200128,2877
20200125,4,총신대입구,6703,7692,20200128,14395
20200125,4,사당,10484,8774,20200128,19258
20200125,4,남태령,679,457,20200128,1136
20200126,4,당고개,7767,7220,20200129,14987
20200126,4,상계,10589,9945,20200129,20534
20200126,4,노원,13439,15757,20200129,29196
20200126,4,창동,14526,15391,20200129,29917
20200126,4,쌍문,17546,15492,20200129,33038
20200126,4,수유,21330,21782,20200129,43112
20200126,4,미아,8575,8025,20200129,16600
20200126,4,미아사거리,17298,17003,20200129,34301
20200126,4,길음,10363,10379,20200129,20742
20200126,4,성신여대입구,11888,12414,20200129,24302
20200126,4,한성대입구,7248,7323,20200129,14571
20200126,4,혜화,24647,27035,20200129,51682
20200126,4,동대문,9308,8483,20200129,17791
20200126,4,동대문역사문화공원,14140,11916,20200129,26056
20200126,4,충무로,12095,12812,20200129,24907
20200126,4,명동,29940,31977,20200129,61917
20200126,4,회현,8376,8710,20200129,17086
20200126,4,서울역,5701,12704,20200129,18405
20200126,4,숙대입구,6861,6791,20200129,13652
20200126,4,삼각지,1728,2233,20200129,3961
20200126,4,신용산,8138,6805,20200129,14943
20200126,4,이촌,6351,6689,20200129,13040
20200126,4,동작,1515,1618,20200129,3133
20200126,4,총신대입구,9672,11161,20200129,20833
20200126,4,사당,14120,12840,20200129,26960
20200126,4,남태령,647,460,20200129,1107
20200127,4,당고개,7811,7269,20200130,15080
20200127,4,상계,10671,9755,20200130,20426
20200127,4,노원,13729,15483,20200130,29212
20200127,4,창동,15016,15798,20200130,30814
20200127,4,쌍문,17127,15349,20200130,32476
20200127,4,수유,21427,21639,20200130,43066
20200127,4,미아,8251,7912,20200130,16163
20200127,4,미아사거리,18036,17366,20200130,35402
20200127,4,길음,10778,10636,20200130,21414
20200127,4,성신여대입구,13362,14218,20200130,27580
20200127,4,한성대입구,7504,7928,20200130,15432
20200127,4,혜화,22965,24722,20200130,47687
20200127,4,동대문,7613,7417,20200130,15030
20200127,4,동대문역사문화공원,12294,10126,20200130,22420
20200127,4,충무로,10915,11471,20200130,22386
20200127,4,명동,23179,24879,20200130,48058
20200127,4,회현,11430,11910,20200130,23340
20200127,4,서울역,5213,12680,20200130,17893
20200127,4,숙대입구,6081,6174,20200130,12255
20200127,4,삼각지,1654,2226,20200130,3880
20200127,4,신용산,8728,7790,20200130,16518
20200127,4,이촌,5625,5980,20200130,11605
20200127,4,동작,1347,1432,20200130,2779
20200127,4,총신대입구,10678,11905,20200130,22583
20200127,4,사당,14622,13866,20200130,28488
20200127,4,남태령,635,630,20200130,1265
20200128,4,당고개,13273,12167,20200131,25440
20200128,4,상계,20861,18904,20200131,39765
20200128,4,노원,21983,25019,20200131,47002
20200128,4,창동,28506,30283,20200131,58789
20200128,4,쌍문,32936,30154,20200131,63090
20200128,4,수유,37738,37938,20200131,75676
20200128,4,미아,16409,15628,20200131,32037
20200128,4,미아사거리,30285,29603,20200131,59888
20200128,4,길음,21758,20736,20200131,42494
20200128,4,성신여대입구,22490,22418,20200131,44908
20200128,4,한성대입구,14078,13952,20200131,28030
20200128,4,혜화,33932,35334,20200131,69266
20200128,4,동대문,19318,21167,20200131,40485
20200128,4,동대문역사문화공원,19113,17586,20200131,36699
20200128,4,충무로,30468,31554,20200131,62022
20200128,4,명동,29329,31266,20200131,60595
20200128,4,회현,25345,27210,20200131,52555
20200128,4,서울역,13636,20132,20200131,33768
20200128,4,숙대입구,13977,13961,20200131,27938
20200128,4,삼각지,5180,5704,20200131,10884
20200128,4,신용산,17642,17637,20200131,35279
20200128,4,이촌,7834,8671,20200131,16505
20200128,4,동작,2284,2443,20200131,4727
20200128,4,총신대입구,20677,22759,20200131,43436
20200128,4,사당,26449,22885,20200131,49334
20200128,4,남태령,1209,1137,20200131,2346
20200129,4,당고개,13751,12714,20200201,26465
20200129,4,상계,21759,19701,20200201,41460
20200129,4,노원,23368,26460,20200201,49828
20200129,4,창동,29546,31292,20200201,60838
20200129,4,쌍문,34499,31405,20200201,65904
20200129,4,수유,38979,38730,20200201,77709
20200129,4,미아,17121,16343,20200201,33464
20200129,4,미아사거리,32022,31219,20200201,63241
20200129,4,길음,22957,21882,20200201,44839
20200129,4,성신여대입구,23221,22450,20200201,45671
20200129,4,한성대입구,14756,14330,20200201,29086
20200129,4,혜화,38807,40090,20200201,78897
20200129,4,동대문,23467,24117,20200201,47584
20200129,4,동대문역사문화공원,20462,18725,20200201,39187
20200129,4,충무로,32857,33575,20200201,66432
20200129,4,명동,29851,32380,20200201,62231
20200129,4,회현,28552,30593,20200201,59145
20200129,4,서울역,14845,22003,20200201,36848
20200129,4,숙대입구,14943,14865,20200201,29808
20200129,4,삼각지,5491,6025,20200201,11516
20200129,4,신용산,18142,18586,20200201,36728
20200129,4,이촌,8569,9293,20200201,17862
20200129,4,동작,2442,2551,20200201,4993
20200129,4,총신대입구,22205,24495,20200201,46700
20200129,4,사당,28533,24373,20200201,52906
20200129,4,남태령,1269,1129,20200201,2398
20200130,4,남태령,1432,1252,20200202,2684
20200130,4,사당,29073,25015,20200202,54088
20200130,4,총신대입구,22308,24260,20200202,46568
20200130,4,동작,2544,2673,20200202,5217
20200130,4,이촌,8168,9021,20200202,17189
20200130,4,신용산,18203,18516,20200202,36719
20200130,4,삼각지,5387,6024,20200202,11411
20200130,4,숙대입구,15140,15088,20200202,30228
20200130,4,서울역,15046,22438,20200202,37484
20200130,4,회현,28321,30514,20200202,58835
20200130,4,명동,30381,32556,20200202,62937
20200130,4,충무로,32910,33637,20200202,66547
20200130,4,동대문역사문화공원,20464,18782,20200202,39246
20200130,4,동대문,23261,23964,20200202,47225
20200130,4,혜화,37439,38669,20200202,76108
20200130,4,한성대입구,14928,14318,20200202,29246
20200130,4,성신여대입구,23386,22474,20200202,45860
20200130,4,길음,23237,22161,20200202,45398
20200130,4,미아사거리,31650,30613,20200202,62263
20200130,4,미아,17284,16362,20200202,33646
20200130,4,수유,39108,38863,20200202,77971
20200130,4,쌍문,34260,31181,20200202,65441
20200130,4,창동,29969,31886,20200202,61855
20200130,4,노원,22787,25895,20200202,48682
20200130,4,상계,21824,19809,20200202,41633
20200130,4,당고개,13538,12764,20200202,26302
20200131,4,당고개,14020,12752,20200203,26772
20200131,4,상계,21929,19659,20200203,41588
20200131,4,노원,23503,27334,20200203,50837
20200131,4,창동,30577,32627,20200203,63204
20200131,4,쌍문,34562,30725,20200203,65287
20200131,4,수유,39730,40108,20200203,79838
20200131,4,미아,17375,16113,20200203,33488
20200131,4,미아사거리,32130,31183,20200203,63313
20200131,4,길음,22881,21504,20200203,44385
20200131,4,성신여대입구,21456,19909,20200203,41365
20200131,4,한성대입구,15000,14356,20200203,29356
20200131,4,혜화,37269,38339,20200203,75608
20200131,4,동대문,22700,23455,20200203,46155
20200131,4,동대문역사문화공원,20307,18994,20200203,39301
20200131,4,충무로,32248,33438,20200203,65686
20200131,4,명동,29907,31808,20200203,61715
20200131,4,회현,27999,30028,20200203,58027
20200131,4,서울역,15247,23993,20200203,39240
20200131,4,숙대입구,15744,15822,20200203,31566
20200131,4,삼각지,5653,6347,20200203,12000
20200131,4,신용산,18960,19234,20200203,38194
20200131,4,이촌,8292,9141,20200203,17433
20200131,4,동작,2432,2549,20200203,4981
20200131,4,총신대입구,23168,25611,20200203,48779
20200131,4,사당,30309,26176,20200203,56485
20200131,4,남태령,1401,1172,20200203,2573
20200201,4,당고개,10082,9645,20200204,19727
20200201,4,상계,14089,12805,20200204,26894
20200201,4,노원,17258,19827,20200204,37085
20200201,4,창동,20678,21743,20200204,42421
20200201,4,쌍문,22511,20009,20200204,42520
20200201,4,수유,27332,27388,20200204,54720
20200201,4,미아,11462,10611,20200204,22073
20200201,4,미아사거리,22406,21780,20200204,44186
20200201,4,길음,13891,13229,20200204,27120
20200201,4,성신여대입구,14830,13564,20200204,28394
20200201,4,한성대입구,10537,10222,20200204,20759
20200201,4,혜화,28461,30515,20200204,58976
20200201,4,동대문,15228,14451,20200204,29679
20200201,4,동대문역사문화공원,14717,12276,20200204,26993
20200201,4,충무로,15711,15867,20200204,31578
20200201,4,명동,22305,24086,20200204,46391
20200201,4,회현,18781,19677,20200204,38458
20200201,4,서울역,6792,15379,20200204,22171
20200201,4,숙대입구,9739,9468,20200204,19207
20200201,4,삼각지,2681,3318,20200204,5999
20200201,4,신용산,9204,9646,20200204,18850
20200201,4,이촌,6097,6586,20200204,12683
20200201,4,동작,1555,1593,20200204,3148
20200201,4,총신대입구,15650,16917,20200204,32567
20200201,4,사당,21990,20185,20200204,42175
20200201,4,남태령,1079,693,20200204,1772
20200202,4,당고개,7596,7379,20200205,14975
20200202,4,상계,10287,9475,20200205,19762
20200202,4,노원,13311,14414,20200205,27725
20200202,4,창동,15585,16485,20200205,32070
20200202,4,쌍문,16711,14753,20200205,31464
20200202,4,수유,20657,19612,20200205,40269
20200202,4,미아,8450,7895,20200205,16345
20200202,4,미아사거리,16274,15563,20200205,31837
20200202,4,길음,9854,9773,20200205,19627
20200202,4,성신여대입구,10842,10196,20200205,21038
20200202,4,한성대입구,7558,7468,20200205,15026
20200202,4,혜화,21840,22903,20200205,44743
20200202,4,동대문,7384,7964,20200205,15348
20200202,4,동대문역사문화공원,10608,10273,20200205,20881
20200202,4,충무로,9545,9196,20200205,18741
20200202,4,명동,19482,20612,20200205,40094
20200202,4,회현,9178,9510,20200205,18688
20200202,4,서울역,5374,12014,20200205,17388
20200202,4,숙대입구,8506,8158,20200205,16664
20200202,4,삼각지,2179,2680,20200205,4859
20200202,4,신용산,6553,6857,20200205,13410
20200202,4,이촌,4671,5149,20200205,9820
20200202,4,동작,1142,1310,20200205,2452
20200202,4,총신대입구,10712,11519,20200205,22231
20200202,4,사당,15153,14389,20200205,29542
20200202,4,남태령,750,562,20200205,1312
20200203,4,당고개,12929,11897,20200206,24826
20200203,4,상계,20584,18602,20200206,39186
20200203,4,노원,21457,24101,20200206,45558
20200203,4,창동,27866,29871,20200206,57737
20200203,4,쌍문,32352,29391,20200206,61743
20200203,4,수유,37121,37169,20200206,74290
20200203,4,미아,16719,15762,20200206,32481
20200203,4,미아사거리,29698,28718,20200206,58416
20200203,4,길음,21171,20442,20200206,41613
20200203,4,성신여대입구,19851,18740,20200206,38591
20200203,4,한성대입구,13827,13286,20200206,27113
20200203,4,혜화,30937,31479,20200206,62416
20200203,4,동대문,21364,21941,20200206,43305
20200203,4,동대문역사문화공원,18749,17116,20200206,35865
20200203,4,충무로,30874,31609,20200206,62483
20200203,4,명동,28718,30673,20200206,59391
20200203,4,회현,26047,27999,20200206,54046
20200203,4,서울역,13848,19749,20200206,33597
20200203,4,숙대입구,14536,14228,20200206,28764
20200203,4,삼각지,5036,5426,20200206,10462
20200203,4,신용산,17051,17690,20200206,34741
20200203,4,이촌,7342,8269,20200206,15611
20200203,4,동작,2140,2277,20200206,4417
20200203,4,총신대입구,21189,22988,20200206,44177
20200203,4,사당,26435,21951,20200206,48386
20200203,4,남태령,1282,1103,20200206,2385
20200204,4,당고개,13555,12593,20200207,26148
20200204,4,상계,20804,19086,20200207,39890
20200204,4,노원,21542,24060,20200207,45602
20200204,4,창동,28051,30264,20200207,58315
20200204,4,쌍문,32713,30157,20200207,62870
20200204,4,수유,37407,37422,20200207,74829
20200204,4,미아,16294,15580,20200207,31874
20200204,4,미아사거리,30140,29274,20200207,59414
20200204,4,길음,21924,21304,20200207,43228
20200204,4,성신여대입구,20426,19466,20200207,39892
20200204,4,한성대입구,14584,14264,20200207,28848
20200204,4,혜화,33199,33740,20200207,66939
20200204,4,동대문,21389,21983,20200207,43372
20200204,4,동대문역사문화공원,18958,17412,20200207,36370
20200204,4,충무로,31340,31934,20200207,63274
20200204,4,명동,28735,30304,20200207,59039
20200204,4,회현,26154,27622,20200207,53776
20200204,4,서울역,14109,19807,20200207,33916
20200204,4,숙대입구,14800,14585,20200207,29385
20200204,4,삼각지,5257,5648,20200207,10905
20200204,4,신용산,16801,17468,20200207,34269
20200204,4,이촌,7547,8488,20200207,16035
20200204,4,동작,2100,2206,20200207,4306
20200204,4,총신대입구,21077,22998,20200207,44075
20200204,4,사당,27069,22782,20200207,49851
20200204,4,남태령,1327,1154,20200207,2481
20200205,4,당고개,12429,11517,20200208,23946
20200205,4,상계,20143,18392,20200208,38535
20200205,4,노원,21127,23999,20200208,45126
20200205,4,창동,26773,28550,20200208,55323
20200205,4,쌍문,31844,29208,20200208,61052
20200205,4,수유,36354,36493,20200208,72847
20200205,4,미아,15963,15037,20200208,31000
20200205,4,미아사거리,29783,28836,20200208,58619
20200205,4,길음,21278,20716,20200208,41994
20200205,4,성신여대입구,19920,18973,20200208,38893
20200205,4,한성대입구,13729,13181,20200208,26910
20200205,4,혜화,33890,34085,20200208,67975
20200205,4,동대문,20481,21317,20200208,41798
20200205,4,동대문역사문화공원,18559,17121,20200208,35680
20200205,4,충무로,30781,31323,20200208,62104
20200205,4,명동,28101,29145,20200208,57246
20200205,4,회현,25097,26655,20200208,51752
20200205,4,서울역,13663,19231,20200208,32894
20200205,4,숙대입구,14426,14353,20200208,28779
20200205,4,삼각지,5038,5560,20200208,10598
20200205,4,신용산,16858,17490,20200208,34348
20200205,4,이촌,7310,8312,20200208,15622
20200205,4,동작,1978,2108,20200208,4086
20200205,4,총신대입구,20798,22641,20200208,43439
20200205,4,사당,26536,22294,20200208,48830
20200205,4,남태령,1178,1042,20200208,2220
20200206,4,당고개,12198,11363,20200209,23561
20200206,4,상계,19771,17824,20200209,37595
20200206,4,노원,20960,23705,20200209,44665
20200206,4,창동,26935,28751,20200209,55686
20200206,4,쌍문,31753,28834,20200209,60587
20200206,4,수유,35930,36017,20200209,71947
20200206,4,미아,15910,14905,20200209,30815
20200206,4,미아사거리,28986,28079,20200209,57065
20200206,4,길음,20997,20206,20200209,41203
20200206,4,성신여대입구,19813,18678,20200209,38491
20200206,4,한성대입구,13676,13215,20200209,26891
20200206,4,혜화,32740,33359,20200209,66099
20200206,4,동대문,20213,21122,20200209,41335
20200206,4,동대문역사문화공원,18411,16897,20200209,35308
20200206,4,충무로,30231,31019,20200209,61250
20200206,4,명동,26931,28801,20200209,55732
20200206,4,회현,24349,26106,20200209,50455
20200206,4,서울역,13943,19588,20200209,33531
20200206,4,숙대입구,14399,14287,20200209,28686
20200206,4,삼각지,5113,5652,20200209,10765
20200206,4,신용산,16694,17415,20200209,34109
20200206,4,이촌,7228,8020,20200209,15248
20200206,4,동작,2088,2069,20200209,4157
20200206,4,총신대입구,20396,22160,20200209,42556
20200206,4,사당,26460,22372,20200209,48832
20200206,4,남태령,1171,1050,20200209,2221
20200207,4,당고개,12963,11849,20200210,24812
20200207,4,상계,20544,18721,20200210,39265
20200207,4,노원,22231,25889,20200210,48120
20200207,4,창동,29156,30800,20200210,59956
20200207,4,쌍문,33209,29695,20200210,62904
20200207,4,수유,38416,38624,20200210,77040
20200207,4,미아,17040,16097,20200210,33137
20200207,4,미아사거리,30642,30005,20200210,60647
20200207,4,길음,21575,20385,20200210,41960
20200207,4,성신여대입구,20852,19517,20200210,40369
20200207,4,한성대입구,14125,13442,20200210,27567
20200207,4,혜화,33829,34491,20200210,68320
20200207,4,동대문,20643,21367,20200210,42010
20200207,4,동대문역사문화공원,18871,17577,20200210,36448
20200207,4,충무로,30818,31898,20200210,62716
20200207,4,명동,27383,28727,20200210,56110
20200207,4,회현,25079,26579,20200210,51658
20200207,4,서울역,14249,21793,20200210,36042
20200207,4,숙대입구,15055,14921,20200210,29976
20200207,4,삼각지,5290,5932,20200210,11222
20200207,4,신용산,18098,18491,20200210,36589
20200207,4,이촌,7569,8450,20200210,16019
20200207,4,동작,2306,2356,20200210,4662
20200207,4,총신대입구,22273,24483,20200210,46756
20200207,4,사당,28410,24108,20200210,52518
20200207,4,남태령,1401,1160,20200210,2561
20200208,4,당고개,9771,9088,20200211,18859
20200208,4,상계,13887,12733,20200211,26620
20200208,4,노원,17040,19558,20200211,36598
20200208,4,창동,20155,21145,20200211,41300
20200208,4,쌍문,21905,19341,20200211,41246
20200208,4,수유,26757,26598,20200211,53355
20200208,4,미아,11447,10577,20200211,22024
20200208,4,미아사거리,21621,20810,20200211,42431
20200208,4,길음,13604,12837,20200211,26441
20200208,4,성신여대입구,15316,14128,20200211,29444
20200208,4,한성대입구,10286,9767,20200211,20053
20200208,4,혜화,27450,28679,20200211,56129
20200208,4,동대문,13540,13236,20200211,26776
20200208,4,동대문역사문화공원,13379,11552,20200211,24931
20200208,4,충무로,12943,14616,20200211,27559
20200208,4,명동,20892,22716,20200211,43608
20200208,4,회현,16725,16961,20200211,33686
20200208,4,서울역,6405,13734,20200211,20139
20200208,4,숙대입구,9725,9208,20200211,18933
20200208,4,삼각지,2537,3381,20200211,5918
20200208,4,신용산,8825,9363,20200211,18188
20200208,4,이촌,5207,5821,20200211,11028
20200208,4,동작,1631,1672,20200211,3303
20200208,4,총신대입구,15013,16251,20200211,31264
20200208,4,사당,21046,19038,20200211,40084
20200208,4,남태령,964,604,20200211,1568
20200209,4,당고개,7445,7145,20200212,14590
20200209,4,상계,10157,9365,20200212,19522
20200209,4,노원,13358,14465,20200212,27823
20200209,4,창동,15395,15985,20200212,31380
20200209,4,쌍문,16548,14582,20200212,31130
20200209,4,수유,20454,19607,20200212,40061
20200209,4,미아,8192,7583,20200212,15775
20200209,4,미아사거리,16089,15157,20200212,31246
20200209,4,길음,9870,9665,20200212,19535
20200209,4,성신여대입구,11638,10984,20200212,22622
20200209,4,한성대입구,7542,7440,20200212,14982
20200209,4,혜화,22326,23454,20200212,45780
20200209,4,동대문,6899,7747,20200212,14646
20200209,4,동대문역사문화공원,11141,10729,20200212,21870
20200209,4,충무로,9280,9255,20200212,18535
20200209,4,명동,19282,20286,20200212,39568
20200209,4,회현,8993,9162,20200212,18155
20200209,4,서울역,5340,10872,20200212,16212
20200209,4,숙대입구,8357,8051,20200212,16408
20200209,4,삼각지,2011,2643,20200212,4654
20200209,4,신용산,6500,6833,20200212,13333
20200209,4,이촌,4692,5268,20200212,9960
20200209,4,동작,1252,1373,20200212,2625
20200209,4,총신대입구,10568,11402,20200212,21970
20200209,4,사당,15141,14196,20200212,29337
20200209,4,남태령,668,465,20200212,1133
20200210,4,당고개,12886,11972,20200213,24858
20200210,4,상계,20498,18424,20200213,38922
20200210,4,노원,20928,23878,20200213,44806
20200210,4,창동,27794,29297,20200213,57091
20200210,4,쌍문,32166,28901,20200213,61067
20200210,4,수유,36773,36721,20200213,73494
20200210,4,미아,16174,15261,20200213,31435
20200210,4,미아사거리,28900,28022,20200213,56922
20200210,4,길음,21192,20217,20200213,41409
20200210,4,성신여대입구,20551,19612,20200213,40163
20200210,4,한성대입구,13557,12991,20200213,26548
20200210,4,혜화,31224,31903,20200213,63127
20200210,4,동대문,21897,22679,20200213,44576
20200210,4,동대문역사문화공원,18643,17166,20200213,35809
20200210,4,충무로,30398,31489,20200213,61887
20200210,4,명동,28061,29521,20200213,57582
20200210,4,회현,23904,26055,20200213,49959
20200210,4,서울역,13934,19932,20200213,33866
20200210,4,숙대입구,14012,13891,20200213,27903
20200210,4,삼각지,5100,5563,20200213,10663
20200210,4,신용산,16741,17283,20200213,34024
20200210,4,이촌,7160,8040,20200213,15200
20200210,4,동작,2296,2383,20200213,4679
20200210,4,총신대입구,20997,23245,20200213,44242
20200210,4,사당,26273,22433,20200213,48706
20200210,4,남태령,1194,1070,20200213,2264
20200211,4,당고개,13460,12377,20200214,25837
20200211,4,상계,20774,19016,20200214,39790
20200211,4,노원,22199,25312,20200214,47511
20200211,4,창동,28406,29937,20200214,58343
20200211,4,쌍문,32972,30078,20200214,63050
20200211,4,수유,37685,37704,20200214,75389
20200211,4,미아,16403,15661,20200214,32064
20200211,4,미아사거리,30778,29601,20200214,60379
20200211,4,길음,21950,20988,20200214,42938
20200211,4,성신여대입구,21333,20202,20200214,41535
20200211,4,한성대입구,14258,13872,20200214,28130
20200211,4,혜화,34222,35316,20200214,69538
20200211,4,동대문,22343,23049,20200214,45392
20200211,4,동대문역사문화공원,19151,17663,20200214,36814
20200211,4,충무로,31216,32201,20200214,63417
20200211,4,명동,27491,29001,20200214,56492
20200211,4,회현,26456,28181,20200214,54637
20200211,4,서울역,14252,19931,20200214,34183
20200211,4,숙대입구,14670,14495,20200214,29165
20200211,4,삼각지,5355,5908,20200214,11263
20200211,4,신용산,17225,17900,20200214,35125
20200211,4,이촌,7531,8582,20200214,16113
20200211,4,동작,2344,2525,20200214,4869
20200211,4,총신대입구,21347,23609,20200214,44956
20200211,4,사당,27883,23418,20200214,51301
20200211,4,남태령,1271,1061,20200214,2332
20200212,4,당고개,12743,11717,20200215,24460
20200212,4,상계,20284,18436,20200215,38720
20200212,4,노원,21411,24194,20200215,45605
20200212,4,창동,27371,28953,20200215,56324
20200212,4,쌍문,32091,29330,20200215,61421
20200212,4,수유,36359,36412,20200215,72771
20200212,4,미아,15998,15177,20200215,31175
20200212,4,미아사거리,29956,28976,20200215,58932
20200212,4,길음,21192,20398,20200215,41590
20200212,4,성신여대입구,20412,19525,20200215,39937
20200212,4,한성대입구,13646,13273,20200215,26919
20200212,4,혜화,34751,35513,20200215,70264
20200212,4,동대문,21082,21808,20200215,42890
20200212,4,동대문역사문화공원,18889,17467,20200215,36356
20200212,4,충무로,30803,31644,20200215,62447
20200212,4,명동,25976,27653,20200215,53629
20200212,4,회현,25697,26964,20200215,52661
20200212,4,서울역,13891,19860,20200215,33751
20200212,4,숙대입구,14182,14151,20200215,28333
20200212,4,삼각지,5295,5799,20200215,11094
20200212,4,신용산,17205,17829,20200215,35034
20200212,4,이촌,7424,8187,20200215,15611
20200212,4,동작,2058,2152,20200215,4210
20200212,4,총신대입구,20662,22759,20200215,43421
20200212,4,사당,27486,23046,20200215,50532
20200212,4,남태령,1258,1133,20200215,2391
20200213,4,당고개,13305,12368,20200216,25673
20200213,4,상계,21184,19118,20200216,40302
20200213,4,노원,22465,25684,20200216,48149
20200213,4,창동,29285,30932,20200216,60217
20200213,4,쌍문,33308,29986,20200216,63294
20200213,4,수유,38474,38035,20200216,76509
20200213,4,미아,16742,15820,20200216,32562
20200213,4,미아사거리,31039,30222,20200216,61261
20200213,4,길음,22355,21427,20200216,43782
20200213,4,성신여대입구,21877,20903,20200216,42780
20200213,4,한성대입구,14567,13970,20200216,28537
20200213,4,혜화,36306,37438,20200216,73744
20200213,4,동대문,22701,23391,20200216,46092
20200213,4,동대문역사문화공원,19131,17888,20200216,37019
20200213,4,충무로,31825,32757,20200216,64582
20200213,4,명동,27296,29051,20200216,56347
20200213,4,회현,26959,28943,20200216,55902
20200213,4,서울역,14237,20761,20200216,34998
20200213,4,숙대입구,14880,14679,20200216,29559
20200213,4,삼각지,5378,5987,20200216,11365
20200213,4,신용산,17900,18529,20200216,36429
20200213,4,이촌,7537,8425,20200216,15962
20200213,4,동작,2381,2477,20200216,4858
20200213,4,총신대입구,21788,23808,20200216,45596
20200213,4,사당,28630,24360,20200216,52990
20200213,4,남태령,1288,1122,20200216,2410
20200214,4,당고개,13878,12587,20200217,26465
20200214,4,상계,21782,19374,20200217,41156
20200214,4,노원,23813,28060,20200217,51873
20200214,4,창동,30565,32544,20200217,63109
20200214,4,쌍문,34713,30735,20200217,65448
20200214,4,수유,40422,40731,20200217,81153
20200214,4,미아,17257,16181,20200217,33438
20200214,4,미아사거리,32962,32218,20200217,65180
20200214,4,길음,22969,21172,20200217,44141
20200214,4,성신여대입구,23153,22267,20200217,45420
20200214,4,한성대입구,15399,14474,20200217,29873
20200214,4,혜화,39490,41076,20200217,80566
20200214,4,동대문,23080,23947,20200217,47027
20200214,4,동대문역사문화공원,20001,18585,20200217,38586
20200214,4,충무로,32086,33709,20200217,65795
20200214,4,명동,28337,29900,20200217,58237
20200214,4,회현,27564,29437,20200217,57001
20200214,4,서울역,14808,23382,20200217,38190
20200214,4,숙대입구,15473,15470,20200217,30943
20200214,4,삼각지,5588,6323,20200217,11911
20200214,4,신용산,19111,19863,20200217,38974
20200214,4,이촌,8208,9168,20200217,17376
20200214,4,동작,2607,2691,20200217,5298
20200214,4,총신대입구,23123,25712,20200217,48835
20200214,4,사당,31026,26338,20200217,57364
20200214,4,남태령,1470,1203,20200217,2673
20200215,4,당고개,10446,9807,20200218,20253
20200215,4,상계,15198,13774,20200218,28972
20200215,4,노원,18751,20838,20200218,39589
20200215,4,창동,22017,23253,20200218,45270
20200215,4,쌍문,24006,21093,20200218,45099
20200215,4,수유,29053,28925,20200218,57978
20200215,4,미아,12020,11037,20200218,23057
20200215,4,미아사거리,24260,23621,20200218,47881
20200215,4,길음,15721,14615,20200218,30336
20200215,4,성신여대입구,17238,16211,20200218,33449
20200215,4,한성대입구,11249,10683,20200218,21932
20200215,4,혜화,31861,33644,20200218,65505
20200215,4,동대문,15995,15601,20200218,31596
20200215,4,동대문역사문화공원,14815,12719,20200218,27534
20200215,4,충무로,15990,16572,20200218,32562
20200215,4,명동,21928,23865,20200218,45793
20200215,4,회현,19098,19986,20200218,39084
20200215,4,서울역,7099,15806,20200218,22905
20200215,4,숙대입구,9986,9447,20200218,19433
20200215,4,삼각지,3024,4049,20200218,7073
20200215,4,신용산,9719,10494,20200218,20213
20200215,4,이촌,6025,6553,20200218,12578
20200215,4,동작,1908,1868,20200218,3776
20200215,4,총신대입구,16650,17864,20200218,34514
20200215,4,사당,23519,20863,20200218,44382
20200215,4,남태령,1130,733,20200218,1863
20200216,4,당고개,7466,7225,20200219,14691
20200216,4,상계,10879,10006,20200219,20885
20200216,4,노원,13855,14936,20200219,28791
20200216,4,창동,16124,16903,20200219,33027
20200216,4,쌍문,17377,15197,20200219,32574
20200216,4,수유,20934,20337,20200219,41271
20200216,4,미아,9160,8423,20200219,17583
20200216,4,미아사거리,17235,16383,20200219,33618
20200216,4,길음,10556,10182,20200219,20738
20200216,4,성신여대입구,12693,12204,20200219,24897
20200216,4,한성대입구,7930,7912,20200219,15842
20200216,4,혜화,25051,26207,20200219,51258
20200216,4,동대문,6432,7299,20200219,13731
20200216,4,동대문역사문화공원,11031,10619,20200219,21650
20200216,4,충무로,9581,9520,20200219,19101
20200216,4,명동,18119,19524,20200219,37643
20200216,4,회현,9014,9320,20200219,18334
20200216,4,서울역,5266,12322,20200219,17588
20200216,4,숙대입구,8837,8379,20200219,17216
20200216,4,삼각지,2151,2725,20200219,4876
20200216,4,신용산,7249,7602,20200219,14851
20200216,4,이촌,4847,5425,20200219,10272
20200216,4,동작,1058,1195,20200219,2253
20200216,4,총신대입구,10754,11606,20200219,22360
20200216,4,사당,15895,15077,20200219,30972
20200216,4,남태령,801,566,20200219,1367
20200217,4,당고개,13075,11996,20200220,25071
20200217,4,상계,20754,18849,20200220,39603
20200217,4,노원,21487,24257,20200220,45744
20200217,4,창동,27542,29312,20200220,56854
20200217,4,쌍문,32600,29713,20200220,62313
20200217,4,수유,37568,37223,20200220,74791
20200217,4,미아,16129,15337,20200220,31466
20200217,4,미아사거리,30074,29133,20200220,59207
20200217,4,길음,21938,21150,20200220,43088
20200217,4,성신여대입구,21876,20846,20200220,42722
20200217,4,한성대입구,14675,14122,20200220,28797
20200217,4,혜화,32353,32772,20200220,65125
20200217,4,동대문,21639,22546,20200220,44185
20200217,4,동대문역사문화공원,18598,17412,20200220,36010
20200217,4,충무로,30752,31851,20200220,62603
20200217,4,명동,27163,29140,20200220,56303
20200217,4,회현,25733,27404,20200220,53137
20200217,4,서울역,14180,20755,20200220,34935
20200217,4,숙대입구,14562,14478,20200220,29040
20200217,4,삼각지,5225,5744,20200220,10969
20200217,4,신용산,18032,18824,20200220,36856
20200217,4,이촌,7903,8524,20200220,16427
20200217,4,동작,2038,2147,20200220,4185
20200217,4,총신대입구,21447,23304,20200220,44751
20200217,4,사당,27101,23060,20200220,50161
20200217,4,남태령,1255,1140,20200220,2395
20200218,4,당고개,13177,12019,20200221,25196
20200218,4,상계,20758,18659,20200221,39417
20200218,4,노원,21822,24784,20200221,46606
20200218,4,창동,27889,29822,20200221,57711
20200218,4,쌍문,32462,29826,20200221,62288
20200218,4,수유,37170,37012,20200221,74182
20200218,4,미아,16168,15300,20200221,31468
20200218,4,미아사거리,30097,29194,20200221,59291
20200218,4,길음,22026,21312,20200221,43338
20200218,4,성신여대입구,21818,20784,20200221,42602
20200218,4,한성대입구,14289,13994,20200221,28283
20200218,4,혜화,34957,35541,20200221,70498
20200218,4,동대문,22402,23042,20200221,45444
20200218,4,동대문역사문화공원,19069,17623,20200221,36692
20200218,4,충무로,31257,32099,20200221,63356
20200218,4,명동,27934,29755,20200221,57689
20200218,4,회현,26125,27850,20200221,53975
20200218,4,서울역,14157,20204,20200221,34361
20200218,4,숙대입구,14520,14464,20200221,28984
20200218,4,삼각지,5305,5777,20200221,11082
20200218,4,신용산,17865,18649,20200221,36514
20200218,4,이촌,7555,8410,20200221,15965
20200218,4,동작,2195,2303,20200221,4498
20200218,4,총신대입구,21264,23579,20200221,44843
20200218,4,사당,28076,23498,20200221,51574
20200218,4,남태령,1217,1071,20200221,2288
20200219,4,당고개,13358,12206,20200222,25564
20200219,4,상계,20995,19108,20200222,40103
20200219,4,노원,21865,25180,20200222,47045
20200219,4,창동,28586,30292,20200222,58878
20200219,4,쌍문,33137,30208,20200222,63345
20200219,4,수유,37988,37861,20200222,75849
20200219,4,미아,16469,15740,20200222,32209
20200219,4,미아사거리,30691,29581,20200222,60272
20200219,4,길음,22366,21269,20200222,43635
20200219,4,성신여대입구,21824,20881,20200222,42705
20200219,4,한성대입구,14732,14065,20200222,28797
20200219,4,혜화,36955,37665,20200222,74620
20200219,4,동대문,22660,23133,20200222,45793
20200219,4,동대문역사문화공원,19497,17881,20200222,37378
20200219,4,충무로,31354,32260,20200222,63614
20200219,4,명동,27852,29380,20200222,57232
20200219,4,회현,26813,28508,20200222,55321
20200219,4,서울역,14272,20617,20200222,34889
20200219,4,숙대입구,14781,14734,20200222,29515
20200219,4,삼각지,5274,5933,20200222,11207
20200219,4,신용산,17796,18608,20200222,36404
20200219,4,이촌,7763,8652,20200222,16415
20200219,4,동작,2312,2432,20200222,4744
20200219,4,총신대입구,21912,24013,20200222,45925
20200219,4,사당,28644,24315,20200222,52959
20200219,4,남태령,1276,1140,20200222,2416
20200220,4,당고개,13108,12125,20200223,25233
20200220,4,상계,20793,18628,20200223,39421
20200220,4,노원,21699,24685,20200223,46384
20200220,4,창동,28165,29764,20200223,57929
20200220,4,쌍문,32600,29688,20200223,62288
20200220,4,수유,37371,36963,20200223,74334
20200220,4,미아,16304,15458,20200223,31762
20200220,4,미아사거리,29809,28993,20200223,58802
20200220,4,길음,22037,20781,20200223,42818
20200220,4,성신여대입구,21146,20129,20200223,41275
20200220,4,한성대입구,13859,13318,20200223,27177
20200220,4,혜화,35247,36067,20200223,71314
20200220,4,동대문,22223,22858,20200223,45081
20200220,4,동대문역사문화공원,18853,17185,20200223,36038
20200220,4,충무로,31099,32095,20200223,63194
20200220,4,명동,26536,28023,20200223,54559
20200220,4,회현,25884,27774,20200223,53658
20200220,4,서울역,14226,20533,20200223,34759
20200220,4,숙대입구,14466,14325,20200223,28791
20200220,4,삼각지,5342,5993,20200223,11335
20200220,4,신용산,17969,18649,20200223,36618
20200220,4,이촌,7341,8232,20200223,15573
20200220,4,동작,2365,2403,20200223,4768
20200220,4,총신대입구,21276,23301,20200223,44577
20200220,4,사당,28013,23884,20200223,51897
20200220,4,남태령,1284,1110,20200223,2394
20200221,4,당고개,12730,11743,20200224,24473
20200221,4,상계,20222,18302,20200224,38524
20200221,4,노원,21886,25390,20200224,47276
20200221,4,창동,27978,30004,20200224,57982
20200221,4,쌍문,32120,28819,20200224,60939
20200221,4,수유,36911,37460,20200224,74371
20200221,4,미아,15980,15064,20200224,31044
20200221,4,미아사거리,29799,29222,20200224,59021
20200221,4,길음,21414,20360,20200224,41774
20200221,4,성신여대입구,21235,20241,20200224,41476
20200221,4,한성대입구,14200,13648,20200224,27848
20200221,4,혜화,33644,33995,20200224,67639
20200221,4,동대문,20775,21420,20200224,42195
20200221,4,동대문역사문화공원,18007,17065,20200224,35072
20200221,4,충무로,29861,30764,20200224,60625
20200221,4,명동,25691,27051,20200224,52742
20200221,4,회현,24933,26392,20200224,51325
20200221,4,서울역,14187,20583,20200224,34770
20200221,4,숙대입구,14302,14296,20200224,28598
20200221,4,삼각지,5162,5767,20200224,10929
20200221,4,신용산,18040,19155,20200224,37195
20200221,4,이촌,7509,8553,20200224,16062
20200221,4,동작,2203,2272,20200224,4475
20200221,4,총신대입구,21046,23221,20200224,44267
20200221,4,사당,28018,23902,20200224,51920
20200221,4,남태령,1261,1019,20200224,2280
20200222,4,당고개,8665,8113,20200225,16778
20200222,4,상계,12457,11457,20200225,23914
20200222,4,노원,14986,16889,20200225,31875
20200222,4,창동,17539,18783,20200225,36322
20200222,4,쌍문,19867,17605,20200225,37472
20200222,4,수유,24431,24515,20200225,48946
20200222,4,미아,10444,9843,20200225,20287
20200222,4,미아사거리,20262,19588,20200225,39850
20200222,4,길음,12635,11927,20200225,24562
20200222,4,성신여대입구,14381,13363,20200225,27744
20200222,4,한성대입구,9057,8660,20200225,17717
20200222,4,혜화,25125,26258,20200225,51383
20200222,4,동대문,11852,11468,20200225,23320
20200222,4,동대문역사문화공원,12310,10555,20200225,22865
20200222,4,충무로,12997,13220,20200225,26217
20200222,4,명동,18542,20647,20200225,39189
20200222,4,회현,14284,14919,20200225,29203
20200222,4,서울역,5728,10993,20200225,16721
20200222,4,숙대입구,8029,7722,20200225,15751
20200222,4,삼각지,2531,3132,20200225,5663
20200222,4,신용산,8008,8331,20200225,16339
20200222,4,이촌,4621,5133,20200225,9754
20200222,4,동작,1235,1343,20200225,2578
20200222,4,총신대입구,12400,13652,20200225,26052
20200222,4,사당,18252,16139,20200225,34391
20200222,4,남태령,769,503,20200225,1272
20200223,4,당고개,6218,6074,20200226,12292
20200223,4,상계,8752,8034,20200226,16786
20200223,4,노원,10488,11383,20200226,21871
20200223,4,창동,11911,12480,20200226,24391
20200223,4,쌍문,13839,12167,20200226,26006
20200223,4,수유,17210,16401,20200226,33611
20200223,4,미아,7011,6560,20200226,13571
20200223,4,미아사거리,13958,13029,20200226,26987
20200223,4,길음,8236,8001,20200226,16237
20200223,4,성신여대입구,10092,9552,20200226,19644
20200223,4,한성대입구,6182,6064,20200226,12246
20200223,4,혜화,17139,18205,20200226,35344
20200223,4,동대문,5511,6444,20200226,11955
20200223,4,동대문역사문화공원,9109,8652,20200226,17761
20200223,4,충무로,7875,7755,20200226,15630
20200223,4,명동,15297,16392,20200226,31689
20200223,4,회현,7432,7712,20200226,15144
20200223,4,서울역,4137,8134,20200226,12271
20200223,4,숙대입구,5347,5174,20200226,10521
20200223,4,삼각지,1482,1866,20200226,3348
20200223,4,신용산,5199,5457,20200226,10656
20200223,4,이촌,3185,3611,20200226,6796
20200223,4,동작,974,994,20200226,1968
20200223,4,총신대입구,7735,8319,20200226,16054
20200223,4,사당,11484,10871,20200226,22355
20200223,4,남태령,420,364,20200226,784
20200224,4,당고개,11441,10447,20200227,21888
20200224,4,상계,18156,16426,20200227,34582
20200224,4,노원,18140,20429,20200227,38569
20200224,4,창동,23792,25458,20200227,49250
20200224,4,쌍문,28748,26298,20200227,55046
20200224,4,수유,32900,32721,20200227,65621
20200224,4,미아,14205,13630,20200227,27835
20200224,4,미아사거리,25748,25225,20200227,50973
20200224,4,길음,18505,17654,20200227,36159
20200224,4,성신여대입구,17777,16828,20200227,34605
20200224,4,한성대입구,11704,11482,20200227,23186
20200224,4,혜화,25431,25731,20200227,51162
20200224,4,동대문,18743,19517,20200227,38260
20200224,4,동대문역사문화공원,15931,14718,20200227,30649
20200224,4,충무로,26697,27399,20200227,54096
20200224,4,명동,22653,23584,20200227,46237
20200224,4,회현,22224,23792,20200227,46016
20200224,4,서울역,12329,15893,20200227,28222
20200224,4,숙대입구,12004,11910,20200227,23914
20200224,4,삼각지,4410,4759,20200227,9169
20200224,4,신용산,14655,15333,20200227,29988
20200224,4,이촌,5904,6514,20200227,12418
20200224,4,동작,1909,1978,20200227,3887
20200224,4,총신대입구,17108,18848,20200227,35956
20200224,4,사당,21889,18247,20200227,40136
20200224,4,남태령,1010,926,20200227,1936
20200225,4,당고개,10268,9552,20200228,19820
20200225,4,상계,16675,15135,20200228,31810
20200225,4,노원,15974,17963,20200228,33937
20200225,4,창동,22058,23585,20200228,45643
20200225,4,쌍문,26858,24531,20200228,51389
20200225,4,수유,30345,30212,20200228,60557
20200225,4,미아,13156,12644,20200228,25800
20200225,4,미아사거리,23919,23379,20200228,47298
20200225,4,길음,17136,16319,20200228,33455
20200225,4,성신여대입구,16587,15743,20200228,32330
20200225,4,한성대입구,10821,10404,20200228,21225
20200225,4,혜화,24376,24893,20200228,49269
20200225,4,동대문,17452,18306,20200228,35758
20200225,4,동대문역사문화공원,14847,13860,20200228,28707
20200225,4,충무로,25507,26150,20200228,51657
20200225,4,명동,20339,21367,20200228,41706
20200225,4,회현,20508,21846,20200228,42354
20200225,4,서울역,11410,14294,20200228,25704
20200225,4,숙대입구,11180,11113,20200228,22293
20200225,4,삼각지,4186,4467,20200228,8653
20200225,4,신용산,11947,12442,20200228,24389
20200225,4,이촌,5251,5856,20200228,11107
20200225,4,동작,1550,1596,20200228,3146
20200225,4,총신대입구,15145,16848,20200228,31993
20200225,4,사당,20070,16391,20200228,36461
20200225,4,남태령,937,853,20200228,1790
20200226,4,당고개,10340,9627,20200229,19967
20200226,4,상계,16429,14814,20200229,31243
20200226,4,노원,15530,17471,20200229,33001
20200226,4,창동,22475,24119,20200229,46594
20200226,4,쌍문,26578,24400,20200229,50978
20200226,4,수유,30661,30423,20200229,61084
20200226,4,미아,13357,12917,20200229,26274
20200226,4,미아사거리,23995,23567,20200229,47562
20200226,4,길음,16970,16083,20200229,33053
20200226,4,성신여대입구,16427,15614,20200229,32041
20200226,4,한성대입구,10849,10485,20200229,21334
20200226,4,혜화,25115,25497,20200229,50612
20200226,4,동대문,17735,18484,20200229,36219
20200226,4,동대문역사문화공원,14545,13650,20200229,28195
20200226,4,충무로,25242,25920,20200229,51162
20200226,4,명동,19565,20527,20200229,40092
20200226,4,회현,20589,21869,20200229,42458
20200226,4,서울역,10926,13349,20200229,24275
20200226,4,숙대입구,11159,11096,20200229,22255
20200226,4,삼각지,4105,4531,20200229,8636
20200226,4,신용산,10112,10548,20200229,20660
20200226,4,이촌,5146,5749,20200229,10895
20200226,4,동작,1734,1793,20200229,3527
20200226,4,총신대입구,15735,17289,20200229,33024
20200226,4,사당,20144,16824,20200229,36968
20200226,4,남태령,934,860,20200229,1794
20200227,4,당고개,10200,9539,20200301,19739
20200227,4,상계,15970,14469,20200301,30439
20200227,4,노원,15482,17188,20200301,32670
20200227,4,창동,22213,23617,20200301,45830
20200227,4,쌍문,26343,24106,20200301,50449
20200227,4,수유,29942,29848,20200301,59790
20200227,4,미아,13158,12575,20200301,25733
20200227,4,미아사거리,23464,23196,20200301,46660
20200227,4,길음,16521,15618,20200301,32139
20200227,4,성신여대입구,16117,15350,20200301,31467
20200227,4,한성대입구,10635,10313,20200301,20948
20200227,4,혜화,23540,23939,20200301,47479
20200227,4,동대문,17064,17857,20200301,34921
20200227,4,동대문역사문화공원,14154,13418,20200301,27572
20200227,4,충무로,24591,25276,20200301,49867
20200227,4,명동,18377,19163,20200301,37540
20200227,4,회현,19779,21126,20200301,40905
20200227,4,서울역,10424,12804,20200301,23228
20200227,4,숙대입구,10839,10583,20200301,21422
20200227,4,삼각지,3964,4270,20200301,8234
20200227,4,신용산,11954,12418,20200301,24372
20200227,4,이촌,4944,5684,20200301,10628
20200227,4,동작,1780,1868,20200301,3648
20200227,4,총신대입구,15006,16510,20200301,31516
20200227,4,사당,19332,16452,20200301,35784
20200227,4,남태령,807,715,20200301,1522
20200228,4,당고개,10002,9071,20200302,19073
20200228,4,상계,15682,14335,20200302,30017
20200228,4,노원,14979,17006,20200302,31985
20200228,4,창동,21388,22855,20200302,44243
20200228,4,쌍문,25665,23208,20200302,48873
20200228,4,수유,29512,30138,20200302,59650
20200228,4,미아,12660,11920,20200302,24580
20200228,4,미아사거리,23326,23063,20200302,46389
20200228,4,길음,15935,15011,20200302,30946
20200228,4,성신여대입구,15730,15272,20200302,31002
20200228,4,한성대입구,10611,10226,20200302,20837
20200228,4,혜화,23402,23914,20200302,47316
20200228,4,동대문,16452,16934,20200302,33386
20200228,4,동대문역사문화공원,13318,12771,20200302,26089
20200228,4,충무로,23576,24441,20200302,48017
20200228,4,명동,16115,16850,20200302,32965
20200228,4,회현,19249,20192,20200302,39441
20200228,4,서울역,9890,12516,20200302,22406
20200228,4,숙대입구,10660,10525,20200302,21185
20200228,4,삼각지,3925,4224,20200302,8149
20200228,4,신용산,11768,12275,20200302,24043
20200228,4,이촌,4799,5504,20200302,10303
20200228,4,동작,1462,1534,20200302,2996
20200228,4,총신대입구,15149,16555,20200302,31704
20200228,4,사당,19327,16422,20200302,35749
20200228,4,남태령,794,655,20200302,1449
20200229,4,당고개,6644,6378,20200303,13022
20200229,4,상계,9600,8902,20200303,18502
20200229,4,노원,10169,11607,20200303,21776
20200229,4,창동,13242,14212,20200303,27454
20200229,4,쌍문,15531,13871,20200303,29402
20200229,4,수유,19234,19226,20200303,38460
20200229,4,미아,7954,7589,20200303,15543
20200229,4,미아사거리,15617,15250,20200303,30867
20200229,4,길음,8954,8333,20200303,17287
20200229,4,성신여대입구,11003,10248,20200303,21251
20200229,4,한성대입구,6486,6317,20200303,12803
20200229,4,혜화,15239,16300,20200303,31539
20200229,4,동대문,8550,8315,20200303,16865
20200229,4,동대문역사문화공원,7449,6484,20200303,13933
20200229,4,충무로,8593,8742,20200303,17335
20200229,4,명동,9255,9966,20200303,19221
20200229,4,회현,9710,10188,20200303,19898
20200229,4,서울역,3459,5457,20200303,8916
20200229,4,숙대입구,5918,5643,20200303,11561
20200229,4,삼각지,1657,1956,20200303,3613
20200229,4,신용산,5148,5568,20200303,10716
20200229,4,이촌,2613,3019,20200303,5632
20200229,4,동작,1194,1146,20200303,2340
20200229,4,총신대입구,8882,9829,20200303,18711
20200229,4,사당,11424,9997,20200303,21421
20200229,4,남태령,477,390,20200303,867
20200301,4,당고개,4855,4619,20200304,9474
20200301,4,상계,6338,5858,20200304,12196
20200301,4,노원,7022,7641,20200304,14663
20200301,4,창동,9373,9874,20200304,19247
20200301,4,쌍문,10227,9018,20200304,19245
20200301,4,수유,13256,12548,20200304,25804
20200301,4,미아,5252,4841,20200304,10093
20200301,4,미아사거리,10365,9700,20200304,20065
20200301,4,길음,5804,5619,20200304,11423
20200301,4,성신여대입구,7370,7074,20200304,14444
20200301,4,한성대입구,4379,4212,20200304,8591
20200301,4,혜화,11562,12243,20200304,23805
20200301,4,동대문,3242,3984,20200304,7226
20200301,4,동대문역사문화공원,4931,5349,20200304,10280
20200301,4,충무로,4493,4461,20200304,8954
20200301,4,명동,6157,6485,20200304,12642
20200301,4,회현,4755,5158,20200304,9913
20200301,4,서울역,2446,4081,20200304,6527
20200301,4,숙대입구,3745,3682,20200304,7427
20200301,4,삼각지,999,1200,20200304,2199
20200301,4,신용산,3571,3721,20200304,7292
20200301,4,이촌,1676,2009,20200304,3685
20200301,4,동작,779,799,20200304,1578
20200301,4,총신대입구,5541,5926,20200304,11467
20200301,4,사당,7201,7356,20200304,14557
20200301,4,남태령,263,250,20200304,513
20200302,4,당고개,10208,9365,20200305,19573
20200302,4,상계,15974,14612,20200305,30586
20200302,4,노원,14799,16522,20200305,31321
20200302,4,창동,22059,23452,20200305,45511
20200302,4,쌍문,25437,23382,20200305,48819
20200302,4,수유,29555,29243,20200305,58798
20200302,4,미아,12855,12301,20200305,25156
20200302,4,미아사거리,22383,22063,20200305,44446
20200302,4,길음,15952,15326,20200305,31278
20200302,4,성신여대입구,15668,14836,20200305,30504
20200302,4,한성대입구,10290,10022,20200305,20312
20200302,4,혜화,20689,21043,20200305,41732
20200302,4,동대문,16924,17653,20200305,34577
20200302,4,동대문역사문화공원,12816,12165,20200305,24981
20200302,4,충무로,22997,23961,20200305,46958
20200302,4,명동,15154,15760,20200305,30914
20200302,4,회현,18986,20204,20200305,39190
20200302,4,서울역,9485,11226,20200305,20711
20200302,4,숙대입구,10570,10378,20200305,20948
20200302,4,삼각지,3901,4134,20200305,8035
20200302,4,신용산,12175,12797,20200305,24972
20200302,4,이촌,4788,5388,20200305,10176
20200302,4,동작,1708,1778,20200305,3486
20200302,4,총신대입구,14789,16499,20200305,31288
20200302,4,사당,18166,15459,20200305,33625
20200302,4,남태령,759,678,20200305,1437
20200303,4,당고개,10079,9305,20200306,19384
20200303,4,상계,15898,14586,20200306,30484
20200303,4,노원,15124,16965,20200306,32089
20200303,4,창동,21682,23236,20200306,44918
20200303,4,쌍문,25060,22998,20200306,48058
20200303,4,수유,29310,29040,20200306,58350
20200303,4,미아,12642,12196,20200306,24838
20200303,4,미아사거리,23307,22719,20200306,46026
20200303,4,길음,15874,15100,20200306,30974
20200303,4,성신여대입구,15660,14862,20200306,30522
20200303,4,한성대입구,10410,10238,20200306,20648
20200303,4,혜화,20942,21161,20200306,42103
20200303,4,동대문,16516,17368,20200306,33884
20200303,4,동대문역사문화공원,12624,11851,20200306,24475
20200303,4,충무로,23084,23726,20200306,46810
20200303,4,명동,14576,15308,20200306,29884
20200303,4,회현,18723,19887,20200306,38610
20200303,4,서울역,9329,11187,20200306,20516
20200303,4,숙대입구,10582,10409,20200306,20991
20200303,4,삼각지,3930,4176,20200306,8106
20200303,4,신용산,12192,12742,20200306,24934
20200303,4,이촌,4748,5376,20200306,10124
20200303,4,동작,1755,1884,20200306,3639
20200303,4,총신대입구,14959,16491,20200306,31450
20200303,4,사당,18329,15702,20200306,34031
20200303,4,남태령,730,672,20200306,1402
20200304,4,당고개,9864,9100,20200307,18964
20200304,4,상계,15806,14441,20200307,30247
20200304,4,노원,15057,16973,20200307,32030
20200304,4,창동,21509,23048,20200307,44557
20200304,4,쌍문,25285,23194,20200307,48479
20200304,4,수유,29076,29160,20200307,58236
20200304,4,미아,12480,12164,20200307,24644
20200304,4,미아사거리,23019,22329,20200307,45348
20200304,4,길음,15807,15080,20200307,30887
20200304,4,성신여대입구,15399,14666,20200307,30065
20200304,4,한성대입구,10155,9925,20200307,20080
20200304,4,혜화,21802,21961,20200307,43763
20200304,4,동대문,16806,17289,20200307,34095
20200304,4,동대문역사문화공원,12556,11987,20200307,24543
20200304,4,충무로,23204,23559,20200307,46763
20200304,4,명동,14049,14555,20200307,28604
20200304,4,회현,18410,19522,20200307,37932
20200304,4,서울역,9316,10864,20200307,20180
20200304,4,숙대입구,10261,10183,20200307,20444
20200304,4,삼각지,3909,4184,20200307,8093
20200304,4,신용산,12243,12775,20200307,25018
20200304,4,이촌,4849,5513,20200307,10362
20200304,4,동작,1601,1685,20200307,3286
20200304,4,총신대입구,14729,16204,20200307,30933
20200304,4,사당,18573,15783,20200307,34356
20200304,4,남태령,757,671,20200307,1428
20200305,4,당고개,9935,9202,20200308,19137
20200305,4,상계,15997,14578,20200308,30575
20200305,4,노원,15200,17110,20200308,32310
20200305,4,창동,21405,23018,20200308,44423
20200305,4,쌍문,25236,23141,20200308,48377
20200305,4,수유,28832,28816,20200308,57648
20200305,4,미아,12549,12040,20200308,24589
20200305,4,미아사거리,22851,22006,20200308,44857
20200305,4,길음,15940,14976,20200308,30916
20200305,4,성신여대입구,15525,14899,20200308,30424
20200305,4,한성대입구,10341,10088,20200308,20429
20200305,4,혜화,21208,21460,20200308,42668
20200305,4,동대문,16752,17389,20200308,34141
20200305,4,동대문역사문화공원,12521,12015,20200308,24536
20200305,4,충무로,23256,24146,20200308,47402
20200305,4,명동,14207,14881,20200308,29088
20200305,4,회현,18352,19671,20200308,38023
20200305,4,서울역,9401,11211,20200308,20612
20200305,4,숙대입구,10375,10307,20200308,20682
20200305,4,삼각지,3916,4147,20200308,8063
20200305,4,신용산,12032,12839,20200308,24871
20200305,4,이촌,4738,5508,20200308,10246
20200305,4,동작,1659,1730,20200308,3389
20200305,4,총신대입구,14918,16500,20200308,31418
20200305,4,사당,18752,15975,20200308,34727
20200305,4,남태령,734,650,20200308,1384
20200306,4,당고개,10329,9620,20200309,19949
20200306,4,상계,16171,14769,20200309,30940
20200306,4,노원,16054,18747,20200309,34801
20200306,4,창동,22045,23521,20200309,45566
20200306,4,쌍문,26012,23353,20200309,49365
20200306,4,수유,29784,30259,20200309,60043
20200306,4,미아,12949,12338,20200309,25287
20200306,4,미아사거리,23586,23047,20200309,46633
20200306,4,길음,16386,15255,20200309,31641
20200306,4,성신여대입구,16285,15792,20200309,32077
20200306,4,한성대입구,10819,10384,20200309,21203
20200306,4,혜화,22001,22373,20200309,44374
20200306,4,동대문,17020,17626,20200309,34646
20200306,4,동대문역사문화공원,12811,12149,20200309,24960
20200306,4,충무로,23149,24206,20200309,47355
20200306,4,명동,14122,14861,20200309,28983
20200306,4,회현,18775,20050,20200309,38825
20200306,4,서울역,9374,11681,20200309,21055
20200306,4,숙대입구,10741,10613,20200309,21354
20200306,4,삼각지,3973,4323,20200309,8296
20200306,4,신용산,12678,13338,20200309,26016
20200306,4,이촌,4999,5770,20200309,10769
20200306,4,동작,1805,1866,20200309,3671
20200306,4,총신대입구,15799,17419,20200309,33218
20200306,4,사당,20367,17257,20200309,37624
20200306,4,남태령,838,679,20200309,1517
20200307,4,당고개,6993,6645,20200310,13638
20200307,4,상계,9917,9187,20200310,19104
20200307,4,노원,11127,12806,20200310,23933
20200307,4,창동,13863,14682,20200310,28545
20200307,4,쌍문,15872,14061,20200310,29933
20200307,4,수유,19132,19335,20200310,38467
20200307,4,미아,8399,7635,20200310,16034
20200307,4,미아사거리,15411,14817,20200310,30228
20200307,4,길음,9125,8601,20200310,17726
20200307,4,성신여대입구,11358,10742,20200310,22100
20200307,4,한성대입구,6943,6606,20200310,13549
20200307,4,혜화,14626,15397,20200310,30023
20200307,4,동대문,9018,8911,20200310,17929
20200307,4,동대문역사문화공원,7547,6485,20200310,14032
20200307,4,충무로,8785,9198,20200310,17983
20200307,4,명동,8145,8773,20200310,16918
20200307,4,회현,9994,10547,20200310,20541
20200307,4,서울역,3399,5358,20200310,8757
20200307,4,숙대입구,5777,5630,20200310,11407
20200307,4,삼각지,1737,2055,20200310,3792
20200307,4,신용산,5471,5842,20200310,11313
20200307,4,이촌,2695,3186,20200310,5881
20200307,4,동작,1244,1356,20200310,2600
20200307,4,총신대입구,9864,10549,20200310,20413
20200307,4,사당,12557,10996,20200310,23553
20200307,4,남태령,475,351,20200310,826
20200308,4,당고개,5251,5012,20200311,10263
20200308,4,상계,7181,6693,20200311,13874
20200308,4,노원,7923,8586,20200311,16509
20200308,4,창동,9717,10325,20200311,20042
20200308,4,쌍문,11118,9639,20200311,20757
20200308,4,수유,14179,13128,20200311,27307
20200308,4,미아,5662,5278,20200311,10940
20200308,4,미아사거리,10808,10155,20200311,20963
20200308,4,길음,6385,6090,20200311,12475
20200308,4,성신여대입구,8218,7727,20200311,15945
20200308,4,한성대입구,4906,4873,20200311,9779
20200308,4,혜화,11531,12207,20200311,23738
20200308,4,동대문,3716,4339,20200311,8055
20200308,4,동대문역사문화공원,5471,5850,20200311,11321
20200308,4,충무로,4899,5076,20200311,9975
20200308,4,명동,5851,6399,20200311,12250
20200308,4,회현,4855,5284,20200311,10139
20200308,4,서울역,2396,4326,20200311,6722
20200308,4,숙대입구,4220,4076,20200311,8296
20200308,4,삼각지,1152,1561,20200311,2713
20200308,4,신용산,3824,3922,20200311,7746
20200308,4,이촌,1988,2458,20200311,4446
20200308,4,동작,1263,1315,20200311,2578
20200308,4,총신대입구,6422,6948,20200311,13370
20200308,4,사당,8730,8626,20200311,17356
20200308,4,남태령,354,281,20200311,635
20200309,4,당고개,10555,9571,20200312,20126
20200309,4,상계,16608,15124,20200312,31732
20200309,4,노원,16070,17970,20200312,34040
20200309,4,창동,21823,23314,20200312,45137
20200309,4,쌍문,26309,23892,20200312,50201
20200309,4,수유,29999,29841,20200312,59840
20200309,4,미아,13291,12707,20200312,25998
20200309,4,미아사거리,23434,22942,20200312,46376
20200309,4,길음,16564,15724,20200312,32288
20200309,4,성신여대입구,16100,15297,20200312,31397
20200309,4,한성대입구,10748,10592,20200312,21340
20200309,4,혜화,21179,21449,20200312,42628
20200309,4,동대문,17373,18093,20200312,35466
20200309,4,동대문역사문화공원,12650,12231,20200312,24881
20200309,4,충무로,23273,24448,20200312,47721
20200309,4,명동,14057,14643,20200312,28700
20200309,4,회현,19109,20442,20200312,39551
20200309,4,서울역,9666,11596,20200312,21262
20200309,4,숙대입구,10866,10764,20200312,21630
20200309,4,삼각지,4007,4261,20200312,8268
20200309,4,신용산,12835,13490,20200312,26325
20200309,4,이촌,4856,5733,20200312,10589
20200309,4,동작,1927,1923,20200312,3850
20200309,4,총신대입구,15691,17292,20200312,32983
20200309,4,사당,19585,16651,20200312,36236
20200309,4,남태령,837,678,20200312,1515
20200310,4,당고개,9697,9048,20200313,18745
20200310,4,상계,15994,14526,20200313,30520
20200310,4,노원,15121,17044,20200313,32165
20200310,4,창동,20811,22100,20200313,42911
20200310,4,쌍문,25240,23137,20200313,48377
20200310,4,수유,28763,28731,20200313,57494
20200310,4,미아,12464,12080,20200313,24544
20200310,4,미아사거리,22612,22290,20200313,44902
20200310,4,길음,15997,15360,20200313,31357
20200310,4,성신여대입구,15379,14753,20200313,30132
20200310,4,한성대입구,10459,10113,20200313,20572
20200310,4,혜화,21783,22202,20200313,43985
20200310,4,동대문,16635,17135,20200313,33770
20200310,4,동대문역사문화공원,12453,11751,20200313,24204
20200310,4,충무로,23405,23991,20200313,47396
20200310,4,명동,13287,13887,20200313,27174
20200310,4,회현,18373,19363,20200313,37736
20200310,4,서울역,9534,11316,20200313,20850
20200310,4,숙대입구,10611,10445,20200313,21056
20200310,4,삼각지,3966,4176,20200313,8142
20200310,4,신용산,12570,13206,20200313,25776
20200310,4,이촌,4771,5519,20200313,10290
20200310,4,동작,1514,1576,20200313,3090
20200310,4,총신대입구,14636,16321,20200313,30957
20200310,4,사당,19151,16090,20200313,35241
20200310,4,남태령,765,646,20200313,1411
20200311,4,당고개,10293,9376,20200314,19669
20200311,4,상계,16401,14948,20200314,31349
20200311,4,노원,15694,17842,20200314,33536
20200311,4,창동,21856,23294,20200314,45150
20200311,4,쌍문,25904,23816,20200314,49720
20200311,4,수유,29618,29585,20200314,59203
20200311,4,미아,12899,12386,20200314,25285
20200311,4,미아사거리,23692,22927,20200314,46619
20200311,4,길음,16359,15556,20200314,31915
20200311,4,성신여대입구,16094,15243,20200314,31337
20200311,4,한성대입구,10739,10464,20200314,21203
20200311,4,혜화,23353,23833,20200314,47186
20200311,4,동대문,17273,17871,20200314,35144
20200311,4,동대문역사문화공원,12910,12242,20200314,25152
20200311,4,충무로,23890,24578,20200314,48468
20200311,4,명동,13851,14260,20200314,28111
20200311,4,회현,19025,20258,20200314,39283
20200311,4,서울역,9599,11761,20200314,21360
20200311,4,숙대입구,10725,10715,20200314,21440
20200311,4,삼각지,4013,4261,20200314,8274
20200311,4,신용산,12848,13473,20200314,26321
20200311,4,이촌,4977,5747,20200314,10724
20200311,4,동작,1867,1956,20200314,3823
20200311,4,총신대입구,15762,17160,20200314,32922
20200311,4,사당,20079,16758,20200314,36837
20200311,4,남태령,806,711,20200314,1517
20200312,4,당고개,10187,9428,20200315,19615
20200312,4,상계,16187,14725,20200315,30912
20200312,4,노원,15503,17437,20200315,32940
20200312,4,창동,21555,22953,20200315,44508
20200312,4,쌍문,25654,23311,20200315,48965
20200312,4,수유,29351,29158,20200315,58509
20200312,4,미아,12809,12328,20200315,25137
20200312,4,미아사거리,22994,22516,20200315,45510
20200312,4,길음,16137,15291,20200315,31428
20200312,4,성신여대입구,15665,15075,20200315,30740
20200312,4,한성대입구,10608,10297,20200315,20905
20200312,4,혜화,22497,23026,20200315,45523
20200312,4,동대문,16845,17631,20200315,34476
20200312,4,동대문역사문화공원,12509,11832,20200315,24341
20200312,4,충무로,23349,24244,20200315,47593
20200312,4,명동,13532,14066,20200315,27598
20200312,4,회현,18489,19832,20200315,38321
20200312,4,서울역,9568,11526,20200315,21094
20200312,4,숙대입구,10652,10462,20200315,21114
20200312,4,삼각지,3887,4290,20200315,8177
20200312,4,신용산,11452,12066,20200315,23518
20200312,4,이촌,4813,5629,20200315,10442
20200312,4,동작,1780,1923,20200315,3703
20200312,4,총신대입구,15062,16650,20200315,31712
20200312,4,사당,19549,16723,20200315,36272
20200312,4,남태령,841,685,20200315,1526
20200313,4,당고개,10290,9532,20200316,19822
20200313,4,상계,14792,14718,20200316,29510
20200313,4,노원,15910,18817,20200316,34727
20200313,4,창동,22340,23708,20200316,46048
20200313,4,쌍문,25458,24522,20200316,49980
20200313,4,수유,30154,30709,20200316,60863
20200313,4,미아,12852,12086,20200316,24938
20200313,4,미아사거리,23900,23227,20200316,47127
20200313,4,길음,16116,15404,20200316,31520
20200313,4,성신여대입구,16484,15837,20200316,32321
20200313,4,한성대입구,10751,10419,20200316,21170
20200313,4,혜화,23294,23284,20200316,46578
20200313,4,동대문,16756,17236,20200316,33992
20200313,4,동대문역사문화공원,12670,11925,20200316,24595
20200313,4,충무로,23375,24306,20200316,47681
20200313,4,명동,13611,13919,20200316,27530
20200313,4,회현,18401,19199,20200316,37600
20200313,4,서울역,8705,11225,20200316,19930
20200313,4,숙대입구,10824,10672,20200316,21496
20200313,4,삼각지,3905,4350,20200316,8255
20200313,4,신용산,11945,12267,20200316,24212
20200313,4,이촌,5009,5742,20200316,10751
20200313,4,동작,1811,1823,20200316,3634
20200313,4,총신대입구,15596,17343,20200316,32939
20200313,4,사당,21035,17651,20200316,38686
20200313,4,남태령,819,681,20200316,1500
20200314,4,당고개,7167,6822,20200317,13989
20200314,4,상계,10051,9577,20200317,19628
20200314,4,노원,11326,13047,20200317,24373
20200314,4,창동,14115,14994,20200317,29109
20200314,4,쌍문,16464,14493,20200317,30957
20200314,4,수유,19856,19629,20200317,39485
20200314,4,미아,8373,7871,20200317,16244
20200314,4,미아사거리,15986,15584,20200317,31570
20200314,4,길음,9693,9161,20200317,18854
20200314,4,성신여대입구,11591,10999,20200317,22590
20200314,4,한성대입구,7259,6956,20200317,14215
20200314,4,혜화,16101,16917,20200317,33018
20200314,4,동대문,9160,8827,20200317,17987
20200314,4,동대문역사문화공원,7557,6258,20200317,13815
20200314,4,충무로,9012,9340,20200317,18352
20200314,4,명동,8000,8794,20200317,16794
20200314,4,회현,10155,10652,20200317,20807
20200314,4,서울역,3473,5967,20200317,9440
20200314,4,숙대입구,6068,5861,20200317,11929
20200314,4,삼각지,1817,2238,20200317,4055
20200314,4,신용산,5638,6126,20200317,11764
20200314,4,이촌,2868,3407,20200317,6275
20200314,4,동작,1359,1384,20200317,2743
20200314,4,총신대입구,10103,11010,20200317,21113
20200314,4,사당,13952,12034,20200317,25986
20200314,4,남태령,463,386,20200317,849
20200315,4,당고개,5325,5186,20200318,10511
20200315,4,상계,7040,6486,20200318,13526
20200315,4,노원,7789,8396,20200318,16185
20200315,4,창동,9709,10137,20200318,19846
20200315,4,쌍문,10741,9415,20200318,20156
20200315,4,수유,14036,13116,20200318,27152
20200315,4,미아,5728,5309,20200318,11037
20200315,4,미아사거리,10919,10297,20200318,21216
20200315,4,길음,6299,6163,20200318,12462
20200315,4,성신여대입구,8101,7815,20200318,15916
20200315,4,한성대입구,4707,4867,20200318,9574
20200315,4,혜화,12087,12470,20200318,24557
20200315,4,동대문,3610,4251,20200318,7861
20200315,4,동대문역사문화공원,5339,5559,20200318,10898
20200315,4,충무로,4864,4872,20200318,9736
20200315,4,명동,5339,5685,20200318,11024
20200315,4,회현,4900,5237,20200318,10137
20200315,4,서울역,2587,4500,20200318,7087
20200315,4,숙대입구,4221,4089,20200318,8310
20200315,4,삼각지,1169,1460,20200318,2629
20200315,4,신용산,3975,4144,20200318,8119
20200315,4,이촌,1927,2316,20200318,4243
20200315,4,동작,989,1008,20200318,1997
20200315,4,총신대입구,6197,6726,20200318,12923
20200315,4,사당,9323,8927,20200318,18250
20200315,4,남태령,318,276,20200318,594
20200316,4,당고개,10168,9398,20200319,19566
20200316,4,상계,16406,14849,20200319,31255
20200316,4,노원,15707,17685,20200319,33392
20200316,4,창동,21173,22847,20200319,44020
20200316,4,쌍문,25900,23679,20200319,49579
20200316,4,수유,29615,29616,20200319,59231
20200316,4,미아,12822,12270,20200319,25092
20200316,4,미아사거리,23127,22595,20200319,45722
20200316,4,길음,16215,15677,20200319,31892
20200316,4,성신여대입구,15833,15288,20200319,31121
20200316,4,한성대입구,10447,10285,20200319,20732
20200316,4,혜화,21544,21742,20200319,43286
20200316,4,동대문,17430,18042,20200319,35472
20200316,4,동대문역사문화공원,12706,12048,20200319,24754
20200316,4,충무로,23258,24235,20200319,47493
20200316,4,명동,13727,14022,20200319,27749
20200316,4,회현,16412,17857,20200319,34269
20200316,4,서울역,9453,11439,20200319,20892
20200316,4,숙대입구,10629,10470,20200319,21099
20200316,4,삼각지,3875,4161,20200319,8036
20200316,4,신용산,12529,13021,20200319,25550
20200316,4,이촌,4954,5763,20200319,10717
20200316,4,동작,1824,1931,20200319,3755
20200316,4,총신대입구,15441,17076,20200319,32517
20200316,4,사당,19468,16591,20200319,36059
20200316,4,남태령,769,689,20200319,1458
20200317,4,당고개,10130,9369,20200320,19499
20200317,4,상계,16078,14722,20200320,30800
20200317,4,노원,15723,17727,20200320,33450
20200317,4,창동,21105,22677,20200320,43782
20200317,4,쌍문,25639,23380,20200320,49019
20200317,4,수유,29644,29317,20200320,58961
20200317,4,미아,12585,12374,20200320,24959
20200317,4,미아사거리,23167,22624,20200320,45791
20200317,4,길음,16227,15573,20200320,31800
20200317,4,성신여대입구,15824,15261,20200320,31085
20200317,4,한성대입구,10654,10308,20200320,20962
20200317,4,혜화,22459,22714,20200320,45173
20200317,4,동대문,16946,17547,20200320,34493
20200317,4,동대문역사문화공원,12481,12050,20200320,24531
20200317,4,충무로,23310,24075,20200320,47385
20200317,4,명동,13596,14061,20200320,27657
20200317,4,회현,18683,20100,20200320,38783
20200317,4,서울역,9434,11344,20200320,20778
20200317,4,숙대입구,10836,10602,20200320,21438
20200317,4,삼각지,3877,4134,20200320,8011
20200317,4,신용산,12432,12970,20200320,25402
20200317,4,이촌,4844,5667,20200320,10511
20200317,4,동작,1812,1888,20200320,3700
20200317,4,총신대입구,15190,16785,20200320,31975
20200317,4,사당,19709,16670,20200320,36379
20200317,4,남태령,794,676,20200320,1470
20200318,4,당고개,10638,9879,20200321,20517
20200318,4,상계,16571,15311,20200321,31882
20200318,4,노원,16312,18486,20200321,34798
20200318,4,창동,22250,23952,20200321,46202
20200318,4,쌍문,26472,24031,20200321,50503
20200318,4,수유,30342,30127,20200321,60469
20200318,4,미아,13095,12641,20200321,25736
20200318,4,미아사거리,24148,23336,20200321,47484
20200318,4,길음,16678,15846,20200321,32524
20200318,4,성신여대입구,16321,15648,20200321,31969
20200318,4,한성대입구,10936,10685,20200321,21621
20200318,4,혜화,23910,24437,20200321,48347
20200318,4,동대문,17478,18114,20200321,35592
20200318,4,동대문역사문화공원,12752,12096,20200321,24848
20200318,4,충무로,23834,24629,20200321,48463
20200318,4,명동,13775,14313,20200321,28088
20200318,4,회현,19237,20764,20200321,40001
20200318,4,서울역,9471,11542,20200321,21013
20200318,4,숙대입구,10911,10968,20200321,21879
20200318,4,삼각지,4012,4326,20200321,8338
20200318,4,신용산,12591,13241,20200321,25832
20200318,4,이촌,5106,5876,20200321,10982
20200318,4,동작,2125,2195,20200321,4320
20200318,4,총신대입구,15872,17299,20200321,33171
20200318,4,사당,20621,17292,20200321,37913
20200318,4,남태령,793,701,20200321,1494
20200319,4,당고개,9741,8850,20200322,18591
20200319,4,상계,15604,14415,20200322,30019
20200319,4,노원,15430,17184,20200322,32614
20200319,4,창동,20877,22532,20200322,43409
20200319,4,쌍문,25536,23327,20200322,48863
20200319,4,수유,28844,28777,20200322,57621
20200319,4,미아,12372,11880,20200322,24252
20200319,4,미아사거리,22746,22005,20200322,44751
20200319,4,길음,16005,15352,20200322,31357
20200319,4,성신여대입구,15462,14770,20200322,30232
20200319,4,한성대입구,10445,10152,20200322,20597
20200319,4,혜화,22379,22477,20200322,44856
20200319,4,동대문,16449,17095,20200322,33544
20200319,4,동대문역사문화공원,12206,11528,20200322,23734
20200319,4,충무로,23227,24052,20200322,47279
20200319,4,명동,13126,13744,20200322,26870
20200319,4,회현,17991,19231,20200322,37222
20200319,4,서울역,9164,11180,20200322,20344
20200319,4,숙대입구,10398,10323,20200322,20721
20200319,4,삼각지,3849,4167,20200322,8016
20200319,4,신용산,12578,12994,20200322,25572
20200319,4,이촌,4603,5422,20200322,10025
20200319,4,동작,1632,1731,20200322,3363
20200319,4,총신대입구,14553,16115,20200322,30668
20200319,4,사당,19583,16604,20200322,36187
20200319,4,남태령,761,661,20200322,1422
20200320,4,당고개,10809,10036,20200323,20845
20200320,4,상계,17102,15537,20200323,32639
20200320,4,노원,17262,20316,20200323,37578
20200320,4,창동,23155,24843,20200323,47998
20200320,4,쌍문,27311,24280,20200323,51591
20200320,4,수유,31139,31459,20200323,62598
20200320,4,미아,13551,12934,20200323,26485
20200320,4,미아사거리,25189,24493,20200323,49682
20200320,4,길음,17382,16221,20200323,33603
20200320,4,성신여대입구,17428,16631,20200323,34059
20200320,4,한성대입구,11398,11080,20200323,22478
20200320,4,혜화,24172,24735,20200323,48907
20200320,4,동대문,17733,18373,20200323,36106
20200320,4,동대문역사문화공원,13033,12332,20200323,25365
20200320,4,충무로,23657,24794,20200323,48451
20200320,4,명동,14087,14650,20200323,28737
20200320,4,회현,19326,20762,20200323,40088
20200320,4,서울역,9419,12268,20200323,21687
20200320,4,숙대입구,11146,10996,20200323,22142
20200320,4,삼각지,4095,4549,20200323,8644
20200320,4,신용산,13673,14248,20200323,27921
20200320,4,이촌,5097,6013,20200323,11110
20200320,4,동작,2036,2095,20200323,4131
20200320,4,총신대입구,16564,18213,20200323,34777
20200320,4,사당,22348,18558,20200323,40906
20200320,4,남태령,872,697,20200323,1569
20200321,4,당고개,7614,7266,20200324,14880
20200321,4,상계,10741,9897,20200324,20638
20200321,4,노원,11942,13831,20200324,25773
20200321,4,창동,14908,15856,20200324,30764
20200321,4,쌍문,16929,14925,20200324,31854
20200321,4,수유,20893,20557,20200324,41450
20200321,4,미아,8764,8238,20200324,17002
20200321,4,미아사거리,16851,16163,20200324,33014
20200321,4,길음,10079,9290,20200324,19369
20200321,4,성신여대입구,12376,11507,20200324,23883
20200321,4,한성대입구,7475,7077,20200324,14552
20200321,4,혜화,17088,18131,20200324,35219
20200321,4,동대문,9693,9263,20200324,18956
20200321,4,동대문역사문화공원,7702,6515,20200324,14217
20200321,4,충무로,9231,9732,20200324,18963
20200321,4,명동,7972,8666,20200324,16638
20200321,4,회현,10355,11239,20200324,21594
20200321,4,서울역,3677,6335,20200324,10012
20200321,4,숙대입구,6263,6014,20200324,12277
20200321,4,삼각지,1831,2219,20200324,4050
20200321,4,신용산,5808,6132,20200324,11940
20200321,4,이촌,3108,3879,20200324,6987
20200321,4,동작,1603,1631,20200324,3234
20200321,4,총신대입구,10364,11365,20200324,21729
20200321,4,사당,14550,13037,20200324,27587
20200321,4,남태령,568,420,20200324,988
20200322,4,당고개,5819,5628,20200325,11447
20200322,4,상계,7580,7067,20200325,14647
20200322,4,노원,8175,8905,20200325,17080
20200322,4,창동,10259,10734,20200325,20993
20200322,4,쌍문,11466,10002,20200325,21468
20200322,4,수유,14764,13941,20200325,28705
20200322,4,미아,5820,5488,20200325,11308
20200322,4,미아사거리,11622,10834,20200325,22456
20200322,4,길음,6669,6565,20200325,13234
20200322,4,성신여대입구,8618,8231,20200325,16849
20200322,4,한성대입구,5104,5193,20200325,10297
20200322,4,혜화,13041,13777,20200325,26818
20200322,4,동대문,4127,4667,20200325,8794
20200322,4,동대문역사문화공원,5573,5845,20200325,11418
20200322,4,충무로,5151,5331,20200325,10482
20200322,4,명동,5827,6166,20200325,11993
20200322,4,회현,4987,5253,20200325,10240
20200322,4,서울역,2542,4638,20200325,7180
20200322,4,숙대입구,4301,4179,20200325,8480
20200322,4,삼각지,1214,1462,20200325,2676
20200322,4,신용산,4087,4036,20200325,8123
20200322,4,이촌,2150,2835,20200325,4985
20200322,4,동작,1557,1546,20200325,3103
20200322,4,총신대입구,6844,7414,20200325,14258
20200322,4,사당,9715,9572,20200325,19287
20200322,4,남태령,399,312,20200325,711
20200323,4,당고개,10515,9637,20200326,20152
20200323,4,상계,16530,15153,20200326,31683
20200323,4,노원,16314,18177,20200326,34491
20200323,4,창동,21911,23376,20200326,45287
20200323,4,쌍문,26398,24018,20200326,50416
20200323,4,수유,30176,29806,20200326,59982
20200323,4,미아,13232,12720,20200326,25952
20200323,4,미아사거리,23994,23429,20200326,47423
20200323,4,길음,16773,16276,20200326,33049
20200323,4,성신여대입구,16039,15260,20200326,31299
20200323,4,한성대입구,10679,10483,20200326,21162
20200323,4,혜화,21896,22250,20200326,44146
20200323,4,동대문,17440,18158,20200326,35598
20200323,4,동대문역사문화공원,12712,12108,20200326,24820
20200323,4,충무로,23218,24222,20200326,47440
20200323,4,명동,14025,14581,20200326,28606
20200323,4,회현,19081,20487,20200326,39568
20200323,4,서울역,9273,11344,20200326,20617
20200323,4,숙대입구,10589,10533,20200326,21122
20200323,4,삼각지,3993,4164,20200326,8157
20200323,4,신용산,12682,13298,20200326,25980
20200323,4,이촌,5034,5737,20200326,10771
20200323,4,동작,2073,2156,20200326,4229
20200323,4,총신대입구,15647,17357,20200326,33004
20200323,4,사당,19900,16838,20200326,36738
20200323,4,남태령,810,688,20200326,1498
20200324,4,당고개,10410,9726,20200327,20136
20200324,4,상계,16696,14988,20200327,31684
20200324,4,노원,16180,18384,20200327,34564
20200324,4,창동,21965,23512,20200327,45477
20200324,4,쌍문,26557,24301,20200327,50858
20200324,4,수유,30038,29876,20200327,59914
20200324,4,미아,13134,12723,20200327,25857
20200324,4,미아사거리,23879,23301,20200327,47180
20200324,4,길음,16838,16036,20200327,32874
20200324,4,성신여대입구,16276,15339,20200327,31615
20200324,4,한성대입구,10834,10670,20200327,21504
20200324,4,혜화,23571,24055,20200327,47626
20200324,4,동대문,17734,18216,20200327,35950
20200324,4,동대문역사문화공원,12816,12080,20200327,24896
20200324,4,충무로,23527,24636,20200327,48163
20200324,4,명동,13916,14497,20200327,28413
20200324,4,회현,19393,20670,20200327,40063
20200324,4,서울역,9517,11406,20200327,20923
20200324,4,숙대입구,10801,10757,20200327,21558
20200324,4,삼각지,3991,4299,20200327,8290
20200324,4,신용산,12501,13205,20200327,25706
20200324,4,이촌,4955,5787,20200327,10742
20200324,4,동작,2087,2187,20200327,4274
20200324,4,총신대입구,15719,17259,20200327,32978
20200324,4,사당,20491,17154,20200327,37645
20200324,4,남태령,823,697,20200327,1520
20200325,4,당고개,10800,9895,20200328,20695
20200325,4,상계,16967,15451,20200328,32418
20200325,4,노원,16775,18942,20200328,35717
20200325,4,창동,22488,24066,20200328,46554
20200325,4,쌍문,26941,24412,20200328,51353
20200325,4,수유,30764,30597,20200328,61361
20200325,4,미아,13334,12863,20200328,26197
20200325,4,미아사거리,24604,23730,20200328,48334
20200325,4,길음,17032,16367,20200328,33399
20200325,4,성신여대입구,16571,15784,20200328,32355
20200325,4,한성대입구,10955,10578,20200328,21533
20200325,4,혜화,24327,24779,20200328,49106
20200325,4,동대문,18012,18556,20200328,36568
20200325,4,동대문역사문화공원,13018,12297,20200328,25315
20200325,4,충무로,23892,25047,20200328,48939
20200325,4,명동,14049,14689,20200328,28738
20200325,4,회현,19321,20741,20200328,40062
20200325,4,서울역,9577,11718,20200328,21295
20200325,4,숙대입구,10855,10770,20200328,21625
20200325,4,삼각지,3983,4277,20200328,8260
20200325,4,신용산,12931,13432,20200328,26363
20200325,4,이촌,5068,5974,20200328,11042
20200325,4,동작,2161,2198,20200328,4359
20200325,4,총신대입구,16161,17774,20200328,33935
20200325,4,사당,20817,17455,20200328,38272
20200325,4,남태령,845,683,20200328,1528
20200326,4,당고개,10367,9663,20200329,20030
20200326,4,상계,16573,15286,20200329,31859
20200326,4,노원,16340,18215,20200329,34555
20200326,4,창동,22003,23553,20200329,45556
20200326,4,쌍문,26258,23884,20200329,50142
20200326,4,수유,29655,29601,20200329,59256
20200326,4,미아,13046,12508,20200329,25554
20200326,4,미아사거리,23610,23256,20200329,46866
20200326,4,길음,16850,16051,20200329,32901
20200326,4,성신여대입구,16435,15598,20200329,32033
20200326,4,한성대입구,10706,10418,20200329,21124
20200326,4,혜화,23256,23709,20200329,46965
20200326,4,동대문,17510,17977,20200329,35487
20200326,4,동대문역사문화공원,12709,12133,20200329,24842
20200326,4,충무로,23810,24610,20200329,48420
20200326,4,명동,13576,14165,20200329,27741
20200326,4,회현,19172,20441,20200329,39613
20200326,4,서울역,9388,11511,20200329,20899
20200326,4,숙대입구,10788,10679,20200329,21467
20200326,4,삼각지,3964,4218,20200329,8182
20200326,4,신용산,12818,13336,20200329,26154
20200326,4,이촌,4941,5787,20200329,10728
20200326,4,동작,1942,1995,20200329,3937
20200326,4,총신대입구,15465,16830,20200329,32295
20200326,4,사당,20299,17220,20200329,37519
20200326,4,남태령,791,678,20200329,1469
20200327,4,당고개,10639,9852,20200330,20491
20200327,4,상계,16974,15355,20200330,32329
20200327,4,노원,17136,19742,20200330,36878
20200327,4,창동,22653,24297,20200330,46950
20200327,4,쌍문,27101,24233,20200330,51334
20200327,4,수유,31152,31273,20200330,62425
20200327,4,미아,13402,12587,20200330,25989
20200327,4,미아사거리,24806,24157,20200330,48963
20200327,4,길음,17181,16236,20200330,33417
20200327,4,성신여대입구,17232,16466,20200330,33698
20200327,4,한성대입구,11152,10718,20200330,21870
20200327,4,혜화,24333,24471,20200330,48804
20200327,4,동대문,17972,18590,20200330,36562
20200327,4,동대문역사문화공원,13221,12353,20200330,25574
20200327,4,충무로,23609,24957,20200330,48566
20200327,4,명동,14290,14632,20200330,28922
20200327,4,회현,19282,20772,20200330,40054
20200327,4,서울역,9409,12525,20200330,21934
20200327,4,숙대입구,11130,11016,20200330,22146
20200327,4,삼각지,4041,4485,20200330,8526
20200327,4,신용산,13534,14142,20200330,27676
20200327,4,이촌,5262,6087,20200330,11349
20200327,4,동작,2122,2220,20200330,4342
20200327,4,총신대입구,16521,18525,20200330,35046
20200327,4,사당,22097,18660,20200330,40757
20200327,4,남태령,864,688,20200330,1552
20200328,4,당고개,7640,7474,20200331,15114
20200328,4,상계,10919,10101,20200331,21020
20200328,4,노원,12039,13798,20200331,25837
20200328,4,창동,15107,16059,20200331,31166
20200328,4,쌍문,17209,15352,20200331,32561
20200328,4,수유,20962,20628,20200331,41590
20200328,4,미아,8671,8180,20200331,16851
20200328,4,미아사거리,17187,16494,20200331,33681
20200328,4,길음,10355,9662,20200331,20017
20200328,4,성신여대입구,12464,11866,20200331,24330
20200328,4,한성대입구,7491,7318,20200331,14809
20200328,4,혜화,17203,18134,20200331,35337
20200328,4,동대문,10152,9903,20200331,20055
20200328,4,동대문역사문화공원,7846,6599,20200331,14445
20200328,4,충무로,9519,9987,20200331,19506
20200328,4,명동,8464,9071,20200331,17535
20200328,4,회현,11051,11870,20200331,22921
20200328,4,서울역,3523,6131,20200331,9654
20200328,4,숙대입구,6508,6136,20200331,12644
20200328,4,삼각지,1857,2168,20200331,4025
20200328,4,신용산,5915,6249,20200331,12164
20200328,4,이촌,3200,3892,20200331,7092
20200328,4,동작,1699,1793,20200331,3492
20200328,4,총신대입구,10760,11551,20200331,22311
20200328,4,사당,14539,12807,20200331,27346
20200328,4,남태령,510,388,20200331,898
20200329,4,당고개,5704,5529,20200401,11233
20200329,4,상계,7708,7166,20200401,14874
20200329,4,노원,8245,9047,20200401,17292
20200329,4,창동,10522,11064,20200401,21586
20200329,4,쌍문,11696,10229,20200401,21925
20200329,4,수유,15108,14003,20200401,29111
20200329,4,미아,5932,5488,20200401,11420
20200329,4,미아사거리,11631,10988,20200401,22619
20200329,4,길음,6791,6736,20200401,13527
20200329,4,성신여대입구,8849,8252,20200401,17101
20200329,4,한성대입구,5040,5155,20200401,10195
20200329,4,혜화,12612,13283,20200401,25895
20200329,4,동대문,4299,4830,20200401,9129
20200329,4,동대문역사문화공원,5619,5882,20200401,11501
20200329,4,충무로,5370,5564,20200401,10934
20200329,4,명동,5677,6123,20200401,11800
20200329,4,회현,5051,5422,20200401,10473
20200329,4,서울역,2473,4716,20200401,7189
20200329,4,숙대입구,4364,4165,20200401,8529
20200329,4,삼각지,1281,1621,20200401,2902
20200329,4,신용산,4226,4180,20200401,8406
20200329,4,이촌,2140,2776,20200401,4916
20200329,4,동작,1636,1632,20200401,3268
20200329,4,총신대입구,6899,7621,20200401,14520
20200329,4,사당,9757,9514,20200401,19271
20200329,4,남태령,366,300,20200401,666
20200330,4,당고개,10778,9805,20200402,20583
20200330,4,상계,16826,15362,20200402,32188
20200330,4,노원,16211,18400,20200402,34611
20200330,4,창동,21949,23357,20200402,45306
20200330,4,쌍문,26872,24268,20200402,51140
20200330,4,수유,30352,30291,20200402,60643
20200330,4,미아,13238,12742,20200402,25980
20200330,4,미아사거리,24189,23581,20200402,47770
20200330,4,길음,16892,16346,20200402,33238
20200330,4,성신여대입구,16179,15660,20200402,31839
20200330,4,한성대입구,10871,10613,20200402,21484
20200330,4,혜화,22191,22333,20200402,44524
20200330,4,동대문,18049,18698,20200402,36747
20200330,4,동대문역사문화공원,12881,12238,20200402,25119
20200330,4,충무로,23496,24489,20200402,47985
20200330,4,명동,13923,14416,20200402,28339
20200330,4,회현,19497,21035,20200402,40532
20200330,4,서울역,9628,11685,20200402,21313
20200330,4,숙대입구,10662,10693,20200402,21355
20200330,4,삼각지,3914,4259,20200402,8173
20200330,4,신용산,13174,13576,20200402,26750
20200330,4,이촌,5182,5994,20200402,11176
20200330,4,동작,2117,2361,20200402,4478
20200330,4,총신대입구,16048,17627,20200402,33675
20200330,4,사당,20011,16919,20200402,36930
20200330,4,남태령,854,675,20200402,1529
20200331,4,당고개,10658,9923,20200403,20581
20200331,4,상계,16919,15399,20200403,32318
20200331,4,노원,16491,18585,20200403,35076
20200331,4,창동,22264,23570,20200403,45834
20200331,4,쌍문,26766,24227,20200403,50993
20200331,4,수유,30631,30494,20200403,61125
20200331,4,미아,13256,12670,20200403,25926
20200331,4,미아사거리,24279,23577,20200403,47856
20200331,4,길음,17004,16076,20200403,33080
20200331,4,성신여대입구,16254,15686,20200403,31940
20200331,4,한성대입구,11084,10759,20200403,21843
20200331,4,혜화,22890,23181,20200403,46071
20200331,4,동대문,18282,18942,20200403,37224
20200331,4,동대문역사문화공원,12868,12200,20200403,25068
20200331,4,충무로,23739,24707,20200403,48446
20200331,4,명동,14165,14813,20200403,28978
20200331,4,회현,19984,21486,20200403,41470
20200331,4,서울역,9623,11662,20200403,21285
20200331,4,숙대입구,10887,10764,20200403,21651
20200331,4,삼각지,4024,4327,20200403,8351
20200331,4,신용산,13052,13622,20200403,26674
20200331,4,이촌,5163,5938,20200403,11101
20200331,4,동작,2313,2425,20200403,4738
20200331,4,총신대입구,15975,17879,20200403,33854
20200331,4,사당,20614,17083,20200403,37697
20200331,4,남태령,826,716,20200403,1542
20200401,4,당고개,10471,9626,20200404,20097
20200401,4,상계,17011,15388,20200404,32399
20200401,4,노원,16435,18552,20200404,34987
20200401,4,창동,22139,23588,20200404,45727
20200401,4,쌍문,26719,24290,20200404,51009
20200401,4,수유,30405,30177,20200404,60582
20200401,4,미아,13163,12682,20200404,25845
20200401,4,미아사거리,24418,23620,20200404,48038
20200401,4,길음,17136,16291,20200404,33427
20200401,4,성신여대입구,16678,15917,20200404,32595
20200401,4,한성대입구,11092,10970,20200404,22062
20200401,4,혜화,23977,24316,20200404,48293
20200401,4,동대문,18203,18606,20200404,36809
20200401,4,동대문역사문화공원,13032,12427,20200404,25459
20200401,4,충무로,23707,24828,20200404,48535
20200401,4,명동,14191,14700,20200404,28891
20200401,4,회현,19720,21086,20200404,40806
20200401,4,서울역,9700,11912,20200404,21612
20200401,4,숙대입구,10951,10826,20200404,21777
20200401,4,삼각지,4076,4374,20200404,8450
20200401,4,신용산,12816,13310,20200404,26126
20200401,4,이촌,5185,5962,20200404,11147
20200401,4,동작,2265,2398,20200404,4663
20200401,4,총신대입구,16270,17896,20200404,34166
20200401,4,사당,20759,17567,20200404,38326
20200401,4,남태령,831,674,20200404,1505
20200402,4,당고개,10589,9712,20200405,20301
20200402,4,상계,16650,15109,20200405,31759
20200402,4,노원,16318,18637,20200405,34955
20200402,4,창동,22267,23592,20200405,45859
20200402,4,쌍문,26469,23948,20200405,50417
20200402,4,수유,30219,29913,20200405,60132
20200402,4,미아,13252,12755,20200405,26007
20200402,4,미아사거리,24268,23616,20200405,47884
20200402,4,길음,17091,16166,20200405,33257
20200402,4,성신여대입구,16427,15608,20200405,32035
20200402,4,한성대입구,10773,10747,20200405,21520
20200402,4,혜화,23409,23773,20200405,47182
20200402,4,동대문,17995,18343,20200405,36338
20200402,4,동대문역사문화공원,12972,12316,20200405,25288
20200402,4,충무로,23464,24678,20200405,48142
20200402,4,명동,13642,14389,20200405,28031
20200402,4,회현,19687,21138,20200405,40825
20200402,4,서울역,9579,11936,20200405,21515
20200402,4,숙대입구,11079,10812,20200405,21891
20200402,4,삼각지,4031,4338,20200405,8369
20200402,4,신용산,12792,13236,20200405,26028
20200402,4,이촌,5070,5890,20200405,10960
20200402,4,동작,2343,2508,20200405,4851
20200402,4,총신대입구,16176,17730,20200405,33906
20200402,4,사당,20541,17532,20200405,38073
20200402,4,남태령,838,710,20200405,1548
20200403,4,당고개,10773,9840,20200406,20613
20200403,4,상계,17158,15467,20200406,32625
20200403,4,노원,17196,19982,20200406,37178
20200403,4,창동,22904,24406,20200406,47310
20200403,4,쌍문,27414,24403,20200406,51817
20200403,4,수유,31221,31837,20200406,63058
20200403,4,미아,13854,13004,20200406,26858
20200403,4,미아사거리,25493,24672,20200406,50165
20200403,4,길음,17458,16282,20200406,33740
20200403,4,성신여대입구,17486,16793,20200406,34279
20200403,4,한성대입구,11351,11210,20200406,22561
20200403,4,혜화,24075,24450,20200406,48525
20200403,4,동대문,18444,18934,20200406,37378
20200403,4,동대문역사문화공원,13214,12445,20200406,25659
20200403,4,충무로,23482,24944,20200406,48426
20200403,4,명동,14399,14890,20200406,29289
20200403,4,회현,19866,21348,20200406,41214
20200403,4,서울역,9661,12885,20200406,22546
20200403,4,숙대입구,11385,11189,20200406,22574
20200403,4,삼각지,4041,4551,20200406,8592
20200403,4,신용산,13513,14176,20200406,27689
20200403,4,이촌,5438,6089,20200406,11527
20200403,4,동작,2370,2498,20200406,4868
20200403,4,총신대입구,16912,18479,20200406,35391
20200403,4,사당,22276,19027,20200406,41303
20200403,4,남태령,915,755,20200406,1670
20200404,4,당고개,7425,7161,20200407,14586
20200404,4,상계,10822,10204,20200407,21026
20200404,4,노원,12439,13886,20200407,26325
20200404,4,창동,14825,15818,20200407,30643
20200404,4,쌍문,17144,15348,20200407,32492
20200404,4,수유,21359,21150,20200407,42509
20200404,4,미아,8895,8210,20200407,17105
20200404,4,미아사거리,17443,16910,20200407,34353
20200404,4,길음,10134,9758,20200407,19892
20200404,4,성신여대입구,12546,11711,20200407,24257
20200404,4,한성대입구,7658,7525,20200407,15183
20200404,4,혜화,16170,16767,20200407,32937
20200404,4,동대문,10339,9955,20200407,20294
20200404,4,동대문역사문화공원,8068,6727,20200407,14795
20200404,4,충무로,9566,9976,20200407,19542
20200404,4,명동,8717,9681,20200407,18398
20200404,4,회현,11236,11937,20200407,23173
20200404,4,서울역,3745,6476,20200407,10221
20200404,4,숙대입구,6480,6124,20200407,12604
20200404,4,삼각지,1834,2149,20200407,3983
20200404,4,신용산,5643,6211,20200407,11854
20200404,4,이촌,3397,4029,20200407,7426
20200404,4,동작,1653,1821,20200407,3474
20200404,4,총신대입구,10911,11863,20200407,22774
20200404,4,사당,14785,13054,20200407,27839
20200404,4,남태령,590,444,20200407,1034
20200405,4,당고개,5779,5699,20200408,11478
20200405,4,상계,7676,7077,20200408,14753
20200405,4,노원,8412,9255,20200408,17667
20200405,4,창동,10388,10831,20200408,21219
20200405,4,쌍문,11831,10404,20200408,22235
20200405,4,수유,15111,14076,20200408,29187
20200405,4,미아,5918,5652,20200408,11570
20200405,4,미아사거리,11954,11446,20200408,23400
20200405,4,길음,6984,6961,20200408,13945
20200405,4,성신여대입구,8667,8174,20200408,16841
20200405,4,한성대입구,5235,5425,20200408,10660
20200405,4,혜화,11955,12332,20200408,24287
20200405,4,동대문,4494,4823,20200408,9317
20200405,4,동대문역사문화공원,5475,5647,20200408,11122
20200405,4,충무로,5485,5563,20200408,11048
20200405,4,명동,6098,6408,20200408,12506
20200405,4,회현,5041,5474,20200408,10515
20200405,4,서울역,2577,4963,20200408,7540
20200405,4,숙대입구,4345,4110,20200408,8455
20200405,4,삼각지,1198,1408,20200408,2606
20200405,4,신용산,4198,4214,20200408,8412
20200405,4,이촌,2344,2846,20200408,5190
20200405,4,동작,1416,1557,20200408,2973
20200405,4,총신대입구,7144,7648,20200408,14792
20200405,4,사당,10059,9577,20200408,19636
20200405,4,남태령,407,311,20200408,718
20200406,4,당고개,10869,9933,20200409,20802
20200406,4,상계,17191,15601,20200409,32792
20200406,4,노원,16707,18754,20200409,35461
20200406,4,창동,22597,24082,20200409,46679
20200406,4,쌍문,27167,24592,20200409,51759
20200406,4,수유,30914,30620,20200409,61534
20200406,4,미아,13637,12958,20200409,26595
20200406,4,미아사거리,24622,24116,20200409,48738
20200406,4,길음,17551,16703,20200409,34254
20200406,4,성신여대입구,16720,16018,20200409,32738
20200406,4,한성대입구,10965,10930,20200409,21895
20200406,4,혜화,22604,22939,20200409,45543
20200406,4,동대문,18108,18652,20200409,36760
20200406,4,동대문역사문화공원,13047,12271,20200409,25318
20200406,4,충무로,24056,25265,20200409,49321
20200406,4,명동,14013,14687,20200409,28700
20200406,4,회현,20070,21403,20200409,41473
20200406,4,서울역,10303,12783,20200409,23086
20200406,4,숙대입구,11260,11071,20200409,22331
20200406,4,삼각지,4026,4334,20200409,8360
20200406,4,신용산,13110,13746,20200409,26856
20200406,4,이촌,5260,6019,20200409,11279
20200406,4,동작,2154,2244,20200409,4398
20200406,4,총신대입구,16246,17874,20200409,34120
20200406,4,사당,20513,17664,20200409,38177
20200406,4,남태령,896,729,20200409,1625
20200407,4,당고개,10785,10118,20200410,20903
20200407,4,상계,17237,15724,20200410,32961
20200407,4,노원,16880,19140,20200410,36020
20200407,4,창동,22971,24442,20200410,47413
20200407,4,쌍문,27256,24907,20200410,52163
20200407,4,수유,31087,30933,20200410,62020
20200407,4,미아,13553,13171,20200410,26724
20200407,4,미아사거리,24699,23812,20200410,48511
20200407,4,길음,17634,16881,20200410,34515
20200407,4,성신여대입구,16808,16072,20200410,32880
20200407,4,한성대입구,11227,11023,20200410,22250
20200407,4,혜화,24009,24424,20200410,48433
20200407,4,동대문,18290,18892,20200410,37182
20200407,4,동대문역사문화공원,13246,12477,20200410,25723
20200407,4,충무로,24516,25305,20200410,49821
20200407,4,명동,14533,15170,20200410,29703
20200407,4,회현,20431,21701,20200410,42132
20200407,4,서울역,10352,12641,20200410,22993
20200407,4,숙대입구,11316,11158,20200410,22474
20200407,4,삼각지,4097,4452,20200410,8549
20200407,4,신용산,13156,13674,20200410,26830
20200407,4,이촌,5381,6198,20200410,11579
20200407,4,동작,2225,2246,20200410,4471
20200407,4,총신대입구,16527,18220,20200410,34747
20200407,4,사당,21144,17846,20200410,38990
20200407,4,남태령,890,746,20200410,1636
20200408,4,당고개,10862,9965,20200411,20827
20200408,4,상계,17500,15795,20200411,33295
20200408,4,노원,16955,19271,20200411,36226
20200408,4,창동,23069,24618,20200411,47687
20200408,4,쌍문,27265,24643,20200411,51908
20200408,4,수유,31091,30942,20200411,62033
20200408,4,미아,13620,12978,20200411,26598
20200408,4,미아사거리,24937,24242,20200411,49179
20200408,4,길음,17612,16910,20200411,34522
20200408,4,성신여대입구,17010,16253,20200411,33263
20200408,4,한성대입구,11367,11245,20200411,22612
20200408,4,혜화,24724,25034,20200411,49758
20200408,4,동대문,18395,18935,20200411,37330
20200408,4,동대문역사문화공원,13250,12553,20200411,25803
20200408,4,충무로,24701,25708,20200411,50409
20200408,4,명동,14450,14993,20200411,29443
20200408,4,회현,20381,21739,20200411,42120
20200408,4,서울역,10300,12742,20200411,23042
20200408,4,숙대입구,11268,11191,20200411,22459
20200408,4,삼각지,4087,4466,20200411,8553
20200408,4,신용산,13242,13768,20200411,27010
20200408,4,이촌,5443,6209,20200411,11652
20200408,4,동작,2167,2289,20200411,4456
20200408,4,총신대입구,16632,18450,20200411,35082
20200408,4,사당,21516,18067,20200411,39583
20200408,4,남태령,895,768,20200411,1663
20200409,4,당고개,10767,9982,20200412,20749
20200409,4,상계,16999,15539,20200412,32538
20200409,4,노원,16910,19194,20200412,36104
20200409,4,창동,22793,24235,20200412,47028
20200409,4,쌍문,27198,24468,20200412,51666
20200409,4,수유,30678,30535,20200412,61213
20200409,4,미아,13513,12981,20200412,26494
20200409,4,미아사거리,24618,23850,20200412,48468
20200409,4,길음,17421,16441,20200412,33862
20200409,4,성신여대입구,16864,16240,20200412,33104
20200409,4,한성대입구,11152,11036,20200412,22188
20200409,4,혜화,23869,24311,20200412,48180
20200409,4,동대문,18167,18882,20200412,37049
20200409,4,동대문역사문화공원,13343,12650,20200412,25993
20200409,4,충무로,24528,25461,20200412,49989
20200409,4,명동,14577,15089,20200412,29666
20200409,4,회현,20241,21761,20200412,42002
20200409,4,서울역,10374,12780,20200412,23154
20200409,4,숙대입구,11413,11482,20200412,22895
20200409,4,삼각지,4090,4433,20200412,8523
20200409,4,신용산,13277,13839,20200412,27116
20200409,4,이촌,5372,6139,20200412,11511
20200409,4,동작,2249,2277,20200412,4526
20200409,4,총신대입구,16559,18130,20200412,34689
20200409,4,사당,21289,18235,20200412,39524
20200409,4,남태령,887,759,20200412,1646
20200410,4,당고개,11293,10226,20200413,21519
20200410,4,상계,17633,15923,20200413,33556
20200410,4,노원,17628,20675,20200413,38303
20200410,4,창동,23555,25003,20200413,48558
20200410,4,쌍문,27785,24665,20200413,52450
20200410,4,수유,32192,32011,20200413,64203
20200410,4,미아,13911,13242,20200413,27153
20200410,4,미아사거리,26054,25370,20200413,51424
20200410,4,길음,18146,16705,20200413,34851
20200410,4,성신여대입구,18015,17229,20200413,35244
20200410,4,한성대입구,11884,11621,20200413,23505
20200410,4,혜화,24873,25553,20200413,50426
20200410,4,동대문,18703,19222,20200413,37925
20200410,4,동대문역사문화공원,13503,12597,20200413,26100
20200410,4,충무로,24486,25718,20200413,50204
20200410,4,명동,14809,15630,20200413,30439
20200410,4,회현,20064,21463,20200413,41527
20200410,4,서울역,9731,13313,20200413,23044
20200410,4,숙대입구,11743,11477,20200413,23220
20200410,4,삼각지,4183,4590,20200413,8773
20200410,4,신용산,13571,14116,20200413,27687
20200410,4,이촌,5460,6187,20200413,11647
20200410,4,동작,2204,2299,20200413,4503
20200410,4,총신대입구,17263,19240,20200413,36503
20200410,4,사당,22827,19478,20200413,42305
20200410,4,남태령,902,736,20200413,1638
20200411,4,당고개,7888,7687,20200414,15575
20200411,4,상계,11435,10576,20200414,22011
20200411,4,노원,12887,14760,20200414,27647
20200411,4,창동,15726,16527,20200414,32253
20200411,4,쌍문,17660,15877,20200414,33537
20200411,4,수유,22226,21930,20200414,44156
20200411,4,미아,9226,8726,20200414,17952
20200411,4,미아사거리,18145,17579,20200414,35724
20200411,4,길음,10919,10310,20200414,21229
20200411,4,성신여대입구,13096,12132,20200414,25228
20200411,4,한성대입구,7771,7504,20200414,15275
20200411,4,혜화,17949,18815,20200414,36764
20200411,4,동대문,11427,10849,20200414,22276
20200411,4,동대문역사문화공원,8434,7065,20200414,15499
20200411,4,충무로,9862,10122,20200414,19984
20200411,4,명동,9036,10120,20200414,19156
20200411,4,회현,11838,12751,20200414,24589
20200411,4,서울역,3823,7004,20200414,10827
20200411,4,숙대입구,6798,6569,20200414,13367
20200411,4,삼각지,1876,2322,20200414,4198
20200411,4,신용산,6089,6442,20200414,12531
20200411,4,이촌,3445,4153,20200414,7598
20200411,4,동작,1653,1701,20200414,3354
20200411,4,총신대입구,11387,12236,20200414,23623
20200411,4,사당,15518,13670,20200414,29188
20200411,4,남태령,589,437,20200414,1026
20200412,4,당고개,5969,5804,20200415,11773
20200412,4,상계,7941,7520,20200415,15461
20200412,4,노원,9106,9759,20200415,18865
20200412,4,창동,10823,11148,20200415,21971
20200412,4,쌍문,12078,10865,20200415,22943
20200412,4,수유,15669,14493,20200415,30162
20200412,4,미아,6278,6012,20200415,12290
20200412,4,미아사거리,12311,11586,20200415,23897
20200412,4,길음,7286,6946,20200415,14232
20200412,4,성신여대입구,9171,8694,20200415,17865
20200412,4,한성대입구,5387,5588,20200415,10975
20200412,4,혜화,13290,13959,20200415,27249
20200412,4,동대문,4809,5477,20200415,10286
20200412,4,동대문역사문화공원,6039,6182,20200415,12221
20200412,4,충무로,5898,5914,20200415,11812
20200412,4,명동,6151,6665,20200415,12816
20200412,4,회현,5442,5816,20200415,11258
20200412,4,서울역,2748,5266,20200415,8014
20200412,4,숙대입구,4487,4285,20200415,8772
20200412,4,삼각지,1166,1463,20200415,2629
20200412,4,신용산,4296,4327,20200415,8623
20200412,4,이촌,2298,2713,20200415,5011
20200412,4,동작,1177,1264,20200415,2441
20200412,4,총신대입구,7334,8094,20200415,15428
20200412,4,사당,10588,10184,20200415,20772
20200412,4,남태령,392,340,20200415,732
20200413,4,당고개,11073,10009,20200416,21082
20200413,4,상계,17391,15815,20200416,33206
20200413,4,노원,17193,19339,20200416,36532
20200413,4,창동,22965,24494,20200416,47459
20200413,4,쌍문,27587,24989,20200416,52576
20200413,4,수유,31373,30946,20200416,62319
20200413,4,미아,13885,13176,20200416,27061
20200413,4,미아사거리,25301,24726,20200416,50027
20200413,4,길음,17748,16863,20200416,34611
20200413,4,성신여대입구,17010,16339,20200416,33349
20200413,4,한성대입구,11277,11144,20200416,22421
20200413,4,혜화,23389,23871,20200416,47260
20200413,4,동대문,18963,19541,20200416,38504
20200413,4,동대문역사문화공원,13260,12609,20200416,25869
20200413,4,충무로,24334,25453,20200416,49787
20200413,4,명동,14769,15361,20200416,30130
20200413,4,회현,20711,22304,20200416,43015
20200413,4,서울역,10322,12993,20200416,23315
20200413,4,숙대입구,11345,11226,20200416,22571
20200413,4,삼각지,4146,4545,20200416,8691
20200413,4,신용산,13555,14348,20200416,27903
20200413,4,이촌,5538,6218,20200416,11756
20200413,4,동작,2233,2362,20200416,4595
20200413,4,총신대입구,16939,18620,20200416,35559
20200413,4,사당,21326,17961,20200416,39287
20200413,4,남태령,937,779,20200416,1716
20200414,4,당고개,11290,10161,20200417,21451
20200414,4,상계,17755,15730,20200417,33485
20200414,4,노원,17807,20394,20200417,38201
20200414,4,창동,24662,25252,20200417,49914
20200414,4,쌍문,29847,25253,20200417,55100
20200414,4,수유,32306,32216,20200417,64522
20200414,4,미아,13947,13175,20200417,27122
20200414,4,미아사거리,25951,25005,20200417,50956
20200414,4,길음,18516,16854,20200417,35370
20200414,4,성신여대입구,17977,17197,20200417,35174
20200414,4,한성대입구,11875,11727,20200417,23602
20200414,4,혜화,25988,26761,20200417,52749
20200414,4,동대문,19563,20317,20200417,39880
20200414,4,동대문역사문화공원,14018,13130,20200417,27148
20200414,4,충무로,24545,26338,20200417,50883
20200414,4,명동,15089,15884,20200417,30973
20200414,4,회현,21378,23778,20200417,45156
20200414,4,서울역,10877,15039,20200417,25916
20200414,4,숙대입구,12122,12665,20200417,24787
20200414,4,삼각지,4321,4879,20200417,9200
20200414,4,신용산,14021,15474,20200417,29495
20200414,4,이촌,5741,6602,20200417,12343
20200414,4,동작,2368,2467,20200417,4835
20200414,4,총신대입구,17777,19542,20200417,37319
20200414,4,사당,22799,19702,20200417,42501
20200414,4,남태령,972,796,20200417,1768
20200415,4,당고개,7243,6883,20200418,14126
20200415,4,상계,10288,9736,20200418,20024
20200415,4,노원,11460,12673,20200418,24133
20200415,4,창동,14057,14759,20200418,28816
20200415,4,쌍문,16174,14536,20200418,30710
20200415,4,수유,20252,19582,20200418,39834
20200415,4,미아,8611,8176,20200418,16787
20200415,4,미아사거리,16379,15623,20200418,32002
20200415,4,길음,9553,9158,20200418,18711
20200415,4,성신여대입구,11912,11085,20200418,22997
20200415,4,한성대입구,7269,7050,20200418,14319
20200415,4,혜화,15324,15888,20200418,31212
20200415,4,동대문,14270,14656,20200418,28926
20200415,4,동대문역사문화공원,7954,7489,20200418,15443
20200415,4,충무로,8896,9364,20200418,18260
20200415,4,명동,7551,8280,20200418,15831
20200415,4,회현,12771,13601,20200418,26372
20200415,4,서울역,3305,5517,20200418,8822
20200415,4,숙대입구,6087,5975,20200418,12062
20200415,4,삼각지,1786,2048,20200418,3834
20200415,4,신용산,5146,5290,20200418,10436
20200415,4,이촌,3105,3660,20200418,6765
20200415,4,동작,1725,1604,20200418,3329
20200415,4,총신대입구,9789,10779,20200418,20568
20200415,4,사당,12645,11359,20200418,24004
20200415,4,남태령,480,445,20200418,925
20200416,4,당고개,11190,10241,20200419,21431
20200416,4,상계,17437,15760,20200419,33197
20200416,4,노원,17228,19701,20200419,36929
20200416,4,창동,23570,24904,20200419,48474
20200416,4,쌍문,27800,25063,20200419,52863
20200416,4,수유,31775,31234,20200419,63009
20200416,4,미아,13796,13285,20200419,27081
20200416,4,미아사거리,25332,24514,20200419,49846
20200416,4,길음,17987,17056,20200419,35043
20200416,4,성신여대입구,17368,16535,20200419,33903
20200416,4,한성대입구,11562,11563,20200419,23125
20200416,4,혜화,25265,25975,20200419,51240
20200416,4,동대문,19331,19833,20200419,39164
20200416,4,동대문역사문화공원,13550,12830,20200419,26380
20200416,4,충무로,24354,25971,20200419,50325
20200416,4,명동,14833,15680,20200419,30513
20200416,4,회현,21189,22837,20200419,44026
20200416,4,서울역,10379,13250,20200419,23629
20200416,4,숙대입구,11357,11402,20200419,22759
20200416,4,삼각지,4205,4589,20200419,8794
20200416,4,신용산,13515,14230,20200419,27745
20200416,4,이촌,5502,6351,20200419,11853
20200416,4,동작,2283,2440,20200419,4723
20200416,4,총신대입구,16900,18502,20200419,35402
20200416,4,사당,21784,18704,20200419,40488
20200416,4,남태령,889,772,20200419,1661
20200417,4,당고개,10809,9790,20200420,20599
20200417,4,상계,17179,15494,20200420,32673
20200417,4,노원,17139,20098,20200420,37237
20200417,4,창동,23157,24552,20200420,47709
20200417,4,쌍문,27435,24395,20200420,51830
20200417,4,수유,31239,31351,20200420,62590
20200417,4,미아,13698,12982,20200420,26680
20200417,4,미아사거리,25281,24384,20200420,49665
20200417,4,길음,17577,16317,20200420,33894
20200417,4,성신여대입구,17272,16414,20200420,33686
20200417,4,한성대입구,11448,11240,20200420,22688
20200417,4,혜화,25097,26004,20200420,51101
20200417,4,동대문,18093,18757,20200420,36850
20200417,4,동대문역사문화공원,13210,12568,20200420,25778
20200417,4,충무로,24114,25298,20200420,49412
20200417,4,명동,14149,14850,20200420,28999
20200417,4,회현,19940,21293,20200420,41233
20200417,4,서울역,10438,14019,20200420,24457
20200417,4,숙대입구,11398,11406,20200420,22804
20200417,4,삼각지,4235,4646,20200420,8881
20200417,4,신용산,13925,14611,20200420,28536
20200417,4,이촌,5607,6228,20200420,11835
20200417,4,동작,1937,2043,20200420,3980
20200417,4,총신대입구,17077,18815,20200420,35892
20200417,4,사당,22810,19505,20200420,42315
20200417,4,남태령,922,746,20200420,1668
20200418,4,당고개,8688,8214,20200421,16902
20200418,4,상계,12254,11230,20200421,23484
20200418,4,노원,13787,15678,20200421,29465
20200418,4,창동,16889,17836,20200421,34725
20200418,4,쌍문,18804,16691,20200421,35495
20200418,4,수유,23326,22794,20200421,46120
20200418,4,미아,9668,9193,20200421,18861
20200418,4,미아사거리,19242,18455,20200421,37697
20200418,4,길음,11683,10818,20200421,22501
20200418,4,성신여대입구,13811,12936,20200421,26747
20200418,4,한성대입구,8651,8355,20200421,17006
20200418,4,혜화,19629,20759,20200421,40388
20200418,4,동대문,12385,11808,20200421,24193
20200418,4,동대문역사문화공원,9083,7798,20200421,16881
20200418,4,충무로,10509,11105,20200421,21614
20200418,4,명동,9810,10893,20200421,20703
20200418,4,회현,13495,14497,20200421,27992
20200418,4,서울역,4030,7797,20200421,11827
20200418,4,숙대입구,7110,6787,20200421,13897
20200418,4,삼각지,2145,2690,20200421,4835
20200418,4,신용산,6188,6662,20200421,12850
20200418,4,이촌,3746,4576,20200421,8322
20200418,4,동작,1977,2075,20200421,4052
20200418,4,총신대입구,12300,13362,20200421,25662
20200418,4,사당,16954,14797,20200421,31751
20200418,4,남태령,658,520,20200421,1178
20200419,4,당고개,6019,5890,20200422,11909
20200419,4,상계,8037,7591,20200422,15628
20200419,4,노원,9182,9876,20200422,19058
20200419,4,창동,11188,11753,20200422,22941
20200419,4,쌍문,12384,10987,20200422,23371
20200419,4,수유,15739,14841,20200422,30580
20200419,4,미아,6223,6001,20200422,12224
20200419,4,미아사거리,12506,12143,20200422,24649
20200419,4,길음,7393,7433,20200422,14826
20200419,4,성신여대입구,9234,8758,20200422,17992
20200419,4,한성대입구,5453,5542,20200422,10995
20200419,4,혜화,13839,14380,20200422,28219
20200419,4,동대문,4488,5187,20200422,9675
20200419,4,동대문역사문화공원,5821,5970,20200422,11791
20200419,4,충무로,5576,5680,20200422,11256
20200419,4,명동,5742,6118,20200422,11860
20200419,4,회현,5527,5717,20200422,11244
20200419,4,서울역,2719,5285,20200422,8004
20200419,4,숙대입구,4281,4244,20200422,8525
20200419,4,삼각지,1217,1505,20200422,2722
20200419,4,신용산,4074,4174,20200422,8248
20200419,4,이촌,2188,2528,20200422,4716
20200419,4,동작,1026,1035,20200422,2061
20200419,4,총신대입구,7360,7892,20200422,15252
20200419,4,사당,10527,9986,20200422,20513
20200419,4,남태령,407,322,20200422,729
20200420,4,당고개,11336,10336,20200423,21672
20200420,4,상계,17787,16052,20200423,33839
20200420,4,노원,17466,19536,20200423,37002
20200420,4,창동,23531,25181,20200423,48712
20200420,4,쌍문,28174,25629,20200423,53803
20200420,4,수유,31884,31710,20200423,63594
20200420,4,미아,13710,13220,20200423,26930
20200420,4,미아사거리,25336,24792,20200423,50128
20200420,4,길음,18021,17189,20200423,35210
20200420,4,성신여대입구,17313,16709,20200423,34022
20200420,4,한성대입구,11316,11243,20200423,22559
20200420,4,혜화,24201,23995,20200423,48196
20200420,4,동대문,19304,19651,20200423,38955
20200420,4,동대문역사문화공원,13618,12879,20200423,26497
20200420,4,충무로,24989,26274,20200423,51263
20200420,4,명동,14877,15595,20200423,30472
20200420,4,회현,21172,22562,20200423,43734
20200420,4,서울역,10907,13608,20200423,24515
20200420,4,숙대입구,11621,11472,20200423,23093
20200420,4,삼각지,4289,4723,20200423,9012
20200420,4,신용산,14001,14650,20200423,28651
20200420,4,이촌,5599,6272,20200423,11871
20200420,4,동작,2165,2246,20200423,4411
20200420,4,총신대입구,17394,18967,20200423,36361
20200420,4,사당,21793,18550,20200423,40343
20200420,4,남태령,918,783,20200423,1701
20200421,4,당고개,11397,10473,20200424,21870
20200421,4,상계,17885,16243,20200424,34128
20200421,4,노원,17804,20005,20200424,37809
20200421,4,창동,24352,26085,20200424,50437
20200421,4,쌍문,28536,25700,20200424,54236
20200421,4,수유,32256,32179,20200424,64435
20200421,4,미아,14120,13765,20200424,27885
20200421,4,미아사거리,26021,25364,20200424,51385
20200421,4,길음,18438,17674,20200424,36112
20200421,4,성신여대입구,17929,17224,20200424,35153
20200421,4,한성대입구,11835,11814,20200424,23649
20200421,4,혜화,26257,26507,20200424,52764
20200421,4,동대문,19735,19952,20200424,39687
20200421,4,동대문역사문화공원,13856,12955,20200424,26811
20200421,4,충무로,25623,26587,20200424,52210
20200421,4,명동,15107,15909,20200424,31016
20200421,4,회현,22030,23403,20200424,45433
20200421,4,서울역,11127,13851,20200424,24978
20200421,4,숙대입구,11945,11971,20200424,23916
20200421,4,삼각지,4356,4812,20200424,9168
20200421,4,신용산,14429,14747,20200424,29176
20200421,4,이촌,5828,6524,20200424,12352
20200421,4,동작,2101,2253,20200424,4354
20200421,4,총신대입구,17735,19393,20200424,37128
20200421,4,사당,22935,19177,20200424,42112
20200421,4,남태령,950,778,20200424,1728
20200422,4,당고개,11257,10369,20200425,21626
20200422,4,상계,17894,16310,20200425,34204
20200422,4,노원,18011,20354,20200425,38365
20200422,4,창동,23958,25299,20200425,49257
20200422,4,쌍문,28307,25720,20200425,54027
20200422,4,수유,32178,31830,20200425,64008
20200422,4,미아,13984,13437,20200425,27421
20200422,4,미아사거리,25604,25118,20200425,50722
20200422,4,길음,18207,17212,20200425,35419
20200422,4,성신여대입구,17704,17011,20200425,34715
20200422,4,한성대입구,11703,11666,20200425,23369
20200422,4,혜화,26474,26990,20200425,53464
20200422,4,동대문,19448,19648,20200425,39096
20200422,4,동대문역사문화공원,13849,13233,20200425,27082
20200422,4,충무로,25880,26775,20200425,52655
20200422,4,명동,14876,15743,20200425,30619
20200422,4,회현,21636,22901,20200425,44537
20200422,4,서울역,10915,13761,20200425,24676
20200422,4,숙대입구,11795,11712,20200425,23507
20200422,4,삼각지,4425,4787,20200425,9212
20200422,4,신용산,14459,14954,20200425,29413
20200422,4,이촌,5563,6358,20200425,11921
20200422,4,동작,2028,2192,20200425,4220
20200422,4,총신대입구,17638,19142,20200425,36780
20200422,4,사당,22790,19097,20200425,41887
20200422,4,남태령,982,889,20200425,1871
20200423,4,당고개,11508,10703,20200426,22211
20200423,4,상계,18127,16466,20200426,34593
20200423,4,노원,17739,20117,20200426,37856
20200423,4,창동,24405,25883,20200426,50288
20200423,4,쌍문,28764,25957,20200426,54721
20200423,4,수유,32632,32335,20200426,64967
20200423,4,미아,14155,13708,20200426,27863
20200423,4,미아사거리,25939,25290,20200426,51229
20200423,4,길음,18478,17499,20200426,35977
20200423,4,성신여대입구,18288,17455,20200426,35743
20200423,4,한성대입구,11951,11852,20200426,23803
20200423,4,혜화,27056,27563,20200426,54619
20200423,4,동대문,19420,20076,20200426,39496
20200423,4,동대문역사문화공원,14067,13394,20200426,27461
20200423,4,충무로,26070,27144,20200426,53214
20200423,4,명동,15220,16155,20200426,31375
20200423,4,회현,21694,23229,20200426,44923
20200423,4,서울역,11094,14217,20200426,25311
20200423,4,숙대입구,12120,11940,20200426,24060
20200423,4,삼각지,4429,4851,20200426,9280
20200423,4,신용산,14684,15291,20200426,29975
20200423,4,이촌,5786,6570,20200426,12356
20200423,4,동작,2181,2282,20200426,4463
20200423,4,총신대입구,17759,19506,20200426,37265
20200423,4,사당,23041,19369,20200426,42410
20200423,4,남태령,1019,906,20200426,1925
20200424,4,당고개,11837,10715,20200427,22552
20200424,4,상계,18712,16978,20200427,35690
20200424,4,노원,18929,22016,20200427,40945
20200424,4,창동,25669,27024,20200427,52693
20200424,4,쌍문,29821,26217,20200427,56038
20200424,4,수유,33935,33916,20200427,67851
20200424,4,미아,15095,14200,20200427,29295
20200424,4,미아사거리,27720,27080,20200427,54800
20200424,4,길음,19219,17884,20200427,37103
20200424,4,성신여대입구,19353,18674,20200427,38027
20200424,4,한성대입구,12672,12270,20200427,24942
20200424,4,혜화,28119,28842,20200427,56961
20200424,4,동대문,20017,20632,20200427,40649
20200424,4,동대문역사문화공원,14446,13728,20200427,28174
20200424,4,충무로,26034,27571,20200427,53605
20200424,4,명동,15894,16817,20200427,32711
20200424,4,회현,22404,24029,20200427,46433
20200424,4,서울역,11437,15491,20200427,26928
20200424,4,숙대입구,12583,12378,20200427,24961
20200424,4,삼각지,4540,5071,20200427,9611
20200424,4,신용산,15598,16001,20200427,31599
20200424,4,이촌,6160,6959,20200427,13119
20200424,4,동작,2402,2533,20200427,4935
20200424,4,총신대입구,19236,21111,20200427,40347
20200424,4,사당,24883,21559,20200427,46442
20200424,4,남태령,1084,934,20200427,2018
20200425,4,당고개,8949,8454,20200428,17403
20200425,4,상계,12851,11773,20200428,24624
20200425,4,노원,14194,16213,20200428,30407
20200425,4,창동,17785,18887,20200428,36672
20200425,4,쌍문,19797,17427,20200428,37224
20200425,4,수유,24209,23738,20200428,47947
20200425,4,미아,10262,9688,20200428,19950
20200425,4,미아사거리,19858,19250,20200428,39108
20200425,4,길음,12464,11438,20200428,23902
20200425,4,성신여대입구,14672,13590,20200428,28262
20200425,4,한성대입구,9060,8886,20200428,17946
20200425,4,혜화,20906,21777,20200428,42683
20200425,4,동대문,13169,12861,20200428,26030
20200425,4,동대문역사문화공원,9446,7955,20200428,17401
20200425,4,충무로,10904,11384,20200428,22288
20200425,4,명동,10525,11939,20200428,22464
20200425,4,회현,14352,15651,20200428,30003
20200425,4,서울역,4351,8513,20200428,12864
20200425,4,숙대입구,7368,7186,20200428,14554
20200425,4,삼각지,2148,2688,20200428,4836
20200425,4,신용산,6811,7319,20200428,14130
20200425,4,이촌,3789,4453,20200428,8242
20200425,4,동작,1971,1995,20200428,3966
20200425,4,총신대입구,13042,14000,20200428,27042
20200425,4,사당,17850,15837,20200428,33687
20200425,4,남태령,769,587,20200428,1356
20200426,4,당고개,7057,6622,20200429,13679
20200426,4,상계,9278,8609,20200429,17887
20200426,4,노원,10328,11171,20200429,21499
20200426,4,창동,13082,13525,20200429,26607
20200426,4,쌍문,14093,12540,20200429,26633
20200426,4,수유,17471,16731,20200429,34202
20200426,4,미아,7014,6505,20200429,13519
20200426,4,미아사거리,13996,13047,20200429,27043
20200426,4,길음,8513,8137,20200429,16650
20200426,4,성신여대입구,10276,9882,20200429,20158
20200426,4,한성대입구,6375,6378,20200429,12753
20200426,4,혜화,16721,17682,20200429,34403
20200426,4,동대문,6102,6405,20200429,12507
20200426,4,동대문역사문화공원,6818,6956,20200429,13774
20200426,4,충무로,6556,6793,20200429,13349
20200426,4,명동,7958,8440,20200429,16398
20200426,4,회현,6523,7154,20200429,13677
20200426,4,서울역,3238,6567,20200429,9805
20200426,4,숙대입구,5368,5254,20200429,10622
20200426,4,삼각지,1416,1795,20200429,3211
20200426,4,신용산,5019,4989,20200429,10008
20200426,4,이촌,2947,3625,20200429,6572
20200426,4,동작,1674,1605,20200429,3279
20200426,4,총신대입구,8871,9593,20200429,18464
20200426,4,사당,12524,11615,20200429,24139
20200426,4,남태령,512,436,20200429,948
20200427,4,당고개,11927,10791,20200430,22718
20200427,4,상계,18672,16946,20200430,35618
20200427,4,노원,18118,20347,20200430,38465
20200427,4,창동,24711,26158,20200430,50869
20200427,4,쌍문,29381,26293,20200430,55674
20200427,4,수유,33197,32867,20200430,66064
20200427,4,미아,14631,14090,20200430,28721
20200427,4,미아사거리,26769,25753,20200430,52522
20200427,4,길음,18911,17915,20200430,36826
20200427,4,성신여대입구,18006,17235,20200430,35241
20200427,4,한성대입구,11997,11981,20200430,23978
20200427,4,혜화,25106,25716,20200430,50822
20200427,4,동대문,20488,20965,20200430,41453
20200427,4,동대문역사문화공원,13976,13450,20200430,27426
20200427,4,충무로,25364,26866,20200430,52230
20200427,4,명동,15799,16657,20200430,32456
20200427,4,회현,23129,24838,20200430,47967
20200427,4,서울역,11342,14544,20200430,25886
20200427,4,숙대입구,12118,12081,20200430,24199
20200427,4,삼각지,4521,4853,20200430,9374
20200427,4,신용산,14806,15486,20200430,30292
20200427,4,이촌,5976,6821,20200430,12797
20200427,4,동작,2435,2578,20200430,5013
20200427,4,총신대입구,18359,20012,20200430,38371
20200427,4,사당,23050,19464,20200430,42514
20200427,4,남태령,1122,979,20200430,2101
20200428,4,당고개,12005,10960,20200501,22965
20200428,4,상계,18713,16828,20200501,35541
20200428,4,노원,18520,21128,20200501,39648
20200428,4,창동,25431,26941,20200501,52372
20200428,4,쌍문,29656,26689,20200501,56345
20200428,4,수유,33388,33091,20200501,66479
20200428,4,미아,14736,14139,20200501,28875
20200428,4,미아사거리,27156,26467,20200501,53623
20200428,4,길음,19367,18181,20200501,37548
20200428,4,성신여대입구,18586,17773,20200501,36359
20200428,4,한성대입구,12467,12311,20200501,24778
20200428,4,혜화,27662,27952,20200501,55614
20200428,4,동대문,21083,21289,20200501,42372
20200428,4,동대문역사문화공원,14359,13694,20200501,28053
20200428,4,충무로,26342,27599,20200501,53941
20200428,4,명동,16095,16983,20200501,33078
20200428,4,회현,23658,26042,20200501,49700
20200428,4,서울역,11245,15085,20200501,26330
20200428,4,숙대입구,12607,12372,20200501,24979
20200428,4,삼각지,4693,4999,20200501,9692
20200428,4,신용산,14957,15461,20200501,30418
20200428,4,이촌,6088,7039,20200501,13127
20200428,4,동작,2576,2668,20200501,5244
20200428,4,총신대입구,18705,20530,20200501,39235
20200428,4,사당,23731,20001,20200501,43732
20200428,4,남태령,1134,966,20200501,2100
20200429,4,당고개,12218,11039,20200502,23257
20200429,4,상계,19222,17057,20200502,36279
20200429,4,노원,19378,22586,20200502,41964
20200429,4,창동,26392,27845,20200502,54237
20200429,4,쌍문,30508,27023,20200502,57531
20200429,4,수유,34803,34121,20200502,68924
20200429,4,미아,15318,14435,20200502,29753
20200429,4,미아사거리,28493,27540,20200502,56033
20200429,4,길음,19940,18356,20200502,38296
20200429,4,성신여대입구,19543,18593,20200502,38136
20200429,4,한성대입구,13192,12798,20200502,25990
20200429,4,혜화,30133,30473,20200502,60606
20200429,4,동대문,21510,21919,20200502,43429
20200429,4,동대문역사문화공원,15056,14309,20200502,29365
20200429,4,충무로,26732,28105,20200502,54837
20200429,4,명동,16930,17774,20200502,34704
20200429,4,회현,24604,26413,20200502,51017
20200429,4,서울역,11582,17506,20200502,29088
20200429,4,숙대입구,12815,12849,20200502,25664
20200429,4,삼각지,4745,5280,20200502,10025
20200429,4,신용산,15269,16635,20200502,31904
20200429,4,이촌,6458,7127,20200502,13585
20200429,4,동작,2687,2735,20200502,5422
20200429,4,총신대입구,19643,21512,20200502,41155
20200429,4,사당,25569,21792,20200502,47361
20200429,4,남태령,1215,965,20200502,2180
20200430,4,당고개,9212,8887,20200503,18099
20200430,4,상계,11785,10815,20200503,22600
20200430,4,노원,12887,14439,20200503,27326
20200430,4,창동,16086,16717,20200503,32803
20200430,4,쌍문,18337,15747,20200503,34084
20200430,4,수유,22378,21237,20200503,43615
20200430,4,미아,9326,8313,20200503,17639
20200430,4,미아사거리,18008,16640,20200503,34648
20200430,4,길음,10898,10023,20200503,20921
20200430,4,성신여대입구,13404,12274,20200503,25678
20200430,4,한성대입구,9265,9209,20200503,18474
20200430,4,혜화,19076,20060,20200503,39136
20200430,4,동대문,16593,17191,20200503,33784
20200430,4,동대문역사문화공원,9592,9300,20200503,18892
20200430,4,충무로,9194,9517,20200503,18711
20200430,4,명동,10526,12243,20200503,22769
20200430,4,회현,15104,16477,20200503,31581
20200430,4,서울역,4080,10058,20200503,14138
20200430,4,숙대입구,6443,6138,20200503,12581
20200430,4,삼각지,2041,2468,20200503,4509
20200430,4,신용산,6272,7352,20200503,13624
20200430,4,이촌,3490,4207,20200503,7697
20200430,4,동작,1985,2100,20200503,4085
20200430,4,총신대입구,11476,12071,20200503,23547
20200430,4,사당,16050,13671,20200503,29721
20200430,4,남태령,764,596,20200503,1360
20200501,4,남태령,667,562,20200504,1229
20200501,4,사당,16783,14496,20200504,31279
20200501,4,총신대입구,13061,13990,20200504,27051
20200501,4,동작,2145,2124,20200504,4269
20200501,4,이촌,4201,4904,20200504,9105
20200501,4,신용산,7635,8309,20200504,15944
20200501,4,삼각지,2519,2970,20200504,5489
20200501,4,숙대입구,7851,7412,20200504,15263
20200501,4,서울역,4389,9397,20200504,13786
20200501,4,회현,18014,19387,20200504,37401
20200501,4,명동,11246,12550,20200504,23796
20200501,4,충무로,12091,13038,20200504,25129
20200501,4,동대문역사문화공원,10754,10003,20200504,20757
20200501,4,동대문,19109,19254,20200504,38363
20200501,4,혜화,19254,20128,20200504,39382
20200501,4,한성대입구,9066,8850,20200504,17916
20200501,4,성신여대입구,14540,13488,20200504,28028
20200501,4,길음,12043,11207,20200504,23250
20200501,4,미아사거리,20212,18876,20200504,39088
20200501,4,미아,10665,9789,20200504,20454
20200501,4,수유,24757,23813,20200504,48570
20200501,4,쌍문,20232,17519,20200504,37751
20200501,4,창동,18285,19406,20200504,37691
20200501,4,노원,14361,16529,20200504,30890
20200501,4,상계,13034,11910,20200504,24944
20200501,4,당고개,8693,8223,20200504,16916
20200502,4,당고개,8462,7749,20200505,16211
20200502,4,상계,12011,11167,20200505,23178
20200502,4,노원,13463,15322,20200505,28785
20200502,4,창동,16622,17588,20200505,34210
20200502,4,쌍문,18771,16546,20200505,35317
20200502,4,수유,22430,21874,20200505,44304
20200502,4,미아,9534,8611,20200505,18145
20200502,4,미아사거리,18955,18236,20200505,37191
20200502,4,길음,11697,10867,20200505,22564
20200502,4,성신여대입구,13571,12676,20200505,26247
20200502,4,한성대입구,8541,8262,20200505,16803
20200502,4,혜화,20117,21341,20200505,41458
20200502,4,동대문,13092,12682,20200505,25774
20200502,4,동대문역사문화공원,9323,7850,20200505,17173
20200502,4,충무로,9659,10034,20200505,19693
20200502,4,명동,11370,12774,20200505,24144
20200502,4,회현,14285,15451,20200505,29736
20200502,4,서울역,4170,9038,20200505,13208
20200502,4,숙대입구,6620,6439,20200505,13059
20200502,4,삼각지,2116,2589,20200505,4705
20200502,4,신용산,6611,6957,20200505,13568
20200502,4,이촌,3627,4396,20200505,8023
20200502,4,동작,1915,1930,20200505,3845
20200502,4,총신대입구,11914,13040,20200505,24954
20200502,4,사당,16445,14104,20200505,30549
20200502,4,남태령,644,503,20200505,1147
20200503,4,남태령,521,432,20200506,953
20200503,4,사당,12353,11415,20200506,23768
20200503,4,총신대입구,8635,9603,20200506,18238
20200503,4,동작,1595,1657,20200506,3252
20200503,4,이촌,2880,3457,20200506,6337
20200503,4,신용산,5562,5052,20200506,10614
20200503,4,삼각지,1477,1752,20200506,3229
20200503,4,숙대입구,5397,5277,20200506,10674
20200503,4,서울역,3335,7410,20200506,10745
20200503,4,회현,6549,7139,20200506,13688
20200503,4,명동,8848,9612,20200506,18460
20200503,4,충무로,6451,6780,20200506,13231
20200503,4,동대문역사문화공원,7133,7305,20200506,14438
20200503,4,동대문,6619,6896,20200506,13515
20200503,4,혜화,16602,17984,20200506,34586
20200503,4,한성대입구,6517,6581,20200506,13098
20200503,4,성신여대입구,10202,9972,20200506,20174
20200503,4,미아사거리,14280,13739,20200506,28019
20200503,4,미아,7185,6790,20200506,13975
20200503,4,수유,17854,17262,20200506,35116
20200503,4,쌍문,14345,12741,20200506,27086
20200503,4,창동,13752,14426,20200506,28178
20200503,4,노원,10260,11606,20200506,21866
20200503,4,상계,9594,8930,20200506,18524
20200503,4,당고개,6640,6461,20200506,13101
20200503,4,길음,8630,8444,20200506,17074
20200504,4,남태령,986,801,20200507,1787
20200504,4,사당,21392,18394,20200507,39786
20200504,4,총신대입구,16876,18621,20200507,35497
20200504,4,동작,2305,2469,20200507,4774
20200504,4,이촌,5609,6620,20200507,12229
20200504,4,신용산,11708,11959,20200507,23667
20200504,4,삼각지,3832,4291,20200507,8123
20200504,4,숙대입구,11111,10994,20200507,22105
20200504,4,서울역,8573,12147,20200507,20720
20200504,4,회현,23208,24937,20200507,48145
20200504,4,명동,14963,16186,20200507,31149
20200504,4,충무로,21505,23286,20200507,44791
20200504,4,동대문역사문화공원,13589,12901,20200507,26490
20200504,4,동대문,21515,21852,20200507,43367
20200504,4,혜화,25262,25971,20200507,51233
20200504,4,한성대입구,11654,11265,20200507,22919
20200504,4,성신여대입구,17663,17148,20200507,34811
20200504,4,길음,17386,16071,20200507,33457
20200504,4,미아사거리,25823,25094,20200507,50917
20200504,4,미아,13844,13090,20200507,26934
20200504,4,수유,32139,31766,20200507,63905
20200504,4,쌍문,27190,24104,20200507,51294
20200504,4,창동,23675,25100,20200507,48775
20200504,4,노원,18428,20947,20200507,39375
20200504,4,상계,17370,15648,20200507,33018
20200504,4,당고개,11434,10278,20200507,21712
20200505,4,당고개,7547,7196,20200508,14743
20200505,4,상계,10434,9843,20200508,20277
20200505,4,노원,11916,13075,20200508,24991
20200505,4,창동,14583,15334,20200508,29917
20200505,4,쌍문,16561,14826,20200508,31387
20200505,4,수유,20012,19396,20200508,39408
20200505,4,미아,8437,7946,20200508,16383
20200505,4,미아사거리,16565,16103,20200508,32668
20200505,4,길음,9567,9508,20200508,19075
20200505,4,성신여대입구,12001,11287,20200508,23288
20200505,4,한성대입구,7103,7124,20200508,14227
20200505,4,혜화,17583,18488,20200508,36071
20200505,4,동대문,15360,15400,20200508,30760
20200505,4,동대문역사문화공원,8747,8226,20200508,16973
20200505,4,충무로,7907,8121,20200508,16028
20200505,4,명동,9331,10217,20200508,19548
20200505,4,회현,14264,15378,20200508,29642
20200505,4,서울역,3463,6503,20200508,9966
20200505,4,숙대입구,5788,5622,20200508,11410
20200505,4,삼각지,1708,2046,20200508,3754
20200505,4,신용산,5952,5835,20200508,11787
20200505,4,이촌,3094,3741,20200508,6835
20200505,4,동작,1701,1748,20200508,3449
20200505,4,총신대입구,10239,11162,20200508,21401
20200505,4,사당,13291,12257,20200508,25548
20200505,4,남태령,527,417,20200508,944
20200506,4,남태령,1117,991,20200509,2108
20200506,4,사당,24425,20624,20200509,45049
20200506,4,총신대입구,19446,21212,20200509,40658
20200506,4,동작,2642,2790,20200509,5432
20200506,4,이촌,6809,7780,20200509,14589
20200506,4,신용산,15577,16325,20200509,31902
20200506,4,삼각지,4636,5129,20200509,9765
20200506,4,숙대입구,13049,12834,20200509,25883
20200506,4,서울역,11796,15410,20200509,27206
20200506,4,회현,25308,27259,20200509,52567
20200506,4,명동,17069,17918,20200509,34987
20200506,4,충무로,26602,27978,20200509,54580
20200506,4,동대문역사문화공원,15127,14431,20200509,29558
20200506,4,동대문,22230,22282,20200509,44512
20200506,4,혜화,29506,30104,20200509,59610
20200506,4,한성대입구,12901,12794,20200509,25695
20200506,4,성신여대입구,19286,18316,20200509,37602
20200506,4,길음,20020,18991,20200509,39011
20200506,4,미아사거리,28526,27476,20200509,56002
20200506,4,미아,15190,14549,20200509,29739
20200506,4,수유,34641,34221,20200509,68862
20200506,4,쌍문,30354,27466,20200509,57820
20200506,4,창동,26384,28015,20200509,54399
20200506,4,노원,19289,21954,20200509,41243
20200506,4,상계,19291,17382,20200509,36673
20200506,4,당고개,12402,11278,20200509,23680
20200507,4,당고개,12489,11432,20200510,23921
20200507,4,상계,19539,17541,20200510,37080
20200507,4,노원,19615,22272,20200510,41887
20200507,4,창동,26797,28189,20200510,54986
20200507,4,쌍문,30820,27915,20200510,58735
20200507,4,수유,34791,34428,20200510,69219
20200507,4,미아,15343,14794,20200510,30137
20200507,4,미아사거리,28605,27561,20200510,56166
20200507,4,길음,20304,18980,20200510,39284
20200507,4,성신여대입구,19718,18788,20200510,38506
20200507,4,한성대입구,13185,13039,20200510,26224
20200507,4,혜화,29400,30177,20200510,59577
20200507,4,동대문,21906,22287,20200510,44193
20200507,4,동대문역사문화공원,15277,14391,20200510,29668
20200507,4,충무로,27217,28303,20200510,55520
20200507,4,명동,17181,18289,20200510,35470
20200507,4,회현,25975,27998,20200510,53973
20200507,4,서울역,11922,16101,20200510,28023
20200507,4,숙대입구,13107,13031,20200510,26138
20200507,4,삼각지,4750,5297,20200510,10047
20200507,4,신용산,15682,16622,20200510,32304
20200507,4,이촌,6860,7785,20200510,14645
20200507,4,동작,2732,2786,20200510,5518
20200507,4,총신대입구,19381,21230,20200510,40611
20200507,4,사당,25250,21401,20200510,46651
20200507,4,남태령,1126,1001,20200510,2127
20200508,4,당고개,12885,11740,20200511,24625
20200508,4,상계,19516,18033,20200511,37549
20200508,4,노원,20235,23370,20200511,43605
20200508,4,창동,27049,29422,20200511,56471
20200508,4,쌍문,31442,29050,20200511,60492
20200508,4,수유,35334,36151,20200511,71485
20200508,4,미아,15765,15224,20200511,30989
20200508,4,미아사거리,29402,29940,20200511,59342
20200508,4,길음,20671,20335,20200511,41006
20200508,4,성신여대입구,20243,19808,20200511,40051
20200508,4,한성대입구,13837,13866,20200511,27703
20200508,4,혜화,31796,29835,20200511,61631
20200508,4,동대문,21707,21654,20200511,43361
20200508,4,동대문역사문화공원,15450,14312,20200511,29762
20200508,4,충무로,27076,27581,20200511,54657
20200508,4,명동,18180,18111,20200511,36291
20200508,4,회현,26424,26939,20200511,53363
20200508,4,서울역,12783,18591,20200511,31374
20200508,4,숙대입구,13624,13047,20200511,26671
20200508,4,삼각지,4713,5154,20200511,9867
20200508,4,신용산,16724,17247,20200511,33971
20200508,4,이촌,7249,8189,20200511,15438
20200508,4,동작,2652,2678,20200511,5330
20200508,4,총신대입구,19788,22308,20200511,42096
20200508,4,사당,26580,22173,20200511,48753
20200508,4,남태령,1446,1062,20200511,2508
20200509,4,당고개,7945,7403,20200512,15348
20200509,4,상계,11697,10622,20200512,22319
20200509,4,노원,13812,15661,20200512,29473
20200509,4,창동,16224,17246,20200512,33470
20200509,4,쌍문,18910,16639,20200512,35549
20200509,4,수유,22238,22431,20200512,44669
20200509,4,미아,9695,9076,20200512,18771
20200509,4,미아사거리,19274,18900,20200512,38174
20200509,4,길음,11964,11174,20200512,23138
20200509,4,성신여대입구,13801,13159,20200512,26960
20200509,4,한성대입구,8740,8378,20200512,17118
20200509,4,혜화,20466,22133,20200512,42599
20200509,4,동대문,11847,11240,20200512,23087
20200509,4,동대문역사문화공원,8443,7390,20200512,15833
20200509,4,충무로,10662,11277,20200512,21939
20200509,4,명동,9206,10364,20200512,19570
20200509,4,회현,13391,14150,20200512,27541
20200509,4,서울역,4226,9371,20200512,13597
20200509,4,숙대입구,7315,7011,20200512,14326
20200509,4,삼각지,1992,2360,20200512,4352
20200509,4,신용산,6631,7094,20200512,13725
20200509,4,이촌,4131,4542,20200512,8673
20200509,4,동작,1223,1231,20200512,2454
20200509,4,총신대입구,12069,13101,20200512,25170
20200509,4,사당,17488,14834,20200512,32322
20200509,4,남태령,819,516,20200512,1335
20200510,4,당고개,7139,6932,20200513,14071
20200510,4,상계,9756,8926,20200513,18682
20200510,4,노원,11260,12110,20200513,23370
20200510,4,창동,13655,14228,20200513,27883
20200510,4,쌍문,14930,13440,20200513,28370
20200510,4,수유,18577,17644,20200513,36221
20200510,4,미아,7848,7294,20200513,15142
20200510,4,미아사거리,14974,14210,20200513,29184
20200510,4,길음,9217,8906,20200513,18123
20200510,4,성신여대입구,11319,10946,20200513,22265
20200510,4,한성대입구,6682,6723,20200513,13405
20200510,4,혜화,17657,19030,20200513,36687
20200510,4,동대문,6018,6387,20200513,12405
20200510,4,동대문역사문화공원,6932,7188,20200513,14120
20200510,4,충무로,7386,7655,20200513,15041
20200510,4,명동,8236,8788,20200513,17024
20200510,4,회현,6650,7126,20200513,13776
20200510,4,서울역,3558,7713,20200513,11271
20200510,4,숙대입구,5783,5739,20200513,11522
20200510,4,삼각지,1576,1899,20200513,3475
20200510,4,신용산,5272,5151,20200513,10423
20200510,4,이촌,3602,4096,20200513,7698
20200510,4,동작,1490,1547,20200513,3037
20200510,4,총신대입구,9386,10197,20200513,19583
20200510,4,사당,13366,12528,20200513,25894
20200510,4,남태령,599,501,20200513,1100
20200511,4,동작,2482,2573,20200514,5055
20200511,4,당고개,12313,11177,20200514,23490
20200511,4,상계,19055,17173,20200514,36228
20200511,4,노원,18843,21315,20200514,40158
20200511,4,창동,25964,27563,20200514,53527
20200511,4,쌍문,29957,27011,20200514,56968
20200511,4,수유,33903,33649,20200514,67552
20200511,4,미아,15183,14659,20200514,29842
20200511,4,미아사거리,27497,26917,20200514,54414
20200511,4,길음,19555,18976,20200514,38531
20200511,4,성신여대입구,19259,18612,20200514,37871
20200511,4,한성대입구,12542,12572,20200514,25114
20200511,4,혜화,27457,27749,20200514,55206
20200511,4,동대문,20961,21287,20200514,42248
20200511,4,동대문역사문화공원,14440,13739,20200514,28179
20200511,4,충무로,27536,28489,20200514,56025
20200511,4,명동,16798,17543,20200514,34341
20200511,4,회현,24056,25674,20200514,49730
20200511,4,서울역,11427,15062,20200514,26489
20200511,4,숙대입구,12883,12562,20200514,25445
20200511,4,남태령,1110,1005,20200514,2115
20200511,4,사당,24097,20302,20200514,44399
20200511,4,총신대입구,18853,20554,20200514,39407
20200511,4,삼각지,4419,4704,20200514,9123
20200511,4,신용산,14945,15599,20200514,30544
20200511,4,이촌,6424,7301,20200514,13725
20200512,4,당고개,12137,11154,20200515,23291
20200512,4,상계,19014,17174,20200515,36188
20200512,4,노원,18709,21192,20200515,39901
20200512,4,창동,25390,27044,20200515,52434
20200512,4,쌍문,29563,26836,20200515,56399
20200512,4,수유,33494,33327,20200515,66821
20200512,4,미아,14782,14235,20200515,29017
20200512,4,미아사거리,27485,26801,20200515,54286
20200512,4,길음,19763,18725,20200515,38488
20200512,4,성신여대입구,19290,18531,20200515,37821
20200512,4,한성대입구,12888,12602,20200515,25490
20200512,4,혜화,28605,29041,20200515,57646
20200512,4,동대문,20625,20828,20200515,41453
20200512,4,동대문역사문화공원,14654,13835,20200515,28489
20200512,4,충무로,27060,27824,20200515,54884
20200512,4,명동,16633,17449,20200515,34082
20200512,4,회현,23863,25399,20200515,49262
20200512,4,서울역,11030,14596,20200515,25626
20200512,4,숙대입구,12653,12465,20200515,25118
20200512,4,삼각지,4461,4822,20200515,9283
20200512,4,신용산,14731,15246,20200515,29977
20200512,4,이촌,6407,7383,20200515,13790
20200512,4,동작,2433,2581,20200515,5014
20200512,4,총신대입구,18865,20556,20200515,39421
20200512,4,사당,24159,20483,20200515,44642
20200512,4,남태령,1091,972,20200515,2063
20200513,4,당고개,12283,11344,20200516,23627
20200513,4,상계,19188,17216,20200516,36404
20200513,4,노원,18936,21262,20200516,40198
20200513,4,창동,26076,27707,20200516,53783
20200513,4,쌍문,29712,26971,20200516,56683
20200513,4,수유,34007,33506,20200516,67513
20200513,4,미아,14835,14448,20200516,29283
20200513,4,미아사거리,27649,27141,20200516,54790
20200513,4,길음,19995,18740,20200516,38735
20200513,4,성신여대입구,19534,18771,20200516,38305
20200513,4,한성대입구,13066,12936,20200516,26002
20200513,4,혜화,29782,30396,20200516,60178
20200513,4,동대문,20692,20907,20200516,41599
20200513,4,동대문역사문화공원,14822,13821,20200516,28643
20200513,4,충무로,26928,28003,20200516,54931
20200513,4,명동,16833,17539,20200516,34372
20200513,4,회현,24293,25873,20200516,50166
20200513,4,서울역,11230,14897,20200516,26127
20200513,4,숙대입구,12744,12453,20200516,25197
20200513,4,삼각지,4471,4866,20200516,9337
20200513,4,신용산,14554,15187,20200516,29741
20200513,4,이촌,6375,7431,20200516,13806
20200513,4,동작,2741,2786,20200516,5527
20200513,4,총신대입구,19236,21098,20200516,40334
20200513,4,사당,24255,20523,20200516,44778
20200513,4,남태령,1110,901,20200516,2011
20200514,4,남태령,1080,939,20200517,2019
20200514,4,사당,24156,20652,20200517,44808
20200514,4,총신대입구,18805,20791,20200517,39596
20200514,4,동작,2683,2752,20200517,5435
20200514,4,이촌,6541,7401,20200517,13942
20200514,4,신용산,14608,15146,20200517,29754
20200514,4,삼각지,4570,4907,20200517,9477
20200514,4,숙대입구,12726,12564,20200517,25290
20200514,4,서울역,10766,14177,20200517,24943
20200514,4,회현,23923,25609,20200517,49532
20200514,4,명동,16518,17295,20200517,33813
20200514,4,충무로,27319,28657,20200517,55976
20200514,4,동대문역사문화공원,14409,13687,20200517,28096
20200514,4,동대문,20124,20701,20200517,40825
20200514,4,혜화,28723,29559,20200517,58282
20200514,4,한성대입구,12739,12539,20200517,25278
20200514,4,성신여대입구,19368,18553,20200517,37921
20200514,4,길음,19588,18708,20200517,38296
20200514,4,미아사거리,27488,26625,20200517,54113
20200514,4,미아,14916,14391,20200517,29307
20200514,4,수유,33747,33352,20200517,67099
20200514,4,쌍문,29427,26579,20200517,56006
20200514,4,창동,25773,27274,20200517,53047
20200514,4,노원,18756,21113,20200517,39869
20200514,4,상계,18965,17220,20200517,36185
20200514,4,당고개,12241,11440,20200517,23681
20200515,4,신용산,15008,15340,20200518,30348
20200515,4,삼각지,4432,4822,20200518,9254
20200515,4,숙대입구,12654,12370,20200518,25024
20200515,4,서울역,10808,15610,20200518,26418
20200515,4,회현,22300,23306,20200518,45606
20200515,4,명동,15437,16364,20200518,31801
20200515,4,충무로,25741,26786,20200518,52527
20200515,4,동대문역사문화공원,14262,13380,20200518,27642
20200515,4,동대문,19457,19850,20200518,39307
20200515,4,혜화,29164,29601,20200518,58765
20200515,4,한성대입구,12761,12495,20200518,25256
20200515,4,성신여대입구,19334,18903,20200518,38237
20200515,4,길음,19298,18310,20200518,37608
20200515,4,미아사거리,27076,26801,20200518,53877
20200515,4,미아,14588,13837,20200518,28425
20200515,4,수유,33155,33379,20200518,66534
20200515,4,쌍문,29037,25803,20200518,54840
20200515,4,창동,24870,26685,20200518,51555
20200515,4,노원,18378,21622,20200518,40000
20200515,4,상계,18522,16810,20200518,35332
20200515,4,당고개,11734,10507,20200518,22241
20200515,4,이촌,6478,7352,20200518,13830
20200515,4,동작,2068,2182,20200518,4250
20200515,4,총신대입구,18495,20908,20200518,39403
20200515,4,사당,24973,21563,20200518,46536
20200515,4,남태령,1118,925,20200518,2043
20200516,4,당고개,8987,8476,20200519,17463
20200516,4,상계,12736,11849,20200519,24585
20200516,4,노원,14462,16398,20200519,30860
20200516,4,창동,18197,19353,20200519,37550
20200516,4,쌍문,19556,17210,20200519,36766
20200516,4,수유,24475,24097,20200519,48572
20200516,4,미아,10442,9932,20200519,20374
20200516,4,미아사거리,20620,19749,20200519,40369
20200516,4,길음,12775,11878,20200519,24653
20200516,4,성신여대입구,15703,14650,20200519,30353
20200516,4,한성대입구,9275,8927,20200519,18202
20200516,4,혜화,21012,22402,20200519,43414
20200516,4,동대문,13306,12879,20200519,26185
20200516,4,동대문역사문화공원,9312,7997,20200519,17309
20200516,4,충무로,10865,11459,20200519,22324
20200516,4,명동,10215,11396,20200519,21611
20200516,4,회현,14569,15738,20200519,30307
20200516,4,서울역,4378,9045,20200519,13423
20200516,4,숙대입구,7625,7429,20200519,15054
20200516,4,삼각지,2203,2650,20200519,4853
20200516,4,신용산,6854,7381,20200519,14235
20200516,4,이촌,4399,4833,20200519,9232
20200516,4,동작,1948,1890,20200519,3838
20200516,4,총신대입구,13256,14478,20200519,27734
20200516,4,사당,18347,16417,20200519,34764
20200516,4,남태령,881,724,20200519,1605
20200517,4,미아사거리,15075,14237,20200520,29312
20200517,4,남태령,494,392,20200520,886
20200517,4,사당,13229,12376,20200520,25605
20200517,4,총신대입구,9266,10051,20200520,19317
20200517,4,동작,1856,1737,20200520,3593
20200517,4,이촌,3623,4320,20200520,7943
20200517,4,신용산,4924,5237,20200520,10161
20200517,4,삼각지,1468,1777,20200520,3245
20200517,4,숙대입구,5780,5748,20200520,11528
20200517,4,서울역,3197,6907,20200520,10104
20200517,4,회현,6779,7337,20200520,14116
20200517,4,명동,7965,8368,20200520,16333
20200517,4,충무로,6992,7194,20200520,14186
20200517,4,동대문역사문화공원,6966,7050,20200520,14016
20200517,4,동대문,6255,6693,20200520,12948
20200517,4,혜화,17029,18136,20200520,35165
20200517,4,한성대입구,6773,6758,20200520,13531
20200517,4,성신여대입구,11089,10794,20200520,21883
20200517,4,길음,9174,8826,20200520,18000
20200517,4,미아,7711,7130,20200520,14841
20200517,4,수유,18293,17352,20200520,35645
20200517,4,쌍문,14483,12782,20200520,27265
20200517,4,창동,13717,14411,20200520,28128
20200517,4,노원,10595,11534,20200520,22129
20200517,4,상계,9765,8905,20200520,18670
20200517,4,당고개,7193,7067,20200520,14260
20200518,4,남태령,973,908,20200521,1881
20200518,4,사당,22696,19082,20200521,41778
20200518,4,총신대입구,17974,19941,20200521,37915
20200518,4,동작,2178,2257,20200521,4435
20200518,4,이촌,6223,7145,20200521,13368
20200518,4,신용산,14835,15173,20200521,30008
20200518,4,삼각지,4474,4695,20200521,9169
20200518,4,숙대입구,12026,11999,20200521,24025
20200518,4,서울역,10606,13795,20200521,24401
20200518,4,회현,23015,23487,20200521,46502
20200518,4,명동,15215,16212,20200521,31427
20200518,4,충무로,25772,26547,20200521,52319
20200518,4,동대문역사문화공원,13965,13148,20200521,27113
20200518,4,동대문,20777,20626,20200521,41403
20200518,4,혜화,25900,25834,20200521,51734
20200518,4,한성대입구,12079,12178,20200521,24257
20200518,4,성신여대입구,18179,17684,20200521,35863
20200518,4,길음,19007,18542,20200521,37549
20200518,4,미아사거리,26387,25884,20200521,52271
20200518,4,미아,14346,13929,20200521,28275
20200518,4,수유,32574,32213,20200521,64787
20200518,4,쌍문,28464,26164,20200521,54628
20200518,4,창동,24655,26267,20200521,50922
20200518,4,노원,17853,19979,20200521,37832
20200518,4,상계,18276,16882,20200521,35158
20200518,4,당고개,11655,10631,20200521,22286
20200519,4,신용산,14609,15222,20200522,29831
20200519,4,남태령,1016,869,20200522,1885
20200519,4,사당,23286,20064,20200522,43350
20200519,4,총신대입구,18402,20167,20200522,38569
20200519,4,동작,2373,2444,20200522,4817
20200519,4,이촌,6472,7232,20200522,13704
20200519,4,삼각지,4611,4865,20200522,9476
20200519,4,숙대입구,12522,12452,20200522,24974
20200519,4,서울역,10688,14223,20200522,24911
20200519,4,회현,21951,23361,20200522,45312
20200519,4,명동,15847,16800,20200522,32647
20200519,4,충무로,26179,27099,20200522,53278
20200519,4,동대문역사문화공원,14142,13644,20200522,27786
20200519,4,동대문,19735,20148,20200522,39883
20200519,4,혜화,28525,28992,20200522,57517
20200519,4,한성대입구,12562,12384,20200522,24946
20200519,4,성신여대입구,18792,18207,20200522,36999
20200519,4,길음,19257,18415,20200522,37672
20200519,4,미아사거리,26897,26073,20200522,52970
20200519,4,미아,14494,14043,20200522,28537
20200519,4,수유,32749,32465,20200522,65214
20200519,4,쌍문,28865,26131,20200522,54996
20200519,4,창동,25001,26611,20200522,51612
20200519,4,노원,18181,20896,20200522,39077
20200519,4,상계,18470,16647,20200522,35117
20200519,4,당고개,11736,10689,20200522,22425
20200520,4,남태령,1096,974,20200523,2070
20200520,4,사당,24949,21393,20200523,46342
20200520,4,총신대입구,19800,21778,20200523,41578
20200520,4,동작,2890,3037,20200523,5927
20200520,4,이촌,6919,7870,20200523,14789
20200520,4,신용산,15197,15841,20200523,31038
20200520,4,삼각지,4648,5146,20200523,9794
20200520,4,숙대입구,13183,13102,20200523,26285
20200520,4,서울역,11477,14958,20200523,26435
20200520,4,회현,24495,26135,20200523,50630
20200520,4,명동,17263,18160,20200523,35423
20200520,4,충무로,27552,28502,20200523,56054
20200520,4,동대문역사문화공원,15241,14251,20200523,29492
20200520,4,동대문,21555,21898,20200523,43453
20200520,4,혜화,30946,31707,20200523,62653
20200520,4,한성대입구,13403,13111,20200523,26514
20200520,4,성신여대입구,20180,19157,20200523,39337
20200520,4,길음,20553,19440,20200523,39993
20200520,4,미아사거리,28454,27998,20200523,56452
20200520,4,미아,15424,14881,20200523,30305
20200520,4,수유,34655,33825,20200523,68480
20200520,4,쌍문,30210,27401,20200523,57611
20200520,4,창동,27324,28808,20200523,56132
20200520,4,노원,19436,22130,20200523,41566
20200520,4,상계,19724,17887,20200523,37611
20200520,4,당고개,12791,11634,20200523,24425
20200521,4,남태령,1113,1005,20200524,2118
20200521,4,사당,24972,21366,20200524,46338
20200521,4,총신대입구,19833,21619,20200524,41452
20200521,4,동작,2793,2882,20200524,5675
20200521,4,이촌,6821,7880,20200524,14701
20200521,4,신용산,15153,15896,20200524,31049
20200521,4,삼각지,4662,5101,20200524,9763
20200521,4,숙대입구,13185,12791,20200524,25976
20200521,4,서울역,11267,15365,20200524,26632
20200521,4,회현,24318,26069,20200524,50387
20200521,4,명동,17215,18119,20200524,35334
20200521,4,충무로,27574,28697,20200524,56271
20200521,4,동대문역사문화공원,14916,13965,20200524,28881
20200521,4,동대문,21359,21550,20200524,42909
20200521,4,혜화,29468,30322,20200524,59790
20200521,4,한성대입구,13357,13310,20200524,26667
20200521,4,성신여대입구,19840,18907,20200524,38747
20200521,4,길음,20314,19497,20200524,39811
20200521,4,미아사거리,28188,27381,20200524,55569
20200521,4,미아,15549,14946,20200524,30495
20200521,4,수유,34254,33434,20200524,67688
20200521,4,쌍문,30097,27154,20200524,57251
20200521,4,창동,27014,28699,20200524,55713
20200521,4,노원,19344,22003,20200524,41347
20200521,4,상계,19397,17687,20200524,37084
20200521,4,당고개,12667,11720,20200524,24387
20200522,4,당고개,12698,11435,20200525,24133
20200522,4,상계,19706,17613,20200525,37319
20200522,4,노원,19876,23267,20200525,43143
20200522,4,창동,27473,29210,20200525,56683
20200522,4,쌍문,30597,27456,20200525,58053
20200522,4,수유,34993,34380,20200525,69373
20200522,4,미아,15570,14726,20200525,30296
20200522,4,미아사거리,29139,28458,20200525,57597
20200522,4,길음,20648,19195,20200525,39843
20200522,4,성신여대입구,20550,19791,20200525,40341
20200522,4,한성대입구,13649,13531,20200525,27180
20200522,4,혜화,30590,31228,20200525,61818
20200522,4,동대문,21667,21965,20200525,43632
20200522,4,동대문역사문화공원,15227,14201,20200525,29428
20200522,4,충무로,27299,28917,20200525,56216
20200522,4,명동,17118,18057,20200525,35175
20200522,4,회현,24460,26034,20200525,50494
20200522,4,서울역,11182,16874,20200525,28056
20200522,4,숙대입구,12925,12738,20200525,25663
20200522,4,삼각지,4875,5412,20200525,10287
20200522,4,신용산,15976,16442,20200525,32418
20200522,4,이촌,7082,8013,20200525,15095
20200522,4,동작,2703,2840,20200525,5543
20200522,4,총신대입구,20511,22680,20200525,43191
20200522,4,사당,26154,22987,20200525,49141
20200522,4,남태령,1172,918,20200525,2090
20200523,4,당고개,9832,9389,20200526,19221
20200523,4,상계,13659,12816,20200526,26475
20200523,4,노원,15614,17866,20200526,33480
20200523,4,창동,19725,20964,20200526,40689
20200523,4,쌍문,21476,18946,20200526,40422
20200523,4,수유,25900,24740,20200526,50640
20200523,4,미아,11022,10112,20200526,21134
20200523,4,미아사거리,21889,21009,20200526,42898
20200523,4,길음,13752,12700,20200526,26452
20200523,4,성신여대입구,16205,15224,20200526,31429
20200523,4,한성대입구,10144,10204,20200526,20348
20200523,4,혜화,23667,25423,20200526,49090
20200523,4,동대문,15497,14790,20200526,30287
20200523,4,동대문역사문화공원,10649,9080,20200526,19729
20200523,4,충무로,12639,13275,20200526,25914
20200523,4,명동,12268,14007,20200526,26275
20200523,4,회현,17239,18653,20200526,35892
20200523,4,서울역,5138,10352,20200526,15490
20200523,4,숙대입구,8621,8297,20200526,16918
20200523,4,삼각지,2377,2852,20200526,5229
20200523,4,신용산,7490,8113,20200526,15603
20200523,4,이촌,5168,6139,20200526,11307
20200523,4,동작,2529,2511,20200526,5040
20200523,4,총신대입구,14594,16146,20200526,30740
20200523,4,사당,20594,18347,20200526,38941
20200523,4,남태령,883,631,20200526,1514
20200524,4,남태령,468,401,20200527,869
20200524,4,사당,12919,12085,20200527,25004
20200524,4,총신대입구,9113,10037,20200527,19150
20200524,4,동작,1609,1585,20200527,3194
20200524,4,이촌,3436,4076,20200527,7512
20200524,4,신용산,5238,5211,20200527,10449
20200524,4,삼각지,1475,1723,20200527,3198
20200524,4,숙대입구,5603,5539,20200527,11142
20200524,4,서울역,3335,7079,20200527,10414
20200524,4,회현,6533,7162,20200527,13695
20200524,4,명동,7909,8334,20200527,16243
20200524,4,충무로,7042,7262,20200527,14304
20200524,4,동대문역사문화공원,7051,7186,20200527,14237
20200524,4,동대문,5558,5941,20200527,11499
20200524,4,혜화,17266,18095,20200527,35361
20200524,4,한성대입구,6514,6564,20200527,13078
20200524,4,성신여대입구,11001,10583,20200527,21584
20200524,4,길음,8996,8972,20200527,17968
20200524,4,미아사거리,14400,13762,20200527,28162
20200524,4,미아,7507,6861,20200527,14368
20200524,4,수유,17588,16604,20200527,34192
20200524,4,쌍문,14388,12922,20200527,27310
20200524,4,창동,13375,14072,20200527,27447
20200524,4,노원,10890,11877,20200527,22767
20200524,4,상계,9120,8462,20200527,17582
20200524,4,당고개,6564,6222,20200527,12786
20200525,4,남태령,1151,1032,20200528,2183
20200525,4,사당,24157,20447,20200528,44604
20200525,4,총신대입구,19444,21506,20200528,40950
20200525,4,동작,2662,2800,20200528,5462
20200525,4,이촌,6576,7537,20200528,14113
20200525,4,신용산,15631,16249,20200528,31880
20200525,4,삼각지,4656,5022,20200528,9678
20200525,4,숙대입구,12689,12687,20200528,25376
20200525,4,서울역,11365,15119,20200528,26484
20200525,4,회현,23975,25539,20200528,49514
20200525,4,명동,17132,17995,20200528,35127
20200525,4,충무로,26557,27788,20200528,54345
20200525,4,동대문역사문화공원,14949,13904,20200528,28853
20200525,4,동대문,21572,21851,20200528,43423
20200525,4,혜화,27565,27975,20200528,55540
20200525,4,한성대입구,13066,12809,20200528,25875
20200525,4,성신여대입구,19537,18960,20200528,38497
20200525,4,길음,20111,19304,20200528,39415
20200525,4,미아사거리,28175,27752,20200528,55927
20200525,4,미아,15461,14841,20200528,30302
20200525,4,수유,34147,33703,20200528,67850
20200525,4,쌍문,30232,27017,20200528,57249
20200525,4,창동,26477,28192,20200528,54669
20200525,4,노원,19099,21419,20200528,40518
20200525,4,상계,19526,17809,20200528,37335
20200525,4,당고개,12612,11436,20200528,24048
20200526,4,남태령,1186,1079,20200529,2265
20200526,4,사당,24546,20868,20200529,45414
20200526,4,총신대입구,19536,21533,20200529,41069
20200526,4,동작,2440,2605,20200529,5045
20200526,4,이촌,6879,7738,20200529,14617
20200526,4,신용산,15555,16084,20200529,31639
20200526,4,삼각지,4698,5122,20200529,9820
20200526,4,숙대입구,13242,12990,20200529,26232
20200526,4,서울역,11578,15173,20200529,26751
20200526,4,회현,24889,26396,20200529,51285
20200526,4,명동,16995,17865,20200529,34860
20200526,4,충무로,27297,28305,20200529,55602
20200526,4,동대문역사문화공원,14888,13854,20200529,28742
20200526,4,동대문,21729,21824,20200529,43553
20200526,4,혜화,29293,29819,20200529,59112
20200526,4,한성대입구,13325,13112,20200529,26437
20200526,4,성신여대입구,19752,19081,20200529,38833
20200526,4,길음,20151,19422,20200529,39573
20200526,4,미아사거리,28242,27570,20200529,55812
20200526,4,미아,15546,14887,20200529,30433
20200526,4,수유,33794,33645,20200529,67439
20200526,4,쌍문,30038,27468,20200529,57506
20200526,4,창동,26313,28046,20200529,54359
20200526,4,노원,19159,21495,20200529,40654
20200526,4,상계,19391,17717,20200529,37108
20200526,4,당고개,12513,11437,20200529,23950
20200527,4,남태령,1160,1080,20200530,2240
20200527,4,사당,25144,21543,20200530,46687
20200527,4,총신대입구,20122,21955,20200530,42077
20200527,4,동작,2976,3129,20200530,6105
20200527,4,이촌,7192,8150,20200530,15342
20200527,4,신용산,15625,16411,20200530,32036
20200527,4,삼각지,4836,5279,20200530,10115
20200527,4,숙대입구,13492,13315,20200530,26807
20200527,4,서울역,11793,15618,20200530,27411
20200527,4,회현,24662,26325,20200530,50987
20200527,4,명동,17699,18663,20200530,36362
20200527,4,충무로,27402,28561,20200530,55963
20200527,4,동대문역사문화공원,15390,14417,20200530,29807
20200527,4,동대문,21761,21903,20200530,43664
20200527,4,혜화,31068,31840,20200530,62908
20200527,4,한성대입구,13732,13602,20200530,27334
20200527,4,성신여대입구,20004,19150,20200530,39154
20200527,4,길음,20703,19842,20200530,40545
20200527,4,미아사거리,28887,28019,20200530,56906
20200527,4,미아,16020,15312,20200530,31332
20200527,4,수유,34645,34226,20200530,68871
20200527,4,쌍문,30644,27763,20200530,58407
20200527,4,창동,27246,28869,20200530,56115
20200527,4,노원,19344,21878,20200530,41222
20200527,4,상계,19882,18176,20200530,38058
20200527,4,당고개,12727,11490,20200530,24217
20200528,4,남태령,1191,1097,20200531,2288
20200528,4,사당,24669,21213,20200531,45882
20200528,4,총신대입구,19562,21483,20200531,41045
20200528,4,동작,2620,2906,20200531,5526
20200528,4,이촌,6991,8023,20200531,15014
20200528,4,신용산,15623,16298,20200531,31921
20200528,4,삼각지,4877,5367,20200531,10244
20200528,4,숙대입구,13419,13165,20200531,26584
20200528,4,서울역,11653,15911,20200531,27564
20200528,4,회현,24159,25892,20200531,50051
20200528,4,명동,17351,18429,20200531,35780
20200528,4,충무로,27331,28513,20200531,55844
20200528,4,동대문역사문화공원,14837,13787,20200531,28624
20200528,4,동대문,21331,21673,20200531,43004
20200528,4,혜화,30453,31270,20200531,61723
20200528,4,한성대입구,13293,13243,20200531,26536
20200528,4,성신여대입구,19910,18985,20200531,38895
20200528,4,길음,20333,19515,20200531,39848
20200528,4,미아사거리,28509,27537,20200531,56046
20200528,4,미아,15827,15183,20200531,31010
20200528,4,수유,33978,33387,20200531,67365
20200528,4,쌍문,30194,27227,20200531,57421
20200528,4,창동,26894,28319,20200531,55213
20200528,4,노원,19163,21826,20200531,40989
20200528,4,상계,19639,17825,20200531,37464
20200528,4,당고개,12505,11474,20200531,23979
20200529,4,당고개,12761,11598,20200601,24359
20200529,4,상계,20129,18073,20200601,38202
20200529,4,노원,19663,23236,20200601,42899
20200529,4,창동,27231,28876,20200601,56107
20200529,4,쌍문,31000,27308,20200601,58308
20200529,4,수유,35158,34601,20200601,69759
20200529,4,미아,15909,15103,20200601,31012
20200529,4,미아사거리,29329,28608,20200601,57937
20200529,4,길음,20760,19285,20200601,40045
20200529,4,성신여대입구,20382,19707,20200601,40089
20200529,4,한성대입구,14110,13823,20200601,27933
20200529,4,혜화,30768,31610,20200601,62378
20200529,4,동대문,21571,21923,20200601,43494
20200529,4,동대문역사문화공원,15185,14277,20200601,29462
20200529,4,충무로,27310,28894,20200601,56204
20200529,4,명동,17892,18833,20200601,36725
20200529,4,회현,24297,25847,20200601,50144
20200529,4,서울역,12021,17598,20200601,29619
20200529,4,숙대입구,13433,13310,20200601,26743
20200529,4,삼각지,4901,5371,20200601,10272
20200529,4,신용산,16303,17064,20200601,33367
20200529,4,이촌,7143,8341,20200601,15484
20200529,4,동작,2737,2935,20200601,5672
20200529,4,총신대입구,20287,22301,20200601,42588
20200529,4,사당,26123,22430,20200601,48553
20200529,4,남태령,1287,1077,20200601,2364
20200530,4,당고개,10341,9712,20200602,20053
20200530,4,상계,13503,12492,20200602,25995
20200530,4,노원,15187,17258,20200602,32445
20200530,4,창동,18642,19977,20200602,38619
20200530,4,쌍문,20786,18365,20200602,39151
20200530,4,수유,25215,24345,20200602,49560
20200530,4,미아,10798,10083,20200602,20881
20200530,4,미아사거리,21317,20283,20200602,41600
20200530,4,길음,13372,12522,20200602,25894
20200530,4,성신여대입구,16004,15131,20200602,31135
20200530,4,한성대입구,10429,9974,20200602,20403
20200530,4,혜화,22027,23596,20200602,45623
20200530,4,동대문,14252,13698,20200602,27950
20200530,4,동대문역사문화공원,9881,8488,20200602,18369
20200530,4,충무로,11807,12526,20200602,24333
20200530,4,명동,11407,13009,20200602,24416
20200530,4,회현,16150,17176,20200602,33326
20200530,4,서울역,4747,9535,20200602,14282
20200530,4,숙대입구,8231,7986,20200602,16217
20200530,4,삼각지,2295,2889,20200602,5184
20200530,4,신용산,7251,7922,20200602,15173
20200530,4,이촌,4522,5368,20200602,9890
20200530,4,동작,2336,2394,20200602,4730
20200530,4,총신대입구,13702,15146,20200602,28848
20200530,4,사당,19432,16706,20200602,36138
20200530,4,남태령,825,610,20200602,1435
20200531,4,남태령,551,404,20200603,955
20200531,4,사당,12749,11997,20200603,24746
20200531,4,총신대입구,9166,10196,20200603,19362
20200531,4,동작,1697,1762,20200603,3459
20200531,4,이촌,3309,4076,20200603,7385
20200531,4,신용산,5252,5154,20200603,10406
20200531,4,삼각지,1533,1909,20200603,3442
20200531,4,숙대입구,5746,5585,20200603,11331
20200531,4,서울역,3303,6943,20200603,10246
20200531,4,회현,6623,7213,20200603,13836
20200531,4,명동,8137,8728,20200603,16865
20200531,4,충무로,6954,7212,20200603,14166
20200531,4,동대문역사문화공원,6849,7037,20200603,13886
20200531,4,동대문,5876,6478,20200603,12354
20200531,4,혜화,16583,17662,20200603,34245
20200531,4,한성대입구,6879,6977,20200603,13856
20200531,4,성신여대입구,11225,10620,20200603,21845
20200531,4,길음,9236,9040,20200603,18276
20200531,4,미아사거리,14808,14124,20200603,28932
20200531,4,미아,7432,7123,20200603,14555
20200531,4,수유,18245,17081,20200603,35326
20200531,4,쌍문,14489,12751,20200603,27240
20200531,4,창동,13851,14457,20200603,28308
20200531,4,노원,10546,11463,20200603,22009
20200531,4,상계,9478,8656,20200603,18134
20200531,4,당고개,7067,6885,20200603,13952
20200101,5,마천,2513,2886,20200104,5399
20200101,5,거여,3236,3339,20200104,6575
20200101,5,개롱,2618,2800,20200104,5418
20200101,5,오금,1239,1267,20200104,2506
20200101,5,방이,3212,3249,20200104,6461
20200101,5,올림픽공원,1723,1529,20200104,3252
20200101,5,둔촌동,3690,3919,20200104,7609
20200101,5,상일동,5804,5654,20200104,11458
20200101,5,고덕,3733,3855,20200104,7588
20200101,5,명일,3509,3773,20200104,7282
20200101,5,굽은다리,4720,4732,20200104,9452
20200101,5,길동,3548,3645,20200104,7193
20200101,5,강동,9082,8585,20200104,17667
20200101,5,천호,10564,10446,20200104,21010
20200101,5,광나루,6639,6603,20200104,13242
20200101,5,아차산,11000,10740,20200104,21740
20200101,5,군자,5306,5967,20200104,11273
20200101,5,장한평,7977,7927,20200104,15904
20200101,5,답십리,6768,6415,20200104,13183
20200101,5,마장,2818,2894,20200104,5712
20200101,5,왕십리,2563,3023,20200104,5586
20200101,5,행당,3526,3245,20200104,6771
20200101,5,신금호,2763,2995,20200104,5758
20200101,5,청구,1683,1629,20200104,3312
20200101,5,동대문역사문화공원,913,960,20200104,1873
20200101,5,을지로4가,1467,1521,20200104,2988
20200101,5,종로3가,11043,9303,20200104,20346
20200101,5,광화문,14455,14112,20200104,28567
20200101,5,서대문,5058,4839,20200104,9897
20200101,5,충정로,1129,1203,20200104,2332
20200101,5,애오개,2467,2610,20200104,5077
20200101,5,공덕,4067,4350,20200104,8417
20200101,5,마포,4568,4518,20200104,9086
20200101,5,여의나루,3468,3538,20200104,7006
20200101,5,여의도,4652,4914,20200104,9566
20200101,5,신길,1473,1623,20200104,3096
20200101,5,영등포시장,4405,4613,20200104,9018
20200101,5,영등포구청,1138,1093,20200104,2231
20200101,5,양평,2100,2272,20200104,4372
20200101,5,오목교,10151,10853,20200104,21004
20200101,5,목동,7142,7638,20200104,14780
20200101,5,신정,5624,5205,20200104,10829
20200101,5,까치산,14837,14783,20200104,29620
20200101,5,화곡,12863,12898,20200104,25761
20200101,5,우장산,6199,6459,20200104,12658
20200101,5,발산,7915,8357,20200104,16272
20200101,5,마곡,2189,2216,20200104,4405
20200101,5,송정,3726,3710,20200104,7436
20200101,5,김포공항,7254,7138,20200104,14392
20200101,5,개화산,2805,2978,20200104,5783
20200101,5,방화,3953,3966,20200104,7919
20200102,5,방화,7690,7286,20200105,14976
20200102,5,개화산,6272,5936,20200105,12208
20200102,5,김포공항,8515,8178,20200105,16693
20200102,5,송정,7806,7161,20200105,14967
20200102,5,마곡,7983,7485,20200105,15468
20200102,5,발산,21120,21393,20200105,42513
20200102,5,우장산,16576,16352,20200105,32928
20200102,5,화곡,32168,29814,20200105,61982
20200102,5,까치산,32357,30881,20200105,63238
20200102,5,신정,15241,11711,20200105,26952
20200102,5,목동,19773,21525,20200105,41298
20200102,5,오목교,26539,28743,20200105,55282
20200102,5,양평,7950,7876,20200105,15826
20200102,5,영등포구청,4228,4265,20200105,8493
20200102,5,영등포시장,10803,11289,20200105,22092
20200102,5,신길,3911,4384,20200105,8295
20200102,5,여의도,29489,30935,20200105,60424
20200102,5,여의나루,8145,8751,20200105,16896
20200102,5,마포,15972,16337,20200105,32309
20200102,5,공덕,15677,16832,20200105,32509
20200102,5,애오개,8256,8250,20200105,16506
20200102,5,충정로,4998,5057,20200105,10055
20200102,5,서대문,20906,21616,20200105,42522
20200102,5,광화문,38226,40379,20200105,78605
20200102,5,종로3가,17306,16601,20200105,33907
20200102,5,을지로4가,6568,6814,20200105,13382
20200102,5,동대문역사문화공원,3524,4151,20200105,7675
20200102,5,청구,4485,4007,20200105,8492
20200102,5,신금호,7015,7051,20200105,14066
20200102,5,행당,9197,8248,20200105,17445
20200102,5,왕십리,5036,5745,20200105,10781
20200102,5,마장,6308,6003,20200105,12311
20200102,5,답십리,17807,16339,20200105,34146
20200102,5,장한평,20581,20571,20200105,41152
20200102,5,군자,11784,12826,20200105,24610
20200102,5,아차산,14863,14392,20200105,29255
20200102,5,광나루,14691,13291,20200105,27982
20200102,5,천호,20832,21750,20200105,42582
20200102,5,강동,22470,19427,20200105,41897
20200102,5,길동,8013,8609,20200105,16622
20200102,5,굽은다리,10127,9590,20200105,19717
20200102,5,명일,9333,9585,20200105,18918
20200102,5,고덕,10677,10649,20200105,21326
20200102,5,상일동,16880,14354,20200105,31234
20200102,5,둔촌동,9265,9410,20200105,18675
20200102,5,올림픽공원,4422,3922,20200105,8344
20200102,5,방이,8089,8304,20200105,16393
20200102,5,오금,3904,3897,20200105,7801
20200102,5,개롱,7523,7760,20200105,15283
20200102,5,거여,8822,8140,20200105,16962
20200102,5,마천,5480,5637,20200105,11117
20200103,5,방화,8164,7566,20200106,15730
20200103,5,개화산,6450,6148,20200106,12598
20200103,5,김포공항,9042,8275,20200106,17317
20200103,5,송정,8268,7542,20200106,15810
20200103,5,마곡,8433,7723,20200106,16156
20200103,5,발산,22416,22878,20200106,45294
20200103,5,우장산,17271,16996,20200106,34267
20200103,5,화곡,33888,31072,20200106,64960
20200103,5,까치산,33898,31942,20200106,65840
20200103,5,신정,15931,11807,20200106,27738
20200103,5,목동,20691,22418,20200106,43109
20200103,5,오목교,28019,30554,20200106,58573
20200103,5,양평,8274,7929,20200106,16203
20200103,5,영등포구청,4404,4464,20200106,8868
20200103,5,영등포시장,11701,12117,20200106,23818
20200103,5,신길,4012,4487,20200106,8499
20200103,5,여의도,30396,31914,20200106,62310
20200103,5,여의나루,8881,8997,20200106,17878
20200103,5,마포,16862,17413,20200106,34275
20200103,5,공덕,16709,18147,20200106,34856
20200103,5,애오개,8513,8367,20200106,16880
20200103,5,충정로,5219,5274,20200106,10493
20200103,5,서대문,21637,22384,20200106,44021
20200103,5,광화문,43498,46209,20200106,89707
20200103,5,종로3가,19465,18960,20200106,38425
20200103,5,을지로4가,6915,7189,20200106,14104
20200103,5,동대문역사문화공원,3536,4255,20200106,7791
20200103,5,청구,4638,4201,20200106,8839
20200103,5,신금호,7326,7242,20200106,14568
20200103,5,행당,9538,8229,20200106,17767
20200103,5,왕십리,5451,6428,20200106,11879
20200103,5,마장,6610,6413,20200106,13023
20200103,5,답십리,18455,16726,20200106,35181
20200103,5,장한평,21828,21727,20200106,43555
20200103,5,군자,12588,13789,20200106,26377
20200103,5,아차산,15555,15102,20200106,30657
20200103,5,광나루,15384,13716,20200106,29100
20200103,5,천호,22890,23831,20200106,46721
20200103,5,강동,23193,19940,20200106,43133
20200103,5,길동,8493,9105,20200106,17598
20200103,5,굽은다리,10596,9868,20200106,20464
20200103,5,명일,9845,10128,20200106,19973
20200103,5,고덕,10859,10715,20200106,21574
20200103,5,상일동,17345,14581,20200106,31926
20200103,5,둔촌동,9918,10064,20200106,19982
20200103,5,올림픽공원,4790,4133,20200106,8923
20200103,5,방이,8464,8720,20200106,17184
20200103,5,오금,4051,3987,20200106,8038
20200103,5,개롱,7670,7795,20200106,15465
20200103,5,거여,9101,8406,20200106,17507
20200103,5,마천,5855,5638,20200106,11493
20200104,5,방화,5465,5124,20200107,10589
20200104,5,개화산,4393,4197,20200107,8590
20200104,5,김포공항,8056,8076,20200107,16132
20200104,5,송정,6276,5915,20200107,12191
20200104,5,마곡,4173,3912,20200107,8085
20200104,5,발산,14599,15588,20200107,30187
20200104,5,우장산,11887,11661,20200107,23548
20200104,5,화곡,23575,21458,20200107,45033
20200104,5,까치산,24526,22900,20200107,47426
20200104,5,신정,10209,8275,20200107,18484
20200104,5,목동,13626,14081,20200107,27707
20200104,5,오목교,20220,20904,20200107,41124
20200104,5,양평,3897,3680,20200107,7577
20200104,5,영등포구청,2106,2019,20200107,4125
20200104,5,영등포시장,8941,9457,20200107,18398
20200104,5,신길,2496,2701,20200107,5197
20200104,5,여의도,9402,10508,20200107,19910
20200104,5,여의나루,4803,4786,20200107,9589
20200104,5,마포,8558,8787,20200107,17345
20200104,5,공덕,8724,9141,20200107,17865
20200104,5,애오개,4418,4294,20200107,8712
20200104,5,충정로,2232,2130,20200107,4362
20200104,5,서대문,9693,9342,20200107,19035
20200104,5,광화문,31915,33740,20200107,65655
20200104,5,종로3가,17845,17435,20200107,35280
20200104,5,을지로4가,4220,4572,20200107,8792
20200104,5,동대문역사문화공원,1293,1656,20200107,2949
20200104,5,청구,3000,2664,20200107,5664
20200104,5,신금호,4848,4916,20200107,9764
20200104,5,행당,6667,5764,20200107,12431
20200104,5,왕십리,4152,5095,20200107,9247
20200104,5,마장,4617,4624,20200107,9241
20200104,5,답십리,12244,11186,20200107,23430
20200104,5,장한평,13592,13809,20200107,27401
20200104,5,군자,9303,10235,20200107,19538
20200104,5,아차산,12957,12417,20200107,25374
20200104,5,광나루,12001,11361,20200107,23362
20200104,5,천호,19375,19587,20200107,38962
20200104,5,강동,17269,14909,20200107,32178
20200104,5,길동,6205,6588,20200107,12793
20200104,5,굽은다리,8113,7390,20200107,15503
20200104,5,명일,6722,6605,20200107,13327
20200104,5,고덕,6972,6559,20200107,13531
20200104,5,상일동,10987,9659,20200107,20646
20200104,5,둔촌동,7197,7112,20200107,14309
20200104,5,올림픽공원,3728,3670,20200107,7398
20200104,5,방이,6276,6109,20200107,12385
20200104,5,오금,2327,2290,20200107,4617
20200104,5,개롱,5128,5208,20200107,10336
20200104,5,거여,6077,5700,20200107,11777
20200104,5,마천,4414,4531,20200107,8945
20200105,5,방화,4438,4286,20200108,8724
20200105,5,개화산,3200,3297,20200108,6497
20200105,5,김포공항,7358,7074,20200108,14432
20200105,5,송정,4460,4589,20200108,9049
20200105,5,마곡,2653,2727,20200108,5380
20200105,5,발산,9410,10013,20200108,19423
20200105,5,우장산,8056,8312,20200108,16368
20200105,5,화곡,16516,15800,20200108,32316
20200105,5,까치산,18271,17747,20200108,36018
20200105,5,신정,7304,6231,20200108,13535
20200105,5,목동,9629,9840,20200108,19469
20200105,5,오목교,13732,14734,20200108,28466
20200105,5,양평,2754,2871,20200108,5625
20200105,5,영등포구청,1465,1439,20200108,2904
20200105,5,영등포시장,6136,6356,20200108,12492
20200105,5,신길,1677,1856,20200108,3533
20200105,5,여의도,6210,6722,20200108,12932
20200105,5,여의나루,4064,4133,20200108,8197
20200105,5,마포,5610,5644,20200108,11254
20200105,5,공덕,5149,5138,20200108,10287
20200105,5,애오개,3137,3229,20200108,6366
20200105,5,충정로,1500,1435,20200108,2935
20200105,5,서대문,6181,6117,20200108,12298
20200105,5,광화문,16950,16875,20200108,33825
20200105,5,종로3가,11672,10162,20200108,21834
20200105,5,을지로4가,1718,1942,20200108,3660
20200105,5,동대문역사문화공원,858,1050,20200108,1908
20200105,5,청구,2180,1833,20200108,4013
20200105,5,신금호,3488,3607,20200108,7095
20200105,5,행당,4549,4154,20200108,8703
20200105,5,왕십리,2893,3492,20200108,6385
20200105,5,마장,3491,3374,20200108,6865
20200105,5,답십리,8897,8321,20200108,17218
20200105,5,장한평,9540,9593,20200108,19133
20200105,5,군자,6822,7575,20200108,14397
20200105,5,아차산,10905,10841,20200108,21746
20200105,5,광나루,9171,8814,20200108,17985
20200105,5,천호,14707,14520,20200108,29227
20200105,5,강동,11576,10588,20200108,22164
20200105,5,길동,4338,4420,20200108,8758
20200105,5,굽은다리,6115,5795,20200108,11910
20200105,5,명일,5264,5248,20200108,10512
20200105,5,고덕,4422,4641,20200108,9063
20200105,5,상일동,7087,6899,20200108,13986
20200105,5,둔촌동,6143,6179,20200108,12322
20200105,5,올림픽공원,2528,2525,20200108,5053
20200105,5,방이,4610,4413,20200108,9023
20200105,5,오금,1712,1667,20200108,3379
20200105,5,개롱,3684,4056,20200108,7740
20200105,5,거여,4302,4234,20200108,8536
20200105,5,마천,3477,3740,20200108,7217
20200106,5,방화,7745,7442,20200109,15187
20200106,5,개화산,6391,6152,20200109,12543
20200106,5,김포공항,8559,8088,20200109,16647
20200106,5,송정,8116,7415,20200109,15531
20200106,5,마곡,8486,7822,20200109,16308
20200106,5,발산,22171,22078,20200109,44249
20200106,5,우장산,16776,16714,20200109,33490
20200106,5,화곡,33022,30841,20200109,63863
20200106,5,까치산,33226,31764,20200109,64990
20200106,5,신정,15470,12219,20200109,27689
20200106,5,목동,20327,22402,20200109,42729
20200106,5,오목교,26863,28825,20200109,55688
20200106,5,양평,8226,8163,20200109,16389
20200106,5,영등포구청,4313,4374,20200109,8687
20200106,5,영등포시장,10751,11293,20200109,22044
20200106,5,신길,4060,4638,20200109,8698
20200106,5,여의도,31085,32213,20200109,63298
20200106,5,여의나루,7888,8356,20200109,16244
20200106,5,마포,17296,17623,20200109,34919
20200106,5,공덕,16269,17631,20200109,33900
20200106,5,애오개,8465,8686,20200109,17151
20200106,5,충정로,5358,5461,20200109,10819
20200106,5,서대문,22051,22477,20200109,44528
20200106,5,광화문,39257,39980,20200109,79237
20200106,5,종로3가,16805,16250,20200109,33055
20200106,5,을지로4가,6647,6963,20200109,13610
20200106,5,동대문역사문화공원,3622,4059,20200109,7681
20200106,5,청구,4628,4146,20200109,8774
20200106,5,신금호,7137,7258,20200109,14395
20200106,5,행당,9445,8501,20200109,17946
20200106,5,왕십리,5182,5743,20200109,10925
20200106,5,마장,6588,6345,20200109,12933
20200106,5,답십리,18087,16785,20200109,34872
20200106,5,장한평,20657,20812,20200109,41469
20200106,5,군자,11899,13140,20200109,25039
20200106,5,아차산,14954,14825,20200109,29779
20200106,5,광나루,14947,13394,20200109,28341
20200106,5,천호,20185,21113,20200109,41298
20200106,5,강동,22940,20198,20200109,43138
20200106,5,길동,8422,9064,20200109,17486
20200106,5,굽은다리,10242,9834,20200109,20076
20200106,5,명일,9705,10251,20200109,19956
20200106,5,고덕,10778,10842,20200109,21620
20200106,5,상일동,17225,14696,20200109,31921
20200106,5,둔촌동,9858,10139,20200109,19997
20200106,5,올림픽공원,4660,4145,20200109,8805
20200106,5,방이,8162,8497,20200109,16659
20200106,5,오금,4101,4088,20200109,8189
20200106,5,개롱,7736,7954,20200109,15690
20200106,5,거여,9115,8513,20200109,17628
20200106,5,마천,5698,5702,20200109,11400
20200107,5,방화,7525,7234,20200110,14759
20200107,5,개화산,6199,5800,20200110,11999
20200107,5,김포공항,8283,7785,20200110,16068
20200107,5,송정,7629,6976,20200110,14605
20200107,5,마곡,8311,7674,20200110,15985
20200107,5,발산,21375,21470,20200110,42845
20200107,5,우장산,16416,16391,20200110,32807
20200107,5,화곡,31495,29286,20200110,60781
20200107,5,까치산,32095,30770,20200110,62865
20200107,5,신정,15229,11739,20200110,26968
20200107,5,목동,19826,21918,20200110,41744
20200107,5,오목교,26933,29069,20200110,56002
20200107,5,양평,8011,8093,20200110,16104
20200107,5,영등포구청,4222,4328,20200110,8550
20200107,5,영등포시장,10422,10868,20200110,21290
20200107,5,신길,3951,4538,20200110,8489
20200107,5,여의도,31466,32806,20200110,64272
20200107,5,여의나루,7898,8113,20200110,16011
20200107,5,마포,16929,17388,20200110,34317
20200107,5,공덕,16331,17836,20200110,34167
20200107,5,애오개,8290,8487,20200110,16777
20200107,5,충정로,5456,5662,20200110,11118
20200107,5,서대문,22265,22475,20200110,44740
20200107,5,광화문,39458,40731,20200110,80189
20200107,5,종로3가,15853,15282,20200110,31135
20200107,5,을지로4가,6467,6547,20200110,13014
20200107,5,동대문역사문화공원,3593,4120,20200110,7713
20200107,5,청구,4591,4199,20200110,8790
20200107,5,신금호,7060,7211,20200110,14271
20200107,5,행당,9397,8465,20200110,17862
20200107,5,왕십리,5204,5885,20200110,11089
20200107,5,마장,6581,6292,20200110,12873
20200107,5,답십리,17755,16442,20200110,34197
20200107,5,장한평,20175,20133,20200110,40308
20200107,5,군자,11920,13015,20200110,24935
20200107,5,아차산,14728,14428,20200110,29156
20200107,5,광나루,14711,13298,20200110,28009
20200107,5,천호,19887,20739,20200110,40626
20200107,5,강동,22737,20189,20200110,42926
20200107,5,길동,8160,8680,20200110,16840
20200107,5,굽은다리,10177,9973,20200110,20150
20200107,5,명일,9442,10008,20200110,19450
20200107,5,고덕,10791,10680,20200110,21471
20200107,5,상일동,16707,14338,20200110,31045
20200107,5,둔촌동,9652,9870,20200110,19522
20200107,5,올림픽공원,4438,3928,20200110,8366
20200107,5,방이,8250,8556,20200110,16806
20200107,5,오금,4004,3952,20200110,7956
20200107,5,개롱,7582,7863,20200110,15445
20200107,5,거여,8568,8051,20200110,16619
20200107,5,마천,5355,5357,20200110,10712
20200108,5,방화,7989,7514,20200111,15503
20200108,5,개화산,6564,6131,20200111,12695
20200108,5,김포공항,8942,8541,20200111,17483
20200108,5,송정,8260,7474,20200111,15734
20200108,5,마곡,8481,7976,20200111,16457
20200108,5,발산,22721,23112,20200111,45833
20200108,5,우장산,17225,17168,20200111,34393
20200108,5,화곡,33420,31114,20200111,64534
20200108,5,까치산,33322,31879,20200111,65201
20200108,5,신정,15893,12316,20200111,28209
20200108,5,목동,20896,22490,20200111,43386
20200108,5,오목교,27595,29878,20200111,57473
20200108,5,양평,8191,8009,20200111,16200
20200108,5,영등포구청,4454,4506,20200111,8960
20200108,5,영등포시장,11360,11910,20200111,23270
20200108,5,신길,4096,4576,20200111,8672
20200108,5,여의도,31271,32961,20200111,64232
20200108,5,여의나루,8288,8657,20200111,16945
20200108,5,마포,17248,17501,20200111,34749
20200108,5,공덕,16580,17688,20200111,34268
20200108,5,애오개,8497,8573,20200111,17070
20200108,5,충정로,5556,5650,20200111,11206
20200108,5,서대문,21973,22634,20200111,44607
20200108,5,광화문,39937,42556,20200111,82493
20200108,5,종로3가,17616,16920,20200111,34536
20200108,5,을지로4가,6898,7016,20200111,13914
20200108,5,동대문역사문화공원,3516,4192,20200111,7708
20200108,5,청구,4809,4417,20200111,9226
20200108,5,신금호,7307,7398,20200111,14705
20200108,5,행당,9988,8849,20200111,18837
20200108,5,왕십리,5412,6244,20200111,11656
20200108,5,마장,6849,6370,20200111,13219
20200108,5,답십리,18614,16895,20200111,35509
20200108,5,장한평,21542,21531,20200111,43073
20200108,5,군자,12692,13614,20200111,26306
20200108,5,아차산,15532,15158,20200111,30690
20200108,5,광나루,15571,13917,20200111,29488
20200108,5,천호,21288,22057,20200111,43345
20200108,5,강동,23060,20300,20200111,43360
20200108,5,길동,8528,9184,20200111,17712
20200108,5,굽은다리,10648,10214,20200111,20862
20200108,5,명일,9982,10411,20200111,20393
20200108,5,고덕,11263,11058,20200111,22321
20200108,5,상일동,17689,14902,20200111,32591
20200108,5,둔촌동,10005,10392,20200111,20397
20200108,5,올림픽공원,4880,4202,20200111,9082
20200108,5,방이,8571,8981,20200111,17552
20200108,5,오금,4061,4067,20200111,8128
20200108,5,개롱,7970,8145,20200111,16115
20200108,5,거여,9020,8409,20200111,17429
20200108,5,마천,5727,5642,20200111,11369
20200109,5,방화,8039,7677,20200112,15716
20200109,5,개화산,6585,6178,20200112,12763
20200109,5,김포공항,8901,8697,20200112,17598
20200109,5,송정,8280,7665,20200112,15945
20200109,5,마곡,8619,8090,20200112,16709
20200109,5,발산,22797,22874,20200112,45671
20200109,5,우장산,17112,16862,20200112,33974
20200109,5,화곡,33815,31383,20200112,65198
20200109,5,까치산,33710,32270,20200112,65980
20200109,5,신정,15867,12351,20200112,28218
20200109,5,목동,20975,22686,20200112,43661
20200109,5,오목교,27714,29835,20200112,57549
20200109,5,양평,8256,8172,20200112,16428
20200109,5,영등포구청,4346,4568,20200112,8914
20200109,5,영등포시장,11257,11652,20200112,22909
20200109,5,신길,4011,4562,20200112,8573
20200109,5,여의도,31251,33186,20200112,64437
20200109,5,여의나루,8100,8675,20200112,16775
20200109,5,마포,17356,17840,20200112,35196
20200109,5,공덕,16925,18163,20200112,35088
20200109,5,애오개,8533,8565,20200112,17098
20200109,5,충정로,5500,5732,20200112,11232
20200109,5,서대문,21785,22616,20200112,44401
20200109,5,광화문,40484,42765,20200112,83249
20200109,5,종로3가,18461,17424,20200112,35885
20200109,5,을지로4가,7084,7145,20200112,14229
20200109,5,동대문역사문화공원,3471,4199,20200112,7670
20200109,5,청구,4797,4337,20200112,9134
20200109,5,신금호,7273,7262,20200112,14535
20200109,5,행당,9939,8837,20200112,18776
20200109,5,왕십리,5501,6200,20200112,11701
20200109,5,마장,6824,6481,20200112,13305
20200109,5,답십리,18563,16869,20200112,35432
20200109,5,장한평,21702,21587,20200112,43289
20200109,5,군자,12429,13665,20200112,26094
20200109,5,아차산,15726,15277,20200112,31003
20200109,5,광나루,15582,13973,20200112,29555
20200109,5,천호,21594,22790,20200112,44384
20200109,5,강동,23339,20499,20200112,43838
20200109,5,길동,8716,9177,20200112,17893
20200109,5,굽은다리,10913,10341,20200112,21254
20200109,5,명일,9892,10419,20200112,20311
20200109,5,고덕,11064,11022,20200112,22086
20200109,5,상일동,17902,15203,20200112,33105
20200109,5,둔촌동,10366,10186,20200112,20552
20200109,5,올림픽공원,5037,4188,20200112,9225
20200109,5,방이,8895,9238,20200112,18133
20200109,5,오금,4196,4163,20200112,8359
20200109,5,개롱,7954,8028,20200112,15982
20200109,5,거여,8939,8324,20200112,17263
20200109,5,마천,5751,5815,20200112,11566
20200110,5,방화,8466,7838,20200113,16304
20200110,5,개화산,6643,6222,20200113,12865
20200110,5,김포공항,9665,8902,20200113,18567
20200110,5,송정,8540,7822,20200113,16362
20200110,5,마곡,8810,8095,20200113,16905
20200110,5,발산,22970,23719,20200113,46689
20200110,5,우장산,17477,17084,20200113,34561
20200110,5,화곡,34389,31589,20200113,65978
20200110,5,까치산,34840,32695,20200113,67535
20200110,5,신정,16020,11996,20200113,28016
20200110,5,목동,21575,23431,20200113,45006
20200110,5,오목교,28771,31151,20200113,59922
20200110,5,양평,8420,8220,20200113,16640
20200110,5,영등포구청,4456,4576,20200113,9032
20200110,5,영등포시장,12015,12258,20200113,24273
20200110,5,신길,4222,4695,20200113,8917
20200110,5,여의도,31353,33542,20200113,64895
20200110,5,여의나루,8832,8933,20200113,17765
20200110,5,마포,17815,18397,20200113,36212
20200110,5,공덕,17257,18742,20200113,35999
20200110,5,애오개,8679,8663,20200113,17342
20200110,5,충정로,5463,5505,20200113,10968
20200110,5,서대문,21942,22742,20200113,44684
20200110,5,광화문,41489,44117,20200113,85606
20200110,5,종로3가,19222,19230,20200113,38452
20200110,5,을지로4가,7024,7313,20200113,14337
20200110,5,동대문역사문화공원,3442,4152,20200113,7594
20200110,5,청구,4928,4550,20200113,9478
20200110,5,신금호,7513,7353,20200113,14866
20200110,5,행당,10088,8812,20200113,18900
20200110,5,왕십리,5600,6476,20200113,12076
20200110,5,마장,7239,6826,20200113,14065
20200110,5,답십리,18871,17022,20200113,35893
20200110,5,장한평,22384,22216,20200113,44600
20200110,5,군자,13059,14511,20200113,27570
20200110,5,아차산,16334,15614,20200113,31948
20200110,5,광나루,16420,14702,20200113,31122
20200110,5,천호,22945,23989,20200113,46934
20200110,5,강동,23829,20628,20200113,44457
20200110,5,길동,8931,9478,20200113,18409
20200110,5,굽은다리,10804,10149,20200113,20953
20200110,5,명일,10492,10639,20200113,21131
20200110,5,고덕,11337,11035,20200113,22372
20200110,5,상일동,18066,14948,20200113,33014
20200110,5,둔촌동,10054,10264,20200113,20318
20200110,5,올림픽공원,5100,4267,20200113,9367
20200110,5,방이,9033,9456,20200113,18489
20200110,5,오금,4188,4143,20200113,8331
20200110,5,개롱,8180,8223,20200113,16403
20200110,5,거여,9255,8589,20200113,17844
20200110,5,마천,5987,5879,20200113,11866
20200111,5,방화,5759,5481,20200114,11240
20200111,5,개화산,4632,4354,20200114,8986
20200111,5,김포공항,8613,8713,20200114,17326
20200111,5,송정,6567,6157,20200114,12724
20200111,5,마곡,4443,4162,20200114,8605
20200111,5,발산,15786,16602,20200114,32388
20200111,5,우장산,12693,12405,20200114,25098
20200111,5,화곡,24661,22687,20200114,47348
20200111,5,까치산,25998,24629,20200114,50627
20200111,5,신정,10932,8855,20200114,19787
20200111,5,목동,14581,14879,20200114,29460
20200111,5,오목교,22043,23223,20200114,45266
20200111,5,양평,4350,4041,20200114,8391
20200111,5,영등포구청,2236,2248,20200114,4484
20200111,5,영등포시장,9743,10374,20200114,20117
20200111,5,신길,2664,2947,20200114,5611
20200111,5,여의도,10420,11741,20200114,22161
20200111,5,여의나루,4751,4815,20200114,9566
20200111,5,마포,9355,9470,20200114,18825
20200111,5,공덕,9097,9620,20200114,18717
20200111,5,애오개,4721,4481,20200114,9202
20200111,5,충정로,2574,2302,20200114,4876
20200111,5,서대문,10915,10558,20200114,21473
20200111,5,광화문,41381,40584,20200114,81965
20200111,5,종로3가,19129,18754,20200114,37883
20200111,5,을지로4가,4470,5135,20200114,9605
20200111,5,동대문역사문화공원,1444,1834,20200114,3278
20200111,5,청구,3234,2860,20200114,6094
20200111,5,신금호,5305,5254,20200114,10559
20200111,5,행당,6929,5969,20200114,12898
20200111,5,왕십리,4134,5392,20200114,9526
20200111,5,마장,5235,5226,20200114,10461
20200111,5,답십리,12637,11457,20200114,24094
20200111,5,장한평,14529,14452,20200114,28981
20200111,5,군자,9733,10892,20200114,20625
20200111,5,아차산,13828,12972,20200114,26800
20200111,5,광나루,11632,10740,20200114,22372
20200111,5,천호,20727,20892,20200114,41619
20200111,5,강동,18416,15609,20200114,34025
20200111,5,길동,6584,6857,20200114,13441
20200111,5,굽은다리,8605,8104,20200114,16709
20200111,5,명일,7299,7098,20200114,14397
20200111,5,고덕,8124,7811,20200114,15935
20200111,5,상일동,12517,11119,20200114,23636
20200111,5,둔촌동,7308,7675,20200114,14983
20200111,5,올림픽공원,3735,3249,20200114,6984
20200111,5,방이,6443,6411,20200114,12854
20200111,5,오금,2804,2626,20200114,5430
20200111,5,개롱,5551,5757,20200114,11308
20200111,5,거여,6528,5943,20200114,12471
20200111,5,마천,4724,4754,20200114,9478
20200112,5,방화,4370,4299,20200115,8669
20200112,5,개화산,3274,3381,20200115,6655
20200112,5,김포공항,7210,7102,20200115,14312
20200112,5,송정,4775,4748,20200115,9523
20200112,5,마곡,2793,2760,20200115,5553
20200112,5,발산,9752,10187,20200115,19939
20200112,5,우장산,8365,8615,20200115,16980
20200112,5,화곡,17054,16323,20200115,33377
20200112,5,까치산,18850,18161,20200115,37011
20200112,5,신정,7456,6635,20200115,14091
20200112,5,목동,9526,9865,20200115,19391
20200112,5,오목교,14935,15458,20200115,30393
20200112,5,양평,2780,2777,20200115,5557
20200112,5,영등포구청,1453,1430,20200115,2883
20200112,5,영등포시장,6493,6761,20200115,13254
20200112,5,신길,1817,1871,20200115,3688
20200112,5,여의도,6524,6856,20200115,13380
20200112,5,여의나루,4258,4260,20200115,8518
20200112,5,마포,5785,6057,20200115,11842
20200112,5,공덕,5497,5541,20200115,11038
20200112,5,애오개,3299,3342,20200115,6641
20200112,5,충정로,1648,1688,20200115,3336
20200112,5,서대문,6793,6724,20200115,13517
20200112,5,광화문,18014,18430,20200115,36444
20200112,5,종로3가,12921,11039,20200115,23960
20200112,5,을지로4가,1882,2130,20200115,4012
20200112,5,동대문역사문화공원,927,1138,20200115,2065
20200112,5,청구,2074,1908,20200115,3982
20200112,5,신금호,3627,3781,20200115,7408
20200112,5,행당,4885,4475,20200115,9360
20200112,5,왕십리,2959,3396,20200115,6355
20200112,5,마장,3797,3824,20200115,7621
20200112,5,답십리,9016,8331,20200115,17347
20200112,5,장한평,9937,9940,20200115,19877
20200112,5,군자,6894,7825,20200115,14719
20200112,5,아차산,10998,11013,20200115,22011
20200112,5,광나루,9212,8957,20200115,18169
20200112,5,천호,15236,14906,20200115,30142
20200112,5,강동,12771,11820,20200115,24591
20200112,5,길동,4706,4749,20200115,9455
20200112,5,굽은다리,6122,5783,20200115,11905
20200112,5,명일,5506,5538,20200115,11044
20200112,5,고덕,4616,4609,20200115,9225
20200112,5,상일동,8299,8017,20200115,16316
20200112,5,둔촌동,6121,6248,20200115,12369
20200112,5,올림픽공원,2251,2087,20200115,4338
20200112,5,방이,4734,4605,20200115,9339
20200112,5,오금,1787,1766,20200115,3553
20200112,5,개롱,3688,4028,20200115,7716
20200112,5,거여,4347,4226,20200115,8573
20200112,5,마천,3537,3924,20200115,7461
20200113,5,방화,7803,7379,20200116,15182
20200113,5,개화산,6490,6177,20200116,12667
20200113,5,김포공항,8645,8371,20200116,17016
20200113,5,송정,8256,7501,20200116,15757
20200113,5,마곡,8500,8082,20200116,16582
20200113,5,발산,21973,22138,20200116,44111
20200113,5,우장산,17014,16903,20200116,33917
20200113,5,화곡,33494,31097,20200116,64591
20200113,5,까치산,33264,31960,20200116,65224
20200113,5,신정,15735,11974,20200116,27709
20200113,5,목동,20485,22621,20200116,43106
20200113,5,오목교,27115,29092,20200116,56207
20200113,5,양평,8255,8211,20200116,16466
20200113,5,영등포구청,4546,4566,20200116,9112
20200113,5,영등포시장,11124,11477,20200116,22601
20200113,5,신길,4062,4570,20200116,8632
20200113,5,여의도,30895,32564,20200116,63459
20200113,5,여의나루,8060,8679,20200116,16739
20200113,5,마포,16972,17558,20200116,34530
20200113,5,공덕,16435,17653,20200116,34088
20200113,5,애오개,8365,8513,20200116,16878
20200113,5,충정로,5507,5662,20200116,11169
20200113,5,서대문,21708,22397,20200116,44105
20200113,5,광화문,39397,41147,20200116,80544
20200113,5,종로3가,17433,16612,20200116,34045
20200113,5,을지로4가,6934,7080,20200116,14014
20200113,5,동대문역사문화공원,3661,4142,20200116,7803
20200113,5,청구,4740,4356,20200116,9096
20200113,5,신금호,7117,7177,20200116,14294
20200113,5,행당,9455,8499,20200116,17954
20200113,5,왕십리,5344,6079,20200116,11423
20200113,5,마장,7083,6766,20200116,13849
20200113,5,답십리,18382,16774,20200116,35156
20200113,5,장한평,20581,20711,20200116,41292
20200113,5,군자,12173,13297,20200116,25470
20200113,5,아차산,15070,14974,20200116,30044
20200113,5,광나루,15048,13411,20200116,28459
20200113,5,천호,20833,22047,20200116,42880
20200113,5,강동,23202,20399,20200116,43601
20200113,5,길동,8595,9235,20200116,17830
20200113,5,굽은다리,10510,10043,20200116,20553
20200113,5,명일,9738,10321,20200116,20059
20200113,5,고덕,10737,10849,20200116,21586
20200113,5,상일동,18073,15333,20200116,33406
20200113,5,둔촌동,9538,9824,20200116,19362
20200113,5,올림픽공원,4706,4120,20200116,8826
20200113,5,방이,8328,8483,20200116,16811
20200113,5,오금,4047,4042,20200116,8089
20200113,5,개롱,7679,7910,20200116,15589
20200113,5,거여,8687,8066,20200116,16753
20200113,5,마천,5817,5875,20200116,11692
20200114,5,마천,5917,5871,20200117,11788
20200114,5,거여,8931,8349,20200117,17280
20200114,5,개롱,7852,7991,20200117,15843
20200114,5,오금,4049,4037,20200117,8086
20200114,5,방이,8365,8718,20200117,17083
20200114,5,올림픽공원,4650,4137,20200117,8787
20200114,5,둔촌동,9847,10072,20200117,19919
20200114,5,상일동,17712,14963,20200117,32675
20200114,5,고덕,10964,10996,20200117,21960
20200114,5,명일,9966,10311,20200117,20277
20200114,5,굽은다리,10735,10332,20200117,21067
20200114,5,길동,8411,9003,20200117,17414
20200114,5,강동,23767,20648,20200117,44415
20200114,5,천호,21190,22135,20200117,43325
20200114,5,광나루,15258,13653,20200117,28911
20200114,5,아차산,15911,15425,20200117,31336
20200114,5,군자,12413,13516,20200117,25929
20200114,5,장한평,20957,20980,20200117,41937
20200114,5,답십리,18656,17111,20200117,35767
20200114,5,마장,7133,6823,20200117,13956
20200114,5,왕십리,5379,6104,20200117,11483
20200114,5,행당,9564,8589,20200117,18153
20200114,5,신금호,7278,7275,20200117,14553
20200114,5,청구,4843,4457,20200117,9300
20200114,5,동대문역사문화공원,3654,4278,20200117,7932
20200114,5,을지로4가,7046,7307,20200117,14353
20200114,5,종로3가,17930,16955,20200117,34885
20200114,5,광화문,41413,43610,20200117,85023
20200114,5,서대문,21895,22754,20200117,44649
20200114,5,충정로,5631,5802,20200117,11433
20200114,5,애오개,8568,8593,20200117,17161
20200114,5,공덕,16934,18077,20200117,35011
20200114,5,마포,17578,18105,20200117,35683
20200114,5,여의나루,8435,8729,20200117,17164
20200114,5,여의도,31223,33028,20200117,64251
20200114,5,신길,3951,4504,20200117,8455
20200114,5,영등포시장,11311,11784,20200117,23095
20200114,5,영등포구청,4533,4597,20200117,9130
20200114,5,양평,8377,8332,20200117,16709
20200114,5,오목교,27752,29853,20200117,57605
20200114,5,목동,20935,22495,20200117,43430
20200114,5,신정,15759,12039,20200117,27798
20200114,5,까치산,33658,32061,20200117,65719
20200114,5,화곡,33445,31160,20200117,64605
20200114,5,우장산,17293,17179,20200117,34472
20200114,5,발산,22432,22631,20200117,45063
20200114,5,마곡,8515,8041,20200117,16556
20200114,5,송정,8314,7623,20200117,15937
20200114,5,김포공항,8755,8330,20200117,17085
20200114,5,개화산,6544,6161,20200117,12705
20200114,5,방화,8080,7741,20200117,15821
20200115,5,방화,7982,7528,20200118,15510
20200115,5,개화산,6610,6309,20200118,12919
20200115,5,김포공항,8933,8556,20200118,17489
20200115,5,송정,8419,7648,20200118,16067
20200115,5,마곡,8797,8243,20200118,17040
20200115,5,발산,22680,22999,20200118,45679
20200115,5,우장산,17319,17027,20200118,34346
20200115,5,화곡,33848,31609,20200118,65457
20200115,5,까치산,34096,32490,20200118,66586
20200115,5,신정,15847,12199,20200118,28046
20200115,5,목동,20893,23035,20200118,43928
20200115,5,오목교,27735,29949,20200118,57684
20200115,5,양평,8320,8286,20200118,16606
20200115,5,영등포구청,4480,4531,20200118,9011
20200115,5,영등포시장,11348,11813,20200118,23161
20200115,5,신길,4166,4669,20200118,8835
20200115,5,여의도,32077,33483,20200118,65560
20200115,5,여의나루,8547,8831,20200118,17378
20200115,5,마포,17695,18314,20200118,36009
20200115,5,공덕,17140,18211,20200118,35351
20200115,5,애오개,8612,8826,20200118,17438
20200115,5,충정로,5753,5920,20200118,11673
20200115,5,서대문,22359,22735,20200118,45094
20200115,5,광화문,41438,43686,20200118,85124
20200115,5,종로3가,18195,17570,20200118,35765
20200115,5,을지로4가,7017,7252,20200118,14269
20200115,5,동대문역사문화공원,3519,4254,20200118,7773
20200115,5,청구,4894,4504,20200118,9398
20200115,5,신금호,7398,7325,20200118,14723
20200115,5,행당,9826,8629,20200118,18455
20200115,5,왕십리,5593,6207,20200118,11800
20200115,5,마장,7280,7034,20200118,14314
20200115,5,답십리,18755,17210,20200118,35965
20200115,5,장한평,21780,21638,20200118,43418
20200115,5,군자,12683,13949,20200118,26632
20200115,5,아차산,15767,15411,20200118,31178
20200115,5,광나루,15687,13769,20200118,29456
20200115,5,천호,21434,22434,20200118,43868
20200115,5,강동,23239,20460,20200118,43699
20200115,5,길동,8822,9379,20200118,18201
20200115,5,굽은다리,10693,10236,20200118,20929
20200115,5,명일,10041,10613,20200118,20654
20200115,5,고덕,11230,11190,20200118,22420
20200115,5,상일동,18031,15307,20200118,33338
20200115,5,둔촌동,10017,10326,20200118,20343
20200115,5,올림픽공원,4775,4175,20200118,8950
20200115,5,방이,8657,8983,20200118,17640
20200115,5,오금,4222,4091,20200118,8313
20200115,5,개롱,7889,8072,20200118,15961
20200115,5,거여,8960,8327,20200118,17287
20200115,5,마천,5884,5853,20200118,11737
20200116,5,마천,5771,5813,20200119,11584
20200116,5,거여,9060,8438,20200119,17498
20200116,5,개롱,7874,8078,20200119,15952
20200116,5,오금,4105,4205,20200119,8310
20200116,5,방이,8821,8908,20200119,17729
20200116,5,올림픽공원,4748,4080,20200119,8828
20200116,5,둔촌동,9727,9908,20200119,19635
20200116,5,상일동,17994,15273,20200119,33267
20200116,5,고덕,10945,10918,20200119,21863
20200116,5,명일,9945,10272,20200119,20217
20200116,5,굽은다리,10778,10300,20200119,21078
20200116,5,길동,8657,9189,20200119,17846
20200116,5,강동,23570,20983,20200119,44553
20200116,5,천호,21809,22693,20200119,44502
20200116,5,광나루,15504,13769,20200119,29273
20200116,5,아차산,15847,15344,20200119,31191
20200116,5,군자,12574,13724,20200119,26298
20200116,5,장한평,21595,21444,20200119,43039
20200116,5,답십리,18495,16950,20200119,35445
20200116,5,마장,7279,6979,20200119,14258
20200116,5,왕십리,5460,6050,20200119,11510
20200116,5,행당,9593,8557,20200119,18150
20200116,5,신금호,7273,7318,20200119,14591
20200116,5,청구,4837,4483,20200119,9320
20200116,5,동대문역사문화공원,3643,4344,20200119,7987
20200116,5,을지로4가,7065,7424,20200119,14489
20200116,5,종로3가,18528,17750,20200119,36278
20200116,5,광화문,40526,42927,20200119,83453
20200116,5,서대문,21586,22442,20200119,44028
20200116,5,충정로,5616,5833,20200119,11449
20200116,5,애오개,8763,8960,20200119,17723
20200116,5,공덕,17076,18481,20200119,35557
20200116,5,마포,17433,17934,20200119,35367
20200116,5,여의나루,8401,8725,20200119,17126
20200116,5,여의도,31896,33709,20200119,65605
20200116,5,신길,4091,4565,20200119,8656
20200116,5,영등포시장,11459,12030,20200119,23489
20200116,5,영등포구청,4474,4612,20200119,9086
20200116,5,양평,8266,8221,20200119,16487
20200116,5,오목교,28575,30739,20200119,59314
20200116,5,목동,21198,22780,20200119,43978
20200116,5,신정,15893,12121,20200119,28014
20200116,5,까치산,34035,32337,20200119,66372
20200116,5,화곡,33978,31372,20200119,65350
20200116,5,우장산,17422,17204,20200119,34626
20200116,5,발산,22913,23243,20200119,46156
20200116,5,마곡,8751,8197,20200119,16948
20200116,5,송정,8411,7693,20200119,16104
20200116,5,김포공항,8951,8407,20200119,17358
20200116,5,개화산,6519,6095,20200119,12614
20200116,5,방화,8003,7607,20200119,15610
20200117,5,방화,8180,7626,20200120,15806
20200117,5,개화산,6784,6363,20200120,13147
20200117,5,김포공항,9390,8534,20200120,17924
20200117,5,송정,8494,7791,20200120,16285
20200117,5,마곡,8951,8294,20200120,17245
20200117,5,발산,22847,23752,20200120,46599
20200117,5,우장산,17712,17218,20200120,34930
20200117,5,화곡,34452,31420,20200120,65872
20200117,5,까치산,34714,32766,20200120,67480
20200117,5,신정,16037,12085,20200120,28122
20200117,5,목동,21698,23515,20200120,45213
20200117,5,오목교,28714,31222,20200120,59936
20200117,5,양평,8497,8169,20200120,16666
20200117,5,영등포구청,4652,4621,20200120,9273
20200117,5,영등포시장,11984,12496,20200120,24480
20200117,5,신길,4157,4534,20200120,8691
20200117,5,여의도,31482,33600,20200120,65082
20200117,5,여의나루,8766,8835,20200120,17601
20200117,5,마포,17772,18507,20200120,36279
20200117,5,공덕,17538,19055,20200120,36593
20200117,5,애오개,8741,8717,20200120,17458
20200117,5,충정로,5541,5511,20200120,11052
20200117,5,서대문,21710,22215,20200120,43925
20200117,5,광화문,40897,43651,20200120,84548
20200117,5,종로3가,19588,19477,20200120,39065
20200117,5,을지로4가,7010,7396,20200120,14406
20200117,5,동대문역사문화공원,3559,4424,20200120,7983
20200117,5,청구,4923,4524,20200120,9447
20200117,5,신금호,7695,7569,20200120,15264
20200117,5,행당,9806,8537,20200120,18343
20200117,5,왕십리,5522,6519,20200120,12041
20200117,5,마장,7533,7299,20200120,14832
20200117,5,답십리,18938,17213,20200120,36151
20200117,5,장한평,22346,22277,20200120,44623
20200117,5,군자,12916,14129,20200120,27045
20200117,5,아차산,16147,15468,20200120,31615
20200117,5,광나루,15913,13934,20200120,29847
20200117,5,천호,22790,24064,20200120,46854
20200117,5,강동,23884,20545,20200120,44429
20200117,5,길동,9133,9736,20200120,18869
20200117,5,굽은다리,10921,10347,20200120,21268
20200117,5,명일,10178,10433,20200120,20611
20200117,5,고덕,11302,10832,20200120,22134
20200117,5,상일동,18106,14965,20200120,33071
20200117,5,둔촌동,10281,10416,20200120,20697
20200117,5,올림픽공원,5384,4953,20200120,10337
20200117,5,방이,8784,9098,20200120,17882
20200117,5,오금,4101,4067,20200120,8168
20200117,5,개롱,8057,8114,20200120,16171
20200117,5,거여,9356,8462,20200120,17818
20200117,5,마천,5993,5849,20200120,11842
20200118,5,방화,5832,5542,20200121,11374
20200118,5,개화산,4551,4331,20200121,8882
20200118,5,김포공항,8201,8178,20200121,16379
20200118,5,송정,6530,5969,20200121,12499
20200118,5,마곡,4359,4133,20200121,8492
20200118,5,발산,14887,15825,20200121,30712
20200118,5,우장산,12581,12206,20200121,24787
20200118,5,화곡,24754,22659,20200121,47413
20200118,5,까치산,25808,24538,20200121,50346
20200118,5,신정,10847,8786,20200121,19633
20200118,5,목동,14512,14978,20200121,29490
20200118,5,오목교,21174,22061,20200121,43235
20200118,5,양평,4187,4016,20200121,8203
20200118,5,영등포구청,2359,2291,20200121,4650
20200118,5,영등포시장,9685,10163,20200121,19848
20200118,5,신길,2615,2838,20200121,5453
20200118,5,여의도,10419,11583,20200121,22002
20200118,5,여의나루,4908,4867,20200121,9775
20200118,5,마포,9336,9459,20200121,18795
20200118,5,공덕,9261,9799,20200121,19060
20200118,5,애오개,4769,4650,20200121,9419
20200118,5,충정로,2419,2197,20200121,4616
20200118,5,서대문,10577,10539,20200121,21116
20200118,5,광화문,31673,32961,20200121,64634
20200118,5,종로3가,18850,18477,20200121,37327
20200118,5,을지로4가,4396,5043,20200121,9439
20200118,5,동대문역사문화공원,1437,2030,20200121,3467
20200118,5,청구,3206,2878,20200121,6084
20200118,5,신금호,5119,5105,20200121,10224
20200118,5,행당,6681,5633,20200121,12314
20200118,5,왕십리,4163,5164,20200121,9327
20200118,5,마장,5627,5524,20200121,11151
20200118,5,답십리,12627,11564,20200121,24191
20200118,5,장한평,14158,13997,20200121,28155
20200118,5,군자,9904,11001,20200121,20905
20200118,5,아차산,13424,13016,20200121,26440
20200118,5,광나루,12484,11146,20200121,23630
20200118,5,천호,20075,20179,20200121,40254
20200118,5,강동,17408,15256,20200121,32664
20200118,5,길동,6836,6999,20200121,13835
20200118,5,굽은다리,8375,7673,20200121,16048
20200118,5,명일,7010,6942,20200121,13952
20200118,5,고덕,7194,6833,20200121,14027
20200118,5,상일동,11636,10113,20200121,21749
20200118,5,둔촌동,7772,7789,20200121,15561
20200118,5,올림픽공원,4843,5534,20200121,10377
20200118,5,방이,6773,6459,20200121,13232
20200118,5,오금,2623,2528,20200121,5151
20200118,5,개롱,5478,5724,20200121,11202
20200118,5,거여,6428,5876,20200121,12304
20200118,5,마천,4985,4853,20200121,9838
20200119,5,방화,4342,4229,20200122,8571
20200119,5,개화산,3232,3330,20200122,6562
20200119,5,김포공항,7055,7103,20200122,14158
20200119,5,송정,4556,4531,20200122,9087
20200119,5,마곡,2782,2747,20200122,5529
20200119,5,발산,9008,9431,20200122,18439
20200119,5,우장산,8191,8315,20200122,16506
20200119,5,화곡,16970,15803,20200122,32773
20200119,5,까치산,18891,17955,20200122,36846
20200119,5,신정,7403,6417,20200122,13820
20200119,5,목동,9433,9773,20200122,19206
20200119,5,오목교,14323,15134,20200122,29457
20200119,5,양평,3018,2930,20200122,5948
20200119,5,영등포구청,1478,1436,20200122,2914
20200119,5,영등포시장,6230,6382,20200122,12612
20200119,5,신길,1798,1899,20200122,3697
20200119,5,여의도,6460,6910,20200122,13370
20200119,5,여의나루,3809,3787,20200122,7596
20200119,5,마포,5649,5614,20200122,11263
20200119,5,공덕,5408,5555,20200122,10963
20200119,5,애오개,3266,3354,20200122,6620
20200119,5,충정로,1754,1644,20200122,3398
20200119,5,서대문,6356,6081,20200122,12437
20200119,5,광화문,16170,16168,20200122,32338
20200119,5,종로3가,12097,10381,20200122,22478
20200119,5,을지로4가,1840,2093,20200122,3933
20200119,5,동대문역사문화공원,960,1150,20200122,2110
20200119,5,청구,2310,2062,20200122,4372
20200119,5,신금호,3524,3751,20200122,7275
20200119,5,행당,4693,4189,20200122,8882
20200119,5,왕십리,3004,3684,20200122,6688
20200119,5,마장,3998,3855,20200122,7853
20200119,5,답십리,8990,8365,20200122,17355
20200119,5,장한평,10063,9797,20200122,19860
20200119,5,군자,7106,8030,20200122,15136
20200119,5,아차산,10542,10100,20200122,20642
20200119,5,광나루,9996,9712,20200122,19708
20200119,5,천호,15059,14771,20200122,29830
20200119,5,강동,12032,11175,20200122,23207
20200119,5,길동,4523,4859,20200122,9382
20200119,5,굽은다리,6303,5951,20200122,12254
20200119,5,명일,5378,5374,20200122,10752
20200119,5,고덕,4572,4562,20200122,9134
20200119,5,상일동,7578,7169,20200122,14747
20200119,5,둔촌동,6417,6421,20200122,12838
20200119,5,올림픽공원,2741,2570,20200122,5311
20200119,5,방이,4712,4589,20200122,9301
20200119,5,오금,1844,1759,20200122,3603
20200119,5,개롱,3734,3988,20200122,7722
20200119,5,거여,4279,4230,20200122,8509
20200119,5,마천,3460,3726,20200122,7186
20200120,5,마천,5834,5769,20200123,11603
20200120,5,거여,8792,8267,20200123,17059
20200120,5,개롱,7685,8039,20200123,15724
20200120,5,오금,4080,4145,20200123,8225
20200120,5,방이,8611,8633,20200123,17244
20200120,5,올림픽공원,4811,4243,20200123,9054
20200120,5,둔촌동,9533,9862,20200123,19395
20200120,5,상일동,17872,15069,20200123,32941
20200120,5,고덕,10757,10727,20200123,21484
20200120,5,명일,9902,10344,20200123,20246
20200120,5,굽은다리,10614,10048,20200123,20662
20200120,5,길동,8851,9463,20200123,18314
20200120,5,강동,23284,20361,20200123,43645
20200120,5,천호,21146,22051,20200123,43197
20200120,5,광나루,15458,13741,20200123,29199
20200120,5,아차산,15301,14859,20200123,30160
20200120,5,군자,12347,13485,20200123,25832
20200120,5,장한평,20878,20793,20200123,41671
20200120,5,답십리,18622,17018,20200123,35640
20200120,5,마장,7391,7206,20200123,14597
20200120,5,왕십리,5430,5931,20200123,11361
20200120,5,행당,9407,8541,20200123,17948
20200120,5,신금호,7282,7270,20200123,14552
20200120,5,청구,4780,4441,20200123,9221
20200120,5,동대문역사문화공원,3539,4213,20200123,7752
20200120,5,을지로4가,7061,7306,20200123,14367
20200120,5,종로3가,17907,16939,20200123,34846
20200120,5,광화문,39496,41465,20200123,80961
20200120,5,서대문,21471,22102,20200123,43573
20200120,5,충정로,5673,5764,20200123,11437
20200120,5,애오개,8518,8631,20200123,17149
20200120,5,공덕,16926,18023,20200123,34949
20200120,5,마포,17174,17632,20200123,34806
20200120,5,여의나루,8480,8997,20200123,17477
20200120,5,여의도,31351,33026,20200123,64377
20200120,5,신길,3941,4489,20200123,8430
20200120,5,영등포시장,11495,11841,20200123,23336
20200120,5,영등포구청,4519,4589,20200123,9108
20200120,5,양평,8339,8358,20200123,16697
20200120,5,오목교,27553,29718,20200123,57271
20200120,5,목동,21018,22799,20200123,43817
20200120,5,신정,15799,12185,20200123,27984
20200120,5,까치산,33978,32230,20200123,66208
20200120,5,화곡,33921,31731,20200123,65652
20200120,5,우장산,17411,17222,20200123,34633
20200120,5,발산,22468,22695,20200123,45163
20200120,5,마곡,8695,8105,20200123,16800
20200120,5,송정,8612,7673,20200123,16285
20200120,5,김포공항,8705,8119,20200123,16824
20200120,5,개화산,6558,6207,20200123,12765
20200120,5,방화,7992,7567,20200123,15559
20200121,5,방화,8043,7615,20200124,15658
20200121,5,개화산,6621,6273,20200124,12894
20200121,5,김포공항,8693,8122,20200124,16815
20200121,5,송정,8241,7677,20200124,15918
20200121,5,마곡,8693,8187,20200124,16880
20200121,5,발산,22603,22695,20200124,45298
20200121,5,우장산,17640,17542,20200124,35182
20200121,5,화곡,33987,31443,20200124,65430
20200121,5,까치산,33921,32327,20200124,66248
20200121,5,신정,15775,12085,20200124,27860
20200121,5,목동,21214,22636,20200124,43850
20200121,5,오목교,28014,30234,20200124,58248
20200121,5,양평,8370,8293,20200124,16663
20200121,5,영등포구청,4521,4555,20200124,9076
20200121,5,영등포시장,11304,11906,20200124,23210
20200121,5,신길,3958,4514,20200124,8472
20200121,5,여의도,31679,33170,20200124,64849
20200121,5,여의나루,8420,8783,20200124,17203
20200121,5,마포,17270,17976,20200124,35246
20200121,5,공덕,17078,18387,20200124,35465
20200121,5,애오개,8568,8611,20200124,17179
20200121,5,충정로,5395,5635,20200124,11030
20200121,5,서대문,22071,22658,20200124,44729
20200121,5,광화문,40610,42853,20200124,83463
20200121,5,종로3가,17599,17102,20200124,34701
20200121,5,을지로4가,7013,7107,20200124,14120
20200121,5,동대문역사문화공원,3521,4196,20200124,7717
20200121,5,청구,4885,4380,20200124,9265
20200121,5,신금호,7306,7346,20200124,14652
20200121,5,행당,9688,8597,20200124,18285
20200121,5,왕십리,5521,6257,20200124,11778
20200121,5,마장,7484,7174,20200124,14658
20200121,5,답십리,18806,17061,20200124,35867
20200121,5,장한평,20929,20752,20200124,41681
20200121,5,군자,12453,13575,20200124,26028
20200121,5,아차산,15682,15365,20200124,31047
20200121,5,광나루,15409,13613,20200124,29022
20200121,5,천호,21595,22441,20200124,44036
20200121,5,강동,23324,20686,20200124,44010
20200121,5,길동,8687,9345,20200124,18032
20200121,5,굽은다리,10756,10247,20200124,21003
20200121,5,명일,10128,10462,20200124,20590
20200121,5,고덕,10924,10960,20200124,21884
20200121,5,상일동,18130,15132,20200124,33262
20200121,5,둔촌동,9848,9984,20200124,19832
20200121,5,올림픽공원,4875,4312,20200124,9187
20200121,5,방이,8559,8833,20200124,17392
20200121,5,오금,4149,4154,20200124,8303
20200121,5,개롱,7908,8059,20200124,15967
20200121,5,거여,8859,8220,20200124,17079
20200121,5,마천,5777,5687,20200124,11464
20200122,5,방화,8013,7534,20200125,15547
20200122,5,개화산,6496,6261,20200125,12757
20200122,5,김포공항,8913,8667,20200125,17580
20200122,5,송정,8325,7375,20200125,15700
20200122,5,마곡,8533,7980,20200125,16513
20200122,5,발산,22444,22742,20200125,45186
20200122,5,우장산,17487,17326,20200125,34813
20200122,5,화곡,33797,31238,20200125,65035
20200122,5,까치산,34477,32374,20200125,66851
20200122,5,신정,15926,12190,20200125,28116
20200122,5,목동,21085,22659,20200125,43744
20200122,5,오목교,28005,30346,20200125,58351
20200122,5,양평,8354,8209,20200125,16563
20200122,5,영등포구청,4589,4541,20200125,9130
20200122,5,영등포시장,11358,11885,20200125,23243
20200122,5,신길,4086,4472,20200125,8558
20200122,5,여의도,31251,32947,20200125,64198
20200122,5,여의나루,8729,8942,20200125,17671
20200122,5,마포,17345,17641,20200125,34986
20200122,5,공덕,16950,18178,20200125,35128
20200122,5,애오개,8645,8664,20200125,17309
20200122,5,충정로,5506,5681,20200125,11187
20200122,5,서대문,21479,21971,20200125,43450
20200122,5,광화문,39802,42052,20200125,81854
20200122,5,종로3가,17061,16553,20200125,33614
20200122,5,을지로4가,6869,7025,20200125,13894
20200122,5,동대문역사문화공원,3408,4027,20200125,7435
20200122,5,청구,4786,4399,20200125,9185
20200122,5,신금호,7428,7364,20200125,14792
20200122,5,행당,9802,8575,20200125,18377
20200122,5,왕십리,5617,6381,20200125,11998
20200122,5,마장,7691,7413,20200125,15104
20200122,5,답십리,18904,16928,20200125,35832
20200122,5,장한평,21721,21686,20200125,43407
20200122,5,군자,12893,14085,20200125,26978
20200122,5,아차산,15860,15264,20200125,31124
20200122,5,광나루,15698,13849,20200125,29547
20200122,5,천호,21467,22244,20200125,43711
20200122,5,강동,23055,20035,20200125,43090
20200122,5,길동,8885,9377,20200125,18262
20200122,5,굽은다리,10924,10123,20200125,21047
20200122,5,명일,9920,10244,20200125,20164
20200122,5,고덕,10945,10827,20200125,21772
20200122,5,상일동,18303,15111,20200125,33414
20200122,5,둔촌동,9862,10199,20200125,20061
20200122,5,올림픽공원,4828,4171,20200125,8999
20200122,5,방이,8668,8777,20200125,17445
20200122,5,오금,4235,4199,20200125,8434
20200122,5,개롱,8217,8227,20200125,16444
20200122,5,거여,8849,8206,20200125,17055
20200122,5,마천,5912,5728,20200125,11640
20200123,5,오목교,26709,29518,20200126,56227
20200123,5,방화,7643,7027,20200126,14670
20200123,5,개화산,6329,5882,20200126,12211
20200123,5,김포공항,9024,9010,20200126,18034
20200123,5,송정,8072,7028,20200126,15100
20200123,5,마곡,7973,7055,20200126,15028
20200123,5,발산,21137,21248,20200126,42385
20200123,5,우장산,16786,16450,20200126,33236
20200123,5,화곡,32952,29115,20200126,62067
20200123,5,까치산,33360,30559,20200126,63919
20200123,5,신정,15290,11192,20200126,26482
20200123,5,목동,19693,20866,20200126,40559
20200123,5,양평,7753,7135,20200126,14888
20200123,5,영등포구청,4188,4136,20200126,8324
20200123,5,영등포시장,10843,10894,20200126,21737
20200123,5,신길,3744,3828,20200126,7572
20200123,5,여의도,27596,29043,20200126,56639
20200123,5,여의나루,7895,7556,20200126,15451
20200123,5,마포,15078,15194,20200126,30272
20200123,5,공덕,14789,15811,20200126,30600
20200123,5,애오개,7848,7447,20200126,15295
20200123,5,충정로,4586,4569,20200126,9155
20200123,5,서대문,19220,19540,20200126,38760
20200123,5,광화문,34056,35709,20200126,69765
20200123,5,종로3가,15424,15670,20200126,31094
20200123,5,을지로4가,6123,6520,20200126,12643
20200123,5,동대문역사문화공원,3067,3765,20200126,6832
20200123,5,청구,4273,3993,20200126,8266
20200123,5,신금호,6867,6589,20200126,13456
20200123,5,행당,9252,7623,20200126,16875
20200123,5,왕십리,5141,6209,20200126,11350
20200123,5,마장,7380,7137,20200126,14517
20200123,5,답십리,17552,15354,20200126,32906
20200123,5,장한평,20106,19454,20200126,39560
20200123,5,군자,11816,12350,20200126,24166
20200123,5,아차산,14778,13848,20200126,28626
20200123,5,광나루,14124,12376,20200126,26500
20200123,5,천호,21393,22329,20200126,43722
20200123,5,강동,22095,18521,20200126,40616
20200123,5,길동,8293,8738,20200126,17031
20200123,5,굽은다리,10270,9557,20200126,19827
20200123,5,명일,9223,9492,20200126,18715
20200123,5,고덕,10302,10126,20200126,20428
20200123,5,상일동,16833,13674,20200126,30507
20200123,5,둔촌동,9159,9093,20200126,18252
20200123,5,올림픽공원,4322,3753,20200126,8075
20200123,5,방이,7857,8211,20200126,16068
20200123,5,오금,3576,3663,20200126,7239
20200123,5,개롱,7151,7077,20200126,14228
20200123,5,거여,8195,7486,20200126,15681
20200123,5,마천,5251,5124,20200126,10375
20200124,5,마천,2531,2694,20200127,5225
20200124,5,거여,3036,2918,20200127,5954
20200124,5,개롱,2533,2602,20200127,5135
20200124,5,오금,1185,1088,20200127,2273
20200124,5,방이,2527,2410,20200127,4937
20200124,5,올림픽공원,1507,1316,20200127,2823
20200124,5,둔촌동,3655,3550,20200127,7205
20200124,5,상일동,5673,5340,20200127,11013
20200124,5,고덕,3303,3115,20200127,6418
20200124,5,명일,3254,3253,20200127,6507
20200124,5,굽은다리,4368,4004,20200127,8372
20200124,5,길동,3362,3436,20200127,6798
20200124,5,강동,8505,7421,20200127,15926
20200124,5,천호,10583,10243,20200127,20826
20200124,5,광나루,5437,4848,20200127,10285
20200124,5,아차산,6989,6355,20200127,13344
20200124,5,군자,4925,4860,20200127,9785
20200124,5,장한평,7425,6920,20200127,14345
20200124,5,답십리,6622,5587,20200127,12209
20200124,5,마장,2951,2961,20200127,5912
20200124,5,왕십리,1968,2494,20200127,4462
20200124,5,행당,3343,2814,20200127,6157
20200124,5,신금호,2634,2566,20200127,5200
20200124,5,청구,1718,1356,20200127,3074
20200124,5,동대문역사문화공원,702,949,20200127,1651
20200124,5,을지로4가,1438,1639,20200127,3077
20200124,5,종로3가,8555,7919,20200127,16474
20200124,5,광화문,9837,9859,20200127,19696
20200124,5,서대문,4193,3926,20200127,8119
20200124,5,충정로,974,883,20200127,1857
20200124,5,애오개,2440,2176,20200127,4616
20200124,5,공덕,3830,3804,20200127,7634
20200124,5,마포,4049,3766,20200127,7815
20200124,5,여의나루,2787,2886,20200127,5673
20200124,5,여의도,3867,4230,20200127,8097
20200124,5,신길,1239,1134,20200127,2373
20200124,5,영등포시장,3863,3649,20200127,7512
20200124,5,영등포구청,1103,963,20200127,2066
20200124,5,양평,2272,1832,20200127,4104
20200124,5,오목교,10590,10781,20200127,21371
20200124,5,목동,7029,6555,20200127,13584
20200124,5,신정,6038,4680,20200127,10718
20200124,5,까치산,15699,13267,20200127,28966
20200124,5,화곡,13393,11277,20200127,24670
20200124,5,우장산,6548,6306,20200127,12854
20200124,5,발산,6678,6649,20200127,13327
20200124,5,마곡,2106,1919,20200127,4025
20200124,5,송정,4134,3971,20200127,8105
20200124,5,김포공항,6517,7277,20200127,13794
20200124,5,개화산,2662,2598,20200127,5260
20200124,5,방화,3351,3065,20200127,6416
20200125,5,방화,3051,2882,20200128,5933
20200125,5,개화산,2626,2465,20200128,5091
20200125,5,김포공항,5808,5430,20200128,11238
20200125,5,송정,3850,3670,20200128,7520
20200125,5,마곡,1565,1566,20200128,3131
20200125,5,발산,4423,4602,20200128,9025
20200125,5,우장산,4754,4828,20200128,9582
20200125,5,화곡,11710,11448,20200128,23158
20200125,5,까치산,12829,13151,20200128,25980
20200125,5,신정,5152,4823,20200128,9975
20200125,5,목동,5913,6373,20200128,12286
20200125,5,오목교,6075,6506,20200128,12581
20200125,5,양평,1646,1574,20200128,3220
20200125,5,영등포구청,772,704,20200128,1476
20200125,5,영등포시장,2675,2962,20200128,5637
20200125,5,신길,921,1065,20200128,1986
20200125,5,여의도,3100,3446,20200128,6546
20200125,5,여의나루,3250,3079,20200128,6329
20200125,5,마포,3315,3346,20200128,6661
20200125,5,공덕,2972,3099,20200128,6071
20200125,5,애오개,1873,1931,20200128,3804
20200125,5,충정로,938,896,20200128,1834
20200125,5,서대문,3738,3714,20200128,7452
20200125,5,광화문,14111,13986,20200128,28097
20200125,5,종로3가,7369,6872,20200128,14241
20200125,5,을지로4가,954,1064,20200128,2018
20200125,5,동대문역사문화공원,772,968,20200128,1740
20200125,5,청구,1449,1463,20200128,2912
20200125,5,신금호,2498,2706,20200128,5204
20200125,5,행당,3108,2719,20200128,5827
20200125,5,왕십리,1751,2144,20200128,3895
20200125,5,마장,2268,2116,20200128,4384
20200125,5,답십리,5771,5685,20200128,11456
20200125,5,장한평,5403,5419,20200128,10822
20200125,5,군자,4006,4634,20200128,8640
20200125,5,아차산,6298,6132,20200128,12430
20200125,5,광나루,6217,4947,20200128,11164
20200125,5,천호,7215,7423,20200128,14638
20200125,5,강동,7404,7060,20200128,14464
20200125,5,길동,2691,2801,20200128,5492
20200125,5,굽은다리,3714,3445,20200128,7159
20200125,5,명일,2679,2740,20200128,5419
20200125,5,고덕,2371,2377,20200128,4748
20200125,5,상일동,4521,4334,20200128,8855
20200125,5,둔촌동,2589,2688,20200128,5277
20200125,5,올림픽공원,1179,1013,20200128,2192
20200125,5,방이,1979,1995,20200128,3974
20200125,5,오금,930,1004,20200128,1934
20200125,5,개롱,2174,2239,20200128,4413
20200125,5,거여,2731,2764,20200128,5495
20200125,5,마천,2201,2379,20200128,4580
20200126,5,방화,3638,3577,20200129,7215
20200126,5,개화산,2845,2865,20200129,5710
20200126,5,김포공항,7439,6782,20200129,14221
20200126,5,송정,4136,4233,20200129,8369
20200126,5,마곡,2057,2135,20200129,4192
20200126,5,발산,7335,8160,20200129,15495
20200126,5,우장산,6361,6630,20200129,12991
20200126,5,화곡,14344,14110,20200129,28454
20200126,5,까치산,15415,15930,20200129,31345
20200126,5,신정,6174,5357,20200129,11531
20200126,5,목동,7467,8043,20200129,15510
20200126,5,오목교,9587,10286,20200129,19873
20200126,5,양평,1985,2157,20200129,4142
20200126,5,영등포구청,1135,1055,20200129,2190
20200126,5,영등포시장,4214,4825,20200129,9039
20200126,5,신길,1148,1400,20200129,2548
20200126,5,여의도,4598,5071,20200129,9669
20200126,5,여의나루,4590,4406,20200129,8996
20200126,5,마포,4196,4343,20200129,8539
20200126,5,공덕,3869,4053,20200129,7922
20200126,5,애오개,2479,2546,20200129,5025
20200126,5,충정로,1170,1130,20200129,2300
20200126,5,서대문,4522,4631,20200129,9153
20200126,5,광화문,16844,17201,20200129,34045
20200126,5,종로3가,10786,10385,20200129,21171
20200126,5,을지로4가,1343,1361,20200129,2704
20200126,5,동대문역사문화공원,809,966,20200129,1775
20200126,5,청구,1795,1695,20200129,3490
20200126,5,신금호,2837,2887,20200129,5724
20200126,5,행당,3866,3542,20200129,7408
20200126,5,왕십리,2226,2724,20200129,4950
20200126,5,마장,2871,2789,20200129,5660
20200126,5,답십리,7117,6921,20200129,14038
20200126,5,장한평,8101,8510,20200129,16611
20200126,5,군자,5278,6316,20200129,11594
20200126,5,아차산,8854,8891,20200129,17745
20200126,5,광나루,6690,6323,20200129,13013
20200126,5,천호,10362,10974,20200129,21336
20200126,5,강동,9356,8920,20200129,18276
20200126,5,길동,3486,3680,20200129,7166
20200126,5,굽은다리,5289,4909,20200129,10198
20200126,5,명일,4250,4220,20200129,8470
20200126,5,고덕,3577,3499,20200129,7076
20200126,5,상일동,6043,5540,20200129,11583
20200126,5,둔촌동,4385,4666,20200129,9051
20200126,5,올림픽공원,1808,1604,20200129,3412
20200126,5,방이,3095,3074,20200129,6169
20200126,5,오금,1299,1347,20200129,2646
20200126,5,개롱,2713,2905,20200129,5618
20200126,5,거여,3506,3351,20200129,6857
20200126,5,마천,2955,3104,20200129,6059
20200127,5,방화,3566,3674,20200130,7240
20200127,5,개화산,3010,3066,20200130,6076
20200127,5,김포공항,7678,6766,20200130,14444
20200127,5,송정,3980,4112,20200130,8092
20200127,5,마곡,2434,2464,20200130,4898
20200127,5,발산,8112,8606,20200130,16718
20200127,5,우장산,7113,7320,20200130,14433
20200127,5,화곡,14863,14503,20200130,29366
20200127,5,까치산,15827,16607,20200130,32434
20200127,5,신정,6444,5765,20200130,12209
20200127,5,목동,7974,8607,20200130,16581
20200127,5,오목교,13031,13680,20200130,26711
20200127,5,양평,2329,2670,20200130,4999
20200127,5,영등포구청,1219,1305,20200130,2524
20200127,5,영등포시장,4990,5529,20200130,10519
20200127,5,신길,1244,1725,20200130,2969
20200127,5,여의도,4969,5693,20200130,10662
20200127,5,여의나루,2243,2345,20200130,4588
20200127,5,마포,4929,5018,20200130,9947
20200127,5,공덕,4485,4776,20200130,9261
20200127,5,애오개,2583,2994,20200130,5577
20200127,5,충정로,1190,1235,20200130,2425
20200127,5,서대문,5080,5073,20200130,10153
20200127,5,광화문,13472,12578,20200130,26050
20200127,5,종로3가,11267,10080,20200130,21347
20200127,5,을지로4가,1544,1714,20200130,3258
20200127,5,동대문역사문화공원,832,955,20200130,1787
20200127,5,청구,1867,1690,20200130,3557
20200127,5,신금호,2809,2963,20200130,5772
20200127,5,행당,3854,3456,20200130,7310
20200127,5,왕십리,2489,3157,20200130,5646
20200127,5,마장,2798,2783,20200130,5581
20200127,5,답십리,7449,7419,20200130,14868
20200127,5,장한평,8923,9287,20200130,18210
20200127,5,군자,5585,6856,20200130,12441
20200127,5,아차산,8860,8573,20200130,17433
20200127,5,광나루,6506,6591,20200130,13097
20200127,5,천호,12776,12919,20200130,25695
20200127,5,강동,9964,9466,20200130,19430
20200127,5,길동,3883,4061,20200130,7944
20200127,5,굽은다리,5300,5072,20200130,10372
20200127,5,명일,3842,3860,20200130,7702
20200127,5,고덕,4069,4044,20200130,8113
20200127,5,상일동,6366,5915,20200130,12281
20200127,5,둔촌동,4099,4252,20200130,8351
20200127,5,올림픽공원,1901,1704,20200130,3605
20200127,5,방이,3339,3257,20200130,6596
20200127,5,오금,1397,1430,20200130,2827
20200127,5,개롱,2977,3257,20200130,6234
20200127,5,거여,3556,3501,20200130,7057
20200127,5,마천,3039,3263,20200130,6302
20200128,5,방화,7224,6974,20200131,14198
20200128,5,개화산,5943,5648,20200131,11591
20200128,5,김포공항,7636,6934,20200131,14570
20200128,5,송정,7503,6946,20200131,14449
20200128,5,마곡,7779,7284,20200131,15063
20200128,5,발산,19809,20207,20200131,40016
20200128,5,우장산,15381,15420,20200131,30801
20200128,5,화곡,30951,29208,20200131,60159
20200128,5,까치산,31090,30268,20200131,61358
20200128,5,신정,14468,11121,20200131,25589
20200128,5,목동,18840,20674,20200131,39514
20200128,5,오목교,24967,26995,20200131,51962
20200128,5,양평,7597,7636,20200131,15233
20200128,5,영등포구청,4133,4280,20200131,8413
20200128,5,영등포시장,10391,10941,20200131,21332
20200128,5,신길,3522,4085,20200131,7607
20200128,5,여의도,27861,29103,20200131,56964
20200128,5,여의나루,7343,7740,20200131,15083
20200128,5,마포,15113,15501,20200131,30614
20200128,5,공덕,14388,15350,20200131,29738
20200128,5,애오개,7511,7779,20200131,15290
20200128,5,충정로,4624,4778,20200131,9402
20200128,5,서대문,19798,20223,20200131,40021
20200128,5,광화문,34253,35715,20200131,69968
20200128,5,종로3가,14619,14171,20200131,28790
20200128,5,을지로4가,5793,5955,20200131,11748
20200128,5,동대문역사문화공원,3340,3746,20200131,7086
20200128,5,청구,4235,3968,20200131,8203
20200128,5,신금호,6451,6668,20200131,13119
20200128,5,행당,8628,7862,20200131,16490
20200128,5,왕십리,5011,5371,20200131,10382
20200128,5,마장,6360,6001,20200131,12361
20200128,5,답십리,16750,15595,20200131,32345
20200128,5,장한평,19025,18966,20200131,37991
20200128,5,군자,11145,12558,20200131,23703
20200128,5,아차산,13889,13744,20200131,27633
20200128,5,광나루,13496,12162,20200131,25658
20200128,5,천호,19180,19994,20200131,39174
20200128,5,강동,20720,18527,20200131,39247
20200128,5,길동,7862,8537,20200131,16399
20200128,5,굽은다리,9628,9245,20200131,18873
20200128,5,명일,8894,9217,20200131,18111
20200128,5,고덕,9769,9923,20200131,19692
20200128,5,상일동,15851,13556,20200131,29407
20200128,5,둔촌동,8795,9000,20200131,17795
20200128,5,올림픽공원,4302,3790,20200131,8092
20200128,5,방이,7715,7940,20200131,15655
20200128,5,오금,3737,3761,20200131,7498
20200128,5,개롱,6869,7200,20200131,14069
20200128,5,거여,7923,7567,20200131,15490
20200128,5,마천,5224,5327,20200131,10551
20200129,5,방화,7509,7139,20200201,14648
20200129,5,개화산,6084,5899,20200201,11983
20200129,5,김포공항,7776,6863,20200201,14639
20200129,5,송정,7783,7097,20200201,14880
20200129,5,마곡,8382,7741,20200201,16123
20200129,5,발산,21557,21870,20200201,43427
20200129,5,우장산,15933,15747,20200201,31680
20200129,5,화곡,32504,30563,20200201,63067
20200129,5,까치산,32522,30977,20200201,63499
20200129,5,신정,15201,11551,20200201,26752
20200129,5,목동,19585,21512,20200201,41097
20200129,5,오목교,25997,28003,20200201,54000
20200129,5,양평,8030,8051,20200201,16081
20200129,5,영등포구청,4281,4373,20200201,8654
20200129,5,영등포시장,10832,11255,20200201,22087
20200129,5,신길,3917,4416,20200201,8333
20200129,5,여의도,29809,31291,20200201,61100
20200129,5,여의나루,8317,8692,20200201,17009
20200129,5,마포,16264,16748,20200201,33012
20200129,5,공덕,15701,16765,20200201,32466
20200129,5,애오개,8134,8177,20200201,16311
20200129,5,충정로,5376,5514,20200201,10890
20200129,5,서대문,20611,21019,20200201,41630
20200129,5,광화문,38244,40266,20200201,78510
20200129,5,종로3가,15619,15276,20200201,30895
20200129,5,을지로4가,6458,6565,20200201,13023
20200129,5,동대문역사문화공원,3360,3918,20200201,7278
20200129,5,청구,4693,4262,20200201,8955
20200129,5,신금호,6903,7078,20200201,13981
20200129,5,행당,9178,8160,20200201,17338
20200129,5,왕십리,5271,6016,20200201,11287
20200129,5,마장,6697,6235,20200201,12932
20200129,5,답십리,18155,16554,20200201,34709
20200129,5,장한평,20897,20931,20200201,41828
20200129,5,군자,12062,13326,20200201,25388
20200129,5,아차산,14956,14778,20200201,29734
20200129,5,광나루,14894,13199,20200201,28093
20200129,5,천호,20073,21214,20200201,41287
20200129,5,강동,22101,19471,20200201,41572
20200129,5,길동,8260,8756,20200201,17016
20200129,5,굽은다리,10183,9880,20200201,20063
20200129,5,명일,9514,10052,20200201,19566
20200129,5,고덕,10208,10129,20200201,20337
20200129,5,상일동,17311,14743,20200201,32054
20200129,5,둔촌동,9251,9598,20200201,18849
20200129,5,올림픽공원,4570,4044,20200201,8614
20200129,5,방이,8130,8498,20200201,16628
20200129,5,오금,4021,4023,20200201,8044
20200129,5,개롱,7403,7551,20200201,14954
20200129,5,거여,8483,8029,20200201,16512
20200129,5,마천,5586,5544,20200201,11130
20200130,5,마천,5641,5580,20200202,11221
20200130,5,거여,8561,8073,20200202,16634
20200130,5,개롱,7439,7781,20200202,15220
20200130,5,오금,4067,4176,20200202,8243
20200130,5,방이,8301,8602,20200202,16903
20200130,5,올림픽공원,4687,4149,20200202,8836
20200130,5,둔촌동,9396,9504,20200202,18900
20200130,5,상일동,17292,14620,20200202,31912
20200130,5,고덕,10313,10328,20200202,20641
20200130,5,명일,9550,9804,20200202,19354
20200130,5,굽은다리,9981,9521,20200202,19502
20200130,5,길동,8158,8668,20200202,16826
20200130,5,강동,21988,19382,20200202,41370
20200130,5,천호,20328,21134,20200202,41462
20200130,5,광나루,14597,13109,20200202,27706
20200130,5,아차산,14932,14656,20200202,29588
20200130,5,군자,12208,13221,20200202,25429
20200130,5,장한평,20766,20582,20200202,41348
20200130,5,답십리,18038,16425,20200202,34463
20200130,5,마장,6781,6397,20200202,13178
20200130,5,왕십리,5222,5809,20200202,11031
20200130,5,행당,9110,8194,20200202,17304
20200130,5,신금호,6912,6984,20200202,13896
20200130,5,청구,4674,4159,20200202,8833
20200130,5,동대문역사문화공원,3484,4060,20200202,7544
20200130,5,을지로4가,6526,6721,20200202,13247
20200130,5,종로3가,16003,15507,20200202,31510
20200130,5,광화문,37572,40173,20200202,77745
20200130,5,서대문,20875,21766,20200202,42641
20200130,5,충정로,5193,5507,20200202,10700
20200130,5,애오개,8393,8353,20200202,16746
20200130,5,공덕,16195,17131,20200202,33326
20200130,5,마포,16306,16887,20200202,33193
20200130,5,여의나루,8537,8873,20200202,17410
20200130,5,여의도,30156,31897,20200202,62053
20200130,5,신길,3904,4323,20200202,8227
20200130,5,영등포시장,10770,11301,20200202,22071
20200130,5,영등포구청,4413,4497,20200202,8910
20200130,5,양평,7946,7851,20200202,15797
20200130,5,오목교,26361,28390,20200202,54751
20200130,5,목동,20024,21638,20200202,41662
20200130,5,신정,15257,11794,20200202,27051
20200130,5,까치산,32505,30962,20200202,63467
20200130,5,화곡,32424,29968,20200202,62392
20200130,5,우장산,16074,15849,20200202,31923
20200130,5,발산,21645,21873,20200202,43518
20200130,5,마곡,8331,7827,20200202,16158
20200130,5,송정,7926,7281,20200202,15207
20200130,5,김포공항,7682,6756,20200202,14438
20200130,5,개화산,6279,5982,20200202,12261
20200130,5,방화,7490,7071,20200202,14561
20200131,5,방화,7515,7094,20200203,14609
20200131,5,개화산,6306,5832,20200203,12138
20200131,5,김포공항,7412,6448,20200203,13860
20200131,5,송정,7954,7180,20200203,15134
20200131,5,마곡,8418,7815,20200203,16233
20200131,5,발산,21229,21953,20200203,43182
20200131,5,우장산,16108,15800,20200203,31908
20200131,5,화곡,32736,29981,20200203,62717
20200131,5,까치산,32817,31025,20200203,63842
20200131,5,신정,15394,11487,20200203,26881
20200131,5,목동,20000,21746,20200203,41746
20200131,5,오목교,26416,28795,20200203,55211
20200131,5,양평,8172,7995,20200203,16167
20200131,5,영등포구청,4349,4516,20200203,8865
20200131,5,영등포시장,10916,11175,20200203,22091
20200131,5,신길,3945,4373,20200203,8318
20200131,5,여의도,29721,31499,20200203,61220
20200131,5,여의나루,8388,8561,20200203,16949
20200131,5,마포,16071,16815,20200203,32886
20200131,5,공덕,16391,18019,20200203,34410
20200131,5,애오개,8313,8278,20200203,16591
20200131,5,충정로,5217,5262,20200203,10479
20200131,5,서대문,20730,21202,20200203,41932
20200131,5,광화문,37259,40257,20200203,77516
20200131,5,종로3가,15985,16114,20200203,32099
20200131,5,을지로4가,6340,6630,20200203,12970
20200131,5,동대문역사문화공원,3398,3989,20200203,7387
20200131,5,청구,4663,4297,20200203,8960
20200131,5,신금호,7041,6936,20200203,13977
20200131,5,행당,9184,7978,20200203,17162
20200131,5,왕십리,5291,6205,20200203,11496
20200131,5,마장,6665,6374,20200203,13039
20200131,5,답십리,18157,16496,20200203,34653
20200131,5,장한평,20954,20928,20200203,41882
20200131,5,군자,12328,13542,20200203,25870
20200131,5,아차산,15018,14523,20200203,29541
20200131,5,광나루,14627,12904,20200203,27531
20200131,5,천호,20950,21931,20200203,42881
20200131,5,강동,22435,19372,20200203,41807
20200131,5,길동,8256,8804,20200203,17060
20200131,5,굽은다리,10095,9587,20200203,19682
20200131,5,명일,9671,9719,20200203,19390
20200131,5,고덕,10237,10307,20200203,20544
20200131,5,상일동,17519,14536,20200203,32055
20200131,5,둔촌동,9425,9456,20200203,18881
20200131,5,올림픽공원,4682,4033,20200203,8715
20200131,5,방이,8099,8427,20200203,16526
20200131,5,오금,4057,4014,20200203,8071
20200131,5,개롱,7469,7771,20200203,15240
20200131,5,거여,8691,8046,20200203,16737
20200131,5,마천,5546,5521,20200203,11067
20200201,5,방화,4782,4529,20200204,9311
20200201,5,개화산,3791,3640,20200204,7431
20200201,5,김포공항,5825,5728,20200204,11553
20200201,5,송정,5349,5120,20200204,10469
20200201,5,마곡,3663,3460,20200204,7123
20200201,5,발산,12720,13365,20200204,26085
20200201,5,우장산,9953,9888,20200204,19841
20200201,5,화곡,20643,19237,20200204,39880
20200201,5,까치산,21652,20557,20200204,42209
20200201,5,신정,9098,7517,20200204,16615
20200201,5,목동,11926,12271,20200204,24197
20200201,5,오목교,17313,18116,20200204,35429
20200201,5,양평,3607,3510,20200204,7117
20200201,5,영등포구청,1934,1950,20200204,3884
20200201,5,영등포시장,7397,7798,20200204,15195
20200201,5,신길,2077,2301,20200204,4378
20200201,5,여의도,8376,8997,20200204,17373
20200201,5,여의나루,3802,3760,20200204,7562
20200201,5,마포,7448,7424,20200204,14872
20200201,5,공덕,7435,7765,20200204,15200
20200201,5,애오개,3841,3657,20200204,7498
20200201,5,충정로,2096,1927,20200204,4023
20200201,5,서대문,7862,7477,20200204,15339
20200201,5,광화문,19033,20312,20200204,39345
20200201,5,종로3가,12798,12776,20200204,25574
20200201,5,을지로4가,3277,3598,20200204,6875
20200201,5,동대문역사문화공원,1170,1411,20200204,2581
20200201,5,청구,2758,2404,20200204,5162
20200201,5,신금호,4260,4353,20200204,8613
20200201,5,행당,5526,4803,20200204,10329
20200201,5,왕십리,3598,4473,20200204,8071
20200201,5,마장,4271,4111,20200204,8382
20200201,5,답십리,10657,9815,20200204,20472
20200201,5,장한평,11865,11926,20200204,23791
20200201,5,군자,8328,9433,20200204,17761
20200201,5,아차산,11375,10816,20200204,22191
20200201,5,광나루,10541,9689,20200204,20230
20200201,5,천호,17036,17062,20200204,34098
20200201,5,강동,14365,12942,20200204,27307
20200201,5,길동,5374,5714,20200204,11088
20200201,5,굽은다리,7050,6343,20200204,13393
20200201,5,명일,5619,5572,20200204,11191
20200201,5,고덕,5703,5623,20200204,11326
20200201,5,상일동,9204,8318,20200204,17522
20200201,5,둔촌동,6244,6244,20200204,12488
20200201,5,올림픽공원,2752,2632,20200204,5384
20200201,5,방이,5372,5210,20200204,10582
20200201,5,오금,2102,2113,20200204,4215
20200201,5,개롱,4568,4759,20200204,9327
20200201,5,거여,5214,4954,20200204,10168
20200201,5,마천,3915,3904,20200204,7819
20200202,5,방화,3533,3513,20200205,7046
20200202,5,개화산,2682,2852,20200205,5534
20200202,5,김포공항,4939,4679,20200205,9618
20200202,5,송정,3884,3850,20200205,7734
20200202,5,마곡,2294,2340,20200205,4634
20200202,5,발산,7584,7962,20200205,15546
20200202,5,우장산,6469,6602,20200205,13071
20200202,5,화곡,14504,13655,20200205,28159
20200202,5,까치산,15825,15314,20200205,31139
20200202,5,신정,6199,5400,20200205,11599
20200202,5,목동,7914,8324,20200205,16238
20200202,5,오목교,11828,12393,20200205,24221
20200202,5,양평,2445,2445,20200205,4890
20200202,5,영등포구청,1250,1204,20200205,2454
20200202,5,영등포시장,4910,5014,20200205,9924
20200202,5,신길,1387,1595,20200205,2982
20200202,5,여의도,5270,5758,20200205,11028
20200202,5,여의나루,3395,3455,20200205,6850
20200202,5,마포,4586,4657,20200205,9243
20200202,5,공덕,4357,4532,20200205,8889
20200202,5,애오개,2750,2875,20200205,5625
20200202,5,충정로,1310,1370,20200205,2680
20200202,5,서대문,5047,4831,20200205,9878
20200202,5,광화문,13429,12839,20200205,26268
20200202,5,종로3가,8047,7166,20200205,15213
20200202,5,을지로4가,1294,1422,20200205,2716
20200202,5,동대문역사문화공원,730,823,20200205,1553
20200202,5,청구,1839,1630,20200205,3469
20200202,5,신금호,2814,3043,20200205,5857
20200202,5,행당,3678,3408,20200205,7086
20200202,5,왕십리,2495,2960,20200205,5455
20200202,5,마장,2994,2836,20200205,5830
20200202,5,답십리,7327,6877,20200205,14204
20200202,5,장한평,8182,7993,20200205,16175
20200202,5,군자,6023,6688,20200205,12711
20200202,5,아차산,8861,8703,20200205,17564
20200202,5,광나루,7802,7540,20200205,15342
20200202,5,천호,12630,12073,20200205,24703
20200202,5,강동,9833,9235,20200205,19068
20200202,5,길동,3881,4043,20200205,7924
20200202,5,굽은다리,5289,4945,20200205,10234
20200202,5,명일,4455,4453,20200205,8908
20200202,5,고덕,3648,3799,20200205,7447
20200202,5,상일동,6199,5965,20200205,12164
20200202,5,둔촌동,5229,5331,20200205,10560
20200202,5,올림픽공원,1997,2047,20200205,4044
20200202,5,방이,4116,4030,20200205,8146
20200202,5,오금,1461,1456,20200205,2917
20200202,5,개롱,3207,3443,20200205,6650
20200202,5,거여,3572,3620,20200205,7192
20200202,5,마천,3050,3250,20200205,6300
20200203,5,방화,7213,6889,20200206,14102
20200203,5,개화산,5978,5692,20200206,11670
20200203,5,김포공항,6784,6050,20200206,12834
20200203,5,송정,7507,6864,20200206,14371
20200203,5,마곡,8176,7779,20200206,15955
20200203,5,발산,19770,19810,20200206,39580
20200203,5,우장산,15368,15366,20200206,30734
20200203,5,화곡,31168,29174,20200206,60342
20200203,5,까치산,31176,30015,20200206,61191
20200203,5,신정,14435,11250,20200206,25685
20200203,5,목동,18965,20898,20200206,39863
20200203,5,오목교,24101,25918,20200206,50019
20200203,5,양평,7947,7842,20200206,15789
20200203,5,영등포구청,4263,4221,20200206,8484
20200203,5,영등포시장,10018,10425,20200206,20443
20200203,5,신길,3856,4248,20200206,8104
20200203,5,여의도,28956,30545,20200206,59501
20200203,5,여의나루,7834,8139,20200206,15973
20200203,5,마포,15403,15856,20200206,31259
20200203,5,공덕,15546,16688,20200206,32234
20200203,5,애오개,7688,7923,20200206,15611
20200203,5,충정로,5086,5289,20200206,10375
20200203,5,서대문,19971,20528,20200206,40499
20200203,5,광화문,34909,36548,20200206,71457
20200203,5,종로3가,14146,13644,20200206,27790
20200203,5,을지로4가,6255,6347,20200206,12602
20200203,5,동대문역사문화공원,3434,3930,20200206,7364
20200203,5,청구,4458,4016,20200206,8474
20200203,5,신금호,6498,6690,20200206,13188
20200203,5,행당,8717,7800,20200206,16517
20200203,5,왕십리,4829,5398,20200206,10227
20200203,5,마장,6109,5901,20200206,12010
20200203,5,답십리,17456,16200,20200206,33656
20200203,5,장한평,19395,19158,20200206,38553
20200203,5,군자,11319,12361,20200206,23680
20200203,5,아차산,14810,14227,20200206,29037
20200203,5,광나루,13780,12650,20200206,26430
20200203,5,천호,18677,19608,20200206,38285
20200203,5,강동,21124,18535,20200206,39659
20200203,5,길동,7878,8444,20200206,16322
20200203,5,굽은다리,9668,9264,20200206,18932
20200203,5,명일,8940,9477,20200206,18417
20200203,5,고덕,9767,9734,20200206,19501
20200203,5,상일동,16713,14261,20200206,30974
20200203,5,둔촌동,8896,9043,20200206,17939
20200203,5,올림픽공원,4350,3918,20200206,8268
20200203,5,방이,7683,7933,20200206,15616
20200203,5,오금,3976,4113,20200206,8089
20200203,5,개롱,6993,7290,20200206,14283
20200203,5,거여,8125,7558,20200206,15683
20200203,5,마천,5486,5420,20200206,10906
20200204,5,방화,7340,7089,20200207,14429
20200204,5,개화산,6059,5752,20200207,11811
20200204,5,김포공항,6715,5983,20200207,12698
20200204,5,송정,7400,6808,20200207,14208
20200204,5,마곡,8288,7758,20200207,16046
20200204,5,발산,20302,20456,20200207,40758
20200204,5,우장산,15712,15647,20200207,31359
20200204,5,화곡,31013,29323,20200207,60336
20200204,5,까치산,31287,30056,20200207,61343
20200204,5,신정,14703,11442,20200207,26145
20200204,5,목동,18687,20700,20200207,39387
20200204,5,오목교,24880,26483,20200207,51363
20200204,5,양평,8047,7966,20200207,16013
20200204,5,영등포구청,4164,4252,20200207,8416
20200204,5,영등포시장,9997,10270,20200207,20267
20200204,5,신길,3824,4362,20200207,8186
20200204,5,여의도,29774,30657,20200207,60431
20200204,5,여의나루,8036,8337,20200207,16373
20200204,5,마포,15806,16189,20200207,31995
20200204,5,공덕,15964,16974,20200207,32938
20200204,5,애오개,8013,8093,20200207,16106
20200204,5,충정로,5201,5425,20200207,10626
20200204,5,서대문,20507,20802,20200207,41309
20200204,5,광화문,36969,38339,20200207,75308
20200204,5,종로3가,14250,13771,20200207,28021
20200204,5,을지로4가,6342,6413,20200207,12755
20200204,5,동대문역사문화공원,3596,3956,20200207,7552
20200204,5,청구,4493,4125,20200207,8618
20200204,5,신금호,6935,7151,20200207,14086
20200204,5,행당,8944,8057,20200207,17001
20200204,5,왕십리,4978,5414,20200207,10392
20200204,5,마장,6292,6163,20200207,12455
20200204,5,답십리,17472,16047,20200207,33519
20200204,5,장한평,19444,19529,20200207,38973
20200204,5,군자,11633,12578,20200207,24211
20200204,5,아차산,15268,14907,20200207,30175
20200204,5,광나루,13914,12517,20200207,26431
20200204,5,천호,18807,19528,20200207,38335
20200204,5,강동,21314,18916,20200207,40230
20200204,5,길동,7769,8407,20200207,16176
20200204,5,굽은다리,9580,9196,20200207,18776
20200204,5,명일,9017,9461,20200207,18478
20200204,5,고덕,9680,9820,20200207,19500
20200204,5,상일동,16634,14220,20200207,30854
20200204,5,둔촌동,9044,9234,20200207,18278
20200204,5,올림픽공원,4534,3970,20200207,8504
20200204,5,방이,7711,8074,20200207,15785
20200204,5,오금,3974,4055,20200207,8029
20200204,5,개롱,7439,7628,20200207,15067
20200204,5,거여,8200,7695,20200207,15895
20200204,5,마천,5421,5508,20200207,10929
20200205,5,방화,7191,6837,20200208,14028
20200205,5,개화산,5780,5534,20200208,11314
20200205,5,김포공항,6427,5850,20200208,12277
20200205,5,송정,7178,6525,20200208,13703
20200205,5,마곡,8024,7576,20200208,15600
20200205,5,발산,19939,20115,20200208,40054
20200205,5,우장산,15250,15101,20200208,30351
20200205,5,화곡,30743,28889,20200208,59632
20200205,5,까치산,30395,29236,20200208,59631
20200205,5,신정,14398,11211,20200208,25609
20200205,5,목동,18400,20144,20200208,38544
20200205,5,오목교,24424,26183,20200208,50607
20200205,5,양평,7658,7690,20200208,15348
20200205,5,영등포구청,3971,4025,20200208,7996
20200205,5,영등포시장,9464,9874,20200208,19338
20200205,5,신길,3820,4268,20200208,8088
20200205,5,여의도,29182,30286,20200208,59468
20200205,5,여의나루,7635,7846,20200208,15481
20200205,5,마포,15237,15656,20200208,30893
20200205,5,공덕,15419,16591,20200208,32010
20200205,5,애오개,7825,8019,20200208,15844
20200205,5,충정로,5155,5320,20200208,10475
20200205,5,서대문,20116,20651,20200208,40767
20200205,5,광화문,36065,38007,20200208,74072
20200205,5,종로3가,13936,13241,20200208,27177
20200205,5,을지로4가,5906,6123,20200208,12029
20200205,5,동대문역사문화공원,3451,3916,20200208,7367
20200205,5,청구,4407,4055,20200208,8462
20200205,5,신금호,6908,6957,20200208,13865
20200205,5,행당,8732,7859,20200208,16591
20200205,5,왕십리,4877,5400,20200208,10277
20200205,5,마장,6103,5732,20200208,11835
20200205,5,답십리,17193,15673,20200208,32866
20200205,5,장한평,19819,19797,20200208,39616
20200205,5,군자,11290,12400,20200208,23690
20200205,5,아차산,14293,13805,20200208,28098
20200205,5,광나루,13331,11762,20200208,25093
20200205,5,천호,18277,18951,20200208,37228
20200205,5,강동,20575,18303,20200208,38878
20200205,5,길동,7592,8052,20200208,15644
20200205,5,굽은다리,9531,9081,20200208,18612
20200205,5,명일,8610,9176,20200208,17786
20200205,5,고덕,9568,9433,20200208,19001
20200205,5,상일동,16305,13831,20200208,30136
20200205,5,둔촌동,8754,9040,20200208,17794
20200205,5,올림픽공원,4377,3806,20200208,8183
20200205,5,방이,7546,7820,20200208,15366
20200205,5,오금,3854,3871,20200208,7725
20200205,5,개롱,7059,7267,20200208,14326
20200205,5,거여,7995,7540,20200208,15535
20200205,5,마천,5150,5119,20200208,10269
20200206,5,방화,7254,6955,20200209,14209
20200206,5,개화산,5825,5537,20200209,11362
20200206,5,김포공항,6705,5807,20200209,12512
20200206,5,송정,7269,6568,20200209,13837
20200206,5,마곡,7921,7473,20200209,15394
20200206,5,발산,20073,20187,20200209,40260
20200206,5,우장산,15075,15049,20200209,30124
20200206,5,화곡,30146,28020,20200209,58166
20200206,5,까치산,30302,28793,20200209,59095
20200206,5,신정,14337,10995,20200209,25332
20200206,5,목동,18146,20038,20200209,38184
20200206,5,오목교,24639,26625,20200209,51264
20200206,5,양평,7658,7531,20200209,15189
20200206,5,영등포구청,3985,4134,20200209,8119
20200206,5,영등포시장,9637,9892,20200209,19529
20200206,5,신길,3840,4332,20200209,8172
20200206,5,여의도,28796,30062,20200209,58858
20200206,5,여의나루,7546,8000,20200209,15546
20200206,5,마포,15222,15629,20200209,30851
20200206,5,공덕,15403,16659,20200209,32062
20200206,5,애오개,7717,7806,20200209,15523
20200206,5,충정로,5033,5269,20200209,10302
20200206,5,서대문,19645,20259,20200209,39904
20200206,5,광화문,35093,37479,20200209,72572
20200206,5,종로3가,13700,13315,20200209,27015
20200206,5,을지로4가,6021,6090,20200209,12111
20200206,5,동대문역사문화공원,3430,3984,20200209,7414
20200206,5,청구,4401,3994,20200209,8395
20200206,5,신금호,6659,6768,20200209,13427
20200206,5,행당,8538,7587,20200209,16125
20200206,5,왕십리,4713,5305,20200209,10018
20200206,5,마장,5811,5646,20200209,11457
20200206,5,답십리,16846,15567,20200209,32413
20200206,5,장한평,19358,19405,20200209,38763
20200206,5,군자,11288,12160,20200209,23448
20200206,5,아차산,14169,13846,20200209,28015
20200206,5,광나루,12790,11149,20200209,23939
20200206,5,천호,18087,19122,20200209,37209
20200206,5,강동,20528,18227,20200209,38755
20200206,5,길동,7182,7782,20200209,14964
20200206,5,굽은다리,9215,8793,20200209,18008
20200206,5,명일,8458,8804,20200209,17262
20200206,5,고덕,9345,9282,20200209,18627
20200206,5,상일동,16072,13549,20200209,29621
20200206,5,둔촌동,8575,8734,20200209,17309
20200206,5,올림픽공원,4246,3959,20200209,8205
20200206,5,방이,7277,7524,20200209,14801
20200206,5,오금,3816,3855,20200209,7671
20200206,5,개롱,6971,7103,20200209,14074
20200206,5,거여,7748,7279,20200209,15027
20200206,5,마천,5019,5000,20200209,10019
20200207,5,방화,7520,7062,20200210,14582
20200207,5,개화산,5887,5585,20200210,11472
20200207,5,김포공항,6985,6301,20200210,13286
20200207,5,송정,7489,6912,20200210,14401
20200207,5,마곡,8325,7771,20200210,16096
20200207,5,발산,20935,21480,20200210,42415
20200207,5,우장산,16043,15682,20200210,31725
20200207,5,화곡,31566,28963,20200210,60529
20200207,5,까치산,31733,30054,20200210,61787
20200207,5,신정,14913,11132,20200210,26045
20200207,5,목동,19086,20868,20200210,39954
20200207,5,오목교,27726,29466,20200210,57192
20200207,5,양평,7664,7454,20200210,15118
20200207,5,영등포구청,4051,4047,20200210,8098
20200207,5,영등포시장,10046,10325,20200210,20371
20200207,5,신길,4176,4511,20200210,8687
20200207,5,여의도,28940,30472,20200210,59412
20200207,5,여의나루,7989,8118,20200210,16107
20200207,5,마포,15482,16148,20200210,31630
20200207,5,공덕,15661,17215,20200210,32876
20200207,5,애오개,7880,7837,20200210,15717
20200207,5,충정로,4945,5130,20200210,10075
20200207,5,서대문,19880,20224,20200210,40104
20200207,5,광화문,36018,38255,20200210,74273
20200207,5,종로3가,14738,14818,20200210,29556
20200207,5,을지로4가,6051,6278,20200210,12329
20200207,5,동대문역사문화공원,3359,3915,20200210,7274
20200207,5,청구,4475,4010,20200210,8485
20200207,5,신금호,6958,6936,20200210,13894
20200207,5,행당,8775,7725,20200210,16500
20200207,5,왕십리,5004,5874,20200210,10878
20200207,5,마장,6145,5863,20200210,12008
20200207,5,답십리,17446,15769,20200210,33215
20200207,5,장한평,19876,19794,20200210,39670
20200207,5,군자,11752,12907,20200210,24659
20200207,5,아차산,14835,14145,20200210,28980
20200207,5,광나루,13394,11868,20200210,25262
20200207,5,천호,19620,20509,20200210,40129
20200207,5,강동,21063,18295,20200210,39358
20200207,5,길동,7785,8347,20200210,16132
20200207,5,굽은다리,9971,9557,20200210,19528
20200207,5,명일,8767,9202,20200210,17969
20200207,5,고덕,9725,9549,20200210,19274
20200207,5,상일동,16480,13696,20200210,30176
20200207,5,둔촌동,9103,9126,20200210,18229
20200207,5,올림픽공원,4780,4757,20200210,9537
20200207,5,방이,7402,7637,20200210,15039
20200207,5,오금,3853,4002,20200210,7855
20200207,5,개롱,7136,7026,20200210,14162
20200207,5,거여,8025,7440,20200210,15465
20200207,5,마천,5141,5076,20200210,10217
20200208,5,방화,4675,4373,20200211,9048
20200208,5,개화산,3600,3585,20200211,7185
20200208,5,김포공항,5539,5559,20200211,11098
20200208,5,송정,5272,4962,20200211,10234
20200208,5,마곡,3674,3498,20200211,7172
20200208,5,발산,12924,13605,20200211,26529
20200208,5,우장산,9789,9606,20200211,19395
20200208,5,화곡,19982,18489,20200211,38471
20200208,5,까치산,20842,19923,20200211,40765
20200208,5,신정,8816,7024,20200211,15840
20200208,5,목동,11329,11784,20200211,23113
20200208,5,오목교,18941,19577,20200211,38518
20200208,5,양평,3435,3304,20200211,6739
20200208,5,영등포구청,1805,1708,20200211,3513
20200208,5,영등포시장,7298,7662,20200211,14960
20200208,5,신길,2252,2502,20200211,4754
20200208,5,여의도,8355,9213,20200211,17568
20200208,5,여의나루,3698,3593,20200211,7291
20200208,5,마포,6873,7092,20200211,13965
20200208,5,공덕,6784,6994,20200211,13778
20200208,5,애오개,3766,3644,20200211,7410
20200208,5,충정로,1992,1799,20200211,3791
20200208,5,서대문,7269,7159,20200211,14428
20200208,5,광화문,19015,18692,20200211,37707
20200208,5,종로3가,11514,11656,20200211,23170
20200208,5,을지로4가,2984,3266,20200211,6250
20200208,5,동대문역사문화공원,1094,1398,20200211,2492
20200208,5,청구,2553,2251,20200211,4804
20200208,5,신금호,4210,4223,20200211,8433
20200208,5,행당,5112,4466,20200211,9578
20200208,5,왕십리,3478,4245,20200211,7723
20200208,5,마장,3942,3824,20200211,7766
20200208,5,답십리,10354,9515,20200211,19869
20200208,5,장한평,11186,11251,20200211,22437
20200208,5,군자,7871,8967,20200211,16838
20200208,5,아차산,10963,10701,20200211,21664
20200208,5,광나루,10314,9470,20200211,19784
20200208,5,천호,16462,16256,20200211,32718
20200208,5,강동,14026,12526,20200211,26552
20200208,5,길동,5392,5470,20200211,10862
20200208,5,굽은다리,6508,5988,20200211,12496
20200208,5,명일,5151,5310,20200211,10461
20200208,5,고덕,5285,5175,20200211,10460
20200208,5,상일동,8852,7974,20200211,16826
20200208,5,둔촌동,5841,5729,20200211,11570
20200208,5,올림픽공원,2823,2958,20200211,5781
20200208,5,방이,4797,4651,20200211,9448
20200208,5,오금,1856,1872,20200211,3728
20200208,5,개롱,4210,4289,20200211,8499
20200208,5,거여,4915,4587,20200211,9502
20200208,5,마천,3819,3728,20200211,7547
20200209,5,방화,3491,3544,20200212,7035
20200209,5,개화산,2773,2742,20200212,5515
20200209,5,김포공항,5120,4634,20200212,9754
20200209,5,송정,3800,3774,20200212,7574
20200209,5,마곡,2290,2336,20200212,4626
20200209,5,발산,7916,8437,20200212,16353
20200209,5,우장산,6404,6582,20200212,12986
20200209,5,화곡,13818,13137,20200212,26955
20200209,5,까치산,15161,14698,20200212,29859
20200209,5,신정,6084,5189,20200212,11273
20200209,5,목동,7630,7933,20200212,15563
20200209,5,오목교,14447,14685,20200212,29132
20200209,5,양평,2421,2409,20200212,4830
20200209,5,영등포구청,1201,1205,20200212,2406
20200209,5,영등포시장,4828,5196,20200212,10024
20200209,5,신길,1648,1795,20200212,3443
20200209,5,여의도,5018,5253,20200212,10271
20200209,5,여의나루,3153,3191,20200212,6344
20200209,5,마포,4477,4592,20200212,9069
20200209,5,공덕,4256,4228,20200212,8484
20200209,5,애오개,2661,2793,20200212,5454
20200209,5,충정로,1251,1237,20200212,2488
20200209,5,서대문,4913,4818,20200212,9731
20200209,5,광화문,11987,12166,20200212,24153
20200209,5,종로3가,8206,7333,20200212,15539
20200209,5,을지로4가,1203,1346,20200212,2549
20200209,5,동대문역사문화공원,740,845,20200212,1585
20200209,5,청구,1741,1547,20200212,3288
20200209,5,신금호,2802,3048,20200212,5850
20200209,5,행당,3886,3619,20200212,7505
20200209,5,왕십리,2470,2910,20200212,5380
20200209,5,마장,2899,2822,20200212,5721
20200209,5,답십리,7241,6812,20200212,14053
20200209,5,장한평,7887,7882,20200212,15769
20200209,5,군자,5874,6703,20200212,12577
20200209,5,아차산,9308,9186,20200212,18494
20200209,5,광나루,8043,7859,20200212,15902
20200209,5,천호,11949,11621,20200212,23570
20200209,5,강동,9627,8895,20200212,18522
20200209,5,길동,3797,3983,20200212,7780
20200209,5,굽은다리,4960,4572,20200212,9532
20200209,5,명일,4234,4249,20200212,8483
20200209,5,고덕,3464,3500,20200212,6964
20200209,5,상일동,6075,5899,20200212,11974
20200209,5,둔촌동,5051,5067,20200212,10118
20200209,5,올림픽공원,2240,2403,20200212,4643
20200209,5,방이,3911,3831,20200212,7742
20200209,5,오금,1445,1389,20200212,2834
20200209,5,개롱,2808,3098,20200212,5906
20200209,5,거여,3429,3360,20200212,6789
20200209,5,마천,2964,3248,20200212,6212
20200210,5,방화,7371,6981,20200213,14352
20200210,5,개화산,6026,5819,20200213,11845
20200210,5,김포공항,6436,6161,20200213,12597
20200210,5,송정,7449,6748,20200213,14197
20200210,5,마곡,8204,7794,20200213,15998
20200210,5,발산,20459,20666,20200213,41125
20200210,5,우장산,15375,15237,20200213,30612
20200210,5,화곡,30855,28689,20200213,59544
20200210,5,까치산,30661,29456,20200213,60117
20200210,5,신정,14395,10944,20200213,25339
20200210,5,목동,18628,20494,20200213,39122
20200210,5,오목교,22597,24407,20200213,47004
20200210,5,양평,7819,7782,20200213,15601
20200210,5,영등포구청,4255,4288,20200213,8543
20200210,5,영등포시장,9806,10142,20200213,19948
20200210,5,신길,3991,4278,20200213,8269
20200210,5,여의도,29054,30628,20200213,59682
20200210,5,여의나루,7989,8378,20200213,16367
20200210,5,마포,15116,15513,20200213,30629
20200210,5,공덕,14837,16204,20200213,31041
20200210,5,애오개,7468,7626,20200213,15094
20200210,5,충정로,5130,5303,20200213,10433
20200210,5,서대문,19631,20249,20200213,39880
20200210,5,광화문,35252,36916,20200213,72168
20200210,5,종로3가,14321,14000,20200213,28321
20200210,5,을지로4가,6268,6461,20200213,12729
20200210,5,동대문역사문화공원,3431,3853,20200213,7284
20200210,5,청구,4343,3964,20200213,8307
20200210,5,신금호,6432,6599,20200213,13031
20200210,5,행당,8685,7781,20200213,16466
20200210,5,왕십리,4905,5266,20200213,10171
20200210,5,마장,5738,5442,20200213,11180
20200210,5,답십리,17179,15664,20200213,32843
20200210,5,장한평,19376,19159,20200213,38535
20200210,5,군자,11343,12374,20200213,23717
20200210,5,아차산,13905,13574,20200213,27479
20200210,5,광나루,13632,12244,20200213,25876
20200210,5,천호,17498,18495,20200213,35993
20200210,5,강동,20875,18303,20200213,39178
20200210,5,길동,7842,8433,20200213,16275
20200210,5,굽은다리,9361,8830,20200213,18191
20200210,5,명일,8680,9171,20200213,17851
20200210,5,고덕,9333,9446,20200213,18779
20200210,5,상일동,16664,14082,20200213,30746
20200210,5,둔촌동,8530,8781,20200213,17311
20200210,5,올림픽공원,4268,3699,20200213,7967
20200210,5,방이,7513,7666,20200213,15179
20200210,5,오금,3791,3821,20200213,7612
20200210,5,개롱,6616,6872,20200213,13488
20200210,5,거여,7734,7245,20200213,14979
20200210,5,마천,5193,5212,20200213,10405
20200211,5,방화,7654,7185,20200214,14839
20200211,5,개화산,6223,5809,20200214,12032
20200211,5,김포공항,6823,6282,20200214,13105
20200211,5,송정,7503,6939,20200214,14442
20200211,5,마곡,8386,7799,20200214,16185
20200211,5,발산,20534,20736,20200214,41270
20200211,5,우장산,15776,15633,20200214,31409
20200211,5,화곡,31679,29577,20200214,61256
20200211,5,까치산,31637,30148,20200214,61785
20200211,5,신정,14838,11371,20200214,26209
20200211,5,목동,19214,21141,20200214,40355
20200211,5,오목교,25496,27528,20200214,53024
20200211,5,양평,7884,7865,20200214,15749
20200211,5,영등포구청,4286,4326,20200214,8612
20200211,5,영등포시장,10076,10360,20200214,20436
20200211,5,신길,3861,4298,20200214,8159
20200211,5,여의도,29328,31226,20200214,60554
20200211,5,여의나루,8988,9153,20200214,18141
20200211,5,마포,15536,16031,20200214,31567
20200211,5,공덕,15450,16747,20200214,32197
20200211,5,애오개,7669,7738,20200214,15407
20200211,5,충정로,5090,5382,20200214,10472
20200211,5,서대문,20097,20778,20200214,40875
20200211,5,광화문,36482,38716,20200214,75198
20200211,5,종로3가,14826,14528,20200214,29354
20200211,5,을지로4가,6547,6645,20200214,13192
20200211,5,동대문역사문화공원,3426,3937,20200214,7363
20200211,5,청구,4440,3996,20200214,8436
20200211,5,신금호,6751,6810,20200214,13561
20200211,5,행당,8835,7880,20200214,16715
20200211,5,왕십리,4970,5510,20200214,10480
20200211,5,마장,5868,5559,20200214,11427
20200211,5,답십리,17565,15866,20200214,33431
20200211,5,장한평,19743,19572,20200214,39315
20200211,5,군자,11756,12768,20200214,24524
20200211,5,아차산,14731,14458,20200214,29189
20200211,5,광나루,13881,12449,20200214,26330
20200211,5,천호,19295,20209,20200214,39504
20200211,5,강동,21478,18949,20200214,40427
20200211,5,길동,7717,8243,20200214,15960
20200211,5,굽은다리,9522,9023,20200214,18545
20200211,5,명일,9054,9343,20200214,18397
20200211,5,고덕,9365,9507,20200214,18872
20200211,5,상일동,17054,14449,20200214,31503
20200211,5,둔촌동,8982,9181,20200214,18163
20200211,5,올림픽공원,4258,3824,20200214,8082
20200211,5,방이,7634,7912,20200214,15546
20200211,5,오금,3813,3782,20200214,7595
20200211,5,개롱,6992,7068,20200214,14060
20200211,5,거여,8065,7549,20200214,15614
20200211,5,마천,5337,5261,20200214,10598
20200212,5,방화,7012,6655,20200215,13667
20200212,5,개화산,5916,5602,20200215,11518
20200212,5,김포공항,6747,6052,20200215,12799
20200212,5,송정,7209,6574,20200215,13783
20200212,5,마곡,8109,7601,20200215,15710
20200212,5,발산,20795,21195,20200215,41990
20200212,5,우장산,15403,15261,20200215,30664
20200212,5,화곡,30755,28876,20200215,59631
20200212,5,까치산,30626,29208,20200215,59834
20200212,5,신정,14471,11067,20200215,25538
20200212,5,목동,18605,20404,20200215,39009
20200212,5,오목교,25125,26961,20200215,52086
20200212,5,양평,7937,7861,20200215,15798
20200212,5,영등포구청,4063,4188,20200215,8251
20200212,5,영등포시장,9698,10117,20200215,19815
20200212,5,신길,3802,4242,20200215,8044
20200212,5,여의도,29084,30428,20200215,59512
20200212,5,여의나루,7453,7767,20200215,15220
20200212,5,마포,15469,16003,20200215,31472
20200212,5,공덕,15086,16526,20200215,31612
20200212,5,애오개,7742,7869,20200215,15611
20200212,5,충정로,5098,5333,20200215,10431
20200212,5,서대문,19931,20473,20200215,40404
20200212,5,광화문,36231,38125,20200215,74356
20200212,5,종로3가,14219,13640,20200215,27859
20200212,5,을지로4가,5918,6366,20200215,12284
20200212,5,동대문역사문화공원,3407,3953,20200215,7360
20200212,5,청구,4402,3968,20200215,8370
20200212,5,신금호,6455,6614,20200215,13069
20200212,5,행당,8750,7646,20200215,16396
20200212,5,왕십리,4952,5618,20200215,10570
20200212,5,마장,5780,5470,20200215,11250
20200212,5,답십리,17198,15611,20200215,32809
20200212,5,장한평,19838,19910,20200215,39748
20200212,5,군자,11389,12514,20200215,23903
20200212,5,아차산,13903,13665,20200215,27568
20200212,5,광나루,13278,11611,20200215,24889
20200212,5,천호,18763,19272,20200215,38035
20200212,5,강동,21032,18555,20200215,39587
20200212,5,길동,7831,8374,20200215,16205
20200212,5,굽은다리,9503,9270,20200215,18773
20200212,5,명일,8626,9235,20200215,17861
20200212,5,고덕,9161,9217,20200215,18378
20200212,5,상일동,16502,13924,20200215,30426
20200212,5,둔촌동,8839,9171,20200215,18010
20200212,5,올림픽공원,4116,3583,20200215,7699
20200212,5,방이,7612,7872,20200215,15484
20200212,5,오금,3724,3702,20200215,7426
20200212,5,개롱,6753,7064,20200215,13817
20200212,5,거여,7800,7358,20200215,15158
20200212,5,마천,5081,5055,20200215,10136
20200213,5,방화,7429,7049,20200216,14478
20200213,5,개화산,6097,5767,20200216,11864
20200213,5,김포공항,7016,6683,20200216,13699
20200213,5,송정,7601,6984,20200216,14585
20200213,5,마곡,8296,7797,20200216,16093
20200213,5,발산,20972,21304,20200216,42276
20200213,5,우장산,15800,15646,20200216,31446
20200213,5,화곡,31790,29482,20200216,61272
20200213,5,까치산,31889,30012,20200216,61901
20200213,5,신정,14756,11266,20200216,26022
20200213,5,목동,19105,20830,20200216,39935
20200213,5,오목교,26227,28315,20200216,54542
20200213,5,양평,7982,7824,20200216,15806
20200213,5,영등포구청,4229,4233,20200216,8462
20200213,5,영등포시장,10285,10616,20200216,20901
20200213,5,신길,3824,4218,20200216,8042
20200213,5,여의도,29702,31405,20200216,61107
20200213,5,여의나루,8245,8741,20200216,16986
20200213,5,마포,15645,16319,20200216,31964
20200213,5,공덕,15511,16785,20200216,32296
20200213,5,애오개,7761,7991,20200216,15752
20200213,5,충정로,4924,5111,20200216,10035
20200213,5,서대문,19777,20887,20200216,40664
20200213,5,광화문,36892,39200,20200216,76092
20200213,5,종로3가,15327,14997,20200216,30324
20200213,5,을지로4가,6364,6667,20200216,13031
20200213,5,동대문역사문화공원,3391,3852,20200216,7243
20200213,5,청구,4491,3984,20200216,8475
20200213,5,신금호,6739,6700,20200216,13439
20200213,5,행당,8917,7927,20200216,16844
20200213,5,왕십리,5102,5659,20200216,10761
20200213,5,마장,5993,5542,20200216,11535
20200213,5,답십리,17622,15967,20200216,33589
20200213,5,장한평,20684,20432,20200216,41116
20200213,5,군자,11781,12776,20200216,24557
20200213,5,아차산,14766,14397,20200216,29163
20200213,5,광나루,13927,12336,20200216,26263
20200213,5,천호,20030,20722,20200216,40752
20200213,5,강동,21621,18963,20200216,40584
20200213,5,길동,7847,8402,20200216,16249
20200213,5,굽은다리,9831,9179,20200216,19010
20200213,5,명일,9010,9279,20200216,18289
20200213,5,고덕,9477,9557,20200216,19034
20200213,5,상일동,17287,14520,20200216,31807
20200213,5,둔촌동,9193,9325,20200216,18518
20200213,5,올림픽공원,4348,3685,20200216,8033
20200213,5,방이,7856,8164,20200216,16020
20200213,5,오금,3781,3916,20200216,7697
20200213,5,개롱,7014,7098,20200216,14112
20200213,5,거여,8001,7471,20200216,15472
20200213,5,마천,5303,5229,20200216,10532
20200214,5,방화,7650,6966,20200217,14616
20200214,5,개화산,6291,5941,20200217,12232
20200214,5,김포공항,7514,7264,20200217,14778
20200214,5,송정,7880,7075,20200217,14955
20200214,5,마곡,8417,7867,20200217,16284
20200214,5,발산,21567,22446,20200217,44013
20200214,5,우장산,16461,15927,20200217,32388
20200214,5,화곡,32954,29947,20200217,62901
20200214,5,까치산,33074,31127,20200217,64201
20200214,5,신정,15230,11319,20200217,26549
20200214,5,목동,19930,21299,20200217,41229
20200214,5,오목교,27111,29817,20200217,56928
20200214,5,양평,8060,7685,20200217,15745
20200214,5,영등포구청,4446,4415,20200217,8861
20200214,5,영등포시장,10833,11153,20200217,21986
20200214,5,신길,4041,4266,20200217,8307
20200214,5,여의도,29793,31617,20200217,61410
20200214,5,여의나루,9728,9562,20200217,19290
20200214,5,마포,15846,16651,20200217,32497
20200214,5,공덕,16083,17397,20200217,33480
20200214,5,애오개,8150,8086,20200217,16236
20200214,5,충정로,5013,5114,20200217,10127
20200214,5,서대문,19866,20654,20200217,40520
20200214,5,광화문,37601,40160,20200217,77761
20200214,5,종로3가,16050,16762,20200217,32812
20200214,5,을지로4가,6492,6744,20200217,13236
20200214,5,동대문역사문화공원,3255,3847,20200217,7102
20200214,5,청구,4497,4139,20200217,8636
20200214,5,신금호,6989,6847,20200217,13836
20200214,5,행당,9033,7873,20200217,16906
20200214,5,왕십리,5290,6316,20200217,11606
20200214,5,마장,6198,5736,20200217,11934
20200214,5,답십리,17954,16325,20200217,34279
20200214,5,장한평,20891,20738,20200217,41629
20200214,5,군자,12334,13437,20200217,25771
20200214,5,아차산,15305,14890,20200217,30195
20200214,5,광나루,14468,12767,20200217,27235
20200214,5,천호,21656,22804,20200217,44460
20200214,5,강동,22148,19124,20200217,41272
20200214,5,길동,8367,8915,20200217,17282
20200214,5,굽은다리,10036,9302,20200217,19338
20200214,5,명일,9486,9552,20200217,19038
20200214,5,고덕,9940,9854,20200217,19794
20200214,5,상일동,17666,14464,20200217,32130
20200214,5,둔촌동,9398,9544,20200217,18942
20200214,5,올림픽공원,4526,3834,20200217,8360
20200214,5,방이,7908,8002,20200217,15910
20200214,5,오금,3889,3905,20200217,7794
20200214,5,개롱,7054,7040,20200217,14094
20200214,5,거여,8391,7735,20200217,16126
20200214,5,마천,5413,5267,20200217,10680
20200215,5,방화,5155,4833,20200218,9988
20200215,5,개화산,4087,3924,20200218,8011
20200215,5,김포공항,6447,6595,20200218,13042
20200215,5,송정,5519,5274,20200218,10793
20200215,5,마곡,3956,3638,20200218,7594
20200215,5,발산,14699,15575,20200218,30274
20200215,5,우장산,10524,10342,20200218,20866
20200215,5,화곡,21956,20135,20200218,42091
20200215,5,까치산,22619,21335,20200218,43954
20200215,5,신정,9397,7670,20200218,17067
20200215,5,목동,12396,12590,20200218,24986
20200215,5,오목교,18688,19467,20200218,38155
20200215,5,양평,3748,3445,20200218,7193
20200215,5,영등포구청,1987,1988,20200218,3975
20200215,5,영등포시장,8332,8803,20200218,17135
20200215,5,신길,2272,2440,20200218,4712
20200215,5,여의도,9062,9851,20200218,18913
20200215,5,여의나루,4814,4911,20200218,9725
20200215,5,마포,7709,7886,20200218,15595
20200215,5,공덕,7766,8357,20200218,16123
20200215,5,애오개,4044,3848,20200218,7892
20200215,5,충정로,2109,1904,20200218,4013
20200215,5,서대문,7878,7726,20200218,15604
20200215,5,광화문,22324,22370,20200218,44694
20200215,5,종로3가,13759,13332,20200218,27091
20200215,5,을지로4가,3364,3847,20200218,7211
20200215,5,동대문역사문화공원,1086,1384,20200218,2470
20200215,5,청구,2803,2485,20200218,5288
20200215,5,신금호,4328,4293,20200218,8621
20200215,5,행당,6126,5303,20200218,11429
20200215,5,왕십리,3746,4788,20200218,8534
20200215,5,마장,4014,3936,20200218,7950
20200215,5,답십리,11144,10339,20200218,21483
20200215,5,장한평,12332,12249,20200218,24581
20200215,5,군자,8740,9865,20200218,18605
20200215,5,아차산,12249,11603,20200218,23852
20200215,5,광나루,11127,10709,20200218,21836
20200215,5,천호,18127,17901,20200218,36028
20200215,5,강동,15549,13978,20200218,29527
20200215,5,길동,5795,5957,20200218,11752
20200215,5,굽은다리,7607,6973,20200218,14580
20200215,5,명일,6025,5779,20200218,11804
20200215,5,고덕,5973,5804,20200218,11777
20200215,5,상일동,10366,9142,20200218,19508
20200215,5,둔촌동,6473,6371,20200218,12844
20200215,5,올림픽공원,2868,2680,20200218,5548
20200215,5,방이,5414,5372,20200218,10786
20200215,5,오금,2445,2286,20200218,4731
20200215,5,개롱,4873,4916,20200218,9789
20200215,5,거여,5332,5147,20200218,10479
20200215,5,마천,4231,4226,20200218,8457
20200216,5,방화,3706,3647,20200219,7353
20200216,5,개화산,2829,2819,20200219,5648
20200216,5,김포공항,5952,5879,20200219,11831
20200216,5,송정,3868,3944,20200219,7812
20200216,5,마곡,2261,2382,20200219,4643
20200216,5,발산,8666,9077,20200219,17743
20200216,5,우장산,6889,7016,20200219,13905
20200216,5,화곡,14940,13912,20200219,28852
20200216,5,까치산,15911,15470,20200219,31381
20200216,5,신정,6415,5623,20200219,12038
20200216,5,목동,7931,8240,20200219,16171
20200216,5,오목교,12978,13539,20200219,26517
20200216,5,양평,2447,2501,20200219,4948
20200216,5,영등포구청,1253,1269,20200219,2522
20200216,5,영등포시장,5168,5485,20200219,10653
20200216,5,신길,1393,1667,20200219,3060
20200216,5,여의도,5730,6195,20200219,11925
20200216,5,여의나루,2794,3036,20200219,5830
20200216,5,마포,4667,4869,20200219,9536
20200216,5,공덕,4656,4589,20200219,9245
20200216,5,애오개,2765,3002,20200219,5767
20200216,5,충정로,1405,1374,20200219,2779
20200216,5,서대문,4961,4767,20200219,9728
20200216,5,광화문,13468,13422,20200219,26890
20200216,5,종로3가,8921,7408,20200219,16329
20200216,5,을지로4가,1190,1400,20200219,2590
20200216,5,동대문역사문화공원,694,851,20200219,1545
20200216,5,청구,1835,1522,20200219,3357
20200216,5,신금호,2915,3081,20200219,5996
20200216,5,행당,3894,3630,20200219,7524
20200216,5,왕십리,2725,3181,20200219,5906
20200216,5,마장,3066,3060,20200219,6126
20200216,5,답십리,7634,7031,20200219,14665
20200216,5,장한평,8198,8150,20200219,16348
20200216,5,군자,6000,6874,20200219,12874
20200216,5,아차산,8812,8526,20200219,17338
20200216,5,광나루,9757,9237,20200219,18994
20200216,5,천호,12989,12682,20200219,25671
20200216,5,강동,10451,9689,20200219,20140
20200216,5,길동,4104,4146,20200219,8250
20200216,5,굽은다리,5509,5169,20200219,10678
20200216,5,명일,4589,4498,20200219,9087
20200216,5,고덕,3907,3880,20200219,7787
20200216,5,상일동,6627,6284,20200219,12911
20200216,5,둔촌동,5240,5295,20200219,10535
20200216,5,올림픽공원,2103,2085,20200219,4188
20200216,5,방이,3950,3890,20200219,7840
20200216,5,오금,1585,1556,20200219,3141
20200216,5,개롱,3095,3326,20200219,6421
20200216,5,거여,3657,3593,20200219,7250
20200216,5,마천,2912,3204,20200219,6116
20200217,5,방화,7261,6918,20200220,14179
20200217,5,개화산,6042,5743,20200220,11785
20200217,5,김포공항,7012,6729,20200220,13741
20200217,5,송정,7273,6707,20200220,13980
20200217,5,마곡,8255,7754,20200220,16009
20200217,5,발산,20731,21107,20200220,41838
20200217,5,우장산,15342,15213,20200220,30555
20200217,5,화곡,31104,28956,20200220,60060
20200217,5,까치산,30931,29489,20200220,60420
20200217,5,신정,14658,11348,20200220,26006
20200217,5,목동,18702,20694,20200220,39396
20200217,5,오목교,25537,27357,20200220,52894
20200217,5,양평,8069,8143,20200220,16212
20200217,5,영등포구청,4165,4207,20200220,8372
20200217,5,영등포시장,9780,10242,20200220,20022
20200217,5,신길,3890,4285,20200220,8175
20200217,5,여의도,29691,31540,20200220,61231
20200217,5,여의나루,7414,7993,20200220,15407
20200217,5,마포,15953,16256,20200220,32209
20200217,5,공덕,15633,16623,20200220,32256
20200217,5,애오개,7887,8023,20200220,15910
20200217,5,충정로,5064,5278,20200220,10342
20200217,5,서대문,19893,20624,20200220,40517
20200217,5,광화문,36309,38114,20200220,74423
20200217,5,종로3가,14181,13698,20200220,27879
20200217,5,을지로4가,6163,6282,20200220,12445
20200217,5,동대문역사문화공원,3580,4066,20200220,7646
20200217,5,청구,4441,4140,20200220,8581
20200217,5,신금호,6595,6610,20200220,13205
20200217,5,행당,9088,8016,20200220,17104
20200217,5,왕십리,4949,5522,20200220,10471
20200217,5,마장,6001,5832,20200220,11833
20200217,5,답십리,17361,16220,20200220,33581
20200217,5,장한평,19456,19515,20200220,38971
20200217,5,군자,11794,12722,20200220,24516
20200217,5,아차산,14259,13744,20200220,28003
20200217,5,광나루,13902,12344,20200220,26246
20200217,5,천호,18608,19493,20200220,38101
20200217,5,강동,21698,19188,20200220,40886
20200217,5,길동,8013,8603,20200220,16616
20200217,5,굽은다리,9784,9393,20200220,19177
20200217,5,명일,9173,9521,20200220,18694
20200217,5,고덕,9807,9837,20200220,19644
20200217,5,상일동,17458,14797,20200220,32255
20200217,5,둔촌동,8950,9110,20200220,18060
20200217,5,올림픽공원,4493,3898,20200220,8391
20200217,5,방이,8102,8311,20200220,16413
20200217,5,오금,3952,3813,20200220,7765
20200217,5,개롱,7217,7294,20200220,14511
20200217,5,거여,8437,7803,20200220,16240
20200217,5,마천,5383,5217,20200220,10600
20200218,5,방화,7295,6869,20200221,14164
20200218,5,개화산,6062,5718,20200221,11780
20200218,5,김포공항,7149,6810,20200221,13959
20200218,5,송정,7476,6807,20200221,14283
20200218,5,마곡,8151,7747,20200221,15898
20200218,5,발산,20651,20872,20200221,41523
20200218,5,우장산,15586,15403,20200221,30989
20200218,5,화곡,31196,28898,20200221,60094
20200218,5,까치산,31171,29814,20200221,60985
20200218,5,신정,14674,11240,20200221,25914
20200218,5,목동,19023,20660,20200221,39683
20200218,5,오목교,25723,27681,20200221,53404
20200218,5,양평,7968,7850,20200221,15818
20200218,5,영등포구청,4212,4158,20200221,8370
20200218,5,영등포시장,10113,10383,20200221,20496
20200218,5,신길,3893,4317,20200221,8210
20200218,5,여의도,29491,31102,20200221,60593
20200218,5,여의나루,7714,8147,20200221,15861
20200218,5,마포,15771,16205,20200221,31976
20200218,5,공덕,15564,16792,20200221,32356
20200218,5,애오개,7816,7920,20200221,15736
20200218,5,충정로,4927,5135,20200221,10062
20200218,5,서대문,19696,20397,20200221,40093
20200218,5,광화문,37346,39338,20200221,76684
20200218,5,종로3가,14258,13620,20200221,27878
20200218,5,을지로4가,6211,6317,20200221,12528
20200218,5,동대문역사문화공원,3473,3979,20200221,7452
20200218,5,청구,4417,4130,20200221,8547
20200218,5,신금호,6558,6713,20200221,13271
20200218,5,행당,8802,7918,20200221,16720
20200218,5,왕십리,4971,5519,20200221,10490
20200218,5,마장,5926,5729,20200221,11655
20200218,5,답십리,17634,16018,20200221,33652
20200218,5,장한평,19670,19661,20200221,39331
20200218,5,군자,11696,12768,20200221,24464
20200218,5,아차산,14238,13883,20200221,28121
20200218,5,광나루,13998,12343,20200221,26341
20200218,5,천호,19136,20003,20200221,39139
20200218,5,강동,21178,18822,20200221,40000
20200218,5,길동,7822,8404,20200221,16226
20200218,5,굽은다리,9608,9238,20200221,18846
20200218,5,명일,9060,9365,20200221,18425
20200218,5,고덕,9440,9603,20200221,19043
20200218,5,상일동,17177,14715,20200221,31892
20200218,5,둔촌동,8951,9147,20200221,18098
20200218,5,올림픽공원,4153,3717,20200221,7870
20200218,5,방이,7960,8182,20200221,16142
20200218,5,오금,3792,3874,20200221,7666
20200218,5,개롱,7465,7506,20200221,14971
20200218,5,거여,7932,7506,20200221,15438
20200218,5,마천,5266,5208,20200221,10474
20200219,5,방화,7377,6897,20200222,14274
20200219,5,개화산,6051,5827,20200222,11878
20200219,5,김포공항,7092,6629,20200222,13721
20200219,5,송정,7529,6953,20200222,14482
20200219,5,마곡,8338,7839,20200222,16177
20200219,5,발산,21346,21772,20200222,43118
20200219,5,우장산,15700,15402,20200222,31102
20200219,5,화곡,31546,29221,20200222,60767
20200219,5,까치산,31745,30161,20200222,61906
20200219,5,신정,14759,11411,20200222,26170
20200219,5,목동,19232,20978,20200222,40210
20200219,5,오목교,26315,27987,20200222,54302
20200219,5,양평,8036,7917,20200222,15953
20200219,5,영등포구청,4249,4323,20200222,8572
20200219,5,영등포시장,10187,10532,20200222,20719
20200219,5,신길,3848,4251,20200222,8099
20200219,5,여의도,29390,31234,20200222,60624
20200219,5,여의나루,8245,8498,20200222,16743
20200219,5,마포,15683,16265,20200222,31948
20200219,5,공덕,15874,17044,20200222,32918
20200219,5,애오개,7986,8068,20200222,16054
20200219,5,충정로,5293,5587,20200222,10880
20200219,5,서대문,19773,20534,20200222,40307
20200219,5,광화문,38244,40425,20200222,78669
20200219,5,종로3가,14440,13910,20200222,28350
20200219,5,을지로4가,6284,6550,20200222,12834
20200219,5,동대문역사문화공원,3492,4001,20200222,7493
20200219,5,청구,4588,4135,20200222,8723
20200219,5,신금호,6394,6555,20200222,12949
20200219,5,행당,8870,7833,20200222,16703
20200219,5,왕십리,4819,5179,20200222,9998
20200219,5,마장,5896,5558,20200222,11454
20200219,5,답십리,17710,16210,20200222,33920
20200219,5,장한평,20420,20360,20200222,40780
20200219,5,군자,11800,13055,20200222,24855
20200219,5,아차산,14643,14287,20200222,28930
20200219,5,광나루,14282,12521,20200222,26803
20200219,5,천호,19232,20055,20200222,39287
20200219,5,강동,21814,19045,20200222,40859
20200219,5,길동,7848,8429,20200222,16277
20200219,5,굽은다리,9912,9594,20200222,19506
20200219,5,명일,9009,9647,20200222,18656
20200219,5,고덕,9768,9903,20200222,19671
20200219,5,상일동,17574,14766,20200222,32340
20200219,5,둔촌동,8898,8948,20200222,17846
20200219,5,올림픽공원,4165,3717,20200222,7882
20200219,5,방이,7901,8306,20200222,16207
20200219,5,오금,3750,3894,20200222,7644
20200219,5,개롱,7481,7654,20200222,15135
20200219,5,거여,8301,7722,20200222,16023
20200219,5,마천,5348,5292,20200222,10640
20200220,5,방화,7314,6830,20200223,14144
20200220,5,개화산,5973,5695,20200223,11668
20200220,5,김포공항,7252,6609,20200223,13861
20200220,5,송정,7416,6756,20200223,14172
20200220,5,마곡,8218,7826,20200223,16044
20200220,5,발산,20833,20953,20200223,41786
20200220,5,우장산,15246,15088,20200223,30334
20200220,5,화곡,31185,28830,20200223,60015
20200220,5,까치산,31155,29657,20200223,60812
20200220,5,신정,14575,10977,20200223,25552
20200220,5,목동,19008,20766,20200223,39774
20200220,5,오목교,25273,27143,20200223,52416
20200220,5,양평,7881,7777,20200223,15658
20200220,5,영등포구청,4177,4305,20200223,8482
20200220,5,영등포시장,10060,10389,20200223,20449
20200220,5,신길,3807,4179,20200223,7986
20200220,5,여의도,29144,31102,20200223,60246
20200220,5,여의나루,8461,8996,20200223,17457
20200220,5,마포,15810,16183,20200223,31993
20200220,5,공덕,15483,16720,20200223,32203
20200220,5,애오개,7877,7877,20200223,15754
20200220,5,충정로,5069,5269,20200223,10338
20200220,5,서대문,19405,20194,20200223,39599
20200220,5,광화문,35969,38020,20200223,73989
20200220,5,종로3가,13737,13282,20200223,27019
20200220,5,을지로4가,6292,6355,20200223,12647
20200220,5,동대문역사문화공원,3357,3941,20200223,7298
20200220,5,청구,4383,4070,20200223,8453
20200220,5,신금호,6168,6212,20200223,12380
20200220,5,행당,8468,7486,20200223,15954
20200220,5,왕십리,4510,4981,20200223,9491
20200220,5,마장,5675,5373,20200223,11048
20200220,5,답십리,17068,15640,20200223,32708
20200220,5,장한평,20017,20079,20200223,40096
20200220,5,군자,11566,12766,20200223,24332
20200220,5,아차산,14307,14115,20200223,28422
20200220,5,광나루,13916,12365,20200223,26281
20200220,5,천호,19081,19901,20200223,38982
20200220,5,강동,21255,18634,20200223,39889
20200220,5,길동,7528,8033,20200223,15561
20200220,5,굽은다리,9611,9172,20200223,18783
20200220,5,명일,8849,9152,20200223,18001
20200220,5,고덕,9143,9199,20200223,18342
20200220,5,상일동,17308,14618,20200223,31926
20200220,5,둔촌동,8820,8668,20200223,17488
20200220,5,올림픽공원,4036,3706,20200223,7742
20200220,5,방이,7855,8014,20200223,15869
20200220,5,오금,3820,3877,20200223,7697
20200220,5,개롱,6893,7110,20200223,14003
20200220,5,거여,8129,7665,20200223,15794
20200220,5,마천,5277,5259,20200223,10536
20200221,5,방화,7082,6627,20200224,13709
20200221,5,개화산,5862,5574,20200224,11436
20200221,5,김포공항,7024,6311,20200224,13335
20200221,5,송정,7239,6654,20200224,13893
20200221,5,마곡,8186,7584,20200224,15770
20200221,5,발산,19893,20576,20200224,40469
20200221,5,우장산,14768,14447,20200224,29215
20200221,5,화곡,30669,28125,20200224,58794
20200221,5,까치산,30833,28839,20200224,59672
20200221,5,신정,14419,10922,20200224,25341
20200221,5,목동,18260,20104,20200224,38364
20200221,5,오목교,25085,27279,20200224,52364
20200221,5,양평,7745,7722,20200224,15467
20200221,5,영등포구청,4017,4055,20200224,8072
20200221,5,영등포시장,9916,10341,20200224,20257
20200221,5,신길,3822,4117,20200224,7939
20200221,5,여의도,28169,29643,20200224,57812
20200221,5,여의나루,8070,8065,20200224,16135
20200221,5,마포,15418,15926,20200224,31344
20200221,5,공덕,14927,16560,20200224,31487
20200221,5,애오개,7518,7569,20200224,15087
20200221,5,충정로,4951,4977,20200224,9928
20200221,5,서대문,18639,19142,20200224,37781
20200221,5,광화문,34530,36097,20200224,70627
20200221,5,종로3가,12716,12713,20200224,25429
20200221,5,을지로4가,5884,6180,20200224,12064
20200221,5,동대문역사문화공원,3334,3850,20200224,7184
20200221,5,청구,4298,3880,20200224,8178
20200221,5,신금호,6100,6092,20200224,12192
20200221,5,행당,8245,7207,20200224,15452
20200221,5,왕십리,4530,5247,20200224,9777
20200221,5,마장,5657,5386,20200224,11043
20200221,5,답십리,16897,15148,20200224,32045
20200221,5,장한평,19668,19745,20200224,39413
20200221,5,군자,11594,12587,20200224,24181
20200221,5,아차산,13959,13473,20200224,27432
20200221,5,광나루,14211,12163,20200224,26374
20200221,5,천호,18888,19939,20200224,38827
20200221,5,강동,20681,17936,20200224,38617
20200221,5,길동,7642,8242,20200224,15884
20200221,5,굽은다리,9518,8830,20200224,18348
20200221,5,명일,8586,8984,20200224,17570
20200221,5,고덕,9046,9032,20200224,18078
20200221,5,상일동,16833,13966,20200224,30799
20200221,5,둔촌동,8559,8693,20200224,17252
20200221,5,올림픽공원,3974,3426,20200224,7400
20200221,5,방이,7650,7820,20200224,15470
20200221,5,오금,3566,3556,20200224,7122
20200221,5,개롱,6681,6876,20200224,13557
20200221,5,거여,7915,7333,20200224,15248
20200221,5,마천,5267,5211,20200224,10478
20200222,5,방화,3965,3708,20200225,7673
20200222,5,개화산,3336,3212,20200225,6548
20200222,5,김포공항,5151,5011,20200225,10162
20200222,5,송정,4513,4423,20200225,8936
20200222,5,마곡,3230,3059,20200225,6289
20200222,5,발산,11995,12856,20200225,24851
20200222,5,우장산,8207,8163,20200225,16370
20200222,5,화곡,17905,16389,20200225,34294
20200222,5,까치산,18902,18064,20200225,36966
20200222,5,신정,7923,6339,20200225,14262
20200222,5,목동,10071,10501,20200225,20572
20200222,5,오목교,15418,16140,20200225,31558
20200222,5,양평,3148,2912,20200225,6060
20200222,5,영등포구청,1642,1694,20200225,3336
20200222,5,영등포시장,6954,7286,20200225,14240
20200222,5,신길,2045,2185,20200225,4230
20200222,5,여의도,7286,8027,20200225,15313
20200222,5,여의나루,4250,4373,20200225,8623
20200222,5,마포,6331,6326,20200225,12657
20200222,5,공덕,6639,7005,20200225,13644
20200222,5,애오개,3244,3139,20200225,6383
20200222,5,충정로,1691,1584,20200225,3275
20200222,5,서대문,6234,6050,20200225,12284
20200222,5,광화문,13899,14295,20200225,28194
20200222,5,종로3가,7767,7948,20200225,15715
20200222,5,을지로4가,2617,2955,20200225,5572
20200222,5,동대문역사문화공원,981,1177,20200225,2158
20200222,5,청구,2347,1971,20200225,4318
20200222,5,신금호,3432,3460,20200225,6892
20200222,5,행당,4657,4066,20200225,8723
20200222,5,왕십리,2848,3447,20200225,6295
20200222,5,마장,3382,3219,20200225,6601
20200222,5,답십리,9271,8692,20200225,17963
20200222,5,장한평,10268,10075,20200225,20343
20200222,5,군자,7345,8064,20200225,15409
20200222,5,아차산,9369,9005,20200225,18374
20200222,5,광나루,8659,7973,20200225,16632
20200222,5,천호,14603,14521,20200225,29124
20200222,5,강동,12899,11549,20200225,24448
20200222,5,길동,4783,5004,20200225,9787
20200222,5,굽은다리,6013,5652,20200225,11665
20200222,5,명일,4693,4623,20200225,9316
20200222,5,고덕,4660,4677,20200225,9337
20200222,5,상일동,8080,7274,20200225,15354
20200222,5,둔촌동,5204,5127,20200225,10331
20200222,5,올림픽공원,2048,1843,20200225,3891
20200222,5,방이,4598,4367,20200225,8965
20200222,5,오금,2104,2006,20200225,4110
20200222,5,개롱,3977,4103,20200225,8080
20200222,5,거여,4578,4294,20200225,8872
20200222,5,마천,3545,3503,20200225,7048
20200223,5,방화,2770,2734,20200226,5504
20200223,5,개화산,2269,2276,20200226,4545
20200223,5,김포공항,4327,3824,20200226,8151
20200223,5,송정,3049,2984,20200226,6033
20200223,5,마곡,2022,1976,20200226,3998
20200223,5,발산,6845,7273,20200226,14118
20200223,5,우장산,5374,5410,20200226,10784
20200223,5,화곡,11553,10935,20200226,22488
20200223,5,까치산,13004,12506,20200226,25510
20200223,5,신정,4965,4467,20200226,9432
20200223,5,목동,6397,6658,20200226,13055
20200223,5,오목교,9871,10167,20200226,20038
20200223,5,양평,2011,2061,20200226,4072
20200223,5,영등포구청,1088,1015,20200226,2103
20200223,5,영등포시장,3532,3801,20200226,7333
20200223,5,신길,1224,1432,20200226,2656
20200223,5,여의도,4634,4976,20200226,9610
20200223,5,여의나루,3048,3135,20200226,6183
20200223,5,마포,3731,3743,20200226,7474
20200223,5,공덕,3582,3700,20200226,7282
20200223,5,애오개,2276,2360,20200226,4636
20200223,5,충정로,1054,1105,20200226,2159
20200223,5,서대문,3884,3791,20200226,7675
20200223,5,광화문,9266,9720,20200226,18986
20200223,5,종로3가,5336,4856,20200226,10192
20200223,5,을지로4가,1016,1087,20200226,2103
20200223,5,동대문역사문화공원,614,733,20200226,1347
20200223,5,청구,1508,1324,20200226,2832
20200223,5,신금호,2255,2385,20200226,4640
20200223,5,행당,3191,2976,20200226,6167
20200223,5,왕십리,1940,2214,20200226,4154
20200223,5,마장,2253,2245,20200226,4498
20200223,5,답십리,5959,5548,20200226,11507
20200223,5,장한평,6156,6098,20200226,12254
20200223,5,군자,4717,5286,20200226,10003
20200223,5,아차산,7511,7396,20200226,14907
20200223,5,광나루,6657,6622,20200226,13279
20200223,5,천호,9599,9237,20200226,18836
20200223,5,강동,8193,7677,20200226,15870
20200223,5,길동,3171,3214,20200226,6385
20200223,5,굽은다리,3921,3745,20200226,7666
20200223,5,명일,3065,3181,20200226,6246
20200223,5,고덕,2950,2974,20200226,5924
20200223,5,상일동,5097,4832,20200226,9929
20200223,5,둔촌동,3663,3701,20200226,7364
20200223,5,올림픽공원,1376,1319,20200226,2695
20200223,5,방이,3153,3030,20200226,6183
20200223,5,오금,1202,1231,20200226,2433
20200223,5,개롱,2360,2596,20200226,4956
20200223,5,거여,2925,2818,20200226,5743
20200223,5,마천,2470,2761,20200226,5231
20200224,5,방화,6071,5638,20200227,11709
20200224,5,개화산,5314,5086,20200227,10400
20200224,5,김포공항,5532,4912,20200227,10444
20200224,5,송정,6307,5700,20200227,12007
20200224,5,마곡,7256,6733,20200227,13989
20200224,5,발산,17024,17365,20200227,34389
20200224,5,우장산,12546,12434,20200227,24980
20200224,5,화곡,27155,25196,20200227,52351
20200224,5,까치산,27727,26474,20200227,54201
20200224,5,신정,12876,9715,20200227,22591
20200224,5,목동,15950,17866,20200227,33816
20200224,5,오목교,20738,22566,20200227,43304
20200224,5,양평,7207,7181,20200227,14388
20200224,5,영등포구청,3802,3860,20200227,7662
20200224,5,영등포시장,8461,8692,20200227,17153
20200224,5,신길,3592,3901,20200227,7493
20200224,5,여의도,25929,27147,20200227,53076
20200224,5,여의나루,7362,7668,20200227,15030
20200224,5,마포,13282,13602,20200227,26884
20200224,5,공덕,13369,14367,20200227,27736
20200224,5,애오개,6609,6708,20200227,13317
20200224,5,충정로,4457,4644,20200227,9101
20200224,5,서대문,17110,17485,20200227,34595
20200224,5,광화문,30201,31831,20200227,62032
20200224,5,종로3가,10299,10247,20200227,20546
20200224,5,을지로4가,5531,5619,20200227,11150
20200224,5,동대문역사문화공원,3129,3527,20200227,6656
20200224,5,청구,3908,3445,20200227,7353
20200224,5,신금호,5297,5567,20200227,10864
20200224,5,행당,7443,6691,20200227,14134
20200224,5,왕십리,3954,4202,20200227,8156
20200224,5,마장,4945,4667,20200227,9612
20200224,5,답십리,15434,14036,20200227,29470
20200224,5,장한평,16997,16797,20200227,33794
20200224,5,군자,9776,10577,20200227,20353
20200224,5,아차산,12109,11913,20200227,24022
20200224,5,광나루,11340,10243,20200227,21583
20200224,5,천호,14934,15885,20200227,30819
20200224,5,강동,17979,15804,20200227,33783
20200224,5,길동,6392,6867,20200227,13259
20200224,5,굽은다리,7923,7666,20200227,15589
20200224,5,명일,7069,7504,20200227,14573
20200224,5,고덕,7413,7707,20200227,15120
20200224,5,상일동,14911,12665,20200227,27576
20200224,5,둔촌동,7161,7258,20200227,14419
20200224,5,올림픽공원,3191,2836,20200227,6027
20200224,5,방이,6054,6249,20200227,12303
20200224,5,오금,3295,3228,20200227,6523
20200224,5,개롱,5508,5766,20200227,11274
20200224,5,거여,6742,6371,20200227,13113
20200224,5,마천,4552,4609,20200227,9161
20200225,5,방화,5526,5301,20200228,10827
20200225,5,개화산,4836,4663,20200228,9499
20200225,5,김포공항,5030,4519,20200228,9549
20200225,5,송정,5871,5276,20200228,11147
20200225,5,마곡,6675,6346,20200228,13021
20200225,5,발산,15808,16015,20200228,31823
20200225,5,우장산,11213,11242,20200228,22455
20200225,5,화곡,25079,23309,20200228,48388
20200225,5,까치산,25740,24613,20200228,50353
20200225,5,신정,12089,9166,20200228,21255
20200225,5,목동,14766,16399,20200228,31165
20200225,5,오목교,18965,20487,20200228,39452
20200225,5,양평,6898,6900,20200228,13798
20200225,5,영등포구청,3622,3616,20200228,7238
20200225,5,영등포시장,7769,8020,20200228,15789
20200225,5,신길,3397,3718,20200228,7115
20200225,5,여의도,24703,25967,20200228,50670
20200225,5,여의나루,6423,6792,20200228,13215
20200225,5,마포,12582,12965,20200228,25547
20200225,5,공덕,12485,13500,20200228,25985
20200225,5,애오개,6412,6429,20200228,12841
20200225,5,충정로,4245,4332,20200228,8577
20200225,5,서대문,16520,17161,20200228,33681
20200225,5,광화문,29541,31513,20200228,61054
20200225,5,종로3가,9455,9255,20200228,18710
20200225,5,을지로4가,5269,5395,20200228,10664
20200225,5,동대문역사문화공원,3119,3512,20200228,6631
20200225,5,청구,3684,3311,20200228,6995
20200225,5,신금호,5165,5317,20200228,10482
20200225,5,행당,6883,6133,20200228,13016
20200225,5,왕십리,3694,4066,20200228,7760
20200225,5,마장,4710,4467,20200228,9177
20200225,5,답십리,14108,12996,20200228,27104
20200225,5,장한평,15979,15898,20200228,31877
20200225,5,군자,9238,9835,20200228,19073
20200225,5,아차산,10749,10777,20200228,21526
20200225,5,광나루,10797,9506,20200228,20303
20200225,5,천호,13697,14379,20200228,28076
20200225,5,강동,16553,14544,20200228,31097
20200225,5,길동,5807,6251,20200228,12058
20200225,5,굽은다리,7046,6751,20200228,13797
20200225,5,명일,6460,6632,20200228,13092
20200225,5,고덕,6449,6687,20200228,13136
20200225,5,상일동,13713,11743,20200228,25456
20200225,5,둔촌동,6526,6517,20200228,13043
20200225,5,올림픽공원,2696,2366,20200228,5062
20200225,5,방이,5474,5673,20200228,11147
20200225,5,오금,3020,3053,20200228,6073
20200225,5,개롱,5110,5308,20200228,10418
20200225,5,거여,6199,5927,20200228,12126
20200225,5,마천,4061,4068,20200228,8129
20200226,5,방화,5664,5305,20200229,10969
20200226,5,개화산,4967,4788,20200229,9755
20200226,5,김포공항,4924,4398,20200229,9322
20200226,5,송정,5895,5205,20200229,11100
20200226,5,마곡,6709,6256,20200229,12965
20200226,5,발산,15779,16177,20200229,31956
20200226,5,우장산,11219,11006,20200229,22225
20200226,5,화곡,25039,23442,20200229,48481
20200226,5,까치산,26121,24829,20200229,50950
20200226,5,신정,12188,9213,20200229,21401
20200226,5,목동,14485,16362,20200229,30847
20200226,5,오목교,18623,20252,20200229,38875
20200226,5,양평,6704,6709,20200229,13413
20200226,5,영등포구청,3504,3685,20200229,7189
20200226,5,영등포시장,7921,8132,20200229,16053
20200226,5,신길,3307,3639,20200229,6946
20200226,5,여의도,24440,25405,20200229,49845
20200226,5,여의나루,6841,7048,20200229,13889
20200226,5,마포,12236,12708,20200229,24944
20200226,5,공덕,12336,13074,20200229,25410
20200226,5,애오개,6321,6440,20200229,12761
20200226,5,충정로,4160,4336,20200229,8496
20200226,5,서대문,16058,16668,20200229,32726
20200226,5,광화문,28509,30060,20200229,58569
20200226,5,종로3가,9718,9628,20200229,19346
20200226,5,을지로4가,5403,5451,20200229,10854
20200226,5,동대문역사문화공원,3068,3401,20200229,6469
20200226,5,청구,3651,3330,20200229,6981
20200226,5,신금호,5115,5244,20200229,10359
20200226,5,행당,6770,6005,20200229,12775
20200226,5,왕십리,3700,4046,20200229,7746
20200226,5,마장,4546,4342,20200229,8888
20200226,5,답십리,14165,12887,20200229,27052
20200226,5,장한평,15945,15928,20200229,31873
20200226,5,군자,9433,9964,20200229,19397
20200226,5,아차산,11304,11221,20200229,22525
20200226,5,광나루,10392,9204,20200229,19596
20200226,5,천호,13987,14859,20200229,28846
20200226,5,강동,16327,14379,20200229,30706
20200226,5,길동,5756,6242,20200229,11998
20200226,5,굽은다리,6806,6478,20200229,13284
20200226,5,명일,5919,6123,20200229,12042
20200226,5,고덕,6196,6433,20200229,12629
20200226,5,상일동,13492,11538,20200229,25030
20200226,5,둔촌동,6388,6492,20200229,12880
20200226,5,올림픽공원,2687,2282,20200229,4969
20200226,5,방이,5166,5365,20200229,10531
20200226,5,오금,2973,2967,20200229,5940
20200226,5,개롱,5007,5256,20200229,10263
20200226,5,거여,6068,5683,20200229,11751
20200226,5,마천,4117,4178,20200229,8295
20200227,5,방화,5574,5310,20200301,10884
20200227,5,개화산,4799,4677,20200301,9476
20200227,5,김포공항,4731,4236,20200301,8967
20200227,5,송정,5743,5302,20200301,11045
20200227,5,마곡,6615,6303,20200301,12918
20200227,5,발산,15209,15509,20200301,30718
20200227,5,우장산,10697,10676,20200301,21373
20200227,5,화곡,24568,22594,20200301,47162
20200227,5,까치산,25379,24298,20200301,49677
20200227,5,신정,11877,8931,20200301,20808
20200227,5,목동,14134,15722,20200301,29856
20200227,5,오목교,17940,19430,20200301,37370
20200227,5,양평,6549,6579,20200301,13128
20200227,5,영등포구청,3479,3548,20200301,7027
20200227,5,영등포시장,7670,8021,20200301,15691
20200227,5,신길,3216,3579,20200301,6795
20200227,5,여의도,23022,24343,20200301,47365
20200227,5,여의나루,6791,6902,20200301,13693
20200227,5,마포,12049,12349,20200301,24398
20200227,5,공덕,11978,12876,20200301,24854
20200227,5,애오개,6208,6190,20200301,12398
20200227,5,충정로,4026,4124,20200301,8150
20200227,5,서대문,15594,16112,20200301,31706
20200227,5,광화문,27106,28586,20200301,55692
20200227,5,종로3가,9262,9130,20200301,18392
20200227,5,을지로4가,5313,5419,20200301,10732
20200227,5,동대문역사문화공원,2936,3235,20200301,6171
20200227,5,청구,3628,3293,20200301,6921
20200227,5,신금호,4986,5118,20200301,10104
20200227,5,행당,6690,5984,20200301,12674
20200227,5,왕십리,3622,4004,20200301,7626
20200227,5,마장,4553,4299,20200301,8852
20200227,5,답십리,13849,12545,20200301,26394
20200227,5,장한평,15843,15646,20200301,31489
20200227,5,군자,9101,9733,20200301,18834
20200227,5,아차산,11243,11164,20200301,22407
20200227,5,광나루,10338,9212,20200301,19550
20200227,5,천호,13584,14543,20200301,28127
20200227,5,강동,16041,14021,20200301,30062
20200227,5,길동,5670,5960,20200301,11630
20200227,5,굽은다리,6705,6383,20200301,13088
20200227,5,명일,5814,5964,20200301,11778
20200227,5,고덕,6114,6262,20200301,12376
20200227,5,상일동,13330,11298,20200301,24628
20200227,5,둔촌동,6279,6394,20200301,12673
20200227,5,올림픽공원,2670,2286,20200301,4956
20200227,5,방이,5102,5274,20200301,10376
20200227,5,오금,2927,2964,20200301,5891
20200227,5,개롱,4819,5010,20200301,9829
20200227,5,거여,5964,5641,20200301,11605
20200227,5,마천,4130,4165,20200301,8295
20200228,5,방화,5277,4967,20200302,10244
20200228,5,개화산,4620,4366,20200302,8986
20200228,5,김포공항,4658,4320,20200302,8978
20200228,5,송정,5561,5189,20200302,10750
20200228,5,마곡,6315,5741,20200302,12056
20200228,5,발산,14226,14937,20200302,29163
20200228,5,우장산,10444,10275,20200302,20719
20200228,5,화곡,23643,21583,20200302,45226
20200228,5,까치산,24584,23367,20200302,47951
20200228,5,신정,11563,8666,20200302,20229
20200228,5,목동,13630,15167,20200302,28797
20200228,5,오목교,18412,19738,20200302,38150
20200228,5,양평,6343,6375,20200302,12718
20200228,5,영등포구청,3243,3319,20200302,6562
20200228,5,영등포시장,7428,7573,20200302,15001
20200228,5,신길,3069,3383,20200302,6452
20200228,5,여의도,21062,22485,20200302,43547
20200228,5,여의나루,3869,4183,20200302,8052
20200228,5,마포,11757,12111,20200302,23868
20200228,5,공덕,11558,12644,20200302,24202
20200228,5,애오개,5882,5993,20200302,11875
20200228,5,충정로,3710,3838,20200302,7548
20200228,5,서대문,15039,15325,20200302,30364
20200228,5,광화문,24993,26116,20200302,51109
20200228,5,종로3가,8777,8985,20200302,17762
20200228,5,을지로4가,4980,5134,20200302,10114
20200228,5,동대문역사문화공원,2575,2899,20200302,5474
20200228,5,청구,3486,3093,20200302,6579
20200228,5,신금호,4853,4939,20200302,9792
20200228,5,행당,6479,5721,20200302,12200
20200228,5,왕십리,3366,3794,20200302,7160
20200228,5,마장,4430,4164,20200302,8594
20200228,5,답십리,13265,12164,20200302,25429
20200228,5,장한평,15177,15139,20200302,30316
20200228,5,군자,8966,9679,20200302,18645
20200228,5,아차산,10553,10283,20200302,20836
20200228,5,광나루,9735,8523,20200302,18258
20200228,5,천호,13255,14194,20200302,27449
20200228,5,강동,15558,13534,20200302,29092
20200228,5,길동,5601,6024,20200302,11625
20200228,5,굽은다리,6572,6379,20200302,12951
20200228,5,명일,5656,5813,20200302,11469
20200228,5,고덕,5933,6034,20200302,11967
20200228,5,상일동,12926,10987,20200302,23913
20200228,5,둔촌동,6228,6252,20200302,12480
20200228,5,올림픽공원,2502,2092,20200302,4594
20200228,5,방이,5020,5256,20200302,10276
20200228,5,오금,2903,2851,20200302,5754
20200228,5,개롱,4815,4894,20200302,9709
20200228,5,거여,5790,5414,20200302,11204
20200228,5,마천,4015,3936,20200302,7951
20200229,5,장한평,7175,7127,20200303,14302
20200229,5,군자,5307,5906,20200303,11213
20200229,5,아차산,7185,6993,20200303,14178
20200229,5,광나루,5780,5355,20200303,11135
20200229,5,천호,9944,9919,20200303,19863
20200229,5,강동,8475,7570,20200303,16045
20200229,5,길동,3406,3536,20200303,6942
20200229,5,굽은다리,4024,3613,20200303,7637
20200229,5,명일,2778,2723,20200303,5501
20200229,5,고덕,2973,2954,20200303,5927
20200229,5,상일동,6104,5397,20200303,11501
20200229,5,둔촌동,3559,3526,20200303,7085
20200229,5,올림픽공원,1424,1309,20200303,2733
20200229,5,방이,2618,2672,20200303,5290
20200229,5,오금,1234,1246,20200303,2480
20200229,5,개롱,2475,2612,20200303,5087
20200229,5,거여,3220,3122,20200303,6342
20200229,5,마천,2704,2644,20200303,5348
20200229,5,방화,3036,2924,20200303,5960
20200229,5,개화산,2666,2664,20200303,5330
20200229,5,김포공항,3561,3464,20200303,7025
20200229,5,송정,3651,3560,20200303,7211
20200229,5,마곡,2533,2424,20200303,4957
20200229,5,발산,7800,8285,20200303,16085
20200229,5,우장산,5864,5835,20200303,11699
20200229,5,화곡,13600,12332,20200303,25932
20200229,5,까치산,14829,14112,20200303,28941
20200229,5,신정,5984,4846,20200303,10830
20200229,5,목동,7087,7544,20200303,14631
20200229,5,오목교,11232,11866,20200303,23098
20200229,5,양평,2248,2250,20200303,4498
20200229,5,영등포구청,1222,1235,20200303,2457
20200229,5,영등포시장,4238,4430,20200303,8668
20200229,5,신길,1537,1600,20200303,3137
20200229,5,여의도,4538,4903,20200303,9441
20200229,5,여의나루,2872,2829,20200303,5701
20200229,5,마포,4500,4491,20200303,8991
20200229,5,공덕,4425,4802,20200303,9227
20200229,5,애오개,2414,2346,20200303,4760
20200229,5,충정로,1200,1118,20200303,2318
20200229,5,서대문,4437,4331,20200303,8768
20200229,5,광화문,7102,7273,20200303,14375
20200229,5,종로3가,5133,5487,20200303,10620
20200229,5,을지로4가,1987,2182,20200303,4169
20200229,5,동대문역사문화공원,678,821,20200303,1499
20200229,5,청구,1831,1571,20200303,3402
20200229,5,신금호,2661,2615,20200303,5276
20200229,5,행당,3217,2744,20200303,5961
20200229,5,왕십리,2175,2623,20200303,4798
20200229,5,마장,2531,2415,20200303,4946
20200229,5,답십리,6961,6437,20200303,13398
20200301,5,방화,2149,2068,20200304,4217
20200301,5,개화산,1808,1891,20200304,3699
20200301,5,김포공항,3127,2941,20200304,6068
20200301,5,송정,2303,2322,20200304,4625
20200301,5,마곡,1450,1418,20200304,2868
20200301,5,발산,4784,4942,20200304,9726
20200301,5,우장산,3633,3628,20200304,7261
20200301,5,화곡,8530,7914,20200304,16444
20200301,5,까치산,9938,9605,20200304,19543
20200301,5,신정,3770,3218,20200304,6988
20200301,5,목동,4311,4453,20200304,8764
20200301,5,오목교,7824,8258,20200304,16082
20200301,5,양평,1440,1487,20200304,2927
20200301,5,영등포구청,803,793,20200304,1596
20200301,5,영등포시장,2525,2721,20200304,5246
20200301,5,신길,920,1054,20200304,1974
20200301,5,여의도,2908,3058,20200304,5966
20200301,5,여의나루,1591,1683,20200304,3274
20200301,5,마포,2613,2639,20200304,5252
20200301,5,공덕,2451,2495,20200304,4946
20200301,5,애오개,1579,1595,20200304,3174
20200301,5,충정로,793,825,20200304,1618
20200301,5,서대문,2978,2836,20200304,5814
20200301,5,광화문,4787,4719,20200304,9506
20200301,5,종로3가,3487,3365,20200304,6852
20200301,5,을지로4가,654,733,20200304,1387
20200301,5,동대문역사문화공원,402,485,20200304,887
20200301,5,청구,1058,979,20200304,2037
20200301,5,신금호,1692,1775,20200304,3467
20200301,5,행당,2060,1887,20200304,3947
20200301,5,왕십리,1358,1588,20200304,2946
20200301,5,마장,1602,1571,20200304,3173
20200301,5,답십리,4359,4056,20200304,8415
20200301,5,장한평,4377,4261,20200304,8638
20200301,5,군자,3557,3704,20200304,7261
20200301,5,아차산,5554,5518,20200304,11072
20200301,5,광나루,4114,4077,20200304,8191
20200301,5,천호,6827,6636,20200304,13463
20200301,5,강동,5494,5131,20200304,10625
20200301,5,길동,2222,2334,20200304,4556
20200301,5,굽은다리,2589,2500,20200304,5089
20200301,5,명일,1721,1741,20200304,3462
20200301,5,고덕,1938,1896,20200304,3834
20200301,5,상일동,3727,3585,20200304,7312
20200301,5,둔촌동,2237,2314,20200304,4551
20200301,5,올림픽공원,895,819,20200304,1714
20200301,5,방이,1751,1731,20200304,3482
20200301,5,오금,810,776,20200304,1586
20200301,5,개롱,1569,1740,20200304,3309
20200301,5,거여,2019,1948,20200304,3967
20200301,5,마천,1793,2091,20200304,3884
20200302,5,방화,5459,5201,20200305,10660
20200302,5,개화산,4546,4324,20200305,8870
20200302,5,김포공항,4394,4309,20200305,8703
20200302,5,송정,5673,5228,20200305,10901
20200302,5,마곡,6451,6056,20200305,12507
20200302,5,발산,14367,14608,20200305,28975
20200302,5,우장산,10752,10820,20200305,21572
20200302,5,화곡,24156,22359,20200305,46515
20200302,5,까치산,24673,23739,20200305,48412
20200302,5,신정,11376,8745,20200305,20121
20200302,5,목동,13712,15347,20200305,29059
20200302,5,오목교,19286,20380,20200305,39666
20200302,5,양평,6282,6360,20200305,12642
20200302,5,영등포구청,3406,3367,20200305,6773
20200302,5,영등포시장,7483,7710,20200305,15193
20200302,5,신길,3036,3424,20200305,6460
20200302,5,여의도,21415,22342,20200305,43757
20200302,5,여의나루,5392,5589,20200305,10981
20200302,5,마포,11529,11946,20200305,23475
20200302,5,공덕,11346,12153,20200305,23499
20200302,5,애오개,5810,5881,20200305,11691
20200302,5,충정로,3813,3897,20200305,7710
20200302,5,서대문,14754,15009,20200305,29763
20200302,5,광화문,24380,25606,20200305,49986
20200302,5,종로3가,8210,8142,20200305,16352
20200302,5,을지로4가,5050,5162,20200305,10212
20200302,5,동대문역사문화공원,2429,2732,20200305,5161
20200302,5,청구,3495,3040,20200305,6535
20200302,5,신금호,4783,5002,20200305,9785
20200302,5,행당,6321,5679,20200305,12000
20200302,5,왕십리,3559,3864,20200305,7423
20200302,5,마장,4487,4248,20200305,8735
20200302,5,답십리,13341,12242,20200305,25583
20200302,5,장한평,14873,14855,20200305,29728
20200302,5,군자,8842,9562,20200305,18404
20200302,5,아차산,10826,10540,20200305,21366
20200302,5,광나루,9895,8797,20200305,18692
20200302,5,천호,13090,13893,20200305,26983
20200302,5,강동,15587,13619,20200305,29206
20200302,5,길동,5650,5996,20200305,11646
20200302,5,굽은다리,6696,6370,20200305,13066
20200302,5,명일,5742,6038,20200305,11780
20200302,5,고덕,6122,6424,20200305,12546
20200302,5,상일동,13152,11338,20200305,24490
20200302,5,둔촌동,6259,6355,20200305,12614
20200302,5,올림픽공원,2629,2281,20200305,4910
20200302,5,방이,5128,5342,20200305,10470
20200302,5,오금,2975,3037,20200305,6012
20200302,5,개롱,4813,5000,20200305,9813
20200302,5,거여,5885,5636,20200305,11521
20200302,5,마천,4091,4030,20200305,8121
20200303,5,방화,5457,5111,20200306,10568
20200303,5,개화산,4638,4474,20200306,9112
20200303,5,김포공항,4372,4183,20200306,8555
20200303,5,송정,5536,5184,20200306,10720
20200303,5,마곡,6382,6075,20200306,12457
20200303,5,발산,14288,14707,20200306,28995
20200303,5,우장산,10676,10648,20200306,21324
20200303,5,화곡,23858,22224,20200306,46082
20200303,5,까치산,24618,23502,20200306,48120
20200303,5,신정,11202,8760,20200306,19962
20200303,5,목동,13751,15302,20200306,29053
20200303,5,오목교,19341,20586,20200306,39927
20200303,5,양평,6304,6310,20200306,12614
20200303,5,영등포구청,3374,3385,20200306,6759
20200303,5,영등포시장,7287,7510,20200306,14797
20200303,5,신길,3070,3459,20200306,6529
20200303,5,여의도,21120,22318,20200306,43438
20200303,5,여의나루,5421,5760,20200306,11181
20200303,5,마포,11647,12053,20200306,23700
20200303,5,공덕,11568,12387,20200306,23955
20200303,5,애오개,5864,5924,20200306,11788
20200303,5,충정로,3736,3886,20200306,7622
20200303,5,서대문,14640,15018,20200306,29658
20200303,5,광화문,25104,26154,20200306,51258
20200303,5,종로3가,8062,8126,20200306,16188
20200303,5,을지로4가,5065,5192,20200306,10257
20200303,5,동대문역사문화공원,2396,2709,20200306,5105
20200303,5,청구,3319,3003,20200306,6322
20200303,5,신금호,4848,4992,20200306,9840
20200303,5,행당,6344,5675,20200306,12019
20200303,5,왕십리,3479,3873,20200306,7352
20200303,5,마장,4442,4223,20200306,8665
20200303,5,답십리,13304,12238,20200306,25542
20200303,5,장한평,14932,14884,20200306,29816
20200303,5,군자,9087,9750,20200306,18837
20200303,5,아차산,10823,10684,20200306,21507
20200303,5,광나루,9998,9036,20200306,19034
20200303,5,천호,13421,14092,20200306,27513
20200303,5,강동,15591,13770,20200306,29361
20200303,5,길동,5624,6002,20200306,11626
20200303,5,굽은다리,6699,6405,20200306,13104
20200303,5,명일,5766,6038,20200306,11804
20200303,5,고덕,6189,6395,20200306,12584
20200303,5,상일동,13229,11474,20200306,24703
20200303,5,둔촌동,6236,6286,20200306,12522
20200303,5,올림픽공원,2701,2356,20200306,5057
20200303,5,방이,5216,5374,20200306,10590
20200303,5,오금,2919,2932,20200306,5851
20200303,5,개롱,4812,5009,20200306,9821
20200303,5,거여,5953,5673,20200306,11626
20200303,5,마천,4215,4138,20200306,8353
20200304,5,방화,5355,5128,20200307,10483
20200304,5,개화산,4586,4427,20200307,9013
20200304,5,김포공항,4374,4162,20200307,8536
20200304,5,송정,5509,5029,20200307,10538
20200304,5,마곡,6316,5976,20200307,12292
20200304,5,발산,14545,14913,20200307,29458
20200304,5,우장산,10516,10482,20200307,20998
20200304,5,화곡,23711,22078,20200307,45789
20200304,5,까치산,24573,23526,20200307,48099
20200304,5,신정,11236,8770,20200307,20006
20200304,5,목동,13666,15311,20200307,28977
20200304,5,오목교,17513,18677,20200307,36190
20200304,5,양평,6247,6391,20200307,12638
20200304,5,영등포구청,3363,3457,20200307,6820
20200304,5,영등포시장,7245,7406,20200307,14651
20200304,5,신길,3016,3415,20200307,6431
20200304,5,여의도,21570,22216,20200307,43786
20200304,5,여의나루,4985,5260,20200307,10245
20200304,5,마포,11628,12073,20200307,23701
20200304,5,공덕,11562,12228,20200307,23790
20200304,5,애오개,5786,5895,20200307,11681
20200304,5,충정로,3805,3938,20200307,7743
20200304,5,서대문,14685,15087,20200307,29772
20200304,5,광화문,25017,26061,20200307,51078
20200304,5,종로3가,8283,8162,20200307,16445
20200304,5,을지로4가,4971,5157,20200307,10128
20200304,5,동대문역사문화공원,2444,2729,20200307,5173
20200304,5,청구,3374,3028,20200307,6402
20200304,5,신금호,4701,4950,20200307,9651
20200304,5,행당,6241,5740,20200307,11981
20200304,5,왕십리,3452,3616,20200307,7068
20200304,5,마장,4359,4193,20200307,8552
20200304,5,답십리,13168,12017,20200307,25185
20200304,5,장한평,14745,14785,20200307,29530
20200304,5,군자,8882,9602,20200307,18484
20200304,5,아차산,10658,10556,20200307,21214
20200304,5,광나루,9781,8668,20200307,18449
20200304,5,천호,13069,13845,20200307,26914
20200304,5,강동,15652,13841,20200307,29493
20200304,5,길동,5668,6114,20200307,11782
20200304,5,굽은다리,6812,6452,20200307,13264
20200304,5,명일,5761,6058,20200307,11819
20200304,5,고덕,6096,6378,20200307,12474
20200304,5,상일동,13272,11358,20200307,24630
20200304,5,둔촌동,6215,6305,20200307,12520
20200304,5,올림픽공원,2686,2257,20200307,4943
20200304,5,방이,5155,5379,20200307,10534
20200304,5,오금,2759,2844,20200307,5603
20200304,5,개롱,4789,5058,20200307,9847
20200304,5,거여,5878,5573,20200307,11451
20200304,5,마천,4028,4094,20200307,8122
20200305,5,방화,5379,5105,20200308,10484
20200305,5,개화산,4666,4447,20200308,9113
20200305,5,김포공항,4631,4225,20200308,8856
20200305,5,송정,5638,5177,20200308,10815
20200305,5,마곡,6402,5999,20200308,12401
20200305,5,발산,14518,15060,20200308,29578
20200305,5,우장산,10580,10595,20200308,21175
20200305,5,화곡,23941,22234,20200308,46175
20200305,5,까치산,24661,23634,20200308,48295
20200305,5,신정,11351,8618,20200308,19969
20200305,5,목동,13675,15371,20200308,29046
20200305,5,오목교,17737,18912,20200308,36649
20200305,5,양평,6182,6254,20200308,12436
20200305,5,영등포구청,3254,3356,20200308,6610
20200305,5,영등포시장,7265,7462,20200308,14727
20200305,5,신길,3054,3386,20200308,6440
20200305,5,여의도,21459,22519,20200308,43978
20200305,5,여의나루,5211,5482,20200308,10693
20200305,5,마포,11546,11960,20200308,23506
20200305,5,공덕,11306,12096,20200308,23402
20200305,5,애오개,5714,5694,20200308,11408
20200305,5,충정로,3664,3731,20200308,7395
20200305,5,서대문,14538,14772,20200308,29310
20200305,5,광화문,24845,26200,20200308,51045
20200305,5,종로3가,8265,8303,20200308,16568
20200305,5,을지로4가,4853,5039,20200308,9892
20200305,5,동대문역사문화공원,2433,2688,20200308,5121
20200305,5,청구,3346,3062,20200308,6408
20200305,5,신금호,4821,4908,20200308,9729
20200305,5,행당,6244,5541,20200308,11785
20200305,5,왕십리,3432,3801,20200308,7233
20200305,5,마장,4286,4087,20200308,8373
20200305,5,답십리,13066,11990,20200308,25056
20200305,5,장한평,14865,14792,20200308,29657
20200305,5,군자,8863,9615,20200308,18478
20200305,5,아차산,10899,10751,20200308,21650
20200305,5,광나루,10003,8926,20200308,18929
20200305,5,천호,13292,14091,20200308,27383
20200305,5,강동,15629,13863,20200308,29492
20200305,5,길동,5700,5964,20200308,11664
20200305,5,굽은다리,6803,6542,20200308,13345
20200305,5,명일,5836,6002,20200308,11838
20200305,5,고덕,6263,6460,20200308,12723
20200305,5,상일동,13385,11306,20200308,24691
20200305,5,둔촌동,6237,6374,20200308,12611
20200305,5,올림픽공원,2743,2348,20200308,5091
20200305,5,방이,5359,5371,20200308,10730
20200305,5,오금,2960,2936,20200308,5896
20200305,5,개롱,4765,4969,20200308,9734
20200305,5,거여,5922,5541,20200308,11463
20200305,5,마천,4140,4156,20200308,8296
20200306,5,방화,5547,5126,20200309,10673
20200306,5,개화산,4628,4493,20200309,9121
20200306,5,김포공항,4877,4603,20200309,9480
20200306,5,송정,5904,5332,20200309,11236
20200306,5,마곡,6563,6089,20200309,12652
20200306,5,발산,14500,15371,20200309,29871
20200306,5,우장산,10868,10734,20200309,21602
20200306,5,화곡,24597,22348,20200309,46945
20200306,5,까치산,25245,23823,20200309,49068
20200306,5,신정,11694,8712,20200309,20406
20200306,5,목동,14047,15589,20200309,29636
20200306,5,오목교,18428,19878,20200309,38306
20200306,5,양평,6397,6271,20200309,12668
20200306,5,영등포구청,3319,3364,20200309,6683
20200306,5,영등포시장,7471,7743,20200309,15214
20200306,5,신길,3106,3318,20200309,6424
20200306,5,여의도,21146,22389,20200309,43535
20200306,5,여의나루,5688,5712,20200309,11400
20200306,5,마포,11646,12181,20200309,23827
20200306,5,공덕,11593,12691,20200309,24284
20200306,5,애오개,5920,5855,20200309,11775
20200306,5,충정로,3630,3665,20200309,7295
20200306,5,서대문,14389,14921,20200309,29310
20200306,5,광화문,24579,26015,20200309,50594
20200306,5,종로3가,8541,8980,20200309,17521
20200306,5,을지로4가,4933,5117,20200309,10050
20200306,5,동대문역사문화공원,2353,2690,20200309,5043
20200306,5,청구,3483,3104,20200309,6587
20200306,5,신금호,4895,4857,20200309,9752
20200306,5,행당,6454,5693,20200309,12147
20200306,5,왕십리,3707,4161,20200309,7868
20200306,5,마장,4527,4304,20200309,8831
20200306,5,답십리,13381,12262,20200309,25643
20200306,5,장한평,15158,15211,20200309,30369
20200306,5,군자,9406,10254,20200309,19660
20200306,5,아차산,11160,10966,20200309,22126
20200306,5,광나루,10336,9031,20200309,19367
20200306,5,천호,14322,15360,20200309,29682
20200306,5,강동,15898,13905,20200309,29803
20200306,5,길동,5880,6356,20200309,12236
20200306,5,굽은다리,7144,6476,20200309,13620
20200306,5,명일,6017,6184,20200309,12201
20200306,5,고덕,6484,6503,20200309,12987
20200306,5,상일동,13786,11670,20200309,25456
20200306,5,둔촌동,6376,6494,20200309,12870
20200306,5,올림픽공원,2907,2449,20200309,5356
20200306,5,방이,5344,5519,20200309,10863
20200306,5,오금,2928,2879,20200309,5807
20200306,5,개롱,4958,5144,20200309,10102
20200306,5,거여,6058,5695,20200309,11753
20200306,5,마천,4255,4144,20200309,8399
20200307,5,방화,3159,3006,20200310,6165
20200307,5,개화산,2752,2742,20200310,5494
20200307,5,김포공항,3742,3666,20200310,7408
20200307,5,송정,3748,3605,20200310,7353
20200307,5,마곡,2692,2678,20200310,5370
20200307,5,발산,8300,8883,20200310,17183
20200307,5,우장산,6268,6264,20200310,12532
20200307,5,화곡,14299,13083,20200310,27382
20200307,5,까치산,15539,14731,20200310,30270
20200307,5,신정,6112,5063,20200310,11175
20200307,5,목동,7794,8026,20200310,15820
20200307,5,오목교,10370,11101,20200310,21471
20200307,5,양평,2584,2366,20200310,4950
20200307,5,영등포구청,1373,1209,20200310,2582
20200307,5,영등포시장,4459,4601,20200310,9060
20200307,5,신길,1588,1685,20200310,3273
20200307,5,여의도,5345,5830,20200310,11175
20200307,5,여의나루,3043,3062,20200310,6105
20200307,5,마포,4650,4654,20200310,9304
20200307,5,공덕,4449,4829,20200310,9278
20200307,5,애오개,2576,2418,20200310,4994
20200307,5,충정로,1256,1216,20200310,2472
20200307,5,서대문,4701,4580,20200310,9281
20200307,5,광화문,7508,7647,20200310,15155
20200307,5,종로3가,5734,6148,20200310,11882
20200307,5,을지로4가,2186,2345,20200310,4531
20200307,5,동대문역사문화공원,639,794,20200310,1433
20200307,5,청구,1915,1640,20200310,3555
20200307,5,신금호,2788,2859,20200310,5647
20200307,5,행당,3490,3074,20200310,6564
20200307,5,왕십리,2337,2841,20200310,5178
20200307,5,마장,2720,2578,20200310,5298
20200307,5,답십리,7212,6633,20200310,13845
20200307,5,장한평,7440,7481,20200310,14921
20200307,5,군자,5867,6498,20200310,12365
20200307,5,아차산,8183,7982,20200310,16165
20200307,5,광나루,6364,6088,20200310,12452
20200307,5,천호,11169,10929,20200310,22098
20200307,5,강동,9336,8216,20200310,17552
20200307,5,길동,3882,4015,20200310,7897
20200307,5,굽은다리,4506,4128,20200310,8634
20200307,5,명일,3334,3275,20200310,6609
20200307,5,고덕,3510,3362,20200310,6872
20200307,5,상일동,6815,6012,20200310,12827
20200307,5,둔촌동,3829,3814,20200310,7643
20200307,5,올림픽공원,1703,1430,20200310,3133
20200307,5,방이,3030,3013,20200310,6043
20200307,5,오금,1345,1287,20200310,2632
20200307,5,개롱,2757,2814,20200310,5571
20200307,5,거여,3486,3265,20200310,6751
20200307,5,마천,2882,2881,20200310,5763
20200308,5,방화,2400,2306,20200311,4706
20200308,5,개화산,2086,2040,20200311,4126
20200308,5,김포공항,3264,3152,20200311,6416
20200308,5,송정,2534,2541,20200311,5075
20200308,5,마곡,1604,1670,20200311,3274
20200308,5,발산,5348,5708,20200311,11056
20200308,5,우장산,4145,4070,20200311,8215
20200308,5,화곡,9513,8953,20200311,18466
20200308,5,까치산,10682,10447,20200311,21129
20200308,5,신정,3961,3441,20200311,7402
20200308,5,목동,4893,5047,20200311,9940
20200308,5,오목교,7173,7363,20200311,14536
20200308,5,양평,1577,1659,20200311,3236
20200308,5,영등포구청,853,844,20200311,1697
20200308,5,영등포시장,2788,2885,20200311,5673
20200308,5,신길,1067,1306,20200311,2373
20200308,5,여의도,3842,3908,20200311,7750
20200308,5,여의나루,6250,6667,20200311,12917
20200308,5,마포,3063,2979,20200311,6042
20200308,5,공덕,2764,2821,20200311,5585
20200308,5,애오개,1853,1873,20200311,3726
20200308,5,충정로,856,873,20200311,1729
20200308,5,서대문,3133,3047,20200311,6180
20200308,5,광화문,5540,5580,20200311,11120
20200308,5,종로3가,4144,3897,20200311,8041
20200308,5,을지로4가,783,890,20200311,1673
20200308,5,동대문역사문화공원,373,486,20200311,859
20200308,5,청구,1168,1027,20200311,2195
20200308,5,신금호,1865,1981,20200311,3846
20200308,5,행당,2371,2214,20200311,4585
20200308,5,왕십리,1451,1727,20200311,3178
20200308,5,마장,1808,1761,20200311,3569
20200308,5,답십리,4737,4418,20200311,9155
20200308,5,장한평,4762,4669,20200311,9431
20200308,5,군자,3993,4394,20200311,8387
20200308,5,아차산,6850,6864,20200311,13714
20200308,5,광나루,5029,5011,20200311,10040
20200308,5,천호,7830,7463,20200311,15293
20200308,5,강동,6257,5838,20200311,12095
20200308,5,길동,2458,2503,20200311,4961
20200308,5,굽은다리,2929,2792,20200311,5721
20200308,5,명일,2172,2123,20200311,4295
20200308,5,고덕,2247,2275,20200311,4522
20200308,5,상일동,4382,4120,20200311,8502
20200308,5,둔촌동,2562,2623,20200311,5185
20200308,5,올림픽공원,1208,1097,20200311,2305
20200308,5,방이,2179,2180,20200311,4359
20200308,5,오금,904,928,20200311,1832
20200308,5,개롱,1838,2012,20200311,3850
20200308,5,거여,2223,2263,20200311,4486
20200308,5,마천,2050,2286,20200311,4336
20200309,5,방화,5552,5247,20200312,10799
20200309,5,개화산,4755,4580,20200312,9335
20200309,5,김포공항,4596,4227,20200312,8823
20200309,5,송정,5965,5433,20200312,11398
20200309,5,마곡,6715,6308,20200312,13023
20200309,5,발산,15123,15667,20200312,30790
20200309,5,우장산,11183,11035,20200312,22218
20200309,5,화곡,24958,23209,20200312,48167
20200309,5,까치산,25484,24372,20200312,49856
20200309,5,신정,11694,8870,20200312,20564
20200309,5,목동,14022,15837,20200312,29859
20200309,5,오목교,18202,19641,20200312,37843
20200309,5,양평,6494,6516,20200312,13010
20200309,5,영등포구청,3514,3537,20200312,7051
20200309,5,영등포시장,7629,7850,20200312,15479
20200309,5,신길,3197,3534,20200312,6731
20200309,5,여의도,22773,23670,20200312,46443
20200309,5,여의나루,8317,8680,20200312,16997
20200309,5,마포,11895,12334,20200312,24229
20200309,5,공덕,11854,12769,20200312,24623
20200309,5,애오개,5795,5927,20200312,11722
20200309,5,충정로,3833,3829,20200312,7662
20200309,5,서대문,15352,15798,20200312,31150
20200309,5,광화문,25710,26849,20200312,52559
20200309,5,종로3가,9111,9196,20200312,18307
20200309,5,을지로4가,5221,5312,20200312,10533
20200309,5,동대문역사문화공원,2529,2866,20200312,5395
20200309,5,청구,3463,3096,20200312,6559
20200309,5,신금호,4956,5115,20200312,10071
20200309,5,행당,6704,5981,20200312,12685
20200309,5,왕십리,3602,3920,20200312,7522
20200309,5,마장,4654,4424,20200312,9078
20200309,5,답십리,13793,12522,20200312,26315
20200309,5,장한평,15409,15379,20200312,30788
20200309,5,군자,9199,9998,20200312,19197
20200309,5,아차산,11259,11049,20200312,22308
20200309,5,광나루,10394,9455,20200312,19849
20200309,5,천호,13691,14700,20200312,28391
20200309,5,강동,16476,14416,20200312,30892
20200309,5,길동,5997,6422,20200312,12419
20200309,5,굽은다리,7293,7000,20200312,14293
20200309,5,명일,6336,6644,20200312,12980
20200309,5,고덕,6974,7248,20200312,14222
20200309,5,상일동,14413,12279,20200312,26692
20200309,5,둔촌동,6600,6600,20200312,13200
20200309,5,올림픽공원,2941,2541,20200312,5482
20200309,5,방이,5596,5827,20200312,11423
20200309,5,오금,3092,3113,20200312,6205
20200309,5,개롱,5035,5304,20200312,10339
20200309,5,거여,6182,5826,20200312,12008
20200309,5,마천,4375,4283,20200312,8658
20200310,5,방화,5208,5008,20200313,10216
20200310,5,개화산,4526,4273,20200313,8799
20200310,5,김포공항,4789,4250,20200313,9039
20200310,5,송정,5615,5109,20200313,10724
20200310,5,마곡,6456,6204,20200313,12660
20200310,5,발산,14545,15004,20200313,29549
20200310,5,우장산,10567,10521,20200313,21088
20200310,5,화곡,23595,21898,20200313,45493
20200310,5,까치산,24355,23159,20200313,47514
20200310,5,신정,11313,8649,20200313,19962
20200310,5,목동,13649,15090,20200313,28739
20200310,5,오목교,17557,18874,20200313,36431
20200310,5,양평,6296,6378,20200313,12674
20200310,5,영등포구청,3273,3255,20200313,6528
20200310,5,영등포시장,7317,7531,20200313,14848
20200310,5,신길,3173,3472,20200313,6645
20200310,5,여의도,22534,23533,20200313,46067
20200310,5,여의나루,5672,5932,20200313,11604
20200310,5,마포,11811,12243,20200313,24054
20200310,5,공덕,11466,12566,20200313,24032
20200310,5,애오개,5786,5843,20200313,11629
20200310,5,충정로,3736,3901,20200313,7637
20200310,5,서대문,15142,15541,20200313,30683
20200310,5,광화문,25425,26532,20200313,51957
20200310,5,종로3가,8618,8612,20200313,17230
20200310,5,을지로4가,5056,5101,20200313,10157
20200310,5,동대문역사문화공원,2531,2808,20200313,5339
20200310,5,청구,3358,3027,20200313,6385
20200310,5,신금호,4795,4914,20200313,9709
20200310,5,행당,6404,5834,20200313,12238
20200310,5,왕십리,3504,3857,20200313,7361
20200310,5,마장,4473,4228,20200313,8701
20200310,5,답십리,13305,12175,20200313,25480
20200310,5,장한평,14957,15054,20200313,30011
20200310,5,군자,8843,9715,20200313,18558
20200310,5,아차산,10561,10379,20200313,20940
20200310,5,광나루,9966,8752,20200313,18718
20200310,5,천호,13187,13889,20200313,27076
20200310,5,강동,16098,14275,20200313,30373
20200310,5,길동,5740,6129,20200313,11869
20200310,5,굽은다리,6988,6566,20200313,13554
20200310,5,명일,6089,6281,20200313,12370
20200310,5,고덕,6399,6514,20200313,12913
20200310,5,상일동,13762,11898,20200313,25660
20200310,5,둔촌동,6391,6542,20200313,12933
20200310,5,올림픽공원,2806,2375,20200313,5181
20200310,5,방이,5426,5649,20200313,11075
20200310,5,오금,2948,3017,20200313,5965
20200310,5,개롱,4918,5144,20200313,10062
20200310,5,거여,5960,5606,20200313,11566
20200310,5,마천,4015,4003,20200313,8018
20200311,5,방화,5498,5181,20200314,10679
20200311,5,개화산,4733,4632,20200314,9365
20200311,5,김포공항,4366,4269,20200314,8635
20200311,5,송정,5697,5324,20200314,11021
20200311,5,마곡,6586,6270,20200314,12856
20200311,5,발산,14880,15165,20200314,30045
20200311,5,우장산,10714,10611,20200314,21325
20200311,5,화곡,24151,22322,20200314,46473
20200311,5,까치산,24662,23526,20200314,48188
20200311,5,신정,11509,8622,20200314,20131
20200311,5,목동,14035,15857,20200314,29892
20200311,5,오목교,17977,19289,20200314,37266
20200311,5,양평,6268,6307,20200314,12575
20200311,5,영등포구청,3403,3452,20200314,6855
20200311,5,영등포시장,7413,7632,20200314,15045
20200311,5,신길,3171,3513,20200314,6684
20200311,5,여의도,22424,23237,20200314,45661
20200311,5,여의나루,7172,7539,20200314,14711
20200311,5,마포,11944,12291,20200314,24235
20200311,5,공덕,11387,12506,20200314,23893
20200311,5,애오개,5866,5862,20200314,11728
20200311,5,충정로,3767,3802,20200314,7569
20200311,5,서대문,15039,15705,20200314,30744
20200311,5,광화문,25631,26601,20200314,52232
20200311,5,종로3가,9477,9182,20200314,18659
20200311,5,을지로4가,5183,5308,20200314,10491
20200311,5,동대문역사문화공원,2436,2748,20200314,5184
20200311,5,청구,3546,3104,20200314,6650
20200311,5,신금호,5015,5117,20200314,10132
20200311,5,행당,6440,5799,20200314,12239
20200311,5,왕십리,3566,4035,20200314,7601
20200311,5,마장,4498,4277,20200314,8775
20200311,5,답십리,13622,12429,20200314,26051
20200311,5,장한평,15359,15376,20200314,30735
20200311,5,군자,9302,10126,20200314,19428
20200311,5,아차산,11442,11306,20200314,22748
20200311,5,광나루,10512,9327,20200314,19839
20200311,5,천호,14252,15209,20200314,29461
20200311,5,강동,16355,14523,20200314,30878
20200311,5,길동,5997,6304,20200314,12301
20200311,5,굽은다리,7281,6890,20200314,14171
20200311,5,명일,6238,6584,20200314,12822
20200311,5,고덕,6646,6825,20200314,13471
20200311,5,상일동,14328,12221,20200314,26549
20200311,5,둔촌동,6647,6654,20200314,13301
20200311,5,올림픽공원,3008,2574,20200314,5582
20200311,5,방이,5612,5778,20200314,11390
20200311,5,오금,2972,3093,20200314,6065
20200311,5,개롱,5083,5313,20200314,10396
20200311,5,거여,6192,5833,20200314,12025
20200311,5,마천,4258,4271,20200314,8529
20200312,5,방화,5337,5091,20200315,10428
20200312,5,개화산,4663,4532,20200315,9195
20200312,5,김포공항,4383,4136,20200315,8519
20200312,5,송정,5668,5249,20200315,10917
20200312,5,마곡,6343,6036,20200315,12379
20200312,5,발산,14306,14878,20200315,29184
20200312,5,우장산,10328,10382,20200315,20710
20200312,5,화곡,23809,21983,20200315,45792
20200312,5,까치산,24253,22987,20200315,47240
20200312,5,신정,11315,8569,20200315,19884
20200312,5,목동,13750,15287,20200315,29037
20200312,5,오목교,17463,18891,20200315,36354
20200312,5,양평,6198,6268,20200315,12466
20200312,5,영등포구청,3258,3327,20200315,6585
20200312,5,영등포시장,7241,7303,20200315,14544
20200312,5,신길,3096,3443,20200315,6539
20200312,5,여의도,22100,23164,20200315,45264
20200312,5,여의나루,7698,7988,20200315,15686
20200312,5,마포,11477,11874,20200315,23351
20200312,5,공덕,11414,12396,20200315,23810
20200312,5,애오개,5692,5711,20200315,11403
20200312,5,충정로,3587,3714,20200315,7301
20200312,5,서대문,14597,15153,20200315,29750
20200312,5,광화문,24817,26049,20200315,50866
20200312,5,종로3가,8986,8944,20200315,17930
20200312,5,을지로4가,5122,5185,20200315,10307
20200312,5,동대문역사문화공원,2465,2793,20200315,5258
20200312,5,청구,3442,2981,20200315,6423
20200312,5,신금호,4853,4955,20200315,9808
20200312,5,행당,6417,5694,20200315,12111
20200312,5,왕십리,3518,3879,20200315,7397
20200312,5,마장,4443,4144,20200315,8587
20200312,5,답십리,13471,12318,20200315,25789
20200312,5,장한평,15204,14932,20200315,30136
20200312,5,군자,9117,9977,20200315,19094
20200312,5,아차산,11336,11114,20200315,22450
20200312,5,광나루,10270,9370,20200315,19640
20200312,5,천호,13814,14634,20200315,28448
20200312,5,강동,16146,14152,20200315,30298
20200312,5,길동,5789,6136,20200315,11925
20200312,5,굽은다리,7155,6778,20200315,13933
20200312,5,명일,6053,6221,20200315,12274
20200312,5,고덕,6423,6730,20200315,13153
20200312,5,상일동,13974,11995,20200315,25969
20200312,5,둔촌동,6358,6300,20200315,12658
20200312,5,올림픽공원,2921,2521,20200315,5442
20200312,5,방이,5489,5638,20200315,11127
20200312,5,오금,2961,3066,20200315,6027
20200312,5,개롱,4810,5103,20200315,9913
20200312,5,거여,6052,5621,20200315,11673
20200312,5,마천,4197,4251,20200315,8448
20200313,5,방화,5412,5125,20200316,10537
20200313,5,개화산,4711,4440,20200316,9151
20200313,5,김포공항,4570,4282,20200316,8852
20200313,5,송정,5784,5184,20200316,10968
20200313,5,마곡,6662,6169,20200316,12831
20200313,5,발산,14643,15370,20200316,30013
20200313,5,우장산,10426,10374,20200316,20800
20200313,5,화곡,24377,22381,20200316,46758
20200313,5,까치산,24539,23008,20200316,47547
20200313,5,신정,11374,8524,20200316,19898
20200313,5,목동,13818,15517,20200316,29335
20200313,5,오목교,18111,19582,20200316,37693
20200313,5,양평,6048,6079,20200316,12127
20200313,5,영등포구청,3311,3367,20200316,6678
20200313,5,영등포시장,7490,7563,20200316,15053
20200313,5,신길,3087,3308,20200316,6395
20200313,5,여의도,21826,22694,20200316,44520
20200313,5,여의나루,6612,6815,20200316,13427
20200313,5,마포,11658,12293,20200316,23951
20200313,5,공덕,11353,12395,20200316,23748
20200313,5,애오개,5777,5829,20200316,11606
20200313,5,충정로,3546,3519,20200316,7065
20200313,5,서대문,14570,15090,20200316,29660
20200313,5,광화문,24443,25506,20200316,49949
20200313,5,종로3가,9110,9256,20200316,18366
20200313,5,을지로4가,5167,5306,20200316,10473
20200313,5,동대문역사문화공원,2321,2651,20200316,4972
20200313,5,청구,3427,2958,20200316,6385
20200313,5,신금호,4907,4989,20200316,9896
20200313,5,행당,6486,5758,20200316,12244
20200313,5,왕십리,3615,4167,20200316,7782
20200313,5,마장,4649,4438,20200316,9087
20200313,5,답십리,13504,12290,20200316,25794
20200313,5,장한평,15250,15179,20200316,30429
20200313,5,군자,9409,10217,20200316,19626
20200313,5,아차산,11531,11122,20200316,22653
20200313,5,광나루,10425,9276,20200316,19701
20200313,5,천호,14673,15427,20200316,30100
20200313,5,강동,16361,14421,20200316,30782
20200313,5,길동,5996,6415,20200316,12411
20200313,5,굽은다리,7215,6623,20200316,13838
20200313,5,명일,6267,6374,20200316,12641
20200313,5,고덕,6591,6653,20200316,13244
20200313,5,상일동,14235,12004,20200316,26239
20200313,5,둔촌동,6650,6592,20200316,13242
20200313,5,올림픽공원,2958,2589,20200316,5547
20200313,5,방이,5431,5655,20200316,11086
20200313,5,오금,2967,2994,20200316,5961
20200313,5,개롱,5062,5079,20200316,10141
20200313,5,거여,6138,5737,20200316,11875
20200313,5,마천,4138,4116,20200316,8254
20200314,5,방화,3251,3105,20200317,6356
20200314,5,개화산,2809,2782,20200317,5591
20200314,5,김포공항,3745,3668,20200317,7413
20200314,5,송정,3953,3703,20200317,7656
20200314,5,마곡,2784,2627,20200317,5411
20200314,5,발산,8386,9024,20200317,17410
20200314,5,우장산,6209,6198,20200317,12407
20200314,5,화곡,14446,13245,20200317,27691
20200314,5,까치산,15311,14664,20200317,29975
20200314,5,신정,6215,5198,20200317,11413
20200314,5,목동,7694,8163,20200317,15857
20200314,5,오목교,10999,11542,20200317,22541
20200314,5,양평,2449,2245,20200317,4694
20200314,5,영등포구청,1405,1346,20200317,2751
20200314,5,영등포시장,4533,4626,20200317,9159
20200314,5,신길,1597,1738,20200317,3335
20200314,5,여의도,5981,6252,20200317,12233
20200314,5,여의나루,4273,4635,20200317,8908
20200314,5,마포,4710,4799,20200317,9509
20200314,5,공덕,4651,4887,20200317,9538
20200314,5,애오개,2480,2339,20200317,4819
20200314,5,충정로,1349,1227,20200317,2576
20200314,5,서대문,4874,4758,20200317,9632
20200314,5,광화문,8082,8166,20200317,16248
20200314,5,종로3가,6437,6484,20200317,12921
20200314,5,을지로4가,2100,2310,20200317,4410
20200314,5,동대문역사문화공원,607,862,20200317,1469
20200314,5,청구,1914,1684,20200317,3598
20200314,5,신금호,2889,2948,20200317,5837
20200314,5,행당,3822,3278,20200317,7100
20200314,5,왕십리,2416,2833,20200317,5249
20200314,5,마장,2800,2650,20200317,5450
20200314,5,답십리,7320,6761,20200317,14081
20200314,5,장한평,7636,7708,20200317,15344
20200314,5,군자,6083,6532,20200317,12615
20200314,5,아차산,8589,8469,20200317,17058
20200314,5,광나루,6597,6385,20200317,12982
20200314,5,천호,11536,11449,20200317,22985
20200314,5,강동,9816,8755,20200317,18571
20200314,5,길동,4004,4180,20200317,8184
20200314,5,굽은다리,4737,4382,20200317,9119
20200314,5,명일,3588,3467,20200317,7055
20200314,5,고덕,3778,3584,20200317,7362
20200314,5,상일동,6998,6236,20200317,13234
20200314,5,둔촌동,4097,4084,20200317,8181
20200314,5,올림픽공원,1796,1537,20200317,3333
20200314,5,방이,3314,3254,20200317,6568
20200314,5,오금,1402,1395,20200317,2797
20200314,5,개롱,2886,2978,20200317,5864
20200314,5,거여,3624,3397,20200317,7021
20200314,5,마천,2955,3003,20200317,5958
20200315,5,방화,2370,2299,20200318,4669
20200315,5,개화산,1907,1968,20200318,3875
20200315,5,김포공항,3296,3097,20200318,6393
20200315,5,송정,2403,2524,20200318,4927
20200315,5,마곡,1714,1682,20200318,3396
20200315,5,발산,5148,5385,20200318,10533
20200315,5,우장산,4094,4108,20200318,8202
20200315,5,화곡,9249,8618,20200318,17867
20200315,5,까치산,10248,9875,20200318,20123
20200315,5,신정,3983,3347,20200318,7330
20200315,5,목동,4794,5045,20200318,9839
20200315,5,오목교,7345,7604,20200318,14949
20200315,5,양평,1570,1637,20200318,3207
20200315,5,영등포구청,875,842,20200318,1717
20200315,5,영등포시장,2494,2632,20200318,5126
20200315,5,신길,1106,1224,20200318,2330
20200315,5,여의도,3448,3493,20200318,6941
20200315,5,여의나루,2741,2885,20200318,5626
20200315,5,마포,2996,2914,20200318,5910
20200315,5,공덕,2852,2913,20200318,5765
20200315,5,애오개,1727,1783,20200318,3510
20200315,5,충정로,813,883,20200318,1696
20200315,5,서대문,3181,3006,20200318,6187
20200315,5,광화문,5779,5728,20200318,11507
20200315,5,종로3가,4278,3920,20200318,8198
20200315,5,을지로4가,775,804,20200318,1579
20200315,5,동대문역사문화공원,352,446,20200318,798
20200315,5,청구,1141,1031,20200318,2172
20200315,5,신금호,1860,1995,20200318,3855
20200315,5,행당,2393,2087,20200318,4480
20200315,5,왕십리,1597,1890,20200318,3487
20200315,5,마장,1770,1645,20200318,3415
20200315,5,답십리,4625,4272,20200318,8897
20200315,5,장한평,4602,4501,20200318,9103
20200315,5,군자,3938,4465,20200318,8403
20200315,5,아차산,6725,6716,20200318,13441
20200315,5,광나루,4889,4892,20200318,9781
20200315,5,천호,7880,7749,20200318,15629
20200315,5,강동,6311,5898,20200318,12209
20200315,5,길동,2515,2669,20200318,5184
20200315,5,굽은다리,3092,2847,20200318,5939
20200315,5,명일,2247,2212,20200318,4459
20200315,5,고덕,2415,2353,20200318,4768
20200315,5,상일동,4294,4036,20200318,8330
20200315,5,둔촌동,2683,2627,20200318,5310
20200315,5,올림픽공원,1070,951,20200318,2021
20200315,5,방이,2293,2256,20200318,4549
20200315,5,오금,897,922,20200318,1819
20200315,5,개롱,1761,1978,20200318,3739
20200315,5,거여,2310,2238,20200318,4548
20200315,5,마천,2018,2288,20200318,4306
20200316,5,방화,5466,5097,20200319,10563
20200316,5,개화산,4629,4522,20200319,9151
20200316,5,김포공항,4352,3927,20200319,8279
20200316,5,송정,5767,5466,20200319,11233
20200316,5,마곡,7023,6651,20200319,13674
20200316,5,발산,14837,15109,20200319,29946
20200316,5,우장산,10747,10666,20200319,21413
20200316,5,화곡,24265,22590,20200319,46855
20200316,5,까치산,24534,23495,20200319,48029
20200316,5,신정,11367,8758,20200319,20125
20200316,5,목동,14142,15835,20200319,29977
20200316,5,오목교,16567,17762,20200319,34329
20200316,5,양평,6393,6466,20200319,12859
20200316,5,영등포구청,3410,3495,20200319,6905
20200316,5,영등포시장,7540,7579,20200319,15119
20200316,5,신길,3129,3519,20200319,6648
20200316,5,여의도,22270,23244,20200319,45514
20200316,5,여의나루,6682,6806,20200319,13488
20200316,5,마포,11972,12198,20200319,24170
20200316,5,공덕,11580,12508,20200319,24088
20200316,5,애오개,5700,5815,20200319,11515
20200316,5,충정로,3642,3750,20200319,7392
20200316,5,서대문,15164,15558,20200319,30722
20200316,5,광화문,25561,26431,20200319,51992
20200316,5,종로3가,8833,9080,20200319,17913
20200316,5,을지로4가,5181,5164,20200319,10345
20200316,5,동대문역사문화공원,2475,2788,20200319,5263
20200316,5,청구,3469,3136,20200319,6605
20200316,5,신금호,4907,5064,20200319,9971
20200316,5,행당,6654,5955,20200319,12609
20200316,5,왕십리,3614,3935,20200319,7549
20200316,5,마장,4544,4309,20200319,8853
20200316,5,답십리,13717,12427,20200319,26144
20200316,5,장한평,15085,15085,20200319,30170
20200316,5,군자,9034,9781,20200319,18815
20200316,5,아차산,11153,11070,20200319,22223
20200316,5,광나루,10273,9375,20200319,19648
20200316,5,천호,12968,13891,20200319,26859
20200316,5,강동,16599,14636,20200319,31235
20200316,5,길동,5967,6301,20200319,12268
20200316,5,굽은다리,7283,6862,20200319,14145
20200316,5,명일,6283,6598,20200319,12881
20200316,5,고덕,6708,7035,20200319,13743
20200316,5,상일동,14371,12408,20200319,26779
20200316,5,둔촌동,6579,6577,20200319,13156
20200316,5,올림픽공원,2944,2613,20200319,5557
20200316,5,방이,5554,5766,20200319,11320
20200316,5,오금,3015,3067,20200319,6082
20200316,5,개롱,4890,5190,20200319,10080
20200316,5,거여,6119,5822,20200319,11941
20200316,5,마천,4202,4246,20200319,8448
20200317,5,방화,5339,5097,20200320,10436
20200317,5,개화산,4578,4421,20200320,8999
20200317,5,김포공항,4191,3970,20200320,8161
20200317,5,송정,5662,5156,20200320,10818
20200317,5,마곡,7044,6673,20200320,13717
20200317,5,발산,14590,15088,20200320,29678
20200317,5,우장산,10817,10766,20200320,21583
20200317,5,화곡,24070,22450,20200320,46520
20200317,5,까치산,24646,23388,20200320,48034
20200317,5,신정,11526,8679,20200320,20205
20200317,5,목동,13953,15675,20200320,29628
20200317,5,오목교,17874,19169,20200320,37043
20200317,5,양평,6358,6340,20200320,12698
20200317,5,영등포구청,3447,3493,20200320,6940
20200317,5,영등포시장,7307,7485,20200320,14792
20200317,5,신길,3139,3506,20200320,6645
20200317,5,여의도,22235,23377,20200320,45612
20200317,5,여의나루,6764,7056,20200320,13820
20200317,5,마포,11845,12254,20200320,24099
20200317,5,공덕,11554,12493,20200320,24047
20200317,5,애오개,5779,5775,20200320,11554
20200317,5,충정로,3651,3726,20200320,7377
20200317,5,서대문,14803,15499,20200320,30302
20200317,5,광화문,25222,26746,20200320,51968
20200317,5,종로3가,8925,9045,20200320,17970
20200317,5,을지로4가,5104,5194,20200320,10298
20200317,5,동대문역사문화공원,2382,2697,20200320,5079
20200317,5,청구,3459,3070,20200320,6529
20200317,5,신금호,4882,5036,20200320,9918
20200317,5,행당,6547,5834,20200320,12381
20200317,5,왕십리,3626,3908,20200320,7534
20200317,5,마장,4459,4278,20200320,8737
20200317,5,답십리,13528,12291,20200320,25819
20200317,5,장한평,15136,15039,20200320,30175
20200317,5,군자,9264,9947,20200320,19211
20200317,5,아차산,11145,11035,20200320,22180
20200317,5,광나루,10303,9196,20200320,19499
20200317,5,천호,13813,14837,20200320,28650
20200317,5,강동,16501,14558,20200320,31059
20200317,5,길동,5935,6282,20200320,12217
20200317,5,굽은다리,7107,6730,20200320,13837
20200317,5,명일,6125,6447,20200320,12572
20200317,5,고덕,6600,6777,20200320,13377
20200317,5,상일동,14457,12269,20200320,26726
20200317,5,둔촌동,6624,6584,20200320,13208
20200317,5,올림픽공원,2917,2504,20200320,5421
20200317,5,방이,5449,5800,20200320,11249
20200317,5,오금,2967,3050,20200320,6017
20200317,5,개롱,4971,5088,20200320,10059
20200317,5,거여,6135,5711,20200320,11846
20200317,5,마천,4137,4159,20200320,8296
20200318,5,방화,5603,5280,20200321,10883
20200318,5,개화산,4746,4549,20200321,9295
20200318,5,김포공항,4383,4121,20200321,8504
20200318,5,송정,5836,5417,20200321,11253
20200318,5,마곡,7066,6631,20200321,13697
20200318,5,발산,15200,15538,20200321,30738
20200318,5,우장산,10966,10907,20200321,21873
20200318,5,화곡,24616,22809,20200321,47425
20200318,5,까치산,25162,23966,20200321,49128
20200318,5,신정,11728,8922,20200321,20650
20200318,5,목동,14311,15991,20200321,30302
20200318,5,오목교,18005,19498,20200321,37503
20200318,5,양평,6385,6424,20200321,12809
20200318,5,영등포구청,3487,3460,20200321,6947
20200318,5,영등포시장,7472,7650,20200321,15122
20200318,5,신길,3192,3535,20200321,6727
20200318,5,여의도,22493,23790,20200321,46283
20200318,5,여의나루,10058,10346,20200321,20404
20200318,5,마포,11796,12259,20200321,24055
20200318,5,공덕,11499,12478,20200321,23977
20200318,5,애오개,5955,5890,20200321,11845
20200318,5,충정로,3706,3825,20200321,7531
20200318,5,서대문,15145,15578,20200321,30723
20200318,5,광화문,25756,26968,20200321,52724
20200318,5,종로3가,9446,9510,20200321,18956
20200318,5,을지로4가,5286,5231,20200321,10517
20200318,5,동대문역사문화공원,2373,2708,20200321,5081
20200318,5,청구,3586,3159,20200321,6745
20200318,5,신금호,5015,5177,20200321,10192
20200318,5,행당,6717,6004,20200321,12721
20200318,5,왕십리,3662,4051,20200321,7713
20200318,5,마장,4676,4345,20200321,9021
20200318,5,답십리,13840,12612,20200321,26452
20200318,5,장한평,15433,15453,20200321,30886
20200318,5,군자,9410,10333,20200321,19743
20200318,5,아차산,11762,11542,20200321,23304
20200318,5,광나루,10646,9494,20200321,20140
20200318,5,천호,14423,15269,20200321,29692
20200318,5,강동,16855,14944,20200321,31799
20200318,5,길동,6079,6421,20200321,12500
20200318,5,굽은다리,7355,6993,20200321,14348
20200318,5,명일,6404,6558,20200321,12962
20200318,5,고덕,6689,6872,20200321,13561
20200318,5,상일동,14721,12637,20200321,27358
20200318,5,둔촌동,6702,6648,20200321,13350
20200318,5,올림픽공원,3111,2672,20200321,5783
20200318,5,방이,5663,5866,20200321,11529
20200318,5,오금,2993,3024,20200321,6017
20200318,5,개롱,5091,5275,20200321,10366
20200318,5,거여,6275,5939,20200321,12214
20200318,5,마천,4302,4280,20200321,8582
20200319,5,방화,5198,4884,20200322,10082
20200319,5,개화산,4542,4336,20200322,8878
20200319,5,김포공항,4158,3917,20200322,8075
20200319,5,송정,5524,5175,20200322,10699
20200319,5,마곡,6795,6494,20200322,13289
20200319,5,발산,14657,14985,20200322,29642
20200319,5,우장산,10444,10369,20200322,20813
20200319,5,화곡,23596,21887,20200322,45483
20200319,5,까치산,23903,23109,20200322,47012
20200319,5,신정,11218,8638,20200322,19856
20200319,5,목동,13687,15270,20200322,28957
20200319,5,오목교,17417,18609,20200322,36026
20200319,5,양평,6265,6318,20200322,12583
20200319,5,영등포구청,3338,3392,20200322,6730
20200319,5,영등포시장,7051,7297,20200322,14348
20200319,5,신길,3169,3469,20200322,6638
20200319,5,여의도,22332,23332,20200322,45664
20200319,5,여의나루,6019,6222,20200322,12241
20200319,5,마포,11460,11896,20200322,23356
20200319,5,공덕,11222,12251,20200322,23473
20200319,5,애오개,5780,5774,20200322,11554
20200319,5,충정로,3650,3826,20200322,7476
20200319,5,서대문,14810,15130,20200322,29940
20200319,5,광화문,24678,26034,20200322,50712
20200319,5,종로3가,8587,8600,20200322,17187
20200319,5,을지로4가,5053,4936,20200322,9989
20200319,5,동대문역사문화공원,2380,2638,20200322,5018
20200319,5,청구,3354,3061,20200322,6415
20200319,5,신금호,4776,4922,20200322,9698
20200319,5,행당,6426,5801,20200322,12227
20200319,5,왕십리,3545,3974,20200322,7519
20200319,5,마장,4325,4244,20200322,8569
20200319,5,답십리,13188,12112,20200322,25300
20200319,5,장한평,14800,14832,20200322,29632
20200319,5,군자,9000,9616,20200322,18616
20200319,5,아차산,10779,10548,20200322,21327
20200319,5,광나루,9893,8672,20200322,18565
20200319,5,천호,13504,14183,20200322,27687
20200319,5,강동,16250,14289,20200322,30539
20200319,5,길동,5657,6112,20200322,11769
20200319,5,굽은다리,6961,6640,20200322,13601
20200319,5,명일,5966,6297,20200322,12263
20200319,5,고덕,6467,6511,20200322,12978
20200319,5,상일동,13875,12056,20200322,25931
20200319,5,둔촌동,6518,6520,20200322,13038
20200319,5,올림픽공원,2771,2387,20200322,5158
20200319,5,방이,5437,5702,20200322,11139
20200319,5,오금,2916,2972,20200322,5888
20200319,5,개롱,4793,5045,20200322,9838
20200319,5,거여,5900,5519,20200322,11419
20200319,5,마천,4010,4078,20200322,8088
20200320,5,방화,5688,5304,20200323,10992
20200320,5,개화산,4721,4587,20200323,9308
20200320,5,김포공항,4710,4349,20200323,9059
20200320,5,송정,6065,5502,20200323,11567
20200320,5,마곡,7069,6689,20200323,13758
20200320,5,발산,14963,15833,20200323,30796
20200320,5,우장산,11400,11241,20200323,22641
20200320,5,화곡,25474,23095,20200323,48569
20200320,5,까치산,25841,24316,20200323,50157
20200320,5,신정,11986,8960,20200323,20946
20200320,5,목동,14800,16236,20200323,31036
20200320,5,오목교,18839,20393,20200323,39232
20200320,5,양평,6382,6330,20200323,12712
20200320,5,영등포구청,3520,3536,20200323,7056
20200320,5,영등포시장,7679,7858,20200323,15537
20200320,5,신길,3276,3547,20200323,6823
20200320,5,여의도,22316,23531,20200323,45847
20200320,5,여의나루,9179,9281,20200323,18460
20200320,5,마포,12086,12455,20200323,24541
20200320,5,공덕,11632,12873,20200323,24505
20200320,5,애오개,6017,5844,20200323,11861
20200320,5,충정로,3799,3857,20200323,7656
20200320,5,서대문,14952,15552,20200323,30504
20200320,5,광화문,25133,26747,20200323,51880
20200320,5,종로3가,9767,10126,20200323,19893
20200320,5,을지로4가,5142,5359,20200323,10501
20200320,5,동대문역사문화공원,2334,2666,20200323,5000
20200320,5,청구,3525,3179,20200323,6704
20200320,5,신금호,5105,5111,20200323,10216
20200320,5,행당,6825,5950,20200323,12775
20200320,5,왕십리,3955,4517,20200323,8472
20200320,5,마장,4773,4448,20200323,9221
20200320,5,답십리,14052,12641,20200323,26693
20200320,5,장한평,15684,15549,20200323,31233
20200320,5,군자,9735,10537,20200323,20272
20200320,5,아차산,11894,11737,20200323,23631
20200320,5,광나루,11194,9892,20200323,21086
20200320,5,천호,15528,16590,20200323,32118
20200320,5,강동,17297,15038,20200323,32335
20200320,5,길동,6454,6761,20200323,13215
20200320,5,굽은다리,7622,7003,20200323,14625
20200320,5,명일,6495,6790,20200323,13285
20200320,5,고덕,6940,7054,20200323,13994
20200320,5,상일동,15019,12705,20200323,27724
20200320,5,둔촌동,6935,7018,20200323,13953
20200320,5,올림픽공원,3124,2686,20200323,5810
20200320,5,방이,5815,5994,20200323,11809
20200320,5,오금,3095,3075,20200323,6170
20200320,5,개롱,5150,5290,20200323,10440
20200320,5,거여,6392,5986,20200323,12378
20200320,5,마천,4326,4220,20200323,8546
20200321,5,방화,3429,3178,20200324,6607
20200321,5,개화산,2882,2864,20200324,5746
20200321,5,김포공항,3598,3564,20200324,7162
20200321,5,송정,3941,3697,20200324,7638
20200321,5,마곡,2847,2782,20200324,5629
20200321,5,발산,8564,9103,20200324,17667
20200321,5,우장산,6795,6602,20200324,13397
20200321,5,화곡,15155,13711,20200324,28866
20200321,5,까치산,15912,15083,20200324,30995
20200321,5,신정,6521,5269,20200324,11790
20200321,5,목동,8248,8439,20200324,16687
20200321,5,오목교,11156,11711,20200324,22867
20200321,5,양평,2593,2501,20200324,5094
20200321,5,영등포구청,1430,1370,20200324,2800
20200321,5,영등포시장,4800,5048,20200324,9848
20200321,5,신길,1748,1774,20200324,3522
20200321,5,여의도,6331,6764,20200324,13095
20200321,5,여의나루,8935,9887,20200324,18822
20200321,5,마포,5004,5137,20200324,10141
20200321,5,공덕,4977,5255,20200324,10232
20200321,5,애오개,2677,2533,20200324,5210
20200321,5,충정로,1316,1227,20200324,2543
20200321,5,서대문,4928,4872,20200324,9800
20200321,5,광화문,8425,8528,20200324,16953
20200321,5,종로3가,6594,7094,20200324,13688
20200321,5,을지로4가,2259,2460,20200324,4719
20200321,5,동대문역사문화공원,646,809,20200324,1455
20200321,5,청구,1992,1743,20200324,3735
20200321,5,신금호,2997,3048,20200324,6045
20200321,5,행당,3796,3243,20200324,7039
20200321,5,왕십리,2460,2977,20200324,5437
20200321,5,마장,2813,2834,20200324,5647
20200321,5,답십리,7763,7010,20200324,14773
20200321,5,장한평,8180,7953,20200324,16133
20200321,5,군자,6172,6756,20200324,12928
20200321,5,아차산,9363,9068,20200324,18431
20200321,5,광나루,6961,6802,20200324,13763
20200321,5,천호,11672,11757,20200324,23429
20200321,5,강동,10191,8747,20200324,18938
20200321,5,길동,4026,4237,20200324,8263
20200321,5,굽은다리,4798,4363,20200324,9161
20200321,5,명일,3699,3683,20200324,7382
20200321,5,고덕,3733,3569,20200324,7302
20200321,5,상일동,7450,6619,20200324,14069
20200321,5,둔촌동,4235,4060,20200324,8295
20200321,5,올림픽공원,1903,1725,20200324,3628
20200321,5,방이,3388,3359,20200324,6747
20200321,5,오금,1553,1478,20200324,3031
20200321,5,개롱,2972,3097,20200324,6069
20200321,5,거여,3642,3423,20200324,7065
20200321,5,마천,3058,3077,20200324,6135
20200322,5,방화,2431,2347,20200325,4778
20200322,5,개화산,1978,2074,20200325,4052
20200322,5,김포공항,3274,2941,20200325,6215
20200322,5,송정,2699,2724,20200325,5423
20200322,5,마곡,1764,1833,20200325,3597
20200322,5,발산,5778,6103,20200325,11881
20200322,5,우장산,4323,4392,20200325,8715
20200322,5,화곡,10035,9257,20200325,19292
20200322,5,까치산,11086,10775,20200325,21861
20200322,5,신정,4342,3836,20200325,8178
20200322,5,목동,5312,5428,20200325,10740
20200322,5,오목교,7920,8204,20200325,16124
20200322,5,양평,1682,1777,20200325,3459
20200322,5,영등포구청,912,880,20200325,1792
20200322,5,영등포시장,2788,2965,20200325,5753
20200322,5,신길,1149,1342,20200325,2491
20200322,5,여의도,4779,4643,20200325,9422
20200322,5,여의나루,11330,12439,20200325,23769
20200322,5,마포,3335,3320,20200325,6655
20200322,5,공덕,3146,3216,20200325,6362
20200322,5,애오개,1905,1922,20200325,3827
20200322,5,충정로,911,928,20200325,1839
20200322,5,서대문,3322,3304,20200325,6626
20200322,5,광화문,6208,6091,20200325,12299
20200322,5,종로3가,4709,4291,20200325,9000
20200322,5,을지로4가,832,881,20200325,1713
20200322,5,동대문역사문화공원,438,538,20200325,976
20200322,5,청구,1204,1107,20200325,2311
20200322,5,신금호,1971,2091,20200325,4062
20200322,5,행당,2505,2326,20200325,4831
20200322,5,왕십리,1591,1886,20200325,3477
20200322,5,마장,1932,1913,20200325,3845
20200322,5,답십리,5042,4646,20200325,9688
20200322,5,장한평,5100,4921,20200325,10021
20200322,5,군자,4168,4547,20200325,8715
20200322,5,아차산,7822,7828,20200325,15650
20200322,5,광나루,5471,5628,20200325,11099
20200322,5,천호,8469,8108,20200325,16577
20200322,5,강동,6535,6248,20200325,12783
20200322,5,길동,2684,2689,20200325,5373
20200322,5,굽은다리,3118,2851,20200325,5969
20200322,5,명일,2476,2375,20200325,4851
20200322,5,고덕,2496,2392,20200325,4888
20200322,5,상일동,4651,4506,20200325,9157
20200322,5,둔촌동,2856,2856,20200325,5712
20200322,5,올림픽공원,1342,1274,20200325,2616
20200322,5,방이,2426,2313,20200325,4739
20200322,5,오금,1025,950,20200325,1975
20200322,5,개롱,1938,2146,20200325,4084
20200322,5,거여,2355,2342,20200325,4697
20200322,5,마천,2240,2451,20200325,4691
20200323,5,방화,5466,5122,20200326,10588
20200323,5,개화산,4673,4547,20200326,9220
20200323,5,김포공항,4427,3986,20200326,8413
20200323,5,송정,5750,5341,20200326,11091
20200323,5,마곡,7004,6773,20200326,13777
20200323,5,발산,15120,15410,20200326,30530
20200323,5,우장산,11222,11196,20200326,22418
20200323,5,화곡,24668,23004,20200326,47672
20200323,5,까치산,25142,24008,20200326,49150
20200323,5,신정,11733,8880,20200326,20613
20200323,5,목동,14411,16136,20200326,30547
20200323,5,오목교,17974,19436,20200326,37410
20200323,5,양평,6494,6471,20200326,12965
20200323,5,영등포구청,3548,3516,20200326,7064
20200323,5,영등포시장,7473,7694,20200326,15167
20200323,5,신길,3176,3592,20200326,6768
20200323,5,여의도,22846,23854,20200326,46700
20200323,5,여의나루,10919,11361,20200326,22280
20200323,5,마포,11898,12330,20200326,24228
20200323,5,공덕,11715,12502,20200326,24217
20200323,5,애오개,5770,5973,20200326,11743
20200323,5,충정로,3776,3921,20200326,7697
20200323,5,서대문,15240,15688,20200326,30928
20200323,5,광화문,25727,26904,20200326,52631
20200323,5,종로3가,8920,9102,20200326,18022
20200323,5,을지로4가,5128,5209,20200326,10337
20200323,5,동대문역사문화공원,2498,2762,20200326,5260
20200323,5,청구,3516,3138,20200326,6654
20200323,5,신금호,4963,5132,20200326,10095
20200323,5,행당,6650,5944,20200326,12594
20200323,5,왕십리,3527,3942,20200326,7469
20200323,5,마장,4561,4247,20200326,8808
20200323,5,답십리,13802,12724,20200326,26526
20200323,5,장한평,15491,15372,20200326,30863
20200323,5,군자,9293,9997,20200326,19290
20200323,5,아차산,11440,11311,20200326,22751
20200323,5,광나루,10552,9563,20200326,20115
20200323,5,천호,14351,15019,20200326,29370
20200323,5,강동,16770,14826,20200326,31596
20200323,5,길동,5980,6389,20200326,12369
20200323,5,굽은다리,7317,6948,20200326,14265
20200323,5,명일,6271,6637,20200326,12908
20200323,5,고덕,6780,7000,20200326,13780
20200323,5,상일동,14774,12869,20200326,27643
20200323,5,둔촌동,6706,6704,20200326,13410
20200323,5,올림픽공원,3020,2699,20200326,5719
20200323,5,방이,5549,5727,20200326,11276
20200323,5,오금,3123,3087,20200326,6210
20200323,5,개롱,5082,5263,20200326,10345
20200323,5,거여,6124,5811,20200326,11935
20200323,5,마천,4279,4278,20200326,8557
20200324,5,방화,5596,5256,20200327,10852
20200324,5,개화산,4753,4619,20200327,9372
20200324,5,김포공항,4371,3911,20200327,8282
20200324,5,송정,5792,5389,20200327,11181
20200324,5,마곡,7086,6617,20200327,13703
20200324,5,발산,15259,15597,20200327,30856
20200324,5,우장산,11163,11167,20200327,22330
20200324,5,화곡,24874,23074,20200327,47948
20200324,5,까치산,25138,23984,20200327,49122
20200324,5,신정,11839,9054,20200327,20893
20200324,5,목동,14552,16191,20200327,30743
20200324,5,오목교,18407,19853,20200327,38260
20200324,5,양평,6552,6459,20200327,13011
20200324,5,영등포구청,3486,3569,20200327,7055
20200324,5,영등포시장,7592,7683,20200327,15275
20200324,5,신길,3179,3491,20200327,6670
20200324,5,여의도,23037,24037,20200327,47074
20200324,5,여의나루,12210,12804,20200327,25014
20200324,5,마포,11896,12333,20200327,24229
20200324,5,공덕,11907,12771,20200327,24678
20200324,5,애오개,6026,5925,20200327,11951
20200324,5,충정로,3688,3848,20200327,7536
20200324,5,서대문,15350,15960,20200327,31310
20200324,5,광화문,25866,27164,20200327,53030
20200324,5,종로3가,9423,9276,20200327,18699
20200324,5,을지로4가,5172,5193,20200327,10365
20200324,5,동대문역사문화공원,2467,2829,20200327,5296
20200324,5,청구,3474,3160,20200327,6634
20200324,5,신금호,5017,5068,20200327,10085
20200324,5,행당,6724,5877,20200327,12601
20200324,5,왕십리,3742,4047,20200327,7789
20200324,5,마장,4560,4289,20200327,8849
20200324,5,답십리,13822,12691,20200327,26513
20200324,5,장한평,15610,15503,20200327,31113
20200324,5,군자,9220,9950,20200327,19170
20200324,5,아차산,11676,11489,20200327,23165
20200324,5,광나루,10553,9494,20200327,20047
20200324,5,천호,14280,14937,20200327,29217
20200324,5,강동,16872,14987,20200327,31859
20200324,5,길동,5832,6194,20200327,12026
20200324,5,굽은다리,7307,6948,20200327,14255
20200324,5,명일,6301,6567,20200327,12868
20200324,5,고덕,6615,6836,20200327,13451
20200324,5,상일동,14701,12777,20200327,27478
20200324,5,둔촌동,6631,6777,20200327,13408
20200324,5,올림픽공원,3135,2780,20200327,5915
20200324,5,방이,5533,5712,20200327,11245
20200324,5,오금,3065,3113,20200327,6178
20200324,5,개롱,5119,5259,20200327,10378
20200324,5,거여,6241,5863,20200327,12104
20200324,5,마천,4288,4366,20200327,8654
20200325,5,방화,5590,5219,20200328,10809
20200325,5,개화산,4703,4584,20200328,9287
20200325,5,김포공항,4423,4029,20200328,8452
20200325,5,송정,6015,5582,20200328,11597
20200325,5,마곡,7112,6800,20200328,13912
20200325,5,발산,15470,15921,20200328,31391
20200325,5,우장산,11271,11195,20200328,22466
20200325,5,화곡,25024,23184,20200328,48208
20200325,5,까치산,25541,24258,20200328,49799
20200325,5,신정,11918,9076,20200328,20994
20200325,5,목동,14604,16243,20200328,30847
20200325,5,오목교,18505,20006,20200328,38511
20200325,5,양평,6623,6485,20200328,13108
20200325,5,영등포구청,3494,3501,20200328,6995
20200325,5,영등포시장,7638,7838,20200328,15476
20200325,5,신길,3179,3576,20200328,6755
20200325,5,여의도,23147,24531,20200328,47678
20200325,5,여의나루,13340,14197,20200328,27537
20200325,5,마포,12148,12646,20200328,24794
20200325,5,공덕,11940,12714,20200328,24654
20200325,5,애오개,6072,6075,20200328,12147
20200325,5,충정로,3855,3848,20200328,7703
20200325,5,서대문,15453,15957,20200328,31410
20200325,5,광화문,25882,27225,20200328,53107
20200325,5,종로3가,9701,9756,20200328,19457
20200325,5,을지로4가,5124,5322,20200328,10446
20200325,5,동대문역사문화공원,2445,2775,20200328,5220
20200325,5,청구,3496,3177,20200328,6673
20200325,5,신금호,5114,5132,20200328,10246
20200325,5,행당,6780,5965,20200328,12745
20200325,5,왕십리,3844,4188,20200328,8032
20200325,5,마장,4589,4367,20200328,8956
20200325,5,답십리,13707,12449,20200328,26156
20200325,5,장한평,15605,15569,20200328,31174
20200325,5,군자,9546,10419,20200328,19965
20200325,5,아차산,11965,11646,20200328,23611
20200325,5,광나루,10639,9709,20200328,20348
20200325,5,천호,14509,15470,20200328,29979
20200325,5,강동,16663,14855,20200328,31518
20200325,5,길동,6152,6425,20200328,12577
20200325,5,굽은다리,7492,7097,20200328,14589
20200325,5,명일,6518,6772,20200328,13290
20200325,5,고덕,6772,6906,20200328,13678
20200325,5,상일동,14916,12842,20200328,27758
20200325,5,둔촌동,6918,6778,20200328,13696
20200325,5,올림픽공원,3268,2821,20200328,6089
20200325,5,방이,5617,5897,20200328,11514
20200325,5,오금,3054,3146,20200328,6200
20200325,5,개롱,5303,5402,20200328,10705
20200325,5,거여,6234,5900,20200328,12134
20200325,5,마천,4366,4436,20200328,8802
20200326,5,방화,5536,5274,20200329,10810
20200326,5,개화산,4710,4481,20200329,9191
20200326,5,김포공항,4202,3805,20200329,8007
20200326,5,송정,5806,5210,20200329,11016
20200326,5,마곡,6969,6657,20200329,13626
20200326,5,발산,15270,15678,20200329,30948
20200326,5,우장산,11031,10947,20200329,21978
20200326,5,화곡,24324,22594,20200329,46918
20200326,5,까치산,24965,23911,20200329,48876
20200326,5,신정,11728,9006,20200329,20734
20200326,5,목동,14221,15759,20200329,29980
20200326,5,오목교,17895,19380,20200329,37275
20200326,5,양평,6473,6545,20200329,13018
20200326,5,영등포구청,3393,3404,20200329,6797
20200326,5,영등포시장,7445,7689,20200329,15134
20200326,5,신길,3160,3566,20200329,6726
20200326,5,여의도,22668,23778,20200329,46446
20200326,5,여의나루,7247,7461,20200329,14708
20200326,5,마포,11846,12344,20200329,24190
20200326,5,공덕,11721,12610,20200329,24331
20200326,5,애오개,5858,6055,20200329,11913
20200326,5,충정로,3678,3837,20200329,7515
20200326,5,서대문,15372,15782,20200329,31154
20200326,5,광화문,25588,26732,20200329,52320
20200326,5,종로3가,9266,9368,20200329,18634
20200326,5,을지로4가,5094,5235,20200329,10329
20200326,5,동대문역사문화공원,2488,2747,20200329,5235
20200326,5,청구,3459,3152,20200329,6611
20200326,5,신금호,4934,5116,20200329,10050
20200326,5,행당,6624,5965,20200329,12589
20200326,5,왕십리,3758,4151,20200329,7909
20200326,5,마장,4493,4352,20200329,8845
20200326,5,답십리,13533,12477,20200329,26010
20200326,5,장한평,15499,15414,20200329,30913
20200326,5,군자,9357,10004,20200329,19361
20200326,5,아차산,11264,11271,20200329,22535
20200326,5,광나루,10382,9199,20200329,19581
20200326,5,천호,14082,14736,20200329,28818
20200326,5,강동,16529,14813,20200329,31342
20200326,5,길동,5819,6256,20200329,12075
20200326,5,굽은다리,7367,6898,20200329,14265
20200326,5,명일,6248,6633,20200329,12881
20200326,5,고덕,6656,6846,20200329,13502
20200326,5,상일동,14800,12717,20200329,27517
20200326,5,둔촌동,6555,6620,20200329,13175
20200326,5,올림픽공원,3005,2583,20200329,5588
20200326,5,방이,5561,5875,20200329,11436
20200326,5,오금,3109,3066,20200329,6175
20200326,5,개롱,5001,5265,20200329,10266
20200326,5,거여,6142,5709,20200329,11851
20200326,5,마천,4231,4283,20200329,8514
20200327,5,방화,5646,5254,20200330,10900
20200327,5,개화산,4778,4476,20200330,9254
20200327,5,김포공항,4481,4312,20200330,8793
20200327,5,송정,6025,5512,20200330,11537
20200327,5,마곡,7174,6756,20200330,13930
20200327,5,발산,15315,16141,20200330,31456
20200327,5,우장산,11494,11282,20200330,22776
20200327,5,화곡,25565,23131,20200330,48696
20200327,5,까치산,25893,24204,20200330,50097
20200327,5,신정,11915,8930,20200330,20845
20200327,5,목동,14807,16308,20200330,31115
20200327,5,오목교,19034,20576,20200330,39610
20200327,5,양평,6634,6399,20200330,13033
20200327,5,영등포구청,3354,3450,20200330,6804
20200327,5,영등포시장,7701,8021,20200330,15722
20200327,5,신길,3264,3489,20200330,6753
20200327,5,여의도,22761,23972,20200330,46733
20200327,5,여의나루,10784,11038,20200330,21822
20200327,5,마포,12067,12501,20200330,24568
20200327,5,공덕,11927,13073,20200330,25000
20200327,5,애오개,5991,6042,20200330,12033
20200327,5,충정로,3682,3743,20200330,7425
20200327,5,서대문,15096,15589,20200330,30685
20200327,5,광화문,24835,26425,20200330,51260
20200327,5,종로3가,9722,10204,20200330,19926
20200327,5,을지로4가,5047,5307,20200330,10354
20200327,5,동대문역사문화공원,2357,2792,20200330,5149
20200327,5,청구,3432,3147,20200330,6579
20200327,5,신금호,5138,5214,20200330,10352
20200327,5,행당,6859,5890,20200330,12749
20200327,5,왕십리,3910,4395,20200330,8305
20200327,5,마장,4801,4567,20200330,9368
20200327,5,답십리,13930,12591,20200330,26521
20200327,5,장한평,15692,15599,20200330,31291
20200327,5,군자,9721,10468,20200330,20189
20200327,5,아차산,11716,11344,20200330,23060
20200327,5,광나루,10576,9344,20200330,19920
20200327,5,천호,15119,16079,20200330,31198
20200327,5,강동,16928,14681,20200330,31609
20200327,5,길동,6230,6478,20200330,12708
20200327,5,굽은다리,7582,6996,20200330,14578
20200327,5,명일,6492,6694,20200330,13186
20200327,5,고덕,6813,6954,20200330,13767
20200327,5,상일동,14871,12591,20200330,27462
20200327,5,둔촌동,6819,6845,20200330,13664
20200327,5,올림픽공원,3140,2687,20200330,5827
20200327,5,방이,5682,5883,20200330,11565
20200327,5,오금,3054,3126,20200330,6180
20200327,5,개롱,5205,5255,20200330,10460
20200327,5,거여,6402,5941,20200330,12343
20200327,5,마천,4273,4186,20200330,8459
20200328,5,방화,3537,3348,20200331,6885
20200328,5,개화산,2860,2825,20200331,5685
20200328,5,김포공항,3629,3663,20200331,7292
20200328,5,송정,3964,3913,20200331,7877
20200328,5,마곡,2965,2760,20200331,5725
20200328,5,발산,8436,9125,20200331,17561
20200328,5,우장산,7073,6947,20200331,14020
20200328,5,화곡,15538,14052,20200331,29590
20200328,5,까치산,16549,15707,20200331,32256
20200328,5,신정,6697,5529,20200331,12226
20200328,5,목동,8438,8569,20200331,17007
20200328,5,오목교,11630,12048,20200331,23678
20200328,5,양평,2781,2672,20200331,5453
20200328,5,영등포구청,1477,1427,20200331,2904
20200328,5,영등포시장,4790,4855,20200331,9645
20200328,5,신길,1778,1903,20200331,3681
20200328,5,여의도,7338,7642,20200331,14980
20200328,5,여의나루,11348,12493,20200331,23841
20200328,5,마포,5124,5156,20200331,10280
20200328,5,공덕,5046,5271,20200331,10317
20200328,5,애오개,2689,2649,20200331,5338
20200328,5,충정로,1347,1302,20200331,2649
20200328,5,서대문,5081,4988,20200331,10069
20200328,5,광화문,8586,8634,20200331,17220
20200328,5,종로3가,7019,7323,20200331,14342
20200328,5,을지로4가,2345,2654,20200331,4999
20200328,5,동대문역사문화공원,681,801,20200331,1482
20200328,5,청구,2001,1664,20200331,3665
20200328,5,신금호,3138,3159,20200331,6297
20200328,5,행당,3887,3420,20200331,7307
20200328,5,왕십리,2548,3139,20200331,5687
20200328,5,마장,2888,2754,20200331,5642
20200328,5,답십리,7779,6828,20200331,14607
20200328,5,장한평,8135,8115,20200331,16250
20200328,5,군자,6309,6878,20200331,13187
20200328,5,아차산,9585,9504,20200331,19089
20200328,5,광나루,7105,6905,20200331,14010
20200328,5,천호,11984,12022,20200331,24006
20200328,5,강동,10247,9065,20200331,19312
20200328,5,길동,4068,4210,20200331,8278
20200328,5,굽은다리,4942,4598,20200331,9540
20200328,5,명일,3791,3679,20200331,7470
20200328,5,고덕,3942,3798,20200331,7740
20200328,5,상일동,7504,6641,20200331,14145
20200328,5,둔촌동,4415,4261,20200331,8676
20200328,5,올림픽공원,1979,1879,20200331,3858
20200328,5,방이,3575,3365,20200331,6940
20200328,5,오금,1510,1486,20200331,2996
20200328,5,개롱,2990,3156,20200331,6146
20200328,5,거여,3699,3516,20200331,7215
20200328,5,마천,3171,3154,20200331,6325
20200329,5,방화,2590,2548,20200401,5138
20200329,5,개화산,2075,2165,20200401,4240
20200329,5,김포공항,3348,3096,20200401,6444
20200329,5,송정,2706,2840,20200401,5546
20200329,5,마곡,1806,1866,20200401,3672
20200329,5,발산,5496,5709,20200401,11205
20200329,5,우장산,4555,4560,20200401,9115
20200329,5,화곡,10113,9420,20200401,19533
20200329,5,까치산,11383,10986,20200401,22369
20200329,5,신정,4457,3802,20200401,8259
20200329,5,목동,5291,5536,20200401,10827
20200329,5,오목교,8262,8698,20200401,16960
20200329,5,양평,1812,1905,20200401,3717
20200329,5,영등포구청,982,949,20200401,1931
20200329,5,영등포시장,2862,3002,20200401,5864
20200329,5,신길,1173,1332,20200401,2505
20200329,5,여의도,4680,4824,20200401,9504
20200329,5,여의나루,12545,13724,20200401,26269
20200329,5,마포,3322,3245,20200401,6567
20200329,5,공덕,3231,3291,20200401,6522
20200329,5,애오개,1822,1857,20200401,3679
20200329,5,충정로,930,904,20200401,1834
20200329,5,서대문,3255,3184,20200401,6439
20200329,5,광화문,6077,5973,20200401,12050
20200329,5,종로3가,4650,4283,20200401,8933
20200329,5,을지로4가,886,955,20200401,1841
20200329,5,동대문역사문화공원,367,484,20200401,851
20200329,5,청구,1254,1141,20200401,2395
20200329,5,신금호,2051,2199,20200401,4250
20200329,5,행당,2577,2374,20200401,4951
20200329,5,왕십리,1687,2088,20200401,3775
20200329,5,마장,1937,1839,20200401,3776
20200329,5,답십리,5194,4691,20200401,9885
20200329,5,장한평,5100,5004,20200401,10104
20200329,5,군자,4186,4539,20200401,8725
20200329,5,아차산,7784,8021,20200401,15805
20200329,5,광나루,5405,5570,20200401,10975
20200329,5,천호,8529,8351,20200401,16880
20200329,5,강동,6683,6191,20200401,12874
20200329,5,길동,2722,2752,20200401,5474
20200329,5,굽은다리,3406,3169,20200401,6575
20200329,5,명일,2555,2544,20200401,5099
20200329,5,고덕,2543,2601,20200401,5144
20200329,5,상일동,4955,4662,20200401,9617
20200329,5,둔촌동,2816,2814,20200401,5630
20200329,5,올림픽공원,1489,1465,20200401,2954
20200329,5,방이,2505,2413,20200401,4918
20200329,5,오금,963,957,20200401,1920
20200329,5,개롱,1995,2318,20200401,4313
20200329,5,거여,2383,2359,20200401,4742
20200329,5,마천,2272,2540,20200401,4812
20200330,5,방화,5661,5342,20200402,11003
20200330,5,개화산,4865,4705,20200402,9570
20200330,5,김포공항,4246,3841,20200402,8087
20200330,5,송정,5998,5514,20200402,11512
20200330,5,마곡,7285,6872,20200402,14157
20200330,5,발산,15994,16324,20200402,32318
20200330,5,우장산,11270,11279,20200402,22549
20200330,5,화곡,25135,23432,20200402,48567
20200330,5,까치산,25604,24481,20200402,50085
20200330,5,신정,11846,9094,20200402,20940
20200330,5,목동,14523,16219,20200402,30742
20200330,5,오목교,18262,19676,20200402,37938
20200330,5,양평,6624,6634,20200402,13258
20200330,5,영등포구청,3534,3541,20200402,7075
20200330,5,영등포시장,7758,7937,20200402,15695
20200330,5,신길,3169,3571,20200402,6740
20200330,5,여의도,23224,24486,20200402,47710
20200330,5,여의나루,12125,12742,20200402,24867
20200330,5,마포,12108,12460,20200402,24568
20200330,5,공덕,11833,12834,20200402,24667
20200330,5,애오개,5976,6025,20200402,12001
20200330,5,충정로,4065,4152,20200402,8217
20200330,5,서대문,15372,15992,20200402,31364
20200330,5,광화문,26052,26951,20200402,53003
20200330,5,종로3가,9320,9219,20200402,18539
20200330,5,을지로4가,5178,5259,20200402,10437
20200330,5,동대문역사문화공원,2507,2854,20200402,5361
20200330,5,청구,3534,3145,20200402,6679
20200330,5,신금호,4971,5206,20200402,10177
20200330,5,행당,6809,6040,20200402,12849
20200330,5,왕십리,3684,4089,20200402,7773
20200330,5,마장,4699,4372,20200402,9071
20200330,5,답십리,13924,12755,20200402,26679
20200330,5,장한평,15686,15566,20200402,31252
20200330,5,군자,9272,9829,20200402,19101
20200330,5,아차산,11579,11600,20200402,23179
20200330,5,광나루,10563,9579,20200402,20142
20200330,5,천호,14487,14996,20200402,29483
20200330,5,강동,16937,15051,20200402,31988
20200330,5,길동,6184,6552,20200402,12736
20200330,5,굽은다리,7335,7033,20200402,14368
20200330,5,명일,6594,6799,20200402,13393
20200330,5,고덕,6849,7069,20200402,13918
20200330,5,상일동,15218,13148,20200402,28366
20200330,5,둔촌동,6661,6692,20200402,13353
20200330,5,올림픽공원,3067,2803,20200402,5870
20200330,5,방이,5656,5858,20200402,11514
20200330,5,오금,3042,3075,20200402,6117
20200330,5,개롱,5216,5423,20200402,10639
20200330,5,거여,6300,5875,20200402,12175
20200330,5,마천,4301,4309,20200402,8610
20200331,5,방화,5640,5338,20200403,10978
20200331,5,개화산,4870,4662,20200403,9532
20200331,5,김포공항,4396,3946,20200403,8342
20200331,5,송정,6024,5491,20200403,11515
20200331,5,마곡,7189,6882,20200403,14071
20200331,5,발산,15971,16201,20200403,32172
20200331,5,우장산,11312,11356,20200403,22668
20200331,5,화곡,25066,23252,20200403,48318
20200331,5,까치산,25613,24256,20200403,49869
20200331,5,신정,11970,9137,20200403,21107
20200331,5,목동,14747,16315,20200403,31062
20200331,5,오목교,18772,20331,20200403,39103
20200331,5,양평,6596,6609,20200403,13205
20200331,5,영등포구청,3475,3546,20200403,7021
20200331,5,영등포시장,7660,7908,20200403,15568
20200331,5,신길,3377,3608,20200403,6985
20200331,5,여의도,23283,24720,20200403,48003
20200331,5,여의나루,12654,13449,20200403,26103
20200331,5,마포,12180,12760,20200403,24940
20200331,5,공덕,12244,13175,20200403,25419
20200331,5,애오개,6005,6073,20200403,12078
20200331,5,충정로,3938,4042,20200403,7980
20200331,5,서대문,15567,16193,20200403,31760
20200331,5,광화문,26152,27440,20200403,53592
20200331,5,종로3가,9257,9384,20200403,18641
20200331,5,을지로4가,5185,5412,20200403,10597
20200331,5,동대문역사문화공원,2458,2838,20200403,5296
20200331,5,청구,3455,3168,20200403,6623
20200331,5,신금호,5126,5176,20200403,10302
20200331,5,행당,6916,6109,20200403,13025
20200331,5,왕십리,3739,4168,20200403,7907
20200331,5,마장,4618,4378,20200403,8996
20200331,5,답십리,13912,12782,20200403,26694
20200331,5,장한평,15802,15762,20200403,31564
20200331,5,군자,9279,10156,20200403,19435
20200331,5,아차산,12016,11835,20200403,23851
20200331,5,광나루,10639,9637,20200403,20276
20200331,5,천호,14583,15359,20200403,29942
20200331,5,강동,16926,15102,20200403,32028
20200331,5,길동,6087,6358,20200403,12445
20200331,5,굽은다리,7491,7010,20200403,14501
20200331,5,명일,6503,6694,20200403,13197
20200331,5,고덕,6766,7005,20200403,13771
20200331,5,상일동,15335,13000,20200403,28335
20200331,5,둔촌동,6744,6800,20200403,13544
20200331,5,올림픽공원,3083,2797,20200403,5880
20200331,5,방이,5703,6007,20200403,11710
20200331,5,오금,3015,3085,20200403,6100
20200331,5,개롱,5259,5407,20200403,10666
20200331,5,거여,6368,5979,20200403,12347
20200331,5,마천,4329,4423,20200403,8752
20200401,5,방화,5607,5359,20200404,10966
20200401,5,개화산,4815,4612,20200404,9427
20200401,5,김포공항,4269,4024,20200404,8293
20200401,5,송정,5930,5395,20200404,11325
20200401,5,마곡,7310,6889,20200404,14199
20200401,5,발산,16042,16301,20200404,32343
20200401,5,우장산,11324,11230,20200404,22554
20200401,5,화곡,25159,23217,20200404,48376
20200401,5,까치산,25605,24284,20200404,49889
20200401,5,신정,12076,9183,20200404,21259
20200401,5,목동,14670,16250,20200404,30920
20200401,5,오목교,18745,20134,20200404,38879
20200401,5,양평,6731,6757,20200404,13488
20200401,5,영등포구청,3434,3541,20200404,6975
20200401,5,영등포시장,7674,7974,20200404,15648
20200401,5,신길,3234,3627,20200404,6861
20200401,5,여의도,23655,24829,20200404,48484
20200401,5,여의나루,11510,12394,20200404,23904
20200401,5,마포,12331,12832,20200404,25163
20200401,5,공덕,12191,13016,20200404,25207
20200401,5,애오개,6010,6077,20200404,12087
20200401,5,충정로,3918,4025,20200404,7943
20200401,5,서대문,15565,15950,20200404,31515
20200401,5,광화문,26495,27659,20200404,54154
20200401,5,종로3가,9751,9507,20200404,19258
20200401,5,을지로4가,5132,5277,20200404,10409
20200401,5,동대문역사문화공원,2513,2854,20200404,5367
20200401,5,청구,3479,3216,20200404,6695
20200401,5,신금호,5149,5297,20200404,10446
20200401,5,행당,6820,6006,20200404,12826
20200401,5,왕십리,3907,4339,20200404,8246
20200401,5,마장,4675,4413,20200404,9088
20200401,5,답십리,13829,12582,20200404,26411
20200401,5,장한평,15788,15733,20200404,31521
20200401,5,군자,9484,10536,20200404,20020
20200401,5,아차산,11889,11859,20200404,23748
20200401,5,광나루,10823,9696,20200404,20519
20200401,5,천호,14605,15249,20200404,29854
20200401,5,강동,16826,14887,20200404,31713
20200401,5,길동,6197,6476,20200404,12673
20200401,5,굽은다리,7467,6965,20200404,14432
20200401,5,명일,6526,6813,20200404,13339
20200401,5,고덕,6746,6893,20200404,13639
20200401,5,상일동,15116,13042,20200404,28158
20200401,5,둔촌동,6719,6775,20200404,13494
20200401,5,올림픽공원,3177,2754,20200404,5931
20200401,5,방이,5728,5895,20200404,11623
20200401,5,오금,3041,3090,20200404,6131
20200401,5,개롱,5093,5302,20200404,10395
20200401,5,거여,6435,5997,20200404,12432
20200401,5,마천,4311,4274,20200404,8585
20200402,5,방화,5704,5323,20200405,11027
20200402,5,개화산,4790,4634,20200405,9424
20200402,5,김포공항,4148,4078,20200405,8226
20200402,5,송정,5939,5389,20200405,11328
20200402,5,마곡,7260,6876,20200405,14136
20200402,5,발산,16249,16585,20200405,32834
20200402,5,우장산,11315,11309,20200405,22624
20200402,5,화곡,24920,23181,20200405,48101
20200402,5,까치산,25542,24276,20200405,49818
20200402,5,신정,11996,9099,20200405,21095
20200402,5,목동,14761,16338,20200405,31099
20200402,5,오목교,18731,20240,20200405,38971
20200402,5,양평,6789,6708,20200405,13497
20200402,5,영등포구청,3483,3496,20200405,6979
20200402,5,영등포시장,7589,7676,20200405,15265
20200402,5,신길,3202,3592,20200405,6794
20200402,5,여의도,23154,24641,20200405,47795
20200402,5,여의나루,10808,11341,20200405,22149
20200402,5,마포,12114,12472,20200405,24586
20200402,5,공덕,12060,13015,20200405,25075
20200402,5,애오개,6112,6114,20200405,12226
20200402,5,충정로,3886,3954,20200405,7840
20200402,5,서대문,15378,15935,20200405,31313
20200402,5,광화문,26256,27566,20200405,53822
20200402,5,종로3가,9377,9422,20200405,18799
20200402,5,을지로4가,5140,5346,20200405,10486
20200402,5,동대문역사문화공원,2473,2829,20200405,5302
20200402,5,청구,3546,3210,20200405,6756
20200402,5,신금호,5144,5252,20200405,10396
20200402,5,행당,6832,6130,20200405,12962
20200402,5,왕십리,3843,4291,20200405,8134
20200402,5,마장,4678,4449,20200405,9127
20200402,5,답십리,13816,12613,20200405,26429
20200402,5,장한평,15722,15843,20200405,31565
20200402,5,군자,9564,10189,20200405,19753
20200402,5,아차산,12092,12045,20200405,24137
20200402,5,광나루,10954,9723,20200405,20677
20200402,5,천호,14549,15268,20200405,29817
20200402,5,강동,17073,14999,20200405,32072
20200402,5,길동,5973,6363,20200405,12336
20200402,5,굽은다리,7389,6918,20200405,14307
20200402,5,명일,6476,6802,20200405,13278
20200402,5,고덕,6756,6986,20200405,13742
20200402,5,상일동,15134,13055,20200405,28189
20200402,5,둔촌동,6701,6689,20200405,13390
20200402,5,올림픽공원,3119,2849,20200405,5968
20200402,5,방이,5696,5891,20200405,11587
20200402,5,오금,3111,3160,20200405,6271
20200402,5,개롱,5103,5235,20200405,10338
20200402,5,거여,6184,5806,20200405,11990
20200402,5,마천,4282,4358,20200405,8640
20200403,5,방화,5916,5466,20200406,11382
20200403,5,개화산,4913,4611,20200406,9524
20200403,5,김포공항,4598,4411,20200406,9009
20200403,5,송정,6103,5590,20200406,11693
20200403,5,마곡,7551,6930,20200406,14481
20200403,5,발산,16155,16852,20200406,33007
20200403,5,우장산,11708,11502,20200406,23210
20200403,5,화곡,25929,23548,20200406,49477
20200403,5,까치산,26376,24614,20200406,50990
20200403,5,신정,12184,9104,20200406,21288
20200403,5,목동,15153,16657,20200406,31810
20200403,5,오목교,19694,21178,20200406,40872
20200403,5,양평,6658,6482,20200406,13140
20200403,5,영등포구청,3610,3575,20200406,7185
20200403,5,영등포시장,7856,7938,20200406,15794
20200403,5,신길,3226,3530,20200406,6756
20200403,5,여의도,23144,24536,20200406,47680
20200403,5,여의나루,11988,12051,20200406,24039
20200403,5,마포,12280,12751,20200406,25031
20200403,5,공덕,12192,13385,20200406,25577
20200403,5,애오개,6187,6202,20200406,12389
20200403,5,충정로,3872,3937,20200406,7809
20200403,5,서대문,15328,15883,20200406,31211
20200403,5,광화문,25966,27356,20200406,53322
20200403,5,종로3가,9731,10268,20200406,19999
20200403,5,을지로4가,5079,5324,20200406,10403
20200403,5,동대문역사문화공원,2354,2732,20200406,5086
20200403,5,청구,3527,3258,20200406,6785
20200403,5,신금호,5296,5302,20200406,10598
20200403,5,행당,7007,6096,20200406,13103
20200403,5,왕십리,3879,4646,20200406,8525
20200403,5,마장,4676,4438,20200406,9114
20200403,5,답십리,14132,12680,20200406,26812
20200403,5,장한평,15903,15921,20200406,31824
20200403,5,군자,9719,10781,20200406,20500
20200403,5,아차산,12170,11877,20200406,24047
20200403,5,광나루,11089,9689,20200406,20778
20200403,5,천호,15347,16292,20200406,31639
20200403,5,강동,17472,14966,20200406,32438
20200403,5,길동,6311,6664,20200406,12975
20200403,5,굽은다리,7593,6963,20200406,14556
20200403,5,명일,6727,6861,20200406,13588
20200403,5,고덕,6944,7008,20200406,13952
20200403,5,상일동,15564,13163,20200406,28727
20200403,5,둔촌동,6836,6850,20200406,13686
20200403,5,올림픽공원,3211,2730,20200406,5941
20200403,5,방이,5928,6053,20200406,11981
20200403,5,오금,3122,3106,20200406,6228
20200403,5,개롱,5352,5324,20200406,10676
20200403,5,거여,6390,5942,20200406,12332
20200403,5,마천,4466,4351,20200406,8817
20200404,5,방화,3578,3381,20200407,6959
20200404,5,개화산,2999,3016,20200407,6015
20200404,5,김포공항,3744,3855,20200407,7599
20200404,5,송정,3982,3802,20200407,7784
20200404,5,마곡,2969,2854,20200407,5823
20200404,5,발산,8767,9197,20200407,17964
20200404,5,우장산,7026,7011,20200407,14037
20200404,5,화곡,15484,14035,20200407,29519
20200404,5,까치산,16626,15823,20200407,32449
20200404,5,신정,6731,5517,20200407,12248
20200404,5,목동,8538,8880,20200407,17418
20200404,5,오목교,11804,12392,20200407,24196
20200404,5,양평,2721,2643,20200407,5364
20200404,5,영등포구청,1357,1327,20200407,2684
20200404,5,영등포시장,4702,4894,20200407,9596
20200404,5,신길,1667,1852,20200407,3519
20200404,5,여의도,6802,6939,20200407,13741
20200404,5,여의나루,10469,10345,20200407,20814
20200404,5,마포,5335,5201,20200407,10536
20200404,5,공덕,4938,5348,20200407,10286
20200404,5,애오개,2862,2724,20200407,5586
20200404,5,충정로,1420,1330,20200407,2750
20200404,5,서대문,5128,4833,20200407,9961
20200404,5,광화문,8754,8559,20200407,17313
20200404,5,종로3가,7011,7113,20200407,14124
20200404,5,을지로4가,2287,2664,20200407,4951
20200404,5,동대문역사문화공원,715,828,20200407,1543
20200404,5,청구,2021,1776,20200407,3797
20200404,5,신금호,3212,3215,20200407,6427
20200404,5,행당,4004,3480,20200407,7484
20200404,5,왕십리,2619,3042,20200407,5661
20200404,5,마장,2960,2888,20200407,5848
20200404,5,답십리,7762,7112,20200407,14874
20200404,5,장한평,8364,8208,20200407,16572
20200404,5,군자,6160,6909,20200407,13069
20200404,5,아차산,9689,9703,20200407,19392
20200404,5,광나루,7358,7232,20200407,14590
20200404,5,천호,12210,12165,20200407,24375
20200404,5,강동,10143,9273,20200407,19416
20200404,5,길동,4124,4320,20200407,8444
20200404,5,굽은다리,4910,4462,20200407,9372
20200404,5,명일,3983,3893,20200407,7876
20200404,5,고덕,4019,3901,20200407,7920
20200404,5,상일동,7896,6996,20200407,14892
20200404,5,둔촌동,4217,4270,20200407,8487
20200404,5,올림픽공원,2049,1900,20200407,3949
20200404,5,방이,3598,3568,20200407,7166
20200404,5,오금,1473,1498,20200407,2971
20200404,5,개롱,3044,3144,20200407,6188
20200404,5,거여,3755,3625,20200407,7380
20200404,5,마천,3130,3153,20200407,6283
20200405,5,방화,2634,2539,20200408,5173
20200405,5,개화산,2017,2129,20200408,4146
20200405,5,김포공항,3639,2998,20200408,6637
20200405,5,송정,2828,2864,20200408,5692
20200405,5,마곡,1802,1888,20200408,3690
20200405,5,발산,5519,5796,20200408,11315
20200405,5,우장산,4597,4728,20200408,9325
20200405,5,화곡,10164,9407,20200408,19571
20200405,5,까치산,11381,11145,20200408,22526
20200405,5,신정,4436,3793,20200408,8229
20200405,5,목동,5341,5521,20200408,10862
20200405,5,오목교,8293,8724,20200408,17017
20200405,5,양평,1767,1875,20200408,3642
20200405,5,영등포구청,869,913,20200408,1782
20200405,5,영등포시장,2757,2899,20200408,5656
20200405,5,신길,1187,1331,20200408,2518
20200405,5,여의도,4143,4229,20200408,8372
20200405,5,여의나루,8374,8149,20200408,16523
20200405,5,마포,3232,3218,20200408,6450
20200405,5,공덕,2979,3152,20200408,6131
20200405,5,애오개,1858,1922,20200408,3780
20200405,5,충정로,919,983,20200408,1902
20200405,5,서대문,3150,3109,20200408,6259
20200405,5,광화문,6089,5994,20200408,12083
20200405,5,종로3가,4633,4255,20200408,8888
20200405,5,을지로4가,836,950,20200408,1786
20200405,5,동대문역사문화공원,347,476,20200408,823
20200405,5,청구,1234,1138,20200408,2372
20200405,5,신금호,1994,2145,20200408,4139
20200405,5,행당,2579,2344,20200408,4923
20200405,5,왕십리,1735,2024,20200408,3759
20200405,5,마장,1980,1885,20200408,3865
20200405,5,답십리,5063,4632,20200408,9695
20200405,5,장한평,5220,5155,20200408,10375
20200405,5,군자,4218,4631,20200408,8849
20200405,5,아차산,7677,8049,20200408,15726
20200405,5,광나루,5360,5309,20200408,10669
20200405,5,천호,8645,8325,20200408,16970
20200405,5,강동,6744,6247,20200408,12991
20200405,5,길동,2697,2716,20200408,5413
20200405,5,굽은다리,3332,3094,20200408,6426
20200405,5,명일,2607,2631,20200408,5238
20200405,5,고덕,2609,2562,20200408,5171
20200405,5,상일동,5012,4758,20200408,9770
20200405,5,둔촌동,2837,2921,20200408,5758
20200405,5,올림픽공원,1454,1351,20200408,2805
20200405,5,방이,2461,2367,20200408,4828
20200405,5,오금,1025,1010,20200408,2035
20200405,5,개롱,2054,2203,20200408,4257
20200405,5,거여,2377,2383,20200408,4760
20200405,5,마천,2121,2415,20200408,4536
20200406,5,방화,5899,5625,20200409,11524
20200406,5,개화산,4866,4669,20200409,9535
20200406,5,김포공항,4551,4006,20200409,8557
20200406,5,송정,6157,5634,20200409,11791
20200406,5,마곡,7663,7224,20200409,14887
20200406,5,발산,16190,16328,20200409,32518
20200406,5,우장산,11763,11835,20200409,23598
20200406,5,화곡,25592,23971,20200409,49563
20200406,5,까치산,26035,24904,20200409,50939
20200406,5,신정,12153,9350,20200409,21503
20200406,5,목동,15054,16750,20200409,31804
20200406,5,오목교,18918,20313,20200409,39231
20200406,5,양평,6732,6775,20200409,13507
20200406,5,영등포구청,3604,3569,20200409,7173
20200406,5,영등포시장,7860,7999,20200409,15859
20200406,5,신길,3234,3615,20200409,6849
20200406,5,여의도,23817,24823,20200409,48640
20200406,5,여의나루,9388,9625,20200409,19013
20200406,5,마포,12437,12828,20200409,25265
20200406,5,공덕,12305,13182,20200409,25487
20200406,5,애오개,6184,6284,20200409,12468
20200406,5,충정로,4074,4189,20200409,8263
20200406,5,서대문,16031,16464,20200409,32495
20200406,5,광화문,27063,28265,20200409,55328
20200406,5,종로3가,9097,9156,20200409,18253
20200406,5,을지로4가,5415,5614,20200409,11029
20200406,5,동대문역사문화공원,2525,2904,20200409,5429
20200406,5,청구,3571,3234,20200409,6805
20200406,5,신금호,5230,5395,20200409,10625
20200406,5,행당,7139,6327,20200409,13466
20200406,5,왕십리,3788,4149,20200409,7937
20200406,5,마장,4738,4465,20200409,9203
20200406,5,답십리,13977,13041,20200409,27018
20200406,5,장한평,16085,16048,20200409,32133
20200406,5,군자,9544,10430,20200409,19974
20200406,5,아차산,11945,11825,20200409,23770
20200406,5,광나루,10871,9697,20200409,20568
20200406,5,천호,14467,15168,20200409,29635
20200406,5,강동,17299,15469,20200409,32768
20200406,5,길동,6117,6540,20200409,12657
20200406,5,굽은다리,7420,7111,20200409,14531
20200406,5,명일,6818,7018,20200409,13836
20200406,5,고덕,7119,7370,20200409,14489
20200406,5,상일동,15916,13704,20200409,29620
20200406,5,둔촌동,6889,6963,20200409,13852
20200406,5,올림픽공원,3119,2798,20200409,5917
20200406,5,방이,5861,6037,20200409,11898
20200406,5,오금,3092,3083,20200409,6175
20200406,5,개롱,5295,5570,20200409,10865
20200406,5,거여,6525,6171,20200409,12696
20200406,5,마천,4439,4424,20200409,8863
20200407,5,방화,5844,5553,20200410,11397
20200407,5,개화산,4876,4651,20200410,9527
20200407,5,김포공항,4250,3974,20200410,8224
20200407,5,송정,6266,5647,20200410,11913
20200407,5,마곡,7610,7189,20200410,14799
20200407,5,발산,16334,16748,20200410,33082
20200407,5,우장산,11742,11622,20200410,23364
20200407,5,화곡,26064,24057,20200410,50121
20200407,5,까치산,26205,24989,20200410,51194
20200407,5,신정,12246,9336,20200410,21582
20200407,5,목동,15195,16910,20200410,32105
20200407,5,오목교,19238,20584,20200410,39822
20200407,5,양평,6860,6788,20200410,13648
20200407,5,영등포구청,3604,3644,20200410,7248
20200407,5,영등포시장,7938,8060,20200410,15998
20200407,5,신길,3298,3645,20200410,6943
20200407,5,여의도,23804,24986,20200410,48790
20200407,5,여의나루,9118,9327,20200410,18445
20200407,5,마포,12650,13106,20200410,25756
20200407,5,공덕,12441,13406,20200410,25847
20200407,5,애오개,6251,6267,20200410,12518
20200407,5,충정로,3935,4063,20200410,7998
20200407,5,서대문,16058,16787,20200410,32845
20200407,5,광화문,26691,28303,20200410,54994
20200407,5,종로3가,9653,9644,20200410,19297
20200407,5,을지로4가,5411,5610,20200410,11021
20200407,5,동대문역사문화공원,2500,2873,20200410,5373
20200407,5,청구,3660,3207,20200410,6867
20200407,5,신금호,5468,5591,20200410,11059
20200407,5,행당,7036,6311,20200410,13347
20200407,5,왕십리,3863,4218,20200410,8081
20200407,5,마장,4692,4475,20200410,9167
20200407,5,답십리,14275,13032,20200410,27307
20200407,5,장한평,16200,16083,20200410,32283
20200407,5,군자,9788,10570,20200410,20358
20200407,5,아차산,12397,12325,20200410,24722
20200407,5,광나루,11279,10014,20200410,21293
20200407,5,천호,15053,15742,20200410,30795
20200407,5,강동,17363,15475,20200410,32838
20200407,5,길동,6211,6527,20200410,12738
20200407,5,굽은다리,7520,7094,20200410,14614
20200407,5,명일,6722,6924,20200410,13646
20200407,5,고덕,7118,7326,20200410,14444
20200407,5,상일동,16024,13805,20200410,29829
20200407,5,둔촌동,6935,6964,20200410,13899
20200407,5,올림픽공원,3074,2668,20200410,5742
20200407,5,방이,5918,6107,20200410,12025
20200407,5,오금,3134,3143,20200410,6277
20200407,5,개롱,5396,5569,20200410,10965
20200407,5,거여,6640,6195,20200410,12835
20200407,5,마천,4415,4512,20200410,8927
20200408,5,방화,5957,5650,20200411,11607
20200408,5,개화산,4868,4764,20200411,9632
20200408,5,김포공항,4391,4034,20200411,8425
20200408,5,송정,6063,5651,20200411,11714
20200408,5,마곡,7556,7102,20200411,14658
20200408,5,발산,16849,17346,20200411,34195
20200408,5,우장산,11864,11796,20200411,23660
20200408,5,화곡,25781,23862,20200411,49643
20200408,5,까치산,26439,25263,20200411,51702
20200408,5,신정,12199,9364,20200411,21563
20200408,5,목동,15132,16839,20200411,31971
20200408,5,오목교,19460,20839,20200411,40299
20200408,5,양평,6804,6711,20200411,13515
20200408,5,영등포구청,3632,3648,20200411,7280
20200408,5,영등포시장,7830,8168,20200411,15998
20200408,5,신길,3376,3717,20200411,7093
20200408,5,여의도,23841,25025,20200411,48866
20200408,5,여의나루,8713,8940,20200411,17653
20200408,5,마포,12654,12979,20200411,25633
20200408,5,공덕,12565,13638,20200411,26203
20200408,5,애오개,6252,6331,20200411,12583
20200408,5,충정로,4116,4171,20200411,8287
20200408,5,서대문,16090,16632,20200411,32722
20200408,5,광화문,27464,28840,20200411,56304
20200408,5,종로3가,9674,9516,20200411,19190
20200408,5,을지로4가,5415,5523,20200411,10938
20200408,5,동대문역사문화공원,2453,2853,20200411,5306
20200408,5,청구,3615,3195,20200411,6810
20200408,5,신금호,5302,5387,20200411,10689
20200408,5,행당,7193,6388,20200411,13581
20200408,5,왕십리,3874,4316,20200411,8190
20200408,5,마장,4763,4519,20200411,9282
20200408,5,답십리,14287,13083,20200411,27370
20200408,5,장한평,16390,16219,20200411,32609
20200408,5,군자,9621,10589,20200411,20210
20200408,5,아차산,12333,12231,20200411,24564
20200408,5,광나루,11037,9887,20200411,20924
20200408,5,천호,14874,15652,20200411,30526
20200408,5,강동,17440,15394,20200411,32834
20200408,5,길동,6242,6579,20200411,12821
20200408,5,굽은다리,7604,7228,20200411,14832
20200408,5,명일,6859,7077,20200411,13936
20200408,5,고덕,7166,7397,20200411,14563
20200408,5,상일동,15941,13840,20200411,29781
20200408,5,둔촌동,6961,7028,20200411,13989
20200408,5,올림픽공원,3270,2794,20200411,6064
20200408,5,방이,5885,6159,20200411,12044
20200408,5,오금,3115,3164,20200411,6279
20200408,5,개롱,5368,5530,20200411,10898
20200408,5,거여,6589,6135,20200411,12724
20200408,5,마천,4511,4505,20200411,9016
20200409,5,방화,5848,5506,20200412,11354
20200409,5,개화산,4947,4688,20200412,9635
20200409,5,김포공항,4402,4197,20200412,8599
20200409,5,송정,6175,5744,20200412,11919
20200409,5,마곡,7449,7004,20200412,14453
20200409,5,발산,16703,16866,20200412,33569
20200409,5,우장산,11753,11691,20200412,23444
20200409,5,화곡,25820,23774,20200412,49594
20200409,5,까치산,26213,24880,20200412,51093
20200409,5,신정,12260,9380,20200412,21640
20200409,5,목동,15274,16779,20200412,32053
20200409,5,오목교,19582,20856,20200412,40438
20200409,5,양평,6751,6695,20200412,13446
20200409,5,영등포구청,3673,3693,20200412,7366
20200409,5,영등포시장,7928,8126,20200412,16054
20200409,5,신길,3331,3724,20200412,7055
20200409,5,여의도,23738,25143,20200412,48881
20200409,5,여의나루,8505,8762,20200412,17267
20200409,5,마포,12421,12887,20200412,25308
20200409,5,공덕,12370,13527,20200412,25897
20200409,5,애오개,6310,6325,20200412,12635
20200409,5,충정로,4044,4152,20200412,8196
20200409,5,서대문,16035,16572,20200412,32607
20200409,5,광화문,27210,28664,20200412,55874
20200409,5,종로3가,9563,9596,20200412,19159
20200409,5,을지로4가,5444,5639,20200412,11083
20200409,5,동대문역사문화공원,2521,2889,20200412,5410
20200409,5,청구,3651,3285,20200412,6936
20200409,5,신금호,5321,5477,20200412,10798
20200409,5,행당,7082,6296,20200412,13378
20200409,5,왕십리,3831,4335,20200412,8166
20200409,5,마장,4884,4588,20200412,9472
20200409,5,답십리,14321,13076,20200412,27397
20200409,5,장한평,16247,16095,20200412,32342
20200409,5,군자,9669,10625,20200412,20294
20200409,5,아차산,12252,12044,20200412,24296
20200409,5,광나루,11087,9837,20200412,20924
20200409,5,천호,14834,15514,20200412,30348
20200409,5,강동,17452,15505,20200412,32957
20200409,5,길동,6178,6502,20200412,12680
20200409,5,굽은다리,7511,7140,20200412,14651
20200409,5,명일,6677,6965,20200412,13642
20200409,5,고덕,7161,7305,20200412,14466
20200409,5,상일동,16068,13753,20200412,29821
20200409,5,둔촌동,6978,6923,20200412,13901
20200409,5,올림픽공원,3180,2770,20200412,5950
20200409,5,방이,5915,6145,20200412,12060
20200409,5,오금,3148,3145,20200412,6293
20200409,5,개롱,5276,5480,20200412,10756
20200409,5,거여,6613,6072,20200412,12685
20200409,5,마천,4536,4520,20200412,9056
20200410,5,방화,5929,5428,20200413,11357
20200410,5,개화산,5000,4628,20200413,9628
20200410,5,김포공항,4647,4483,20200413,9130
20200410,5,송정,6593,6017,20200413,12610
20200410,5,마곡,6819,6414,20200413,13233
20200410,5,발산,15183,16157,20200413,31340
20200410,5,우장산,12038,11872,20200413,23910
20200410,5,화곡,26336,23995,20200413,50331
20200410,5,까치산,26650,24984,20200413,51634
20200410,5,신정,12371,9254,20200413,21625
20200410,5,목동,15509,17033,20200413,32542
20200410,5,오목교,20068,21808,20200413,41876
20200410,5,양평,6745,6574,20200413,13319
20200410,5,영등포구청,3550,3529,20200413,7079
20200410,5,영등포시장,8004,8217,20200413,16221
20200410,5,신길,3303,3532,20200413,6835
20200410,5,여의도,23351,24866,20200413,48217
20200410,5,여의나루,7058,7531,20200413,14589
20200410,5,마포,12553,13212,20200413,25765
20200410,5,공덕,12448,13588,20200413,26036
20200410,5,애오개,6240,6214,20200413,12454
20200410,5,충정로,3949,3941,20200413,7890
20200410,5,서대문,15487,16170,20200413,31657
20200410,5,광화문,26596,28238,20200413,54834
20200410,5,종로3가,10084,10497,20200413,20581
20200410,5,을지로4가,5401,5519,20200413,10920
20200410,5,동대문역사문화공원,2464,2830,20200413,5294
20200410,5,청구,3595,3299,20200413,6894
20200410,5,신금호,5525,5451,20200413,10976
20200410,5,행당,7256,6250,20200413,13506
20200410,5,왕십리,3928,4531,20200413,8459
20200410,5,마장,4906,4643,20200413,9549
20200410,5,답십리,14494,13093,20200413,27587
20200410,5,장한평,16330,16275,20200413,32605
20200410,5,군자,10149,11117,20200413,21266
20200410,5,아차산,12443,12001,20200413,24444
20200410,5,광나루,11438,9950,20200413,21388
20200410,5,천호,15854,16955,20200413,32809
20200410,5,강동,17798,15381,20200413,33179
20200410,5,길동,6444,6838,20200413,13282
20200410,5,굽은다리,7774,7213,20200413,14987
20200410,5,명일,6982,7181,20200413,14163
20200410,5,고덕,7232,7265,20200413,14497
20200410,5,상일동,16214,13785,20200413,29999
20200410,5,둔촌동,7142,7081,20200413,14223
20200410,5,올림픽공원,3255,2728,20200413,5983
20200410,5,방이,5834,6148,20200413,11982
20200410,5,오금,3280,3260,20200413,6540
20200410,5,개롱,5404,5570,20200413,10974
20200410,5,거여,6679,6161,20200413,12840
20200410,5,마천,4530,4467,20200413,8997
20200411,5,방화,3785,3515,20200414,7300
20200411,5,개화산,3027,3112,20200414,6139
20200411,5,김포공항,3759,4013,20200414,7772
20200411,5,송정,4227,3974,20200414,8201
20200411,5,마곡,2956,2924,20200414,5880
20200411,5,발산,9387,10075,20200414,19462
20200411,5,우장산,7211,7059,20200414,14270
20200411,5,화곡,16204,14876,20200414,31080
20200411,5,까치산,17307,16354,20200414,33661
20200411,5,신정,7068,5727,20200414,12795
20200411,5,목동,8750,9034,20200414,17784
20200411,5,오목교,12553,12952,20200414,25505
20200411,5,양평,2822,2670,20200414,5492
20200411,5,영등포구청,1513,1478,20200414,2991
20200411,5,영등포시장,5008,5292,20200414,10300
20200411,5,신길,1741,1913,20200414,3654
20200411,5,여의도,6336,6583,20200414,12919
20200411,5,여의나루,7595,7546,20200414,15141
20200411,5,마포,5393,5286,20200414,10679
20200411,5,공덕,5342,5687,20200414,11029
20200411,5,애오개,2888,2693,20200414,5581
20200411,5,충정로,1399,1345,20200414,2744
20200411,5,서대문,5229,4908,20200414,10137
20200411,5,광화문,9280,9125,20200414,18405
20200411,5,종로3가,7315,7604,20200414,14919
20200411,5,을지로4가,2313,2705,20200414,5018
20200411,5,동대문역사문화공원,957,1177,20200414,2134
20200411,5,청구,1993,1770,20200414,3763
20200411,5,신금호,3322,3366,20200414,6688
20200411,5,행당,4133,3549,20200414,7682
20200411,5,왕십리,2674,3259,20200414,5933
20200411,5,마장,3106,2965,20200414,6071
20200411,5,답십리,8275,7439,20200414,15714
20200411,5,장한평,8526,8290,20200414,16816
20200411,5,군자,6609,7206,20200414,13815
20200411,5,아차산,9935,9943,20200414,19878
20200411,5,광나루,7803,7399,20200414,15202
20200411,5,천호,12932,12842,20200414,25774
20200411,5,강동,10625,9514,20200414,20139
20200411,5,길동,4300,4425,20200414,8725
20200411,5,굽은다리,5081,4653,20200414,9734
20200411,5,명일,4130,4087,20200414,8217
20200411,5,고덕,4109,4035,20200414,8144
20200411,5,상일동,8302,7469,20200414,15771
20200411,5,둔촌동,4447,4411,20200414,8858
20200411,5,올림픽공원,2037,1886,20200414,3923
20200411,5,방이,3829,3735,20200414,7564
20200411,5,오금,1677,1663,20200414,3340
20200411,5,개롱,3180,3302,20200414,6482
20200411,5,거여,3944,3775,20200414,7719
20200411,5,마천,3319,3316,20200414,6635
20200412,5,방화,2583,2490,20200415,5073
20200412,5,개화산,2158,2132,20200415,4290
20200412,5,김포공항,3443,3204,20200415,6647
20200412,5,송정,2986,2989,20200415,5975
20200412,5,마곡,1856,1958,20200415,3814
20200412,5,발산,6061,6479,20200415,12540
20200412,5,우장산,4660,4801,20200415,9461
20200412,5,화곡,10583,9868,20200415,20451
20200412,5,까치산,11768,11472,20200415,23240
20200412,5,신정,4525,4025,20200415,8550
20200412,5,목동,5535,5759,20200415,11294
20200412,5,오목교,8224,8438,20200415,16662
20200412,5,양평,1832,1893,20200415,3725
20200412,5,영등포구청,916,905,20200415,1821
20200412,5,영등포시장,2979,3089,20200415,6068
20200412,5,신길,1111,1329,20200415,2440
20200412,5,여의도,4069,4185,20200415,8254
20200412,5,여의나루,5306,5075,20200415,10381
20200412,5,마포,3526,3471,20200415,6997
20200412,5,공덕,3155,3247,20200415,6402
20200412,5,애오개,1934,2044,20200415,3978
20200412,5,충정로,940,1001,20200415,1941
20200412,5,서대문,3246,3260,20200415,6506
20200412,5,광화문,6377,6451,20200415,12828
20200412,5,종로3가,4797,4452,20200415,9249
20200412,5,을지로4가,902,973,20200415,1875
20200412,5,동대문역사문화공원,601,749,20200415,1350
20200412,5,청구,1241,1236,20200415,2477
20200412,5,신금호,2200,2316,20200415,4516
20200412,5,행당,2770,2493,20200415,5263
20200412,5,왕십리,1689,1930,20200415,3619
20200412,5,마장,1997,1935,20200415,3932
20200412,5,답십리,5289,4974,20200415,10263
20200412,5,장한평,5251,5122,20200415,10373
20200412,5,군자,4484,4733,20200415,9217
20200412,5,아차산,7860,8317,20200415,16177
20200412,5,광나루,5557,5605,20200415,11162
20200412,5,천호,8772,8449,20200415,17221
20200412,5,강동,6980,6508,20200415,13488
20200412,5,길동,2799,2907,20200415,5706
20200412,5,굽은다리,3348,3214,20200415,6562
20200412,5,명일,2770,2735,20200415,5505
20200412,5,고덕,2568,2579,20200415,5147
20200412,5,상일동,5159,4886,20200415,10045
20200412,5,둔촌동,3044,3018,20200415,6062
20200412,5,올림픽공원,1283,1248,20200415,2531
20200412,5,방이,2687,2567,20200415,5254
20200412,5,오금,999,1056,20200415,2055
20200412,5,개롱,2078,2266,20200415,4344
20200412,5,거여,2557,2517,20200415,5074
20200412,5,마천,2261,2539,20200415,4800
20200413,5,방화,5831,5522,20200416,11353
20200413,5,개화산,4996,4707,20200416,9703
20200413,5,김포공항,4594,4208,20200416,8802
20200413,5,송정,6283,5768,20200416,12051
20200413,5,마곡,7350,6986,20200416,14336
20200413,5,발산,16723,17076,20200416,33799
20200413,5,우장산,11983,11829,20200416,23812
20200413,5,화곡,26132,24297,20200416,50429
20200413,5,까치산,26421,25136,20200416,51557
20200413,5,신정,12265,9348,20200416,21613
20200413,5,목동,15242,16905,20200416,32147
20200413,5,오목교,19117,20537,20200416,39654
20200413,5,양평,6821,6759,20200416,13580
20200413,5,영등포구청,3797,3694,20200416,7491
20200413,5,영등포시장,7981,8081,20200416,16062
20200413,5,신길,3302,3674,20200416,6976
20200413,5,여의도,23668,25091,20200416,48759
20200413,5,여의나루,8273,8493,20200416,16766
20200413,5,마포,12669,13078,20200416,25747
20200413,5,공덕,12488,13601,20200416,26089
20200413,5,애오개,6188,6202,20200416,12390
20200413,5,충정로,4460,4535,20200416,8995
20200413,5,서대문,16018,16918,20200416,32936
20200413,5,광화문,27442,28687,20200416,56129
20200413,5,종로3가,9828,9802,20200416,19630
20200413,5,을지로4가,5603,5683,20200416,11286
20200413,5,동대문역사문화공원,2511,2895,20200416,5406
20200413,5,청구,3632,3302,20200416,6934
20200413,5,신금호,5308,5470,20200416,10778
20200413,5,행당,7241,6399,20200416,13640
20200413,5,왕십리,3822,4313,20200416,8135
20200413,5,마장,4767,4600,20200416,9367
20200413,5,답십리,14361,13212,20200416,27573
20200413,5,장한평,16270,16131,20200416,32401
20200413,5,군자,9692,10485,20200416,20177
20200413,5,아차산,12063,11966,20200416,24029
20200413,5,광나루,11166,9910,20200416,21076
20200413,5,천호,15194,15997,20200416,31191
20200413,5,강동,17767,15663,20200416,33430
20200413,5,길동,6378,6711,20200416,13089
20200413,5,굽은다리,7622,7176,20200416,14798
20200413,5,명일,6919,7198,20200416,14117
20200413,5,고덕,7406,7575,20200416,14981
20200413,5,상일동,16425,14119,20200416,30544
20200413,5,둔촌동,6965,6991,20200416,13956
20200413,5,올림픽공원,3253,2896,20200416,6149
20200413,5,방이,5912,6142,20200416,12054
20200413,5,오금,3288,3243,20200416,6531
20200413,5,개롱,5440,5585,20200416,11025
20200413,5,거여,6711,6273,20200416,12984
20200413,5,마천,4579,4592,20200416,9171
20200414,5,방화,6091,5658,20200417,11749
20200414,5,개화산,5018,4721,20200417,9739
20200414,5,김포공항,4810,4478,20200417,9288
20200414,5,송정,6614,5897,20200417,12511
20200414,5,마곡,7594,7027,20200417,14621
20200414,5,발산,17096,17931,20200417,35027
20200414,5,우장산,12429,12216,20200417,24645
20200414,5,화곡,26829,24501,20200417,51330
20200414,5,까치산,27238,25439,20200417,52677
20200414,5,신정,12673,9379,20200417,22052
20200414,5,목동,15961,17193,20200417,33154
20200414,5,오목교,20110,21299,20200417,41409
20200414,5,양평,6915,6720,20200417,13635
20200414,5,영등포구청,3792,3753,20200417,7545
20200414,5,영등포시장,8325,8739,20200417,17064
20200414,5,신길,3604,4060,20200417,7664
20200414,5,여의도,23978,25838,20200417,49816
20200414,5,여의나루,8588,9019,20200417,17607
20200414,5,마포,12932,13417,20200417,26349
20200414,5,공덕,13135,14305,20200417,27440
20200414,5,애오개,6480,6377,20200417,12857
20200414,5,충정로,4577,4548,20200417,9125
20200414,5,서대문,16339,16893,20200417,33232
20200414,5,광화문,28698,31865,20200417,60563
20200414,5,종로3가,10410,11498,20200417,21908
20200414,5,을지로4가,5644,5978,20200417,11622
20200414,5,동대문역사문화공원,2485,2948,20200417,5433
20200414,5,청구,3649,3378,20200417,7027
20200414,5,신금호,5610,5544,20200417,11154
20200414,5,행당,7564,6456,20200417,14020
20200414,5,왕십리,4057,4799,20200417,8856
20200414,5,마장,4985,4761,20200417,9746
20200414,5,답십리,14930,13213,20200417,28143
20200414,5,장한평,16807,16570,20200417,33377
20200414,5,군자,10251,11262,20200417,21513
20200414,5,아차산,12604,12212,20200417,24816
20200414,5,광나루,11721,10235,20200417,21956
20200414,5,천호,16100,17179,20200417,33279
20200414,5,강동,18244,16105,20200417,34349
20200414,5,길동,6558,6902,20200417,13460
20200414,5,굽은다리,7847,7301,20200417,15148
20200414,5,명일,7166,7262,20200417,14428
20200414,5,고덕,7615,7563,20200417,15178
20200414,5,상일동,16930,14016,20200417,30946
20200414,5,둔촌동,7213,7100,20200417,14313
20200414,5,올림픽공원,3369,2965,20200417,6334
20200414,5,방이,5942,6152,20200417,12094
20200414,5,오금,3320,3300,20200417,6620
20200414,5,개롱,5597,5732,20200417,11329
20200414,5,거여,6879,6419,20200417,13298
20200414,5,마천,4767,4653,20200417,9420
20200415,5,방화,3438,3261,20200418,6699
20200415,5,개화산,2769,2876,20200418,5645
20200415,5,김포공항,3899,3682,20200418,7581
20200415,5,송정,3712,3738,20200418,7450
20200415,5,마곡,2733,2760,20200418,5493
20200415,5,발산,7878,8282,20200418,16160
20200415,5,우장산,6415,6351,20200418,12766
20200415,5,화곡,14644,13456,20200418,28100
20200415,5,까치산,15717,15176,20200418,30893
20200415,5,신정,6233,5348,20200418,11581
20200415,5,목동,7625,7907,20200418,15532
20200415,5,오목교,10326,10922,20200418,21248
20200415,5,양평,2381,2367,20200418,4748
20200415,5,영등포구청,1412,1320,20200418,2732
20200415,5,영등포시장,4102,4194,20200418,8296
20200415,5,신길,1561,1663,20200418,3224
20200415,5,여의도,5229,5585,20200418,10814
20200415,5,여의나루,6619,7235,20200418,13854
20200415,5,마포,4932,4839,20200418,9771
20200415,5,공덕,4371,4525,20200418,8896
20200415,5,애오개,2717,2631,20200418,5348
20200415,5,충정로,1567,1463,20200418,3030
20200415,5,서대문,4402,4287,20200418,8689
20200415,5,광화문,8325,8322,20200418,16647
20200415,5,종로3가,7309,7190,20200418,14499
20200415,5,을지로4가,2457,2644,20200418,5101
20200415,5,동대문역사문화공원,652,807,20200418,1459
20200415,5,청구,2044,1864,20200418,3908
20200415,5,신금호,3031,3061,20200418,6092
20200415,5,행당,3595,3367,20200418,6962
20200415,5,왕십리,2422,2741,20200418,5163
20200415,5,마장,2801,2687,20200418,5488
20200415,5,답십리,7600,7001,20200418,14601
20200415,5,장한평,7850,7918,20200418,15768
20200415,5,군자,5856,6424,20200418,12280
20200415,5,아차산,9274,9452,20200418,18726
20200415,5,광나루,6667,6292,20200418,12959
20200415,5,천호,11239,10926,20200418,22165
20200415,5,강동,9255,8257,20200418,17512
20200415,5,길동,3924,4018,20200418,7942
20200415,5,굽은다리,4591,4297,20200418,8888
20200415,5,명일,3661,3580,20200418,7241
20200415,5,고덕,3511,3578,20200418,7089
20200415,5,상일동,7383,6717,20200418,14100
20200415,5,둔촌동,3879,3884,20200418,7763
20200415,5,올림픽공원,1925,1761,20200418,3686
20200415,5,방이,3198,3298,20200418,6496
20200415,5,오금,1462,1426,20200418,2888
20200415,5,개롱,2897,3118,20200418,6015
20200415,5,거여,3537,3435,20200418,6972
20200415,5,마천,2915,3105,20200418,6020
20200416,5,방화,5962,5622,20200419,11584
20200416,5,개화산,4883,4665,20200419,9548
20200416,5,김포공항,4523,4190,20200419,8713
20200416,5,송정,6435,6083,20200419,12518
20200416,5,마곡,7612,7172,20200419,14784
20200416,5,발산,17170,17540,20200419,34710
20200416,5,우장산,12105,11897,20200419,24002
20200416,5,화곡,26577,24650,20200419,51227
20200416,5,까치산,26970,25475,20200419,52445
20200416,5,신정,12411,9444,20200419,21855
20200416,5,목동,15560,17203,20200419,32763
20200416,5,오목교,19832,21433,20200419,41265
20200416,5,양평,6790,6750,20200419,13540
20200416,5,영등포구청,3702,3572,20200419,7274
20200416,5,영등포시장,8030,8243,20200419,16273
20200416,5,신길,3355,3706,20200419,7061
20200416,5,여의도,23714,25517,20200419,49231
20200416,5,여의나루,8789,9208,20200419,17997
20200416,5,마포,12689,13218,20200419,25907
20200416,5,공덕,12895,13924,20200419,26819
20200416,5,애오개,6435,6459,20200419,12894
20200416,5,충정로,4383,4493,20200419,8876
20200416,5,서대문,16158,16835,20200419,32993
20200416,5,광화문,27594,29317,20200419,56911
20200416,5,종로3가,10063,10266,20200419,20329
20200416,5,을지로4가,5624,5778,20200419,11402
20200416,5,동대문역사문화공원,2542,2842,20200419,5384
20200416,5,청구,3645,3368,20200419,7013
20200416,5,신금호,5493,5558,20200419,11051
20200416,5,행당,7396,6474,20200419,13870
20200416,5,왕십리,3878,4338,20200419,8216
20200416,5,마장,4957,4636,20200419,9593
20200416,5,답십리,14537,13235,20200419,27772
20200416,5,장한평,16343,16161,20200419,32504
20200416,5,군자,9700,10728,20200419,20428
20200416,5,아차산,12505,12184,20200419,24689
20200416,5,광나루,11357,10203,20200419,21560
20200416,5,천호,15347,16252,20200419,31599
20200416,5,강동,18018,15914,20200419,33932
20200416,5,길동,6378,6787,20200419,13165
20200416,5,굽은다리,7768,7310,20200419,15078
20200416,5,명일,6963,7241,20200419,14204
20200416,5,고덕,7421,7526,20200419,14947
20200416,5,상일동,16548,14136,20200419,30684
20200416,5,둔촌동,7124,7069,20200419,14193
20200416,5,올림픽공원,3466,3029,20200419,6495
20200416,5,방이,5906,6125,20200419,12031
20200416,5,오금,3423,3307,20200419,6730
20200416,5,개롱,5394,5644,20200419,11038
20200416,5,거여,6694,6140,20200419,12834
20200416,5,마천,4597,4650,20200419,9247
20200417,5,방화,5779,5385,20200420,11164
20200417,5,개화산,4725,4514,20200420,9239
20200417,5,김포공항,4605,4386,20200420,8991
20200417,5,송정,6295,5692,20200420,11987
20200417,5,마곡,7620,7087,20200420,14707
20200417,5,발산,16618,17334,20200420,33952
20200417,5,우장산,11950,11630,20200420,23580
20200417,5,화곡,25878,23770,20200420,49648
20200417,5,까치산,26614,24676,20200420,51290
20200417,5,신정,12331,9201,20200420,21532
20200417,5,목동,15361,16749,20200420,32110
20200417,5,오목교,19876,21571,20200420,41447
20200417,5,양평,6866,6706,20200420,13572
20200417,5,영등포구청,3664,3627,20200420,7291
20200417,5,영등포시장,7858,8054,20200420,15912
20200417,5,신길,3373,3586,20200420,6959
20200417,5,여의도,23544,25093,20200420,48637
20200417,5,여의나루,6650,6584,20200420,13234
20200417,5,마포,12923,13453,20200420,26376
20200417,5,공덕,12734,14200,20200420,26934
20200417,5,애오개,6362,6228,20200420,12590
20200417,5,충정로,4318,4382,20200420,8700
20200417,5,서대문,16057,16728,20200420,32785
20200417,5,광화문,27120,29113,20200420,56233
20200417,5,종로3가,9711,10264,20200420,19975
20200417,5,을지로4가,5317,5599,20200420,10916
20200417,5,동대문역사문화공원,2414,2752,20200420,5166
20200417,5,청구,3595,3353,20200420,6948
20200417,5,신금호,5527,5501,20200420,11028
20200417,5,행당,7192,6262,20200420,13454
20200417,5,왕십리,3849,4506,20200420,8355
20200417,5,마장,4961,4742,20200420,9703
20200417,5,답십리,14549,13049,20200420,27598
20200417,5,장한평,16182,16003,20200420,32185
20200417,5,군자,9919,11107,20200420,21026
20200417,5,아차산,11784,11626,20200420,23410
20200417,5,광나루,11032,9497,20200420,20529
20200417,5,천호,15922,16385,20200420,32307
20200417,5,강동,18486,15664,20200420,34150
20200417,5,길동,6556,6983,20200420,13539
20200417,5,굽은다리,7848,7286,20200420,15134
20200417,5,명일,6864,7121,20200420,13985
20200417,5,고덕,7300,7325,20200420,14625
20200417,5,상일동,16371,13914,20200420,30285
20200417,5,둔촌동,7076,7133,20200420,14209
20200417,5,올림픽공원,3305,2873,20200420,6178
20200417,5,방이,5900,6191,20200420,12091
20200417,5,오금,3287,3233,20200420,6520
20200417,5,개롱,5499,5583,20200420,11082
20200417,5,거여,6653,6129,20200420,12782
20200417,5,마천,4386,4404,20200420,8790
20200418,5,방화,4083,3777,20200421,7860
20200418,5,개화산,3359,3215,20200421,6574
20200418,5,김포공항,4140,4096,20200421,8236
20200418,5,송정,4674,4487,20200421,9161
20200418,5,마곡,3270,3173,20200421,6443
20200418,5,발산,10040,10795,20200421,20835
20200418,5,우장산,8091,7829,20200421,15920
20200418,5,화곡,17130,15520,20200421,32650
20200418,5,까치산,18411,17220,20200421,35631
20200418,5,신정,7258,5932,20200421,13190
20200418,5,목동,9566,9720,20200421,19286
20200418,5,오목교,13194,13893,20200421,27087
20200418,5,양평,3161,3018,20200421,6179
20200418,5,영등포구청,1647,1581,20200421,3228
20200418,5,영등포시장,5133,5382,20200421,10515
20200418,5,신길,1827,1899,20200421,3726
20200418,5,여의도,6716,7305,20200421,14021
20200418,5,여의나루,9038,9495,20200421,18533
20200418,5,마포,5872,5933,20200421,11805
20200418,5,공덕,5678,5946,20200421,11624
20200418,5,애오개,3103,3017,20200421,6120
20200418,5,충정로,1545,1412,20200421,2957
20200418,5,서대문,5553,5526,20200421,11079
20200418,5,광화문,10213,10341,20200421,20554
20200418,5,종로3가,8545,9460,20200421,18005
20200418,5,을지로4가,2670,3046,20200421,5716
20200418,5,동대문역사문화공원,883,1214,20200421,2097
20200418,5,청구,2141,1872,20200421,4013
20200418,5,신금호,3640,3588,20200421,7228
20200418,5,행당,4419,3853,20200421,8272
20200418,5,왕십리,2834,3317,20200421,6151
20200418,5,마장,3297,3183,20200421,6480
20200418,5,답십리,8655,7962,20200421,16617
20200418,5,장한평,8989,8841,20200421,17830
20200418,5,군자,6924,7563,20200421,14487
20200418,5,아차산,10891,10933,20200421,21824
20200418,5,광나루,8293,7849,20200421,16142
20200418,5,천호,14001,13631,20200421,27632
20200418,5,강동,11816,10582,20200421,22398
20200418,5,길동,4661,4799,20200421,9460
20200418,5,굽은다리,5547,5145,20200421,10692
20200418,5,명일,4485,4424,20200421,8909
20200418,5,고덕,4658,4514,20200421,9172
20200418,5,상일동,9185,8157,20200421,17342
20200418,5,둔촌동,4849,4711,20200421,9560
20200418,5,올림픽공원,2378,2127,20200421,4505
20200418,5,방이,4043,3943,20200421,7986
20200418,5,오금,1734,1565,20200421,3299
20200418,5,개롱,3504,3739,20200421,7243
20200418,5,거여,4244,3962,20200421,8206
20200418,5,마천,3638,3572,20200421,7210
20200419,5,방화,2639,2622,20200422,5261
20200419,5,개화산,2074,2153,20200422,4227
20200419,5,김포공항,3679,3299,20200422,6978
20200419,5,송정,2941,3090,20200422,6031
20200419,5,마곡,1928,1928,20200422,3856
20200419,5,발산,5918,6271,20200422,12189
20200419,5,우장산,4888,4902,20200422,9790
20200419,5,화곡,10403,9711,20200422,20114
20200419,5,까치산,11779,11430,20200422,23209
20200419,5,신정,4558,4043,20200422,8601
20200419,5,목동,5547,5839,20200422,11386
20200419,5,오목교,8515,8754,20200422,17269
20200419,5,양평,1799,1976,20200422,3775
20200419,5,영등포구청,911,884,20200422,1795
20200419,5,영등포시장,2850,3013,20200422,5863
20200419,5,신길,1127,1319,20200422,2446
20200419,5,여의도,3722,3901,20200422,7623
20200419,5,여의나루,2130,2263,20200422,4393
20200419,5,마포,3383,3353,20200422,6736
20200419,5,공덕,3190,3241,20200422,6431
20200419,5,애오개,1986,2071,20200422,4057
20200419,5,충정로,998,1065,20200422,2063
20200419,5,서대문,3296,3190,20200422,6486
20200419,5,광화문,6655,6266,20200422,12921
20200419,5,종로3가,5191,4823,20200422,10014
20200419,5,을지로4가,893,1006,20200422,1899
20200419,5,동대문역사문화공원,731,837,20200422,1568
20200419,5,청구,1311,1186,20200422,2497
20200419,5,신금호,2195,2295,20200422,4490
20200419,5,행당,2767,2530,20200422,5297
20200419,5,왕십리,1860,2101,20200422,3961
20200419,5,마장,2020,1963,20200422,3983
20200419,5,답십리,5312,5015,20200422,10327
20200419,5,장한평,5260,5197,20200422,10457
20200419,5,군자,4349,4642,20200422,8991
20200419,5,아차산,7606,7586,20200422,15192
20200419,5,광나루,5388,5708,20200422,11096
20200419,5,천호,9270,8745,20200422,18015
20200419,5,강동,7194,6809,20200422,14003
20200419,5,길동,2935,3020,20200422,5955
20200419,5,굽은다리,3629,3515,20200422,7144
20200419,5,명일,2827,2896,20200422,5723
20200419,5,고덕,2818,2789,20200422,5607
20200419,5,상일동,5450,5110,20200422,10560
20200419,5,둔촌동,2990,3122,20200422,6112
20200419,5,올림픽공원,1381,1198,20200422,2579
20200419,5,방이,2759,2632,20200422,5391
20200419,5,오금,1094,1032,20200422,2126
20200419,5,개롱,2101,2264,20200422,4365
20200419,5,거여,2510,2549,20200422,5059
20200419,5,마천,2279,2538,20200422,4817
20200420,5,방화,6032,5682,20200423,11714
20200420,5,개화산,4866,4698,20200423,9564
20200420,5,김포공항,4633,4407,20200423,9040
20200420,5,송정,6585,6058,20200423,12643
20200420,5,마곡,7860,7324,20200423,15184
20200420,5,발산,17468,17739,20200423,35207
20200420,5,우장산,12436,12191,20200423,24627
20200420,5,화곡,26450,24688,20200423,51138
20200420,5,까치산,27163,25921,20200423,53084
20200420,5,신정,12645,9669,20200423,22314
20200420,5,목동,15584,17277,20200423,32861
20200420,5,오목교,19591,20997,20200423,40588
20200420,5,양평,6888,6901,20200423,13789
20200420,5,영등포구청,3802,3806,20200423,7608
20200420,5,영등포시장,8257,8471,20200423,16728
20200420,5,신길,3400,3853,20200423,7253
20200420,5,여의도,24484,25951,20200423,50435
20200420,5,여의나루,6802,7161,20200423,13963
20200420,5,마포,12981,13251,20200423,26232
20200420,5,공덕,12983,14019,20200423,27002
20200420,5,애오개,6416,6540,20200423,12956
20200420,5,충정로,4655,4721,20200423,9376
20200420,5,서대문,16606,17123,20200423,33729
20200420,5,광화문,28862,30269,20200423,59131
20200420,5,종로3가,9986,9983,20200423,19969
20200420,5,을지로4가,5627,5765,20200423,11392
20200420,5,동대문역사문화공원,2783,3191,20200423,5974
20200420,5,청구,3688,3314,20200423,7002
20200420,5,신금호,5502,5629,20200423,11131
20200420,5,행당,7511,6712,20200423,14223
20200420,5,왕십리,3952,4373,20200423,8325
20200420,5,마장,4993,4783,20200423,9776
20200420,5,답십리,14926,13784,20200423,28710
20200420,5,장한평,16791,16773,20200423,33564
20200420,5,군자,9874,10759,20200423,20633
20200420,5,아차산,12147,12076,20200423,24223
20200420,5,광나루,11361,10325,20200423,21686
20200420,5,천호,15730,16413,20200423,32143
20200420,5,강동,18798,16737,20200423,35535
20200420,5,길동,6750,6975,20200423,13725
20200420,5,굽은다리,7896,7540,20200423,15436
20200420,5,명일,7266,7679,20200423,14945
20200420,5,고덕,7502,7827,20200423,15329
20200420,5,상일동,17024,14504,20200423,31528
20200420,5,둔촌동,7237,7236,20200423,14473
20200420,5,올림픽공원,3326,2856,20200423,6182
20200420,5,방이,5999,6236,20200423,12235
20200420,5,오금,3412,3372,20200423,6784
20200420,5,개롱,5450,5717,20200423,11167
20200420,5,거여,6703,6295,20200423,12998
20200420,5,마천,4612,4661,20200423,9273
20200421,5,방화,6099,5782,20200424,11881
20200421,5,개화산,5002,4807,20200424,9809
20200421,5,김포공항,4718,4475,20200424,9193
20200421,5,송정,6590,6162,20200424,12752
20200421,5,마곡,7996,7439,20200424,15435
20200421,5,발산,17855,18178,20200424,36033
20200421,5,우장산,12376,12451,20200424,24827
20200421,5,화곡,26769,24869,20200424,51638
20200421,5,까치산,27432,26047,20200424,53479
20200421,5,신정,12863,9970,20200424,22833
20200421,5,목동,15927,17527,20200424,33454
20200421,5,오목교,20472,21714,20200424,42186
20200421,5,양평,7179,7147,20200424,14326
20200421,5,영등포구청,3645,3663,20200424,7308
20200421,5,영등포시장,8296,8581,20200424,16877
20200421,5,신길,3405,3919,20200424,7324
20200421,5,여의도,25237,26342,20200424,51579
20200421,5,여의나루,7365,7489,20200424,14854
20200421,5,마포,13311,13799,20200424,27110
20200421,5,공덕,13416,14452,20200424,27868
20200421,5,애오개,6637,6857,20200424,13494
20200421,5,충정로,4754,4785,20200424,9539
20200421,5,서대문,16881,17358,20200424,34239
20200421,5,광화문,29785,31205,20200424,60990
20200421,5,종로3가,10647,10450,20200424,21097
20200421,5,을지로4가,5716,5981,20200424,11697
20200421,5,동대문역사문화공원,2826,3171,20200424,5997
20200421,5,청구,3807,3400,20200424,7207
20200421,5,신금호,5710,5867,20200424,11577
20200421,5,행당,7574,6817,20200424,14391
20200421,5,왕십리,4050,4492,20200424,8542
20200421,5,마장,5084,4858,20200424,9942
20200421,5,답십리,15163,13911,20200424,29074
20200421,5,장한평,17166,16995,20200424,34161
20200421,5,군자,10249,11232,20200424,21481
20200421,5,아차산,12732,12515,20200424,25247
20200421,5,광나루,11887,10851,20200424,22738
20200421,5,천호,16601,17053,20200424,33654
20200421,5,강동,19454,16989,20200424,36443
20200421,5,길동,6790,7245,20200424,14035
20200421,5,굽은다리,8206,7787,20200424,15993
20200421,5,명일,7442,7853,20200424,15295
20200421,5,고덕,7773,7980,20200424,15753
20200421,5,상일동,17294,14887,20200424,32181
20200421,5,둔촌동,7400,7304,20200424,14704
20200421,5,올림픽공원,3513,3016,20200424,6529
20200421,5,방이,6207,6382,20200424,12589
20200421,5,오금,3508,3389,20200424,6897
20200421,5,개롱,5668,5873,20200424,11541
20200421,5,거여,6900,6502,20200424,13402
20200421,5,마천,4778,4780,20200424,9558
20200422,5,방화,6159,5852,20200425,12011
20200422,5,개화산,4954,4740,20200425,9694
20200422,5,김포공항,4730,4570,20200425,9300
20200422,5,송정,6413,5976,20200425,12389
20200422,5,마곡,7960,7383,20200425,15343
20200422,5,발산,19262,19807,20200425,39069
20200422,5,우장산,12558,12381,20200425,24939
20200422,5,화곡,26565,24735,20200425,51300
20200422,5,까치산,27578,26188,20200425,53766
20200422,5,신정,12815,9886,20200425,22701
20200422,5,목동,15898,17696,20200425,33594
20200422,5,오목교,20236,21458,20200425,41694
20200422,5,양평,7040,7015,20200425,14055
20200422,5,영등포구청,3634,3727,20200425,7361
20200422,5,영등포시장,8300,8491,20200425,16791
20200422,5,신길,3432,3867,20200425,7299
20200422,5,여의도,25079,26483,20200425,51562
20200422,5,여의나루,6854,7082,20200425,13936
20200422,5,마포,13433,13811,20200425,27244
20200422,5,공덕,13256,14336,20200425,27592
20200422,5,애오개,6595,6734,20200425,13329
20200422,5,충정로,4708,4734,20200425,9442
20200422,5,서대문,16751,17251,20200425,34002
20200422,5,광화문,29781,31146,20200425,60927
20200422,5,종로3가,10982,10812,20200425,21794
20200422,5,을지로4가,5721,5784,20200425,11505
20200422,5,동대문역사문화공원,2881,3199,20200425,6080
20200422,5,청구,3773,3356,20200425,7129
20200422,5,신금호,5634,5785,20200425,11419
20200422,5,행당,7407,6650,20200425,14057
20200422,5,왕십리,4046,4391,20200425,8437
20200422,5,마장,5074,4732,20200425,9806
20200422,5,답십리,15004,13939,20200425,28943
20200422,5,장한평,16894,16796,20200425,33690
20200422,5,군자,10226,11153,20200425,21379
20200422,5,아차산,12737,12588,20200425,25325
20200422,5,광나루,11676,10539,20200425,22215
20200422,5,천호,16366,16970,20200425,33336
20200422,5,강동,19722,16821,20200425,36543
20200422,5,길동,6809,7173,20200425,13982
20200422,5,굽은다리,8069,7761,20200425,15830
20200422,5,명일,7421,7769,20200425,15190
20200422,5,고덕,7642,7779,20200425,15421
20200422,5,상일동,17197,14700,20200425,31897
20200422,5,둔촌동,7412,7297,20200425,14709
20200422,5,올림픽공원,3407,2864,20200425,6271
20200422,5,방이,6212,6426,20200425,12638
20200422,5,오금,3424,3317,20200425,6741
20200422,5,개롱,5531,5792,20200425,11323
20200422,5,거여,6850,6363,20200425,13213
20200422,5,마천,4588,4752,20200425,9340
20200423,5,방화,6205,5853,20200426,12058
20200423,5,개화산,5061,4799,20200426,9860
20200423,5,김포공항,5000,4595,20200426,9595
20200423,5,송정,6531,6123,20200426,12654
20200423,5,마곡,7947,7506,20200426,15453
20200423,5,발산,18461,18973,20200426,37434
20200423,5,우장산,12518,12370,20200426,24888
20200423,5,화곡,27049,24864,20200426,51913
20200423,5,까치산,27547,26228,20200426,53775
20200423,5,신정,12819,9835,20200426,22654
20200423,5,목동,16335,17936,20200426,34271
20200423,5,오목교,20597,21880,20200426,42477
20200423,5,양평,7040,7087,20200426,14127
20200423,5,영등포구청,3797,3754,20200426,7551
20200423,5,영등포시장,8379,8591,20200426,16970
20200423,5,신길,3468,3854,20200426,7322
20200423,5,여의도,25086,26652,20200426,51738
20200423,5,여의나루,7409,7638,20200426,15047
20200423,5,마포,13412,14030,20200426,27442
20200423,5,공덕,13476,14773,20200426,28249
20200423,5,애오개,6769,6765,20200426,13534
20200423,5,충정로,4722,4866,20200426,9588
20200423,5,서대문,16828,17552,20200426,34380
20200423,5,광화문,29321,31158,20200426,60479
20200423,5,종로3가,10917,10970,20200426,21887
20200423,5,을지로4가,5680,5978,20200426,11658
20200423,5,동대문역사문화공원,2816,3262,20200426,6078
20200423,5,청구,3756,3419,20200426,7175
20200423,5,신금호,5716,5868,20200426,11584
20200423,5,행당,7636,6756,20200426,14392
20200423,5,왕십리,4049,4513,20200426,8562
20200423,5,마장,5217,4888,20200426,10105
20200423,5,답십리,14936,13758,20200426,28694
20200423,5,장한평,17187,17041,20200426,34228
20200423,5,군자,10369,11328,20200426,21697
20200423,5,아차산,12911,12779,20200426,25690
20200423,5,광나루,12078,10908,20200426,22986
20200423,5,천호,16448,17228,20200426,33676
20200423,5,강동,19872,16944,20200426,36816
20200423,5,길동,6805,7105,20200426,13910
20200423,5,굽은다리,8184,7682,20200426,15866
20200423,5,명일,7516,7801,20200426,15317
20200423,5,고덕,7763,7876,20200426,15639
20200423,5,상일동,17483,14846,20200426,32329
20200423,5,둔촌동,7609,7695,20200426,15304
20200423,5,올림픽공원,3499,3040,20200426,6539
20200423,5,방이,6225,6559,20200426,12784
20200423,5,오금,3430,3371,20200426,6801
20200423,5,개롱,5680,5807,20200426,11487
20200423,5,거여,6916,6422,20200426,13338
20200423,5,마천,4703,4754,20200426,9457
20200424,5,방화,6328,5779,20200427,12107
20200424,5,개화산,5120,4793,20200427,9913
20200424,5,김포공항,5136,5091,20200427,10227
20200424,5,송정,6820,6339,20200427,13159
20200424,5,마곡,8166,7628,20200427,15794
20200424,5,발산,18869,19626,20200427,38495
20200424,5,우장산,13430,13058,20200427,26488
20200424,5,화곡,27963,25380,20200427,53343
20200424,5,까치산,28932,27025,20200427,55957
20200424,5,신정,13120,9776,20200427,22896
20200424,5,목동,16970,18397,20200427,35367
20200424,5,오목교,21531,23476,20200427,45007
20200424,5,양평,7174,6960,20200427,14134
20200424,5,영등포구청,3794,3833,20200427,7627
20200424,5,영등포시장,8648,8801,20200427,17449
20200424,5,신길,3554,3856,20200427,7410
20200424,5,여의도,25051,26746,20200427,51797
20200424,5,여의나루,8650,8586,20200427,17236
20200424,5,마포,13686,14218,20200427,27904
20200424,5,공덕,13777,15111,20200427,28888
20200424,5,애오개,6841,6693,20200427,13534
20200424,5,충정로,4768,4708,20200427,9476
20200424,5,서대문,16724,17421,20200427,34145
20200424,5,광화문,29801,31718,20200427,61519
20200424,5,종로3가,11409,11956,20200427,23365
20200424,5,을지로4가,5804,5962,20200427,11766
20200424,5,동대문역사문화공원,2722,3185,20200427,5907
20200424,5,청구,3901,3400,20200427,7301
20200424,5,신금호,5909,5815,20200427,11724
20200424,5,행당,7837,6889,20200427,14726
20200424,5,왕십리,4202,4929,20200427,9131
20200424,5,마장,5272,4928,20200427,10200
20200424,5,답십리,15497,14079,20200427,29576
20200424,5,장한평,17563,17457,20200427,35020
20200424,5,군자,10689,11892,20200427,22581
20200424,5,아차산,13511,13221,20200427,26732
20200424,5,광나루,12569,11204,20200427,23773
20200424,5,천호,17791,19104,20200427,36895
20200424,5,강동,20469,17157,20200427,37626
20200424,5,길동,7325,7698,20200427,15023
20200424,5,굽은다리,8602,7886,20200427,16488
20200424,5,명일,7929,8167,20200427,16096
20200424,5,고덕,8021,8077,20200427,16098
20200424,5,상일동,18271,15156,20200427,33427
20200424,5,둔촌동,7957,7882,20200427,15839
20200424,5,올림픽공원,3754,3102,20200427,6856
20200424,5,방이,6405,6586,20200427,12991
20200424,5,오금,3594,3556,20200427,7150
20200424,5,개롱,5909,6041,20200427,11950
20200424,5,거여,7225,6674,20200427,13899
20200424,5,마천,4883,4866,20200427,9749
20200425,5,방화,4239,3948,20200428,8187
20200425,5,개화산,3231,3179,20200428,6410
20200425,5,김포공항,4647,4742,20200428,9389
20200425,5,송정,4575,4483,20200428,9058
20200425,5,마곡,3412,3355,20200428,6767
20200425,5,발산,10962,12005,20200428,22967
20200425,5,우장산,8441,8213,20200428,16654
20200425,5,화곡,18031,16393,20200428,34424
20200425,5,까치산,19253,17950,20200428,37203
20200425,5,신정,7671,6307,20200428,13978
20200425,5,목동,10050,10179,20200428,20229
20200425,5,오목교,13899,14591,20200428,28490
20200425,5,양평,3196,3019,20200428,6215
20200425,5,영등포구청,1752,1631,20200428,3383
20200425,5,영등포시장,6022,6088,20200428,12110
20200425,5,신길,1889,1995,20200428,3884
20200425,5,여의도,7349,8031,20200428,15380
20200425,5,여의나루,6911,7058,20200428,13969
20200425,5,마포,6112,6108,20200428,12220
20200425,5,공덕,6157,6457,20200428,12614
20200425,5,애오개,3254,3093,20200428,6347
20200425,5,충정로,1767,1627,20200428,3394
20200425,5,서대문,5754,5631,20200428,11385
20200425,5,광화문,11666,11907,20200428,23573
20200425,5,종로3가,9620,10161,20200428,19781
20200425,5,을지로4가,2898,3237,20200428,6135
20200425,5,동대문역사문화공원,729,970,20200428,1699
20200425,5,청구,2299,1908,20200428,4207
20200425,5,신금호,3658,3666,20200428,7324
20200425,5,행당,4665,3952,20200428,8617
20200425,5,왕십리,2961,3483,20200428,6444
20200425,5,마장,3505,3383,20200428,6888
20200425,5,답십리,8943,8179,20200428,17122
20200425,5,장한평,9570,9381,20200428,18951
20200425,5,군자,7277,7801,20200428,15078
20200425,5,아차산,11033,10904,20200428,21937
20200425,5,광나루,8387,7942,20200428,16329
20200425,5,천호,14451,14485,20200428,28936
20200425,5,강동,12583,11026,20200428,23609
20200425,5,길동,5018,5092,20200428,10110
20200425,5,굽은다리,5767,5232,20200428,10999
20200425,5,명일,4683,4524,20200428,9207
20200425,5,고덕,4696,4673,20200428,9369
20200425,5,상일동,9685,8726,20200428,18411
20200425,5,둔촌동,5159,5099,20200428,10258
20200425,5,올림픽공원,2289,2017,20200428,4306
20200425,5,방이,4402,4291,20200428,8693
20200425,5,오금,1894,1748,20200428,3642
20200425,5,개롱,3642,3782,20200428,7424
20200425,5,거여,4288,4059,20200428,8347
20200425,5,마천,3723,3742,20200428,7465
20200426,5,방화,3185,3119,20200429,6304
20200426,5,개화산,2527,2553,20200429,5080
20200426,5,김포공항,4131,3887,20200429,8018
20200426,5,송정,3298,3403,20200429,6701
20200426,5,마곡,2260,2269,20200429,4529
20200426,5,발산,7395,7754,20200429,15149
20200426,5,우장산,5570,5696,20200429,11266
20200426,5,화곡,12160,11379,20200429,23539
20200426,5,까치산,13457,13133,20200429,26590
20200426,5,신정,5247,4618,20200429,9865
20200426,5,목동,6512,6609,20200429,13121
20200426,5,오목교,9518,9897,20200429,19415
20200426,5,양평,2069,2105,20200429,4174
20200426,5,영등포구청,1025,994,20200429,2019
20200426,5,영등포시장,3441,3660,20200429,7101
20200426,5,신길,1311,1490,20200429,2801
20200426,5,여의도,4851,4959,20200429,9810
20200426,5,여의나루,7648,7794,20200429,15442
20200426,5,마포,3930,3978,20200429,7908
20200426,5,공덕,3870,3947,20200429,7817
20200426,5,애오개,2292,2291,20200429,4583
20200426,5,충정로,1141,1141,20200429,2282
20200426,5,서대문,3764,3648,20200429,7412
20200426,5,광화문,8134,7804,20200429,15938
20200426,5,종로3가,6457,6079,20200429,12536
20200426,5,을지로4가,1074,1242,20200429,2316
20200426,5,동대문역사문화공원,429,531,20200429,960
20200426,5,청구,1481,1272,20200429,2753
20200426,5,신금호,2482,2696,20200429,5178
20200426,5,행당,3440,3083,20200429,6523
20200426,5,왕십리,1947,2254,20200429,4201
20200426,5,마장,2693,2541,20200429,5234
20200426,5,답십리,6293,5897,20200429,12190
20200426,5,장한평,6197,6013,20200429,12210
20200426,5,군자,5023,5514,20200429,10537
20200426,5,아차산,9492,9546,20200429,19038
20200426,5,광나루,6592,6809,20200429,13401
20200426,5,천호,10378,9982,20200429,20360
20200426,5,강동,8370,7751,20200429,16121
20200426,5,길동,3277,3361,20200429,6638
20200426,5,굽은다리,4021,3753,20200429,7774
20200426,5,명일,3318,3364,20200429,6682
20200426,5,고덕,3065,3076,20200429,6141
20200426,5,상일동,6331,5939,20200429,12270
20200426,5,둔촌동,3689,3592,20200429,7281
20200426,5,올림픽공원,1769,1571,20200429,3340
20200426,5,방이,3240,3072,20200429,6312
20200426,5,오금,1271,1272,20200429,2543
20200426,5,개롱,2621,2865,20200429,5486
20200426,5,거여,2996,2959,20200429,5955
20200426,5,마천,2787,3158,20200429,5945
20200427,5,방화,6386,5986,20200430,12372
20200427,5,개화산,5187,4977,20200430,10164
20200427,5,김포공항,5135,4905,20200430,10040
20200427,5,송정,6843,6356,20200430,13199
20200427,5,마곡,8151,7604,20200430,15755
20200427,5,발산,18226,18667,20200430,36893
20200427,5,우장산,12972,12788,20200430,25760
20200427,5,화곡,27844,25722,20200430,53566
20200427,5,까치산,28261,26812,20200430,55073
20200427,5,신정,13158,9884,20200430,23042
20200427,5,목동,16159,17762,20200430,33921
20200427,5,오목교,20677,22195,20200430,42872
20200427,5,양평,7142,7185,20200430,14327
20200427,5,영등포구청,3876,3875,20200430,7751
20200427,5,영등포시장,8753,8926,20200430,17679
20200427,5,신길,3475,3850,20200430,7325
20200427,5,여의도,25354,27027,20200430,52381
20200427,5,여의나루,8477,8801,20200430,17278
20200427,5,마포,13462,14083,20200430,27545
20200427,5,공덕,13736,14980,20200430,28716
20200427,5,애오개,6726,6808,20200430,13534
20200427,5,충정로,4834,5034,20200430,9868
20200427,5,서대문,17033,17773,20200430,34806
20200427,5,광화문,29812,31550,20200430,61362
20200427,5,종로3가,10731,10891,20200430,21622
20200427,5,을지로4가,5926,6070,20200430,11996
20200427,5,동대문역사문화공원,2834,3233,20200430,6067
20200427,5,청구,4007,3509,20200430,7516
20200427,5,신금호,5751,5970,20200430,11721
20200427,5,행당,7712,6852,20200430,14564
20200427,5,왕십리,4019,4593,20200430,8612
20200427,5,마장,5230,4933,20200430,10163
20200427,5,답십리,15467,14095,20200430,29562
20200427,5,장한평,17369,17222,20200430,34591
20200427,5,군자,10311,11268,20200430,21579
20200427,5,아차산,13254,12941,20200430,26195
20200427,5,광나루,12472,11211,20200430,23683
20200427,5,천호,16696,17549,20200430,34245
20200427,5,강동,20008,17070,20200430,37078
20200427,5,길동,7159,7472,20200430,14631
20200427,5,굽은다리,8293,7745,20200430,16038
20200427,5,명일,7777,7993,20200430,15770
20200427,5,고덕,7856,8026,20200430,15882
20200427,5,상일동,17933,15368,20200430,33301
20200427,5,둔촌동,7588,7619,20200430,15207
20200427,5,올림픽공원,3642,3231,20200430,6873
20200427,5,방이,6441,6576,20200430,13017
20200427,5,오금,3566,3536,20200430,7102
20200427,5,개롱,5779,6037,20200430,11816
20200427,5,거여,7009,6593,20200430,13602
20200427,5,마천,4850,4793,20200430,9643
20200428,5,방화,6435,6050,20200501,12485
20200428,5,개화산,5216,4957,20200501,10173
20200428,5,김포공항,5147,5221,20200501,10368
20200428,5,송정,6776,6287,20200501,13063
20200428,5,마곡,8292,7798,20200501,16090
20200428,5,발산,18792,19254,20200501,38046
20200428,5,우장산,13005,12780,20200501,25785
20200428,5,화곡,28003,25728,20200501,53731
20200428,5,까치산,28614,26928,20200501,55542
20200428,5,신정,13248,10027,20200501,23275
20200428,5,목동,16773,18450,20200501,35223
20200428,5,오목교,21198,22672,20200501,43870
20200428,5,양평,7308,7216,20200501,14524
20200428,5,영등포구청,3968,3872,20200501,7840
20200428,5,영등포시장,8740,9021,20200501,17761
20200428,5,신길,3521,3934,20200501,7455
20200428,5,여의도,25626,27420,20200501,53046
20200428,5,여의나루,9090,9545,20200501,18635
20200428,5,마포,13879,14431,20200501,28310
20200428,5,공덕,13945,15229,20200501,29174
20200428,5,애오개,6813,6829,20200501,13642
20200428,5,충정로,5023,5069,20200501,10092
20200428,5,서대문,17185,17909,20200501,35094
20200428,5,광화문,30386,32444,20200501,62830
20200428,5,종로3가,11494,11207,20200501,22701
20200428,5,을지로4가,6074,6297,20200501,12371
20200428,5,동대문역사문화공원,2923,3356,20200501,6279
20200428,5,청구,4045,3663,20200501,7708
20200428,5,신금호,6074,6072,20200501,12146
20200428,5,행당,7918,6957,20200501,14875
20200428,5,왕십리,4329,4825,20200501,9154
20200428,5,마장,5300,5087,20200501,10387
20200428,5,답십리,15432,13991,20200501,29423
20200428,5,장한평,17742,17594,20200501,35336
20200428,5,군자,10526,11398,20200501,21924
20200428,5,아차산,13591,13298,20200501,26889
20200428,5,광나루,12697,11421,20200501,24118
20200428,5,천호,17114,18293,20200501,35407
20200428,5,강동,20635,17481,20200501,38116
20200428,5,길동,7029,7330,20200501,14359
20200428,5,굽은다리,8475,7956,20200501,16431
20200428,5,명일,7818,8071,20200501,15889
20200428,5,고덕,8126,8285,20200501,16411
20200428,5,상일동,18317,15371,20200501,33688
20200428,5,둔촌동,7757,7710,20200501,15467
20200428,5,올림픽공원,3753,3315,20200501,7068
20200428,5,방이,6413,6691,20200501,13104
20200428,5,오금,3516,3411,20200501,6927
20200428,5,개롱,5900,6036,20200501,11936
20200428,5,거여,7214,6642,20200501,13856
20200428,5,마천,4937,4975,20200501,9912
20200429,5,방화,6696,6129,20200502,12825
20200429,5,개화산,5238,4961,20200502,10199
20200429,5,김포공항,5773,6033,20200502,11806
20200429,5,송정,6998,6330,20200502,13328
20200429,5,마곡,8449,7864,20200502,16313
20200429,5,발산,19332,20158,20200502,39490
20200429,5,우장산,13657,13359,20200502,27016
20200429,5,화곡,28859,25974,20200502,54833
20200429,5,까치산,29664,27232,20200502,56896
20200429,5,신정,13579,10172,20200502,23751
20200429,5,목동,17494,18650,20200502,36144
20200429,5,오목교,21948,23868,20200502,45816
20200429,5,양평,7319,7121,20200502,14440
20200429,5,영등포구청,4090,4001,20200502,8091
20200429,5,영등포시장,9000,9285,20200502,18285
20200429,5,신길,3651,3861,20200502,7512
20200429,5,여의도,25672,27624,20200502,53296
20200429,5,여의나루,10321,10276,20200502,20597
20200429,5,마포,14250,15011,20200502,29261
20200429,5,공덕,14298,15683,20200502,29981
20200429,5,애오개,7066,6869,20200502,13935
20200429,5,충정로,4967,5062,20200502,10029
20200429,5,서대문,17441,17961,20200502,35402
20200429,5,광화문,30660,33058,20200502,63718
20200429,5,종로3가,12324,13068,20200502,25392
20200429,5,을지로4가,5968,6329,20200502,12297
20200429,5,동대문역사문화공원,2824,3322,20200502,6146
20200429,5,청구,4029,3513,20200502,7542
20200429,5,신금호,6138,6120,20200502,12258
20200429,5,행당,8159,6921,20200502,15080
20200429,5,왕십리,4316,5144,20200502,9460
20200429,5,마장,5419,4976,20200502,10395
20200429,5,답십리,16238,14328,20200502,30566
20200429,5,장한평,17701,17700,20200502,35401
20200429,5,군자,11031,12110,20200502,23141
20200429,5,아차산,14050,13582,20200502,27632
20200429,5,광나루,13018,11482,20200502,24500
20200429,5,천호,18059,19208,20200502,37267
20200429,5,강동,21496,17698,20200502,39194
20200429,5,길동,7392,7622,20200502,15014
20200429,5,굽은다리,8947,8205,20200502,17152
20200429,5,명일,8073,8308,20200502,16381
20200429,5,고덕,8355,8355,20200502,16710
20200429,5,상일동,18846,15415,20200502,34261
20200429,5,둔촌동,8015,7916,20200502,15931
20200429,5,올림픽공원,3901,3300,20200502,7201
20200429,5,방이,6626,6789,20200502,13415
20200429,5,오금,3616,3597,20200502,7213
20200429,5,개롱,6088,6137,20200502,12225
20200429,5,거여,7465,6734,20200502,14199
20200429,5,마천,5123,5140,20200502,10263
20200430,5,방화,4159,3956,20200503,8115
20200430,5,개화산,3172,3129,20200503,6301
20200430,5,김포공항,4775,5797,20200503,10572
20200430,5,송정,4283,4098,20200503,8381
20200430,5,마곡,3050,2962,20200503,6012
20200430,5,발산,8788,9016,20200503,17804
20200430,5,우장산,7339,7143,20200503,14482
20200430,5,화곡,16410,14519,20200503,30929
20200430,5,까치산,17832,16200,20200503,34032
20200430,5,신정,7092,5485,20200503,12577
20200430,5,목동,8251,8339,20200503,16590
20200430,5,오목교,11439,12204,20200503,23643
20200430,5,양평,2774,2501,20200503,5275
20200430,5,영등포구청,1521,1372,20200503,2893
20200430,5,영등포시장,4776,4646,20200503,9422
20200430,5,신길,1782,1816,20200503,3598
20200430,5,여의도,5951,6679,20200503,12630
20200430,5,여의나루,11206,11785,20200503,22991
20200430,5,마포,5328,5273,20200503,10601
20200430,5,공덕,5036,5260,20200503,10296
20200430,5,애오개,2936,2765,20200503,5701
20200430,5,충정로,1643,1475,20200503,3118
20200430,5,서대문,5071,4993,20200503,10064
20200430,5,광화문,11665,11835,20200503,23500
20200430,5,종로3가,9433,9638,20200503,19071
20200430,5,을지로4가,2679,3030,20200503,5709
20200430,5,동대문역사문화공원,689,875,20200503,1564
20200430,5,청구,2243,1881,20200503,4124
20200430,5,신금호,3462,3395,20200503,6857
20200430,5,행당,4156,3461,20200503,7617
20200430,5,왕십리,2505,2916,20200503,5421
20200430,5,마장,3255,3055,20200503,6310
20200430,5,답십리,8073,7180,20200503,15253
20200430,5,장한평,8667,8304,20200503,16971
20200430,5,군자,6493,6803,20200503,13296
20200430,5,아차산,11566,11324,20200503,22890
20200430,5,광나루,8276,7802,20200503,16078
20200430,5,천호,13442,13410,20200503,26852
20200430,5,강동,11193,9282,20200503,20475
20200430,5,길동,4342,4326,20200503,8668
20200430,5,굽은다리,5418,4830,20200503,10248
20200430,5,명일,4144,4083,20200503,8227
20200430,5,고덕,4257,4158,20200503,8415
20200430,5,상일동,9216,8043,20200503,17259
20200430,5,둔촌동,4668,4466,20200503,9134
20200430,5,올림픽공원,2328,2001,20200503,4329
20200430,5,방이,3587,3493,20200503,7080
20200430,5,오금,1646,1585,20200503,3231
20200430,5,개롱,3137,3257,20200503,6394
20200430,5,거여,3852,3571,20200503,7423
20200430,5,마천,3646,3574,20200503,7220
20200501,5,마천,3538,3559,20200504,7097
20200501,5,거여,4413,4106,20200504,8519
20200501,5,개롱,3680,3770,20200504,7450
20200501,5,오금,1964,1779,20200504,3743
20200501,5,방이,4072,4091,20200504,8163
20200501,5,올림픽공원,2610,2302,20200504,4912
20200501,5,둔촌동,5183,5220,20200504,10403
20200501,5,상일동,9809,8709,20200504,18518
20200501,5,고덕,4750,4756,20200504,9506
20200501,5,명일,4928,4853,20200504,9781
20200501,5,굽은다리,5982,5386,20200504,11368
20200501,5,길동,5218,5205,20200504,10423
20200501,5,강동,11643,10160,20200504,21803
20200501,5,천호,14153,14123,20200504,28276
20200501,5,광나루,8312,7735,20200504,16047
20200501,5,아차산,11122,10790,20200504,21912
20200501,5,군자,6881,7573,20200504,14454
20200501,5,장한평,9647,9632,20200504,19279
20200501,5,답십리,9437,8423,20200504,17860
20200501,5,마장,3638,3426,20200504,7064
20200501,5,왕십리,2852,3494,20200504,6346
20200501,5,행당,4869,4185,20200504,9054
20200501,5,신금호,3811,3870,20200504,7681
20200501,5,청구,2556,2198,20200504,4754
20200501,5,동대문역사문화공원,893,1119,20200504,2012
20200501,5,을지로4가,3555,3948,20200504,7503
20200501,5,종로3가,9875,10160,20200504,20035
20200501,5,광화문,13084,13442,20200504,26526
20200501,5,서대문,6195,6021,20200504,12216
20200501,5,충정로,1781,1656,20200504,3437
20200501,5,애오개,3515,3434,20200504,6949
20200501,5,마포,6263,6129,20200504,12392
20200501,5,여의나루,10237,10804,20200504,21041
20200501,5,여의도,6453,7149,20200504,13602
20200501,5,신길,1824,1931,20200504,3755
20200501,5,영등포시장,5431,5641,20200504,11072
20200501,5,영등포구청,1844,1748,20200504,3592
20200501,5,양평,3020,2882,20200504,5902
20200501,5,오목교,13705,14702,20200504,28407
20200501,5,목동,10586,10799,20200504,21385
20200501,5,신정,7795,6331,20200504,14126
20200501,5,까치산,19124,17618,20200504,36742
20200501,5,화곡,17876,15930,20200504,33806
20200501,5,우장산,8560,8463,20200504,17023
20200501,5,발산,9620,10267,20200504,19887
20200501,5,마곡,4138,3835,20200504,7973
20200501,5,송정,4940,4685,20200504,9625
20200501,5,김포공항,4999,5408,20200504,10407
20200501,5,개화산,3341,3238,20200504,6579
20200501,5,방화,4276,3991,20200504,8267
20200501,5,공덕,5698,5878,20200504,11576
20200502,5,방화,3861,3751,20200505,7612
20200502,5,개화산,3067,2991,20200505,6058
20200502,5,김포공항,4851,4716,20200505,9567
20200502,5,송정,4430,4171,20200505,8601
20200502,5,마곡,3042,2931,20200505,5973
20200502,5,발산,9564,10177,20200505,19741
20200502,5,우장산,7861,7769,20200505,15630
20200502,5,화곡,16494,15115,20200505,31609
20200502,5,까치산,17590,16611,20200505,34201
20200502,5,신정,7292,5861,20200505,13153
20200502,5,목동,9284,9512,20200505,18796
20200502,5,오목교,12561,13148,20200505,25709
20200502,5,양평,2650,2578,20200505,5228
20200502,5,영등포구청,1441,1408,20200505,2849
20200502,5,영등포시장,5034,5362,20200505,10396
20200502,5,신길,1653,1730,20200505,3383
20200502,5,여의도,5889,6663,20200505,12552
20200502,5,여의나루,10148,10569,20200505,20717
20200502,5,마포,5334,5322,20200505,10656
20200502,5,공덕,5249,5373,20200505,10622
20200502,5,애오개,2885,2732,20200505,5617
20200502,5,충정로,1478,1348,20200505,2826
20200502,5,서대문,5166,5051,20200505,10217
20200502,5,광화문,10701,10717,20200505,21418
20200502,5,종로3가,8938,9641,20200505,18579
20200502,5,을지로4가,2635,2990,20200505,5625
20200502,5,동대문역사문화공원,657,811,20200505,1468
20200502,5,청구,2128,1810,20200505,3938
20200502,5,신금호,3346,3405,20200505,6751
20200502,5,행당,4920,4307,20200505,9227
20200502,5,왕십리,2722,3211,20200505,5933
20200502,5,마장,3257,3211,20200505,6468
20200502,5,답십리,8489,7796,20200505,16285
20200502,5,장한평,8520,8444,20200505,16964
20200502,5,군자,6331,6928,20200505,13259
20200502,5,아차산,10464,10257,20200505,20721
20200502,5,광나루,7868,7501,20200505,15369
20200502,5,천호,13741,13953,20200505,27694
20200502,5,강동,11516,10214,20200505,21730
20200502,5,길동,4581,4633,20200505,9214
20200502,5,굽은다리,5373,4991,20200505,10364
20200502,5,명일,4485,4325,20200505,8810
20200502,5,고덕,4644,4589,20200505,9233
20200502,5,상일동,9000,8003,20200505,17003
20200502,5,둔촌동,4771,4608,20200505,9379
20200502,5,올림픽공원,2240,1905,20200505,4145
20200502,5,방이,4104,4038,20200505,8142
20200502,5,오금,1617,1554,20200505,3171
20200502,5,개롱,3280,3520,20200505,6800
20200502,5,거여,3955,3749,20200505,7704
20200502,5,마천,3333,3388,20200505,6721
20200503,5,마천,2597,2890,20200506,5487
20200503,5,거여,3074,3043,20200506,6117
20200503,5,개롱,2640,2846,20200506,5486
20200503,5,오금,1482,1395,20200506,2877
20200503,5,방이,3305,3167,20200506,6472
20200503,5,올림픽공원,1698,1438,20200506,3136
20200503,5,둔촌동,3733,3725,20200506,7458
20200503,5,상일동,6462,6195,20200506,12657
20200503,5,고덕,3246,3268,20200506,6514
20200503,5,명일,3391,3383,20200506,6774
20200503,5,굽은다리,4051,3857,20200506,7908
20200503,5,길동,3306,3350,20200506,6656
20200503,5,강동,8633,7858,20200506,16491
20200503,5,천호,10712,10412,20200506,21124
20200503,5,광나루,6193,6044,20200506,12237
20200503,5,아차산,8671,8905,20200506,17576
20200503,5,군자,4746,5502,20200506,10248
20200503,5,장한평,6037,6075,20200506,12112
20200503,5,답십리,6279,5747,20200506,12026
20200503,5,마장,2491,2500,20200506,4991
20200503,5,왕십리,2021,2408,20200506,4429
20200503,5,행당,3372,3019,20200506,6391
20200503,5,신금호,2453,2648,20200506,5101
20200503,5,청구,1494,1304,20200506,2798
20200503,5,동대문역사문화공원,423,583,20200506,1006
20200503,5,을지로4가,1146,1241,20200506,2387
20200503,5,종로3가,6621,6486,20200506,13107
20200503,5,광화문,8140,8185,20200506,16325
20200503,5,서대문,3598,3672,20200506,7270
20200503,5,충정로,1171,1202,20200506,2373
20200503,5,애오개,2269,2342,20200506,4611
20200503,5,공덕,3578,3776,20200506,7354
20200503,5,마포,3798,3882,20200506,7680
20200503,5,여의나루,8785,8822,20200506,17607
20200503,5,여의도,4234,4981,20200506,9215
20200503,5,신길,1269,1420,20200506,2689
20200503,5,영등포시장,3556,3829,20200506,7385
20200503,5,영등포구청,1083,1135,20200506,2218
20200503,5,양평,2031,2157,20200506,4188
20200503,5,오목교,9535,10048,20200506,19583
20200503,5,목동,6674,6910,20200506,13584
20200503,5,신정,5187,4666,20200506,9853
20200503,5,까치산,13704,13394,20200506,27098
20200503,5,화곡,12448,11869,20200506,24317
20200503,5,우장산,5765,5788,20200506,11553
20200503,5,발산,6989,7563,20200506,14552
20200503,5,마곡,2129,2217,20200506,4346
20200503,5,송정,3354,3441,20200506,6795
20200503,5,김포공항,5396,4372,20200506,9768
20200503,5,개화산,2321,2415,20200506,4736
20200503,5,방화,3330,3225,20200506,6555
20200504,5,마천,4537,4390,20200507,8927
20200504,5,거여,6443,5916,20200507,12359
20200504,5,개롱,5277,5351,20200507,10628
20200504,5,오금,2993,2898,20200507,5891
20200504,5,방이,5552,5549,20200507,11101
20200504,5,올림픽공원,3416,2974,20200507,6390
20200504,5,둔촌동,6878,6835,20200507,13713
20200504,5,상일동,15140,12789,20200507,27929
20200504,5,고덕,6969,7083,20200507,14052
20200504,5,명일,6907,6865,20200507,13772
20200504,5,굽은다리,7891,7210,20200507,15101
20200504,5,길동,6899,7104,20200507,14003
20200504,5,강동,17816,15279,20200507,33095
20200504,5,천호,16934,17681,20200507,34615
20200504,5,광나루,11138,9928,20200507,21066
20200504,5,아차산,12806,12629,20200507,25435
20200504,5,군자,9392,10543,20200507,19935
20200504,5,장한평,15259,15031,20200507,30290
20200504,5,답십리,13678,12636,20200507,26314
20200504,5,마장,4790,4466,20200507,9256
20200504,5,왕십리,3987,4579,20200507,8566
20200504,5,행당,7073,6126,20200507,13199
20200504,5,신금호,5369,5367,20200507,10736
20200504,5,청구,3612,3084,20200507,6696
20200504,5,동대문역사문화공원,1918,2231,20200507,4149
20200504,5,을지로4가,5017,5252,20200507,10269
20200504,5,종로3가,11319,12031,20200507,23350
20200504,5,광화문,23157,24462,20200507,47619
20200504,5,서대문,13976,14493,20200507,28469
20200504,5,충정로,3770,3772,20200507,7542
20200504,5,애오개,5621,5576,20200507,11197
20200504,5,공덕,10633,11368,20200507,22001
20200504,5,마포,11225,11770,20200507,22995
20200504,5,여의나루,10492,11161,20200507,21653
20200504,5,여의도,20048,21258,20200507,41306
20200504,5,신길,2864,3220,20200507,6084
20200504,5,영등포시장,7732,8072,20200507,15804
20200504,5,영등포구청,3343,3204,20200507,6547
20200504,5,양평,5712,5565,20200507,11277
20200504,5,오목교,18618,20263,20200507,38881
20200504,5,목동,14615,15753,20200507,30368
20200504,5,신정,11553,8750,20200507,20303
20200504,5,까치산,25952,24614,20200507,50566
20200504,5,화곡,25300,22894,20200507,48194
20200504,5,우장산,11960,11578,20200507,23538
20200504,5,발산,15645,16559,20200507,32204
20200504,5,마곡,6789,6430,20200507,13219
20200504,5,송정,6348,5960,20200507,12308
20200504,5,김포공항,5762,4919,20200507,10681
20200504,5,개화산,4571,4351,20200507,8922
20200504,5,방화,5879,5480,20200507,11359
20200505,5,방화,3551,3461,20200508,7012
20200505,5,개화산,2706,2757,20200508,5463
20200505,5,김포공항,5554,4725,20200508,10279
20200505,5,송정,3726,3692,20200508,7418
20200505,5,마곡,2816,2851,20200508,5667
20200505,5,발산,8216,8790,20200508,17006
20200505,5,우장산,6314,6515,20200508,12829
20200505,5,화곡,14128,13164,20200508,27292
20200505,5,까치산,15639,15024,20200508,30663
20200505,5,신정,6099,5408,20200508,11507
20200505,5,목동,7474,7748,20200508,15222
20200505,5,오목교,10454,11182,20200508,21636
20200505,5,양평,2389,2370,20200508,4759
20200505,5,영등포구청,1252,1224,20200508,2476
20200505,5,영등포시장,4298,4425,20200508,8723
20200505,5,신길,1538,1794,20200508,3332
20200505,5,여의도,5064,5568,20200508,10632
20200505,5,여의나루,9263,9279,20200508,18542
20200505,5,마포,4543,4617,20200508,9160
20200505,5,공덕,4099,4355,20200508,8454
20200505,5,애오개,2496,2504,20200508,5000
20200505,5,충정로,1501,1448,20200508,2949
20200505,5,서대문,4240,4296,20200508,8536
20200505,5,광화문,9373,9432,20200508,18805
20200505,5,종로3가,8352,8127,20200508,16479
20200505,5,을지로4가,2426,2569,20200508,4995
20200505,5,동대문역사문화공원,626,754,20200508,1380
20200505,5,청구,2003,1707,20200508,3710
20200505,5,신금호,2878,3012,20200508,5890
20200505,5,행당,3815,3345,20200508,7160
20200505,5,왕십리,2345,2811,20200508,5156
20200505,5,마장,2785,2699,20200508,5484
20200505,5,답십리,7259,6758,20200508,14017
20200505,5,장한평,7749,7689,20200508,15438
20200505,5,군자,5635,6225,20200508,11860
20200505,5,아차산,10783,10355,20200508,21138
20200505,5,광나루,6879,6842,20200508,13721
20200505,5,천호,12288,11930,20200508,24218
20200505,5,강동,9665,8876,20200508,18541
20200505,5,길동,3855,3945,20200508,7800
20200505,5,굽은다리,4760,4442,20200508,9202
20200505,5,명일,3664,3567,20200508,7231
20200505,5,고덕,3696,3682,20200508,7378
20200505,5,상일동,7730,7066,20200508,14796
20200505,5,둔촌동,4155,4148,20200508,8303
20200505,5,올림픽공원,1981,1800,20200508,3781
20200505,5,방이,3149,3235,20200508,6384
20200505,5,오금,1413,1266,20200508,2679
20200505,5,개롱,2807,3045,20200508,5852
20200505,5,거여,3581,3412,20200508,6993
20200505,5,마천,3045,3134,20200508,6179
20200506,5,상일동,19009,16077,20200509,35086
20200506,5,고덕,8287,8499,20200509,16786
20200506,5,명일,8313,8820,20200509,17133
20200506,5,굽은다리,8780,8191,20200509,16971
20200506,5,길동,7641,7961,20200509,15602
20200506,5,강동,21530,18301,20200509,39831
20200506,5,천호,17955,18966,20200509,36921
20200506,5,광나루,12956,11582,20200509,24538
20200506,5,아차산,13988,13675,20200509,27663
20200506,5,군자,10794,11925,20200509,22719
20200506,5,장한평,18233,18076,20200509,36309
20200506,5,답십리,16097,14952,20200509,31049
20200506,5,마장,5353,5034,20200509,10387
20200506,5,왕십리,4347,4783,20200509,9130
20200506,5,행당,8177,7271,20200509,15448
20200506,5,신금호,6235,6299,20200509,12534
20200506,5,청구,4101,3678,20200509,7779
20200506,5,동대문역사문화공원,2843,3369,20200509,6212
20200506,5,을지로4가,6078,6341,20200509,12419
20200506,5,종로3가,12017,12238,20200509,24255
20200506,5,광화문,31300,33121,20200509,64421
20200506,5,서대문,17715,18259,20200509,35974
20200506,5,충정로,5273,5280,20200509,10553
20200506,5,애오개,7023,7048,20200509,14071
20200506,5,공덕,13742,14834,20200509,28576
20200506,5,마포,14204,14624,20200509,28828
20200506,5,여의나루,11700,12080,20200509,23780
20200506,5,여의도,26419,28310,20200509,54729
20200506,5,신길,3648,3939,20200509,7587
20200506,5,영등포시장,9041,9301,20200509,18342
20200506,5,영등포구청,4170,4088,20200509,8258
20200506,5,양평,7589,7497,20200509,15086
20200506,5,오목교,21903,23646,20200509,45549
20200506,5,목동,17363,19026,20200509,36389
20200506,5,신정,13758,10425,20200509,24183
20200506,5,까치산,29567,28102,20200509,57669
20200506,5,화곡,28880,26785,20200509,55665
20200506,5,우장산,14025,13893,20200509,27918
20200506,5,발산,19479,19974,20200509,39453
20200506,5,마곡,8780,8374,20200509,17154
20200506,5,송정,6971,6378,20200509,13349
20200506,5,김포공항,5769,5063,20200509,10832
20200506,5,개화산,5331,5130,20200509,10461
20200506,5,방화,6756,6339,20200509,13095
20200506,5,둔촌동,8130,8006,20200509,16136
20200506,5,올림픽공원,3942,3396,20200509,7338
20200506,5,방이,6810,7042,20200509,13852
20200506,5,오금,3748,3642,20200509,7390
20200506,5,개롱,6102,6293,20200509,12395
20200506,5,거여,7567,7011,20200509,14578
20200506,5,마천,5134,5191,20200509,10325
20200507,5,방화,6774,6390,20200510,13164
20200507,5,개화산,5346,5086,20200510,10432
20200507,5,김포공항,5756,5379,20200510,11135
20200507,5,송정,7009,6523,20200510,13532
20200507,5,마곡,8868,8359,20200510,17227
20200507,5,발산,19826,20430,20200510,40256
20200507,5,우장산,14182,14044,20200510,28226
20200507,5,화곡,29287,27112,20200510,56399
20200507,5,까치산,29767,28213,20200510,57980
20200507,5,신정,13875,10541,20200510,24416
20200507,5,목동,17824,19317,20200510,37141
20200507,5,오목교,22611,24413,20200510,47024
20200507,5,양평,7408,7365,20200510,14773
20200507,5,영등포구청,4129,4162,20200510,8291
20200507,5,영등포시장,8940,9149,20200510,18089
20200507,5,신길,3700,3968,20200510,7668
20200507,5,여의도,26584,28682,20200510,55266
20200507,5,여의나루,11320,11837,20200510,23157
20200507,5,마포,14460,15044,20200510,29504
20200507,5,공덕,14561,15620,20200510,30181
20200507,5,애오개,7300,7296,20200510,14596
20200507,5,충정로,5260,5402,20200510,10662
20200507,5,서대문,17990,18773,20200510,36763
20200507,5,광화문,31891,34080,20200510,65971
20200507,5,종로3가,11996,12144,20200510,24140
20200507,5,을지로4가,6188,6314,20200510,12502
20200507,5,동대문역사문화공원,2969,3472,20200510,6441
20200507,5,청구,4083,3631,20200510,7714
20200507,5,신금호,6321,6376,20200510,12697
20200507,5,행당,8224,7212,20200510,15436
20200507,5,왕십리,4410,4875,20200510,9285
20200507,5,마장,5465,5074,20200510,10539
20200507,5,답십리,16199,14733,20200510,30932
20200507,5,장한평,18574,18429,20200510,37003
20200507,5,군자,10914,11943,20200510,22857
20200507,5,아차산,14268,13977,20200510,28245
20200507,5,광나루,13243,11806,20200510,25049
20200507,5,천호,18009,19048,20200510,37057
20200507,5,강동,21648,18401,20200510,40049
20200507,5,길동,7612,7920,20200510,15532
20200507,5,굽은다리,8949,8318,20200510,17267
20200507,5,명일,8381,8540,20200510,16921
20200507,5,고덕,8541,8636,20200510,17177
20200507,5,상일동,19405,16319,20200510,35724
20200507,5,둔촌동,8237,8164,20200510,16401
20200507,5,올림픽공원,3936,3421,20200510,7357
20200507,5,방이,6893,7132,20200510,14025
20200507,5,오금,3733,3634,20200510,7367
20200507,5,개롱,6166,6352,20200510,12518
20200507,5,거여,7526,6985,20200510,14511
20200507,5,마천,5089,5159,20200510,10248
20200508,5,방화,6882,6349,20200511,13231
20200508,5,개화산,5233,5139,20200511,10372
20200508,5,김포공항,6028,5843,20200511,11871
20200508,5,송정,7295,6682,20200511,13977
20200508,5,마곡,9036,8358,20200511,17394
20200508,5,발산,20177,21084,20200511,41261
20200508,5,우장산,14335,14486,20200511,28821
20200508,5,화곡,29770,27816,20200511,57586
20200508,5,까치산,30344,28819,20200511,59163
20200508,5,신정,14079,11076,20200511,25155
20200508,5,목동,18122,19780,20200511,37902
20200508,5,오목교,23717,26267,20200511,49984
20200508,5,양평,7776,7478,20200511,15254
20200508,5,영등포구청,4126,4057,20200511,8183
20200508,5,영등포시장,9390,9495,20200511,18885
20200508,5,신길,3739,4026,20200511,7765
20200508,5,여의도,28333,28207,20200511,56540
20200508,5,여의나루,10291,9743,20200511,20034
20200508,5,마포,14705,15476,20200511,30181
20200508,5,공덕,14721,16169,20200511,30890
20200508,5,애오개,7442,7521,20200511,14963
20200508,5,충정로,5297,5334,20200511,10631
20200508,5,서대문,18428,18223,20200511,36651
20200508,5,광화문,32792,33351,20200511,66143
20200508,5,종로3가,11542,11589,20200511,23131
20200508,5,을지로4가,6027,6103,20200511,12130
20200508,5,동대문역사문화공원,3033,3396,20200511,6429
20200508,5,청구,4046,3717,20200511,7763
20200508,5,신금호,6421,6551,20200511,12972
20200508,5,행당,8426,7425,20200511,15851
20200508,5,왕십리,4535,5025,20200511,9560
20200508,5,마장,5637,5378,20200511,11015
20200508,5,답십리,16599,15426,20200511,32025
20200508,5,장한평,18431,18641,20200511,37072
20200508,5,군자,10945,11978,20200511,22923
20200508,5,아차산,14355,14227,20200511,28582
20200508,5,광나루,13547,12188,20200511,25735
20200508,5,천호,18982,20147,20200511,39129
20200508,5,강동,22086,18590,20200511,40676
20200508,5,길동,7890,8356,20200511,16246
20200508,5,굽은다리,9143,8695,20200511,17838
20200508,5,명일,8421,8902,20200511,17323
20200508,5,고덕,8478,8642,20200511,17120
20200508,5,상일동,19285,16615,20200511,35900
20200508,5,둔촌동,8222,8456,20200511,16678
20200508,5,올림픽공원,3955,3523,20200511,7478
20200508,5,방이,7007,7391,20200511,14398
20200508,5,오금,3725,3694,20200511,7419
20200508,5,개롱,6296,6550,20200511,12846
20200508,5,거여,7699,7192,20200511,14891
20200508,5,마천,5165,5143,20200511,10308
20200509,5,방화,3805,3614,20200512,7419
20200509,5,개화산,2994,2894,20200512,5888
20200509,5,김포공항,4536,4611,20200512,9147
20200509,5,송정,4374,4270,20200512,8644
20200509,5,마곡,3359,3164,20200512,6523
20200509,5,발산,11113,12134,20200512,23247
20200509,5,우장산,8018,7751,20200512,15769
20200509,5,화곡,16999,15547,20200512,32546
20200509,5,까치산,17845,16814,20200512,34659
20200509,5,신정,7517,6093,20200512,13610
20200509,5,목동,9712,9731,20200512,19443
20200509,5,오목교,13711,14340,20200512,28051
20200509,5,양평,2915,2748,20200512,5663
20200509,5,영등포구청,1471,1466,20200512,2937
20200509,5,영등포시장,5352,5644,20200512,10996
20200509,5,신길,1744,1933,20200512,3677
20200509,5,여의도,6761,7284,20200512,14045
20200509,5,여의나루,2645,2581,20200512,5226
20200509,5,마포,5858,5908,20200512,11766
20200509,5,공덕,5666,6301,20200512,11967
20200509,5,애오개,3213,3046,20200512,6259
20200509,5,충정로,1793,1618,20200512,3411
20200509,5,서대문,5659,5575,20200512,11234
20200509,5,광화문,9476,9935,20200512,19411
20200509,5,종로3가,7775,7865,20200512,15640
20200509,5,을지로4가,2548,2787,20200512,5335
20200509,5,동대문역사문화공원,743,915,20200512,1658
20200509,5,청구,2209,1778,20200512,3987
20200509,5,신금호,3396,3333,20200512,6729
20200509,5,행당,4671,3950,20200512,8621
20200509,5,왕십리,2662,3315,20200512,5977
20200509,5,마장,3285,3207,20200512,6492
20200509,5,답십리,8497,7898,20200512,16395
20200509,5,장한평,8786,8861,20200512,17647
20200509,5,군자,6512,7362,20200512,13874
20200509,5,아차산,8653,8545,20200512,17198
20200509,5,광나루,7306,6600,20200512,13906
20200509,5,천호,13706,13590,20200512,27296
20200509,5,강동,12689,11195,20200512,23884
20200509,5,길동,4765,4857,20200512,9622
20200509,5,굽은다리,5719,5209,20200512,10928
20200509,5,명일,4437,4350,20200512,8787
20200509,5,고덕,4626,4574,20200512,9200
20200509,5,상일동,9018,8068,20200512,17086
20200509,5,둔촌동,4818,4848,20200512,9666
20200509,5,올림픽공원,2044,1633,20200512,3677
20200509,5,방이,4343,4143,20200512,8486
20200509,5,오금,1915,1723,20200512,3638
20200509,5,개롱,3786,3878,20200512,7664
20200509,5,거여,4475,4166,20200512,8641
20200509,5,마천,3260,3202,20200512,6462
20200510,5,방화,3228,3167,20200513,6395
20200510,5,개화산,2416,2454,20200513,4870
20200510,5,김포공항,4261,4334,20200513,8595
20200510,5,송정,3469,3557,20200513,7026
20200510,5,마곡,2342,2456,20200513,4798
20200510,5,발산,7479,8046,20200513,15525
20200510,5,우장산,5890,5917,20200513,11807
20200510,5,화곡,12650,11996,20200513,24646
20200510,5,까치산,14399,13858,20200513,28257
20200510,5,신정,5649,4806,20200513,10455
20200510,5,목동,7014,7321,20200513,14335
20200510,5,오목교,10353,10807,20200513,21160
20200510,5,양평,2149,2238,20200513,4387
20200510,5,영등포구청,1057,1063,20200513,2120
20200510,5,영등포시장,3564,3712,20200513,7276
20200510,5,신길,1343,1506,20200513,2849
20200510,5,여의도,4621,5044,20200513,9665
20200510,5,여의나루,7021,6968,20200513,13989
20200510,5,마포,4072,4121,20200513,8193
20200510,5,공덕,3874,3990,20200513,7864
20200510,5,애오개,2440,2486,20200513,4926
20200510,5,충정로,1292,1322,20200513,2614
20200510,5,서대문,4078,3988,20200513,8066
20200510,5,광화문,8179,8175,20200513,16354
20200510,5,종로3가,6191,5925,20200513,12116
20200510,5,을지로4가,1127,1242,20200513,2369
20200510,5,동대문역사문화공원,448,585,20200513,1033
20200510,5,청구,1587,1357,20200513,2944
20200510,5,신금호,2514,2750,20200513,5264
20200510,5,행당,3535,3165,20200513,6700
20200510,5,왕십리,2069,2348,20200513,4417
20200510,5,마장,2714,2671,20200513,5385
20200510,5,답십리,6581,6130,20200513,12711
20200510,5,장한평,6452,6395,20200513,12847
20200510,5,군자,5224,5863,20200513,11087
20200510,5,아차산,8739,8695,20200513,17434
20200510,5,광나루,6264,6280,20200513,12544
20200510,5,천호,10947,10704,20200513,21651
20200510,5,강동,9042,8489,20200513,17531
20200510,5,길동,3462,3605,20200513,7067
20200510,5,굽은다리,4226,3938,20200513,8164
20200510,5,명일,3662,3617,20200513,7279
20200510,5,고덕,3267,3303,20200513,6570
20200510,5,상일동,6728,6345,20200513,13073
20200510,5,둔촌동,4104,4037,20200513,8141
20200510,5,올림픽공원,1685,1539,20200513,3224
20200510,5,방이,3503,3349,20200513,6852
20200510,5,오금,1381,1302,20200513,2683
20200510,5,개롱,2636,2857,20200513,5493
20200510,5,거여,3249,3234,20200513,6483
20200510,5,마천,2737,3063,20200513,5800
20200511,5,마천,5098,5083,20200514,10181
20200511,5,거여,7363,6912,20200514,14275
20200511,5,개롱,6115,6391,20200514,12506
20200511,5,오금,3701,3578,20200514,7279
20200511,5,방이,6594,6885,20200514,13479
20200511,5,올림픽공원,3962,3487,20200514,7449
20200511,5,둔촌동,7818,7890,20200514,15708
20200511,5,상일동,19012,16203,20200514,35215
20200511,5,고덕,8237,8464,20200514,16701
20200511,5,명일,8128,8384,20200514,16512
20200511,5,굽은다리,8693,8115,20200514,16808
20200511,5,길동,7687,7780,20200514,15467
20200511,5,강동,21464,18138,20200514,39602
20200511,5,천호,17001,18127,20200514,35128
20200511,5,광나루,12612,11298,20200514,23910
20200511,5,아차산,13532,13429,20200514,26961
20200511,5,군자,10595,11659,20200514,22254
20200511,5,장한평,18004,17937,20200514,35941
20200511,5,답십리,15959,14663,20200514,30622
20200511,5,마장,5440,5034,20200514,10474
20200511,5,왕십리,4296,4728,20200514,9024
20200511,5,행당,8105,7241,20200514,15346
20200511,5,신금호,6010,6212,20200514,12222
20200511,5,청구,4077,3569,20200514,7646
20200511,5,동대문역사문화공원,3024,3380,20200514,6404
20200511,5,을지로4가,6085,6156,20200514,12241
20200511,5,종로3가,10907,11028,20200514,21935
20200511,5,광화문,31333,32540,20200514,63873
20200511,5,서대문,18082,18652,20200514,36734
20200511,5,충정로,5222,5320,20200514,10542
20200511,5,애오개,6951,7070,20200514,14021
20200511,5,공덕,14250,15409,20200514,29659
20200511,5,마포,14123,14548,20200514,28671
20200511,5,여의나루,9256,9638,20200514,18894
20200511,5,여의도,26453,27876,20200514,54329
20200511,5,신길,3630,4143,20200514,7773
20200511,5,영등포시장,8641,8922,20200514,17563
20200511,5,영등포구청,4027,4038,20200514,8065
20200511,5,양평,7412,7410,20200514,14822
20200511,5,오목교,21633,23284,20200514,44917
20200511,5,목동,17150,18945,20200514,36095
20200511,5,신정,13546,10463,20200514,24009
20200511,5,까치산,29340,27805,20200514,57145
20200511,5,화곡,28438,26689,20200514,55127
20200511,5,우장산,13840,13744,20200514,27584
20200511,5,발산,19014,19398,20200514,38412
20200511,5,마곡,8692,8219,20200514,16911
20200511,5,송정,6890,6401,20200514,13291
20200511,5,김포공항,5274,5170,20200514,10444
20200511,5,개화산,5184,4911,20200514,10095
20200511,5,방화,6553,6281,20200514,12834
20200512,5,청구,3942,3620,20200515,7562
20200512,5,신길,3702,3996,20200515,7698
20200512,5,방화,6522,6131,20200515,12653
20200512,5,개화산,5141,4879,20200515,10020
20200512,5,김포공항,5399,5169,20200515,10568
20200512,5,송정,6687,6226,20200515,12913
20200512,5,마곡,8775,8243,20200515,17018
20200512,5,발산,18977,19471,20200515,38448
20200512,5,우장산,13721,13577,20200515,27298
20200512,5,화곡,28175,26442,20200515,54617
20200512,5,까치산,28718,27403,20200515,56121
20200512,5,신정,13595,10391,20200515,23986
20200512,5,목동,17230,18929,20200515,36159
20200512,5,오목교,21721,23356,20200515,45077
20200512,5,양평,7460,7300,20200515,14760
20200512,5,영등포구청,4052,4053,20200515,8105
20200512,5,영등포시장,8759,8952,20200515,17711
20200512,5,여의도,26462,27685,20200515,54147
20200512,5,여의나루,9162,9474,20200515,18636
20200512,5,마포,14305,14747,20200515,29052
20200512,5,공덕,14493,15485,20200515,29978
20200512,5,애오개,7038,7136,20200515,14174
20200512,5,충정로,5441,5491,20200515,10932
20200512,5,서대문,18053,18707,20200515,36760
20200512,5,광화문,31006,32860,20200515,63866
20200512,5,종로3가,11079,11119,20200515,22198
20200512,5,을지로4가,6000,6184,20200515,12184
20200512,5,동대문역사문화공원,2980,3332,20200515,6312
20200512,5,신금호,6061,6100,20200515,12161
20200512,5,행당,8030,7062,20200515,15092
20200512,5,왕십리,4258,4618,20200515,8876
20200512,5,마장,5367,5036,20200515,10403
20200512,5,답십리,15763,14483,20200515,30246
20200512,5,장한평,17802,17752,20200515,35554
20200512,5,군자,10721,11709,20200515,22430
20200512,5,아차산,13448,13438,20200515,26886
20200512,5,광나루,12736,11247,20200515,23983
20200512,5,천호,17270,18438,20200515,35708
20200512,5,강동,21394,18163,20200515,39557
20200512,5,길동,7295,7720,20200515,15015
20200512,5,굽은다리,8646,8079,20200515,16725
20200512,5,명일,8181,8441,20200515,16622
20200512,5,고덕,8280,8537,20200515,16817
20200512,5,상일동,18623,15888,20200515,34511
20200512,5,둔촌동,7949,7985,20200515,15934
20200512,5,올림픽공원,3839,3422,20200515,7261
20200512,5,방이,6674,6793,20200515,13467
20200512,5,오금,3684,3528,20200515,7212
20200512,5,개롱,6109,6329,20200515,12438
20200512,5,거여,7305,6865,20200515,14170
20200512,5,마천,4999,5047,20200515,10046
20200513,5,마천,5118,5156,20200516,10274
20200513,5,거여,7559,6997,20200516,14556
20200513,5,개롱,6141,6313,20200516,12454
20200513,5,오금,3646,3565,20200516,7211
20200513,5,방이,6681,6896,20200516,13577
20200513,5,올림픽공원,3918,3485,20200516,7403
20200513,5,둔촌동,8077,8027,20200516,16104
20200513,5,상일동,18764,15863,20200516,34627
20200513,5,고덕,8183,8369,20200516,16552
20200513,5,명일,8144,8461,20200516,16605
20200513,5,굽은다리,8684,8077,20200516,16761
20200513,5,길동,7454,7776,20200516,15230
20200513,5,강동,21458,18281,20200516,39739
20200513,5,천호,17471,18705,20200516,36176
20200513,5,방화,6678,6220,20200516,12898
20200513,5,개화산,5236,4988,20200516,10224
20200513,5,김포공항,5490,5108,20200516,10598
20200513,5,송정,6789,6317,20200516,13106
20200513,5,마곡,8596,8214,20200516,16810
20200513,5,발산,19029,19426,20200516,38455
20200513,5,우장산,13644,13645,20200516,27289
20200513,5,화곡,28418,26457,20200516,54875
20200513,5,까치산,28960,27791,20200516,56751
20200513,5,신정,13628,10472,20200516,24100
20200513,5,목동,17406,19157,20200516,36563
20200513,5,오목교,21756,23648,20200516,45404
20200513,5,양평,7388,7332,20200516,14720
20200513,5,영등포구청,4107,4047,20200516,8154
20200513,5,영등포시장,8835,9068,20200516,17903
20200513,5,신길,3701,4053,20200516,7754
20200513,5,여의도,26823,28345,20200516,55168
20200513,5,여의나루,10468,10727,20200516,21195
20200513,5,마포,14522,14845,20200516,29367
20200513,5,공덕,14338,15609,20200516,29947
20200513,5,애오개,7124,7122,20200516,14246
20200513,5,충정로,5206,5362,20200516,10568
20200513,5,서대문,17948,18645,20200516,36593
20200513,5,광화문,31693,33328,20200516,65021
20200513,5,종로3가,11286,11337,20200516,22623
20200513,5,을지로4가,6100,6214,20200516,12314
20200513,5,동대문역사문화공원,2899,3388,20200516,6287
20200513,5,청구,4083,3596,20200516,7679
20200513,5,신금호,6198,6194,20200516,12392
20200513,5,행당,8005,7103,20200516,15108
20200513,5,왕십리,4354,4882,20200516,9236
20200513,5,마장,5426,4984,20200516,10410
20200513,5,답십리,15827,14506,20200516,30333
20200513,5,장한평,17944,17977,20200516,35921
20200513,5,군자,10714,11860,20200516,22574
20200513,5,아차산,13804,13650,20200516,27454
20200513,5,광나루,12869,11490,20200516,24359
20200514,5,마천,5036,5118,20200517,10154
20200514,5,거여,7384,6818,20200517,14202
20200514,5,개롱,5973,6243,20200517,12216
20200514,5,오금,3647,3517,20200517,7164
20200514,5,방이,6558,6724,20200517,13282
20200514,5,올림픽공원,3762,3284,20200517,7046
20200514,5,둔촌동,7884,8003,20200517,15887
20200514,5,상일동,18804,15842,20200517,34646
20200514,5,고덕,8193,8283,20200517,16476
20200514,5,명일,7999,8373,20200517,16372
20200514,5,굽은다리,8633,8081,20200517,16714
20200514,5,길동,7322,7622,20200517,14944
20200514,5,강동,21149,17854,20200517,39003
20200514,5,천호,17073,18304,20200517,35377
20200514,5,광나루,12736,11470,20200517,24206
20200514,5,아차산,13643,13328,20200517,26971
20200514,5,군자,10638,11891,20200517,22529
20200514,5,장한평,17904,17794,20200517,35698
20200514,5,답십리,15774,14441,20200517,30215
20200514,5,마장,5418,5068,20200517,10486
20200514,5,왕십리,4326,4932,20200517,9258
20200514,5,행당,7885,6950,20200517,14835
20200514,5,신금호,6006,6038,20200517,12044
20200514,5,청구,3939,3591,20200517,7530
20200514,5,동대문역사문화공원,2941,3281,20200517,6222
20200514,5,을지로4가,6083,6166,20200517,12249
20200514,5,종로3가,10749,10748,20200517,21497
20200514,5,광화문,30940,32698,20200517,63638
20200514,5,서대문,17634,18224,20200517,35858
20200514,5,충정로,5242,5371,20200517,10613
20200514,5,애오개,7017,7096,20200517,14113
20200514,5,공덕,14137,15278,20200517,29415
20200514,5,마포,13957,14633,20200517,28590
20200514,5,여의나루,9642,10316,20200517,19958
20200514,5,여의도,26147,27827,20200517,53974
20200514,5,영등포시장,8740,9023,20200517,17763
20200514,5,영등포구청,4092,4009,20200517,8101
20200514,5,양평,7225,7106,20200517,14331
20200514,5,오목교,21217,23124,20200517,44341
20200514,5,목동,17090,18858,20200517,35948
20200514,5,신정,13514,10363,20200517,23877
20200514,5,까치산,28625,27484,20200517,56109
20200514,5,화곡,27928,25982,20200517,53910
20200514,5,우장산,13553,13381,20200517,26934
20200514,5,발산,18860,19163,20200517,38023
20200514,5,마곡,8506,8097,20200517,16603
20200514,5,송정,6687,6188,20200517,12875
20200514,5,김포공항,5479,5138,20200517,10617
20200514,5,개화산,5234,4864,20200517,10098
20200514,5,방화,6530,6130,20200517,12660
20200514,5,신길,3632,3911,20200517,7543
20200515,5,신길,3647,3870,20200518,7517
20200515,5,여의도,26298,27386,20200518,53684
20200515,5,여의나루,6621,6580,20200518,13201
20200515,5,마포,14157,14676,20200518,28833
20200515,5,공덕,14121,15603,20200518,29724
20200515,5,애오개,6994,7061,20200518,14055
20200515,5,충정로,5200,5170,20200518,10370
20200515,5,서대문,17416,17702,20200518,35118
20200515,5,광화문,31165,32665,20200518,63830
20200515,5,종로3가,10184,10508,20200518,20692
20200515,5,을지로4가,5643,5798,20200518,11441
20200515,5,마천,4882,4850,20200518,9732
20200515,5,거여,7111,6690,20200518,13801
20200515,5,개롱,6035,6188,20200518,12223
20200515,5,오금,3671,3538,20200518,7209
20200515,5,방이,6668,6936,20200518,13604
20200515,5,올림픽공원,3712,3025,20200518,6737
20200515,5,둔촌동,7988,8184,20200518,16172
20200515,5,상일동,18112,15345,20200518,33457
20200515,5,고덕,7921,8087,20200518,16008
20200515,5,명일,7813,8235,20200518,16048
20200515,5,굽은다리,8498,7994,20200518,16492
20200515,5,길동,7323,7592,20200518,14915
20200515,5,강동,20942,17678,20200518,38620
20200515,5,천호,16753,17905,20200518,34658
20200515,5,광나루,12391,10759,20200518,23150
20200515,5,아차산,12743,12446,20200518,25189
20200515,5,군자,10602,12039,20200518,22641
20200515,5,장한평,17347,17514,20200518,34861
20200515,5,답십리,15580,14380,20200518,29960
20200515,5,마장,5372,5018,20200518,10390
20200515,5,왕십리,4336,4964,20200518,9300
20200515,5,행당,7849,6931,20200518,14780
20200515,5,신금호,5999,5803,20200518,11802
20200515,5,청구,3943,3547,20200518,7490
20200515,5,동대문역사문화공원,2963,3302,20200518,6265
20200515,5,목동,17053,18613,20200518,35666
20200515,5,방화,6273,6001,20200518,12274
20200515,5,개화산,4848,4593,20200518,9441
20200515,5,김포공항,5881,5439,20200518,11320
20200515,5,송정,6647,6115,20200518,12762
20200515,5,마곡,8784,8113,20200518,16897
20200515,5,발산,18166,19041,20200518,37207
20200515,5,우장산,13559,13402,20200518,26961
20200515,5,화곡,27572,25630,20200518,53202
20200515,5,까치산,28329,26653,20200518,54982
20200515,5,신정,13402,10165,20200518,23567
20200515,5,오목교,21748,23783,20200518,45531
20200515,5,양평,7235,7182,20200518,14417
20200515,5,영등포구청,3713,3782,20200518,7495
20200515,5,영등포시장,8502,8818,20200518,17320
20200516,5,마포,6326,6405,20200519,12731
20200516,5,공덕,6192,6837,20200519,13029
20200516,5,애오개,3499,3191,20200519,6690
20200516,5,충정로,1776,1599,20200519,3375
20200516,5,서대문,6156,5836,20200519,11992
20200516,5,광화문,11074,11724,20200519,22798
20200516,5,종로3가,8330,8508,20200519,16838
20200516,5,을지로4가,2963,3324,20200519,6287
20200516,5,동대문역사문화공원,753,961,20200519,1714
20200516,5,청구,2373,1984,20200519,4357
20200516,5,신금호,3730,3735,20200519,7465
20200516,5,행당,5094,4267,20200519,9361
20200516,5,왕십리,3049,3575,20200519,6624
20200516,5,마장,3444,3454,20200519,6898
20200516,5,답십리,9092,8404,20200519,17496
20200516,5,장한평,9684,9736,20200519,19420
20200516,5,군자,7145,8124,20200519,15269
20200516,5,아차산,10136,10004,20200519,20140
20200516,5,광나루,8402,7831,20200519,16233
20200516,5,천호,14540,14295,20200519,28835
20200516,5,강동,13270,11794,20200519,25064
20200516,5,길동,4982,5094,20200519,10076
20200516,5,굽은다리,5864,5299,20200519,11163
20200516,5,명일,4805,4721,20200519,9526
20200516,5,고덕,4959,4811,20200519,9770
20200516,5,상일동,9805,8704,20200519,18509
20200516,5,둔촌동,5450,5420,20200519,10870
20200516,5,올림픽공원,2484,2046,20200519,4530
20200516,5,방이,4606,4451,20200519,9057
20200516,5,오금,2199,1985,20200519,4184
20200516,5,개롱,4107,4110,20200519,8217
20200516,5,거여,4505,4256,20200519,8761
20200516,5,마천,3488,3683,20200519,7171
20200516,5,신길,1975,2147,20200519,4122
20200516,5,여의도,7734,8502,20200519,16236
20200516,5,여의나루,5580,5732,20200519,11312
20200516,5,방화,4373,4114,20200519,8487
20200516,5,개화산,3187,3095,20200519,6282
20200516,5,김포공항,4917,5116,20200519,10033
20200516,5,송정,4896,4699,20200519,9595
20200516,5,마곡,3628,3433,20200519,7061
20200516,5,발산,11762,12732,20200519,24494
20200516,5,우장산,8521,8323,20200519,16844
20200516,5,화곡,17892,16296,20200519,34188
20200516,5,까치산,19340,18347,20200519,37687
20200516,5,신정,7887,6386,20200519,14273
20200516,5,목동,10360,10749,20200519,21109
20200516,5,오목교,14866,15586,20200519,30452
20200516,5,양평,3203,3019,20200519,6222
20200516,5,영등포구청,1715,1662,20200519,3377
20200516,5,영등포시장,5964,6315,20200519,12279
20200517,5,마천,2948,3240,20200520,6188
20200517,5,거여,3295,3176,20200520,6471
20200517,5,개롱,3000,3179,20200520,6179
20200517,5,오금,1591,1485,20200520,3076
20200517,5,방이,3605,3402,20200520,7007
20200517,5,올림픽공원,1936,1662,20200520,3598
20200517,5,둔촌동,4011,4053,20200520,8064
20200517,5,상일동,6766,6396,20200520,13162
20200517,5,고덕,3353,3418,20200520,6771
20200517,5,명일,3577,3581,20200520,7158
20200517,5,굽은다리,4264,4047,20200520,8311
20200517,5,길동,3398,3477,20200520,6875
20200517,5,강동,9240,8543,20200520,17783
20200517,5,천호,10973,10549,20200520,21522
20200517,5,광나루,6821,6782,20200520,13603
20200517,5,아차산,9396,9792,20200520,19188
20200517,5,군자,5276,5707,20200520,10983
20200517,5,장한평,6268,6122,20200520,12390
20200517,5,답십리,6613,6093,20200520,12706
20200517,5,마장,2756,2636,20200520,5392
20200517,5,왕십리,2256,2568,20200520,4824
20200517,5,행당,3702,3365,20200520,7067
20200517,5,신금호,2569,2800,20200520,5369
20200517,5,청구,1678,1318,20200520,2996
20200517,5,동대문역사문화공원,452,593,20200520,1045
20200517,5,을지로4가,1214,1251,20200520,2465
20200517,5,종로3가,5898,5548,20200520,11446
20200517,5,광화문,8605,8987,20200520,17592
20200517,5,서대문,4392,4322,20200520,8714
20200517,5,충정로,1295,1304,20200520,2599
20200517,5,애오개,2373,2392,20200520,4765
20200517,5,공덕,4201,4339,20200520,8540
20200517,5,마포,4154,4159,20200520,8313
20200517,5,여의나루,7471,7376,20200520,14847
20200517,5,여의도,5288,5869,20200520,11157
20200517,5,신길,1413,1526,20200520,2939
20200517,5,영등포시장,3596,3717,20200520,7313
20200517,5,영등포구청,1241,1157,20200520,2398
20200517,5,양평,2229,2277,20200520,4506
20200517,5,오목교,10375,10910,20200520,21285
20200517,5,목동,7240,7315,20200520,14555
20200517,5,신정,5657,4938,20200520,10595
20200517,5,까치산,14330,13612,20200520,27942
20200517,5,화곡,13078,12226,20200520,25304
20200517,5,우장산,5864,5964,20200520,11828
20200517,5,발산,7337,7896,20200520,15233
20200517,5,마곡,2249,2359,20200520,4608
20200517,5,송정,3590,3676,20200520,7266
20200517,5,김포공항,4562,4524,20200520,9086
20200517,5,개화산,2487,2492,20200520,4979
20200517,5,방화,3275,3222,20200520,6497
20200518,5,마천,4776,4919,20200521,9695
20200518,5,거여,7115,6824,20200521,13939
20200518,5,개롱,5935,6332,20200521,12267
20200518,5,오금,3611,3542,20200521,7153
20200518,5,방이,6434,6691,20200521,13125
20200518,5,올림픽공원,3811,3164,20200521,6975
20200518,5,둔촌동,7655,7747,20200521,15402
20200518,5,상일동,17924,15960,20200521,33884
20200518,5,고덕,7873,8050,20200521,15923
20200518,5,명일,7903,8348,20200521,16251
20200518,5,굽은다리,8319,8071,20200521,16390
20200518,5,길동,7219,7541,20200521,14760
20200518,5,강동,21021,18036,20200521,39057
20200518,5,천호,16047,17030,20200521,33077
20200518,5,광나루,12065,10778,20200521,22843
20200518,5,아차산,12718,12802,20200521,25520
20200518,5,군자,10127,11057,20200521,21184
20200518,5,장한평,17338,17341,20200521,34679
20200518,5,답십리,15209,14270,20200521,29479
20200518,5,마장,5177,4874,20200521,10051
20200518,5,왕십리,4128,4430,20200521,8558
20200518,5,행당,7843,7213,20200521,15056
20200518,5,신금호,5810,5979,20200521,11789
20200518,5,청구,3954,3550,20200521,7504
20200518,5,동대문역사문화공원,3150,3292,20200521,6442
20200518,5,을지로4가,5894,5991,20200521,11885
20200518,5,종로3가,10342,10294,20200521,20636
20200518,5,광화문,32222,32372,20200521,64594
20200518,5,서대문,17832,17873,20200521,35705
20200518,5,충정로,4994,5108,20200521,10102
20200518,5,애오개,6715,7079,20200521,13794
20200518,5,공덕,13566,14605,20200521,28171
20200518,5,마포,13767,14233,20200521,28000
20200518,5,여의나루,7331,7448,20200521,14779
20200518,5,여의도,26846,27061,20200521,53907
20200518,5,신길,3514,4002,20200521,7516
20200518,5,영등포시장,8428,8779,20200521,17207
20200518,5,영등포구청,3792,3937,20200521,7729
20200518,5,양평,7407,7297,20200521,14704
20200518,5,오목교,20656,22252,20200521,42908
20200518,5,목동,16322,18328,20200521,34650
20200518,5,신정,13275,10412,20200521,23687
20200518,5,까치산,27654,26824,20200521,54478
20200518,5,화곡,27640,25655,20200521,53295
20200518,5,우장산,13295,13302,20200521,26597
20200518,5,발산,18120,18341,20200521,36461
20200518,5,마곡,8700,8208,20200521,16908
20200518,5,송정,6591,6211,20200521,12802
20200518,5,김포공항,5288,4903,20200521,10191
20200518,5,개화산,4950,4702,20200521,9652
20200518,5,방화,6403,6162,20200521,12565
20200519,5,마천,4797,4788,20200522,9585
20200519,5,거여,7135,6712,20200522,13847
20200519,5,개롱,6033,6206,20200522,12239
20200519,5,오금,3671,3547,20200522,7218
20200519,5,방이,6599,6656,20200522,13255
20200519,5,올림픽공원,3684,3171,20200522,6855
20200519,5,둔촌동,7769,7787,20200522,15556
20200519,5,상일동,18178,15458,20200522,33636
20200519,5,고덕,7991,8173,20200522,16164
20200519,5,명일,7845,8238,20200522,16083
20200519,5,굽은다리,8560,7905,20200522,16465
20200519,5,길동,7249,7663,20200522,14912
20200519,5,강동,20518,17505,20200522,38023
20200519,5,천호,16532,17481,20200522,34013
20200519,5,광나루,12087,10865,20200522,22952
20200519,5,아차산,12829,12733,20200522,25562
20200519,5,군자,10348,11479,20200522,21827
20200519,5,장한평,17433,17432,20200522,34865
20200519,5,답십리,15462,14165,20200522,29627
20200519,5,마장,5320,4968,20200522,10288
20200519,5,왕십리,4233,4682,20200522,8915
20200519,5,행당,7933,6996,20200522,14929
20200519,5,신금호,5938,6006,20200522,11944
20200519,5,청구,3986,3560,20200522,7546
20200519,5,동대문역사문화공원,2881,3424,20200522,6305
20200519,5,을지로4가,5893,6000,20200522,11893
20200519,5,종로3가,10750,10730,20200522,21480
20200519,5,광화문,31156,33305,20200522,64461
20200519,5,서대문,17282,18200,20200522,35482
20200519,5,충정로,4969,5011,20200522,9980
20200519,5,애오개,6994,7023,20200522,14017
20200519,5,공덕,13961,15082,20200522,29043
20200519,5,마포,14048,14608,20200522,28656
20200519,5,여의나루,7525,7903,20200522,15428
20200519,5,여의도,26042,27759,20200522,53801
20200519,5,신길,3640,3930,20200522,7570
20200519,5,영등포시장,8585,8776,20200522,17361
20200519,5,영등포구청,3934,3895,20200522,7829
20200519,5,오목교,21091,22946,20200522,44037
20200519,5,목동,16733,18368,20200522,35101
20200519,5,신정,13319,10224,20200522,23543
20200519,5,까치산,28245,26751,20200522,54996
20200519,5,화곡,27456,25569,20200522,53025
20200519,5,우장산,13665,13421,20200522,27086
20200519,5,발산,18411,19079,20200522,37490
20200519,5,마곡,8751,8282,20200522,17033
20200519,5,송정,6589,6071,20200522,12660
20200519,5,김포공항,5332,5210,20200522,10542
20200519,5,개화산,5007,4727,20200522,9734
20200519,5,방화,6423,6118,20200522,12541
20200519,5,양평,7244,7218,20200522,14462
20200520,5,애오개,7334,7380,20200523,14714
20200520,5,마천,5347,5368,20200523,10715
20200520,5,거여,7632,7075,20200523,14707
20200520,5,개롱,6401,6581,20200523,12982
20200520,5,오금,3692,3689,20200523,7381
20200520,5,방이,6875,7138,20200523,14013
20200520,5,올림픽공원,4248,3623,20200523,7871
20200520,5,둔촌동,8270,8142,20200523,16412
20200520,5,상일동,19172,16382,20200523,35554
20200520,5,고덕,8570,8697,20200523,17267
20200520,5,명일,8306,8813,20200523,17119
20200520,5,굽은다리,8954,8452,20200523,17406
20200520,5,길동,7557,7838,20200523,15395
20200520,5,강동,21761,18664,20200523,40425
20200520,5,천호,17603,18885,20200523,36488
20200520,5,광나루,13296,11931,20200523,25227
20200520,5,아차산,14473,14304,20200523,28777
20200520,5,군자,11098,12217,20200523,23315
20200520,5,장한평,18349,18188,20200523,36537
20200520,5,답십리,16225,14954,20200523,31179
20200520,5,마장,5616,5256,20200523,10872
20200520,5,왕십리,4511,4963,20200523,9474
20200520,5,행당,8358,7382,20200523,15740
20200520,5,신금호,6308,6528,20200523,12836
20200520,5,청구,4146,3765,20200523,7911
20200520,5,동대문역사문화공원,3025,3425,20200523,6450
20200520,5,을지로4가,6351,6457,20200523,12808
20200520,5,종로3가,11972,12018,20200523,23990
20200520,5,광화문,32859,34696,20200523,67555
20200520,5,서대문,18307,18828,20200523,37135
20200520,5,충정로,5083,5166,20200523,10249
20200520,5,공덕,14584,15882,20200523,30466
20200520,5,마포,14664,15360,20200523,30024
20200520,5,여의나루,9769,10101,20200523,19870
20200520,5,여의도,26719,28311,20200523,55030
20200520,5,신길,3746,4051,20200523,7797
20200520,5,영등포시장,9036,9275,20200523,18311
20200520,5,영등포구청,4169,4187,20200523,8356
20200520,5,양평,7568,7445,20200523,15013
20200520,5,오목교,21833,23783,20200523,45616
20200520,5,목동,17569,19378,20200523,36947
20200520,5,신정,13862,10708,20200523,24570
20200520,5,까치산,29847,28297,20200523,58144
20200520,5,화곡,29079,27132,20200523,56211
20200520,5,우장산,14481,14195,20200523,28676
20200520,5,발산,19419,19813,20200523,39232
20200520,5,마곡,8999,8609,20200523,17608
20200520,5,송정,6972,6517,20200523,13489
20200520,5,김포공항,5602,5497,20200523,11099
20200520,5,개화산,5240,5004,20200523,10244
20200520,5,방화,6869,6426,20200523,13295
20200521,5,마천,5261,5280,20200524,10541
20200521,5,거여,7514,7179,20200524,14693
20200521,5,개롱,6275,6446,20200524,12721
20200521,5,오금,3839,3746,20200524,7585
20200521,5,방이,6707,6998,20200524,13705
20200521,5,올림픽공원,4104,3661,20200524,7765
20200521,5,둔촌동,8183,8222,20200524,16405
20200521,5,상일동,19361,16214,20200524,35575
20200521,5,고덕,8529,8657,20200524,17186
20200521,5,명일,8328,8595,20200524,16923
20200521,5,굽은다리,8832,8218,20200524,17050
20200521,5,길동,7525,7759,20200524,15284
20200521,5,강동,21295,18251,20200524,39546
20200521,5,천호,17351,18379,20200524,35730
20200521,5,광나루,13284,12088,20200524,25372
20200521,5,아차산,14282,13996,20200524,28278
20200521,5,군자,10918,12155,20200524,23073
20200521,5,장한평,18146,17932,20200524,36078
20200521,5,답십리,16139,14739,20200524,30878
20200521,5,마장,5571,5242,20200524,10813
20200521,5,왕십리,4403,4977,20200524,9380
20200521,5,행당,8291,7297,20200524,15588
20200521,5,신금호,6265,6384,20200524,12649
20200521,5,청구,4115,3537,20200524,7652
20200521,5,동대문역사문화공원,2904,3379,20200524,6283
20200521,5,을지로4가,6314,6393,20200524,12707
20200521,5,종로3가,11819,11886,20200524,23705
20200521,5,광화문,32068,34076,20200524,66144
20200521,5,서대문,17894,18689,20200524,36583
20200521,5,충정로,5262,5280,20200524,10542
20200521,5,애오개,7197,7162,20200524,14359
20200521,5,공덕,14510,16088,20200524,30598
20200521,5,마포,14761,15207,20200524,29968
20200521,5,여의나루,10423,10816,20200524,21239
20200521,5,여의도,26615,28897,20200524,55512
20200521,5,신길,3779,4072,20200524,7851
20200521,5,영등포시장,9008,9139,20200524,18147
20200521,5,영등포구청,4222,4150,20200524,8372
20200521,5,양평,7504,7444,20200524,14948
20200521,5,오목교,21964,23803,20200524,45767
20200521,5,목동,17704,19313,20200524,37017
20200521,5,신정,13881,10638,20200524,24519
20200521,5,까치산,29444,27932,20200524,57376
20200521,5,화곡,28939,26688,20200524,55627
20200521,5,우장산,14340,14022,20200524,28362
20200521,5,발산,19491,20101,20200524,39592
20200521,5,마곡,8938,8443,20200524,17381
20200521,5,송정,6848,6314,20200524,13162
20200521,5,김포공항,5825,5564,20200524,11389
20200521,5,개화산,5292,4996,20200524,10288
20200521,5,방화,6950,6531,20200524,13481
20200522,5,방화,6886,6438,20200525,13324
20200522,5,개화산,5239,4859,20200525,10098
20200522,5,김포공항,5753,5824,20200525,11577
20200522,5,송정,7290,6478,20200525,13768
20200522,5,마곡,9088,8525,20200525,17613
20200522,5,발산,19250,20229,20200525,39479
20200522,5,우장산,14646,14238,20200525,28884
20200522,5,화곡,29202,26721,20200525,55923
20200522,5,까치산,29952,28181,20200525,58133
20200522,5,신정,13858,10558,20200525,24416
20200522,5,목동,17855,19285,20200525,37140
20200522,5,오목교,22681,24884,20200525,47565
20200522,5,양평,7471,7309,20200525,14780
20200522,5,영등포구청,4141,4047,20200525,8188
20200522,5,영등포시장,9075,9427,20200525,18502
20200522,5,신길,3785,3980,20200525,7765
20200522,5,여의도,26819,28324,20200525,55143
20200522,5,여의나루,9667,9623,20200525,19290
20200522,5,마포,14565,15319,20200525,29884
20200522,5,공덕,14705,15973,20200525,30678
20200522,5,애오개,7295,7171,20200525,14466
20200522,5,충정로,4907,4886,20200525,9793
20200522,5,서대문,17843,18111,20200525,35954
20200522,5,광화문,31871,33856,20200525,65727
20200522,5,종로3가,12264,12573,20200525,24837
20200522,5,을지로4가,6192,6508,20200525,12700
20200522,5,동대문역사문화공원,2932,3412,20200525,6344
20200522,5,청구,4218,3718,20200525,7936
20200522,5,신금호,6385,6394,20200525,12779
20200522,5,행당,8369,7253,20200525,15622
20200522,5,왕십리,4529,5247,20200525,9776
20200522,5,마장,5622,5345,20200525,10967
20200522,5,답십리,16211,14686,20200525,30897
20200522,5,장한평,18422,18216,20200525,36638
20200522,5,군자,11255,12551,20200525,23806
20200522,5,아차산,14331,14009,20200525,28340
20200522,5,광나루,13347,11940,20200525,25287
20200522,5,천호,17974,19374,20200525,37348
20200522,5,강동,21709,18222,20200525,39931
20200522,5,길동,7700,8001,20200525,15701
20200522,5,굽은다리,9041,8399,20200525,17440
20200522,5,명일,8354,8577,20200525,16931
20200522,5,고덕,8601,8628,20200525,17229
20200522,5,상일동,19374,16262,20200525,35636
20200522,5,둔촌동,8396,8228,20200525,16624
20200522,5,올림픽공원,4197,3658,20200525,7855
20200522,5,방이,6812,7038,20200525,13850
20200522,5,오금,3896,3790,20200525,7686
20200522,5,개롱,6499,6615,20200525,13114
20200522,5,거여,7840,7212,20200525,15052
20200522,5,마천,5294,5174,20200525,10468
20200523,5,방화,5032,4687,20200526,9719
20200523,5,개화산,3473,3444,20200526,6917
20200523,5,김포공항,5315,5402,20200526,10717
20200523,5,송정,5146,4901,20200526,10047
20200523,5,마곡,4014,3897,20200526,7911
20200523,5,발산,12251,13151,20200526,25402
20200523,5,우장산,9210,9114,20200526,18324
20200523,5,화곡,19508,17698,20200526,37206
20200523,5,까치산,20631,19342,20200526,39973
20200523,5,신정,8377,6865,20200526,15242
20200523,5,목동,10988,11262,20200526,22250
20200523,5,오목교,16163,16797,20200526,32960
20200523,5,양평,3461,3276,20200526,6737
20200523,5,영등포구청,1962,1839,20200526,3801
20200523,5,영등포시장,6181,6611,20200526,12792
20200523,5,신길,2081,2261,20200526,4342
20200523,5,여의도,8662,9867,20200526,18529
20200523,5,여의나루,11365,11936,20200526,23301
20200523,5,마포,7118,7257,20200526,14375
20200523,5,공덕,6739,7374,20200526,14113
20200523,5,애오개,3535,3400,20200526,6935
20200523,5,충정로,1951,1839,20200526,3790
20200523,5,서대문,7013,6745,20200526,13758
20200523,5,광화문,12953,13384,20200526,26337
20200523,5,종로3가,10180,10643,20200526,20823
20200523,5,을지로4가,3335,3687,20200526,7022
20200523,5,동대문역사문화공원,842,1122,20200526,1964
20200523,5,청구,2494,2077,20200526,4571
20200523,5,신금호,4092,4033,20200526,8125
20200523,5,행당,5572,4830,20200526,10402
20200523,5,왕십리,3385,3935,20200526,7320
20200523,5,마장,4039,3923,20200526,7962
20200523,5,답십리,9712,8943,20200526,18655
20200523,5,장한평,10299,10109,20200526,20408
20200523,5,군자,7767,8877,20200526,16644
20200523,5,아차산,12604,12315,20200526,24919
20200523,5,광나루,9927,9589,20200526,19516
20200523,5,천호,15462,15758,20200526,31220
20200523,5,강동,14329,12502,20200526,26831
20200523,5,길동,5405,5493,20200526,10898
20200523,5,굽은다리,6314,5852,20200526,12166
20200523,5,명일,5311,5086,20200526,10397
20200523,5,고덕,5266,5184,20200526,10450
20200523,5,상일동,10844,9623,20200526,20467
20200523,5,둔촌동,5812,5684,20200526,11496
20200523,5,올림픽공원,2874,2591,20200526,5465
20200523,5,방이,4852,4799,20200526,9651
20200523,5,오금,2398,2219,20200526,4617
20200523,5,개롱,4637,4686,20200526,9323
20200523,5,거여,4888,4560,20200526,9448
20200523,5,마천,3987,4099,20200526,8086
20200524,5,마천,2559,2793,20200527,5352
20200524,5,거여,3355,3332,20200527,6687
20200524,5,개롱,2601,2816,20200527,5417
20200524,5,오금,1613,1468,20200527,3081
20200524,5,방이,3742,3438,20200527,7180
20200524,5,올림픽공원,1746,1580,20200527,3326
20200524,5,둔촌동,3850,4053,20200527,7903
20200524,5,상일동,6371,6135,20200527,12506
20200524,5,고덕,3239,3283,20200527,6522
20200524,5,명일,3530,3548,20200527,7078
20200524,5,굽은다리,4082,3841,20200527,7923
20200524,5,길동,3415,3462,20200527,6877
20200524,5,강동,8648,8044,20200527,16692
20200524,5,천호,10204,9864,20200527,20068
20200524,5,광나루,5956,5834,20200527,11790
20200524,5,아차산,8174,8221,20200527,16395
20200524,5,군자,5141,5644,20200527,10785
20200524,5,장한평,6172,6039,20200527,12211
20200524,5,답십리,6287,5743,20200527,12030
20200524,5,마장,2702,2582,20200527,5284
20200524,5,왕십리,1846,2225,20200527,4071
20200524,5,행당,3246,3025,20200527,6271
20200524,5,신금호,2515,2642,20200527,5157
20200524,5,청구,1531,1359,20200527,2890
20200524,5,동대문역사문화공원,480,614,20200527,1094
20200524,5,을지로4가,1199,1296,20200527,2495
20200524,5,종로3가,6411,6057,20200527,12468
20200524,5,광화문,8332,8437,20200527,16769
20200524,5,서대문,4397,4146,20200527,8543
20200524,5,충정로,1226,1273,20200527,2499
20200524,5,애오개,2319,2388,20200527,4707
20200524,5,공덕,3895,4060,20200527,7955
20200524,5,마포,4104,3996,20200527,8100
20200524,5,여의나루,6003,5708,20200527,11711
20200524,5,여의도,4641,4977,20200527,9618
20200524,5,신길,1330,1520,20200527,2850
20200524,5,영등포시장,3453,3565,20200527,7018
20200524,5,영등포구청,1068,988,20200527,2056
20200524,5,양평,2144,2185,20200527,4329
20200524,5,오목교,9722,9693,20200527,19415
20200524,5,목동,6606,6778,20200527,13384
20200524,5,신정,5210,4610,20200527,9820
20200524,5,까치산,13773,13131,20200527,26904
20200524,5,화곡,13307,14993,20200527,28300
20200524,5,우장산,2906,4176,20200527,7082
20200524,5,발산,5155,4490,20200527,9645
20200524,5,마곡,1284,1500,20200527,2784
20200524,5,송정,1818,2246,20200527,4064
20200524,5,김포공항,3657,2989,20200527,6646
20200524,5,개화산,1157,1479,20200527,2636
20200524,5,방화,1595,2116,20200527,3711
20200525,5,마천,5204,5222,20200528,10426
20200525,5,거여,7504,7043,20200528,14547
20200525,5,개롱,6354,6567,20200528,12921
20200525,5,오금,3804,3793,20200528,7597
20200525,5,방이,6766,6929,20200528,13695
20200525,5,올림픽공원,4128,3663,20200528,7791
20200525,5,둔촌동,8126,8102,20200528,16228
20200525,5,상일동,19327,16412,20200528,35739
20200525,5,고덕,8639,8845,20200528,17484
20200525,5,명일,8254,8583,20200528,16837
20200525,5,굽은다리,8777,8142,20200528,16919
20200525,5,길동,7679,7933,20200528,15612
20200525,5,강동,21027,18106,20200528,39133
20200525,5,천호,17038,18217,20200528,35255
20200525,5,광나루,12956,11592,20200528,24548
20200525,5,아차산,13835,13641,20200528,27476
20200525,5,군자,10658,11600,20200528,22258
20200525,5,장한평,18014,17882,20200528,35896
20200525,5,답십리,16078,14649,20200528,30727
20200525,5,마장,5448,5120,20200528,10568
20200525,5,왕십리,4426,4969,20200528,9395
20200525,5,행당,8138,7189,20200528,15327
20200525,5,신금호,6188,6317,20200528,12505
20200525,5,청구,4163,3616,20200528,7779
20200525,5,동대문역사문화공원,2892,3297,20200528,6189
20200525,5,을지로4가,6327,6460,20200528,12787
20200525,5,종로3가,11426,11507,20200528,22933
20200525,5,광화문,31353,32871,20200528,64224
20200525,5,서대문,17898,18423,20200528,36321
20200525,5,충정로,5213,5253,20200528,10466
20200525,5,애오개,6883,6983,20200528,13866
20200525,5,공덕,14362,15452,20200528,29814
20200525,5,마포,14219,14743,20200528,28962
20200525,5,여의나루,9452,9744,20200528,19196
20200525,5,여의도,26285,27897,20200528,54182
20200525,5,신길,3663,4076,20200528,7739
20200525,5,영등포시장,8824,9101,20200528,17925
20200525,5,영등포구청,4154,4093,20200528,8247
20200525,5,양평,7568,7382,20200528,14950
20200525,5,오목교,21354,23379,20200528,44733
20200525,5,목동,17209,19130,20200528,36339
20200525,5,신정,13622,10413,20200528,24035
20200525,5,까치산,29262,27866,20200528,57128
20200525,5,화곡,28799,26629,20200528,55428
20200525,5,우장산,14063,13926,20200528,27989
20200525,5,발산,18622,19144,20200528,37766
20200525,5,마곡,8501,7958,20200528,16459
20200525,5,송정,7075,6591,20200528,13666
20200525,5,김포공항,5463,5161,20200528,10624
20200525,5,개화산,5068,4766,20200528,9834
20200525,5,방화,6691,6328,20200528,13019
20200526,5,마천,5221,5271,20200529,10492
20200526,5,거여,7740,7239,20200529,14979
20200526,5,개롱,6321,6603,20200529,12924
20200526,5,오금,3831,3718,20200529,7549
20200526,5,방이,6888,7226,20200529,14114
20200526,5,올림픽공원,4132,3650,20200529,7782
20200526,5,둔촌동,8237,8289,20200529,16526
20200526,5,상일동,19233,16496,20200529,35729
20200526,5,고덕,8485,8681,20200529,17166
20200526,5,명일,8259,8607,20200529,16866
20200526,5,굽은다리,8782,8386,20200529,17168
20200526,5,길동,7493,7799,20200529,15292
20200526,5,강동,21579,18634,20200529,40213
20200526,5,천호,16875,18241,20200529,35116
20200526,5,광나루,12852,11573,20200529,24425
20200526,5,아차산,13882,13834,20200529,27716
20200526,5,군자,10730,11934,20200529,22664
20200526,5,장한평,18172,17962,20200529,36134
20200526,5,답십리,16087,14602,20200529,30689
20200526,5,마장,5552,5241,20200529,10793
20200526,5,왕십리,4237,4686,20200529,8923
20200526,5,행당,8142,7335,20200529,15477
20200526,5,신금호,6105,6248,20200529,12353
20200526,5,청구,4063,3723,20200529,7786
20200526,5,동대문역사문화공원,3073,3467,20200529,6540
20200526,5,을지로4가,6182,6295,20200529,12477
20200526,5,종로3가,11711,11561,20200529,23272
20200526,5,광화문,32619,33820,20200529,66439
20200526,5,서대문,18243,18492,20200529,36735
20200526,5,충정로,5430,5457,20200529,10887
20200526,5,애오개,7210,7380,20200529,14590
20200526,5,공덕,14702,15885,20200529,30587
20200526,5,마포,14645,15154,20200529,29799
20200526,5,여의나루,8065,8296,20200529,16361
20200526,5,여의도,26952,28270,20200529,55222
20200526,5,신길,3758,4131,20200529,7889
20200526,5,영등포시장,8803,8995,20200529,17798
20200526,5,영등포구청,4008,4071,20200529,8079
20200526,5,양평,7579,7490,20200529,15069
20200526,5,오목교,21876,23571,20200529,45447
20200526,5,목동,17338,19205,20200529,36543
20200526,5,신정,13672,10657,20200529,24329
20200526,5,까치산,28953,27757,20200529,56710
20200526,5,화곡,28527,26520,20200529,55047
20200526,5,우장산,14171,13850,20200529,28021
20200526,5,발산,18957,19357,20200529,38314
20200526,5,마곡,8578,7912,20200529,16490
20200526,5,송정,6904,6453,20200529,13357
20200526,5,김포공항,5623,5302,20200529,10925
20200526,5,개화산,5162,4901,20200529,10063
20200526,5,방화,6722,6368,20200529,13090
20200527,5,마천,5350,5409,20200530,10759
20200527,5,거여,7995,7385,20200530,15380
20200527,5,개롱,6650,6741,20200530,13391
20200527,5,오금,3794,3814,20200530,7608
20200527,5,방이,6974,7341,20200530,14315
20200527,5,올림픽공원,4367,3912,20200530,8279
20200527,5,둔촌동,8374,8230,20200530,16604
20200527,5,상일동,19495,16703,20200530,36198
20200527,5,고덕,8850,9002,20200530,17852
20200527,5,명일,8445,8819,20200530,17264
20200527,5,굽은다리,8880,8256,20200530,17136
20200527,5,길동,7694,8020,20200530,15714
20200527,5,강동,21608,18346,20200530,39954
20200527,5,천호,17799,19003,20200530,36802
20200527,5,광나루,13418,12156,20200530,25574
20200527,5,아차산,14833,14488,20200530,29321
20200527,5,군자,10981,12191,20200530,23172
20200527,5,장한평,18053,18106,20200530,36159
20200527,5,답십리,16297,14931,20200530,31228
20200527,5,마장,5553,5047,20200530,10600
20200527,5,왕십리,4363,4891,20200530,9254
20200527,5,행당,8187,7243,20200530,15430
20200527,5,신금호,6313,6363,20200530,12676
20200527,5,청구,4226,3695,20200530,7921
20200527,5,동대문역사문화공원,2945,3416,20200530,6361
20200527,5,을지로4가,6313,6397,20200530,12710
20200527,5,종로3가,12188,12224,20200530,24412
20200527,5,광화문,32601,34611,20200530,67212
20200527,5,서대문,18247,18689,20200530,36936
20200527,5,충정로,5177,5370,20200530,10547
20200527,5,애오개,7407,7469,20200530,14876
20200527,5,공덕,14758,16013,20200530,30771
20200527,5,마포,14897,15314,20200530,30211
20200527,5,여의나루,11043,11270,20200530,22313
20200527,5,여의도,27142,28725,20200530,55867
20200527,5,신길,3786,4080,20200530,7866
20200527,5,영등포시장,9032,9268,20200530,18300
20200527,5,영등포구청,4149,4130,20200530,8279
20200527,5,양평,7566,7485,20200530,15051
20200527,5,오목교,22291,24467,20200530,46758
20200527,5,목동,17677,19228,20200530,36905
20200527,5,신정,13892,10743,20200530,24635
20200527,5,까치산,29697,28134,20200530,57831
20200527,5,화곡,28884,26781,20200530,55665
20200527,5,우장산,14724,14314,20200530,29038
20200527,5,발산,19366,20055,20200530,39421
20200527,5,마곡,8702,8139,20200530,16841
20200527,5,송정,6963,6453,20200530,13416
20200527,5,김포공항,5571,5158,20200530,10729
20200527,5,개화산,5115,4895,20200530,10010
20200527,5,방화,6966,6553,20200530,13519
20200528,5,상일동,19428,16339,20200531,35767
20200528,5,마천,5271,5338,20200531,10609
20200528,5,거여,7645,7028,20200531,14673
20200528,5,개롱,6488,6724,20200531,13212
20200528,5,오금,3709,3699,20200531,7408
20200528,5,방이,6856,7197,20200531,14053
20200528,5,올림픽공원,4260,3704,20200531,7964
20200528,5,둔촌동,8221,8192,20200531,16413
20200528,5,고덕,8567,8581,20200531,17148
20200528,5,명일,8253,8456,20200531,16709
20200528,5,굽은다리,8708,8166,20200531,16874
20200528,5,길동,7401,7612,20200531,15013
20200528,5,강동,21130,18144,20200531,39274
20200528,5,천호,16926,18539,20200531,35465
20200528,5,광나루,12943,11851,20200531,24794
20200528,5,아차산,14301,13934,20200531,28235
20200528,5,군자,10845,11852,20200531,22697
20200528,5,장한평,17867,17782,20200531,35649
20200528,5,답십리,16196,14692,20200531,30888
20200528,5,마장,5420,5094,20200531,10514
20200528,5,왕십리,4244,4621,20200531,8865
20200528,5,행당,8041,7103,20200531,15144
20200528,5,신금호,6039,6107,20200531,12146
20200528,5,청구,4033,3700,20200531,7733
20200528,5,동대문역사문화공원,2916,3353,20200531,6269
20200528,5,을지로4가,6264,6458,20200531,12722
20200528,5,종로3가,11837,12031,20200531,23868
20200528,5,광화문,32574,34518,20200531,67092
20200528,5,서대문,18423,18973,20200531,37396
20200528,5,충정로,5203,5309,20200531,10512
20200528,5,애오개,7244,7287,20200531,14531
20200528,5,공덕,14649,15849,20200531,30498
20200528,5,마포,14321,14971,20200531,29292
20200528,5,여의나루,10139,10561,20200531,20700
20200528,5,여의도,26585,28478,20200531,55063
20200528,5,신길,3686,3978,20200531,7664
20200528,5,영등포시장,8860,9160,20200531,18020
20200528,5,영등포구청,4027,4020,20200531,8047
20200528,5,양평,7456,7365,20200531,14821
20200528,5,오목교,21815,23567,20200531,45382
20200528,5,목동,17413,19077,20200531,36490
20200528,5,신정,13850,10619,20200531,24469
20200528,5,까치산,28982,27590,20200531,56572
20200528,5,화곡,28432,26211,20200531,54643
20200528,5,우장산,14411,14076,20200531,28487
20200528,5,발산,18763,19412,20200531,38175
20200528,5,마곡,8721,8260,20200531,16981
20200528,5,송정,7021,6490,20200531,13511
20200528,5,김포공항,5466,5402,20200531,10868
20200528,5,개화산,5175,4837,20200531,10012
20200528,5,방화,6663,6330,20200531,12993
20200529,5,방화,6860,6367,20200601,13227
20200529,5,개화산,5184,4826,20200601,10010
20200529,5,김포공항,6142,5838,20200601,11980
20200529,5,송정,7053,6404,20200601,13457
20200529,5,마곡,8681,8127,20200601,16808
20200529,5,발산,18870,19738,20200601,38608
20200529,5,우장산,14661,14309,20200601,28970
20200529,5,화곡,29020,26370,20200601,55390
20200529,5,까치산,29727,27619,20200601,57346
20200529,5,신정,13968,10692,20200601,24660
20200529,5,목동,17837,19324,20200601,37161
20200529,5,오목교,21925,24250,20200601,46175
20200529,5,양평,7464,7227,20200601,14691
20200529,5,영등포구청,4083,4056,20200601,8139
20200529,5,영등포시장,8851,9111,20200601,17962
20200529,5,신길,3765,3886,20200601,7651
20200529,5,여의도,25472,27476,20200601,52948
20200529,5,여의나루,11219,11537,20200601,22756
20200529,5,마포,14390,15184,20200601,29574
20200529,5,공덕,14212,15852,20200601,30064
20200529,5,애오개,7374,7157,20200601,14531
20200529,5,충정로,5084,5082,20200601,10166
20200529,5,서대문,17104,17463,20200601,34567
20200529,5,광화문,31774,34021,20200601,65795
20200529,5,종로3가,12155,12515,20200601,24670
20200529,5,을지로4가,5982,6323,20200601,12305
20200529,5,동대문역사문화공원,2821,3349,20200601,6170
20200529,5,청구,4150,3580,20200601,7730
20200529,5,신금호,6104,6060,20200601,12164
20200529,5,행당,8032,7000,20200601,15032
20200529,5,왕십리,4231,5012,20200601,9243
20200529,5,마장,5634,5342,20200601,10976
20200529,5,답십리,16256,14688,20200601,30944
20200529,5,장한평,18126,18045,20200601,36171
20200529,5,군자,11001,12473,20200601,23474
20200529,5,아차산,14543,13891,20200601,28434
20200529,5,광나루,13439,11895,20200601,25334
20200529,5,천호,18456,19520,20200601,37976
20200529,5,강동,21451,18091,20200601,39542
20200529,5,길동,7819,8166,20200601,15985
20200529,5,굽은다리,8872,8198,20200601,17070
20200529,5,명일,8374,8676,20200601,17050
20200529,5,고덕,8783,8612,20200601,17395
20200529,5,상일동,19509,16415,20200601,35924
20200529,5,둔촌동,8283,8558,20200601,16841
20200529,5,올림픽공원,4370,3735,20200601,8105
20200529,5,방이,7001,7251,20200601,14252
20200529,5,오금,3803,3795,20200601,7598
20200529,5,개롱,6543,6586,20200601,13129
20200529,5,거여,7950,7256,20200601,15206
20200529,5,마천,5381,5347,20200601,10728
20200530,5,방화,4752,4365,20200602,9117
20200530,5,개화산,3447,3298,20200602,6745
20200530,5,김포공항,4992,5251,20200602,10243
20200530,5,송정,4824,4486,20200602,9310
20200530,5,마곡,3669,3433,20200602,7102
20200530,5,발산,11268,11901,20200602,23169
20200530,5,우장산,8870,9006,20200602,17876
20200530,5,화곡,18274,16732,20200602,35006
20200530,5,까치산,19760,18671,20200602,38431
20200530,5,신정,8265,6686,20200602,14951
20200530,5,목동,10292,10792,20200602,21084
20200530,5,오목교,14670,15349,20200602,30019
20200530,5,양평,3273,2996,20200602,6269
20200530,5,영등포구청,1826,1772,20200602,3598
20200530,5,영등포시장,5916,6424,20200602,12340
20200530,5,신길,2081,2203,20200602,4284
20200530,5,여의도,7710,8802,20200602,16512
20200530,5,여의나루,11274,11847,20200602,23121
20200530,5,마포,6681,6718,20200602,13399
20200530,5,공덕,6325,6795,20200602,13120
20200530,5,애오개,3404,3196,20200602,6600
20200530,5,충정로,1811,1688,20200602,3499
20200530,5,서대문,6354,6328,20200602,12682
20200530,5,광화문,12055,12598,20200602,24653
20200530,5,종로3가,9596,10072,20200602,19668
20200530,5,을지로4가,3141,3476,20200602,6617
20200530,5,동대문역사문화공원,782,1029,20200602,1811
20200530,5,청구,2475,2018,20200602,4493
20200530,5,신금호,3601,3556,20200602,7157
20200530,5,행당,5230,4497,20200602,9727
20200530,5,왕십리,3026,3602,20200602,6628
20200530,5,마장,3614,3503,20200602,7117
20200530,5,답십리,9288,8534,20200602,17822
20200530,5,장한평,10129,9847,20200602,19976
20200530,5,군자,7556,8245,20200602,15801
20200530,5,아차산,11797,11490,20200602,23287
20200530,5,광나루,9212,8666,20200602,17878
20200530,5,천호,15436,15394,20200602,30830
20200530,5,강동,13439,11762,20200602,25201
20200530,5,길동,5235,5337,20200602,10572
20200530,5,굽은다리,6155,5716,20200602,11871
20200530,5,명일,5273,5035,20200602,10308
20200530,5,고덕,4853,4836,20200602,9689
20200530,5,상일동,10391,9308,20200602,19699
20200530,5,둔촌동,5545,5641,20200602,11186
20200530,5,올림픽공원,2746,2355,20200602,5101
20200530,5,방이,4536,4451,20200602,8987
20200530,5,오금,2127,1968,20200602,4095
20200530,5,개롱,3870,4013,20200602,7883
20200530,5,거여,5008,4826,20200602,9834
20200530,5,마천,4030,4071,20200602,8101
20200531,5,마천,2931,3217,20200603,6148
20200531,5,거여,3284,3231,20200603,6515
20200531,5,개롱,2612,2766,20200603,5378
20200531,5,오금,1453,1371,20200603,2824
20200531,5,방이,3522,3387,20200603,6909
20200531,5,올림픽공원,1856,1639,20200603,3495
20200531,5,둔촌동,4045,4110,20200603,8155
20200531,5,상일동,6610,6174,20200603,12784
20200531,5,고덕,3172,3346,20200603,6518
20200531,5,명일,3573,3490,20200603,7063
20200531,5,굽은다리,4425,4101,20200603,8526
20200531,5,길동,3268,3380,20200603,6648
20200531,5,강동,8913,8266,20200603,17179
20200531,5,천호,10924,10540,20200603,21464
20200531,5,광나루,6569,6528,20200603,13097
20200531,5,아차산,9160,9478,20200603,18638
20200531,5,군자,5196,5604,20200603,10800
20200531,5,장한평,6387,6127,20200603,12514
20200531,5,답십리,6488,5877,20200603,12365
20200531,5,마장,2688,2540,20200603,5228
20200531,5,왕십리,2078,2373,20200603,4451
20200531,5,행당,3383,3055,20200603,6438
20200531,5,신금호,2388,2507,20200603,4895
20200531,5,청구,1584,1336,20200603,2920
20200531,5,동대문역사문화공원,496,669,20200603,1165
20200531,5,을지로4가,1141,1322,20200603,2463
20200531,5,종로3가,6424,5991,20200603,12415
20200531,5,광화문,8429,8577,20200603,17006
20200531,5,서대문,4093,4084,20200603,8177
20200531,5,충정로,1232,1167,20200603,2399
20200531,5,애오개,2255,2278,20200603,4533
20200531,5,공덕,3920,4056,20200603,7976
20200531,5,마포,3870,3935,20200603,7805
20200531,5,여의나루,7353,7566,20200603,14919
20200531,5,여의도,4729,5143,20200603,9872
20200531,5,신길,1316,1548,20200603,2864
20200531,5,영등포시장,3294,3532,20200603,6826
20200531,5,영등포구청,1177,1143,20200603,2320
20200531,5,양평,2081,2168,20200603,4249
20200531,5,오목교,9476,9917,20200603,19393
20200531,5,목동,6564,6784,20200603,13348
20200531,5,신정,5346,4705,20200603,10051
20200531,5,까치산,13708,13179,20200603,26887
20200531,5,화곡,12150,11259,20200603,23409
20200531,5,우장산,5435,5509,20200603,10944
20200531,5,발산,6888,7217,20200603,14105
20200531,5,마곡,2228,2265,20200603,4493
20200531,5,송정,3463,3447,20200603,6910
20200531,5,김포공항,4586,4373,20200603,8959
20200531,5,개화산,2302,2398,20200603,4700
20200531,5,방화,3165,3188,20200603,6353
20200101,6,봉화산,3818,3883,20200104,7701
20200101,6,화랑대,4859,4226,20200104,9085
20200101,6,태릉입구,2554,3063,20200104,5617
20200101,6,석계,6045,6302,20200104,12347
20200101,6,돌곶이,3885,4020,20200104,7905
20200101,6,상월곡,2571,2547,20200104,5118
20200101,6,월곡,5348,5454,20200104,10802
20200101,6,고려대,3752,3921,20200104,7673
20200101,6,안암,5032,5115,20200104,10147
20200101,6,보문,3492,3441,20200104,6933
20200101,6,창신,1357,1310,20200104,2667
20200101,6,동묘앞,5027,4467,20200104,9494
20200101,6,신당,4246,3630,20200104,7876
20200101,6,청구,1556,1656,20200104,3212
20200101,6,약수,1466,1595,20200104,3061
20200101,6,버티고개,1059,1194,20200104,2253
20200101,6,한강진,3996,4340,20200104,8336
20200101,6,이태원,18496,11098,20200104,29594
20200101,6,녹사평,3579,3009,20200104,6588
20200101,6,삼각지,2980,2411,20200104,5391
20200101,6,효창공원앞,2820,2511,20200104,5331
20200101,6,공덕,6602,6518,20200104,13120
20200101,6,대흥,3117,3449,20200104,6566
20200101,6,광흥창,3525,3510,20200104,7035
20200101,6,상수,6403,6232,20200104,12635
20200101,6,합정,7952,7259,20200104,15211
20200101,6,망원,7081,7772,20200104,14853
20200101,6,마포구청,6325,5723,20200104,12048
20200101,6,월드컵경기장,5356,5405,20200104,10761
20200101,6,디지털미디어시티,4788,5061,20200104,9849
20200101,6,증산,5168,5443,20200104,10611
20200101,6,새절,6152,6276,20200104,12428
20200101,6,구산,3408,2705,20200104,6113
20200101,6,독바위,1432,1778,20200104,3210
20200101,6,불광,3146,2850,20200104,5996
20200101,6,역촌,1906,2284,20200104,4190
20200101,6,응암,8753,9341,20200104,18094
20200102,6,응암,18944,18609,20200105,37553
20200102,6,역촌,4268,4797,20200105,9065
20200102,6,불광,5017,5036,20200105,10053
20200102,6,독바위,3055,3221,20200105,6276
20200102,6,구산,8258,6416,20200105,14674
20200102,6,새절,14342,13562,20200105,27904
20200102,6,증산,11015,10704,20200105,21719
20200102,6,디지털미디어시티,15425,16866,20200105,32291
20200102,6,월드컵경기장,5014,5258,20200105,10272
20200102,6,마포구청,15521,13972,20200105,29493
20200102,6,망원,15105,16254,20200105,31359
20200102,6,합정,14538,14197,20200105,28735
20200102,6,상수,10279,11671,20200105,21950
20200102,6,광흥창,10685,10330,20200105,21015
20200102,6,대흥,8959,9597,20200105,18556
20200102,6,공덕,20931,20541,20200105,41472
20200102,6,효창공원앞,7444,6805,20200105,14249
20200102,6,삼각지,6891,5925,20200105,12816
20200102,6,녹사평,5559,5632,20200105,11191
20200102,6,이태원,13788,14854,20200105,28642
20200102,6,한강진,8081,9576,20200105,17657
20200102,6,버티고개,2626,2449,20200105,5075
20200102,6,약수,4014,4152,20200105,8166
20200102,6,청구,4005,4302,20200105,8307
20200102,6,신당,8116,8744,20200105,16860
20200102,6,동묘앞,8129,8597,20200105,16726
20200102,6,창신,3967,3144,20200105,7111
20200102,6,보문,7700,7192,20200105,14892
20200102,6,안암,12296,12961,20200105,25257
20200102,6,고려대,9431,9251,20200105,18682
20200102,6,월곡,13061,12764,20200105,25825
20200102,6,상월곡,7457,6811,20200105,14268
20200102,6,돌곶이,9572,8945,20200105,18517
20200102,6,석계,13741,14170,20200105,27911
20200102,6,태릉입구,5829,6683,20200105,12512
20200102,6,화랑대,13311,10102,20200105,23413
20200102,6,봉화산,10867,9684,20200105,20551
20200103,6,응암,19902,19384,20200106,39286
20200103,6,역촌,4478,4926,20200106,9404
20200103,6,불광,5270,5255,20200106,10525
20200103,6,독바위,3167,3224,20200106,6391
20200103,6,연신내,1,0,20200106,1
20200103,6,구산,8761,6421,20200106,15182
20200103,6,새절,15077,13933,20200106,29010
20200103,6,증산,11639,10855,20200106,22494
20200103,6,디지털미디어시티,16023,17202,20200106,33225
20200103,6,월드컵경기장,5246,5493,20200106,10739
20200103,6,마포구청,16260,14591,20200106,30851
20200103,6,망원,16060,17484,20200106,33544
20200103,6,합정,16228,16080,20200106,32308
20200103,6,상수,12481,15036,20200106,27517
20200103,6,광흥창,11071,10966,20200106,22037
20200103,6,대흥,9585,9965,20200106,19550
20200103,6,공덕,22266,21829,20200106,44095
20200103,6,효창공원앞,7958,7151,20200106,15109
20200103,6,삼각지,7466,6301,20200106,13767
20200103,6,녹사평,6051,6394,20200106,12445
20200103,6,이태원,16307,21245,20200106,37552
20200103,6,한강진,8575,10335,20200106,18910
20200103,6,버티고개,2688,2550,20200106,5238
20200103,6,약수,4202,4278,20200106,8480
20200103,6,청구,4199,4601,20200106,8800
20200103,6,신당,9658,9575,20200106,19233
20200103,6,동묘앞,8863,9024,20200106,17887
20200103,6,창신,4033,3184,20200106,7217
20200103,6,보문,8233,7490,20200106,15723
20200103,6,안암,12937,12641,20200106,25578
20200103,6,고려대,9960,9441,20200106,19401
20200103,6,월곡,13647,13137,20200106,26784
20200103,6,상월곡,7183,6196,20200106,13379
20200103,6,돌곶이,9879,9077,20200106,18956
20200103,6,석계,14671,15003,20200106,29674
20200103,6,태릉입구,6303,7047,20200106,13350
20200103,6,화랑대,13853,10308,20200106,24161
20200103,6,봉화산,11037,9837,20200106,20874
20200104,6,응암,14632,14074,20200107,28706
20200104,6,역촌,3198,3614,20200107,6812
20200104,6,불광,4571,4155,20200107,8726
20200104,6,독바위,2305,2573,20200107,4878
20200104,6,연신내,1,0,20200107,1
20200104,6,구산,6087,4547,20200107,10634
20200104,6,새절,10395,9903,20200107,20298
20200104,6,증산,8427,7963,20200107,16390
20200104,6,디지털미디어시티,8392,8429,20200107,16821
20200104,6,월드컵경기장,4820,5062,20200107,9882
20200104,6,마포구청,10740,9298,20200107,20038
20200104,6,망원,13202,14613,20200107,27815
20200104,6,합정,14282,13146,20200107,27428
20200104,6,상수,9711,11995,20200107,21706
20200104,6,광흥창,6341,5858,20200107,12199
20200104,6,대흥,6073,6180,20200107,12253
20200104,6,공덕,12325,11623,20200107,23948
20200104,6,효창공원앞,5140,4596,20200107,9736
20200104,6,삼각지,6195,4440,20200107,10635
20200104,6,녹사평,5593,6578,20200107,12171
20200104,6,이태원,18738,24107,20200107,42845
20200104,6,한강진,8930,10860,20200107,19790
20200104,6,버티고개,1742,1791,20200107,3533
20200104,6,약수,2837,2950,20200107,5787
20200104,6,청구,2704,2819,20200107,5523
20200104,6,신당,7188,6013,20200107,13201
20200104,6,동묘앞,9103,8714,20200107,17817
20200104,6,창신,2461,1915,20200107,4376
20200104,6,보문,5976,5190,20200107,11166
20200104,6,안암,8510,8270,20200107,16780
20200104,6,고려대,6519,6196,20200107,12715
20200104,6,월곡,9435,9038,20200107,18473
20200104,6,상월곡,4542,3945,20200107,8487
20200104,6,돌곶이,6590,5976,20200107,12566
20200104,6,석계,10386,10229,20200107,20615
20200104,6,태릉입구,4609,5071,20200107,9680
20200104,6,화랑대,8688,6933,20200107,15621
20200104,6,봉화산,6863,6362,20200107,13225
20200105,6,응암,10931,10761,20200108,21692
20200105,6,역촌,2429,2759,20200108,5188
20200105,6,불광,3754,3276,20200108,7030
20200105,6,독바위,1710,2230,20200108,3940
20200105,6,구산,4467,3418,20200108,7885
20200105,6,새절,7919,7795,20200108,15714
20200105,6,증산,6395,6341,20200108,12736
20200105,6,디지털미디어시티,5944,6264,20200108,12208
20200105,6,월드컵경기장,4050,4248,20200108,8298
20200105,6,마포구청,8017,7188,20200108,15205
20200105,6,망원,9902,10510,20200108,20412
20200105,6,합정,10574,9649,20200108,20223
20200105,6,상수,7377,8375,20200108,15752
20200105,6,광흥창,5147,4942,20200108,10089
20200105,6,대흥,4371,4577,20200108,8948
20200105,6,공덕,7886,7192,20200108,15078
20200105,6,효창공원앞,3716,3330,20200108,7046
20200105,6,삼각지,4019,2970,20200108,6989
20200105,6,녹사평,4380,4409,20200108,8789
20200105,6,이태원,15430,13025,20200108,28455
20200105,6,한강진,6998,7550,20200108,14548
20200105,6,버티고개,1246,1290,20200108,2536
20200105,6,약수,1821,1909,20200108,3730
20200105,6,청구,1825,2010,20200108,3835
20200105,6,신당,4665,5206,20200108,9871
20200105,6,동묘앞,7321,7089,20200108,14410
20200105,6,창신,1808,1646,20200108,3454
20200105,6,보문,4525,4360,20200108,8885
20200105,6,안암,5873,6259,20200108,12132
20200105,6,고려대,4773,4646,20200108,9419
20200105,6,월곡,7753,7412,20200108,15165
20200105,6,상월곡,3817,3502,20200108,7319
20200105,6,돌곶이,4954,4848,20200108,9802
20200105,6,석계,7738,7725,20200108,15463
20200105,6,태릉입구,3272,3881,20200108,7153
20200105,6,화랑대,6231,5419,20200108,11650
20200105,6,봉화산,5030,4850,20200108,9880
20200106,6,응암,19468,19376,20200109,38844
20200106,6,역촌,4478,5053,20200109,9531
20200106,6,불광,4988,5080,20200109,10068
20200106,6,독바위,3106,3274,20200109,6380
20200106,6,구산,8642,6811,20200109,15453
20200106,6,새절,14612,13949,20200109,28561
20200106,6,증산,11282,11022,20200109,22304
20200106,6,디지털미디어시티,15686,17239,20200109,32925
20200106,6,월드컵경기장,4784,4936,20200109,9720
20200106,6,마포구청,16291,14754,20200109,31045
20200106,6,망원,15149,16288,20200109,31437
20200106,6,합정,14413,13795,20200109,28208
20200106,6,상수,9848,10810,20200109,20658
20200106,6,광흥창,10878,10685,20200109,21563
20200106,6,대흥,9716,10241,20200109,19957
20200106,6,공덕,21503,21221,20200109,42724
20200106,6,효창공원앞,7882,7285,20200109,15167
20200106,6,삼각지,6401,5635,20200109,12036
20200106,6,녹사평,5041,4972,20200109,10013
20200106,6,이태원,12168,12545,20200109,24713
20200106,6,한강진,6900,8113,20200109,15013
20200106,6,버티고개,2596,2494,20200109,5090
20200106,6,약수,4360,4435,20200109,8795
20200106,6,청구,4189,4705,20200109,8894
20200106,6,신당,9552,10092,20200109,19644
20200106,6,동묘앞,9057,9480,20200109,18537
20200106,6,창신,4084,3434,20200109,7518
20200106,6,보문,8267,7512,20200109,15779
20200106,6,안암,13830,13887,20200109,27717
20200106,6,고려대,9845,9621,20200109,19466
20200106,6,월곡,13740,13484,20200109,27224
20200106,6,상월곡,6798,6236,20200109,13034
20200106,6,돌곶이,10142,9442,20200109,19584
20200106,6,석계,14149,14922,20200109,29071
20200106,6,태릉입구,5923,6715,20200109,12638
20200106,6,화랑대,13621,10322,20200109,23943
20200106,6,봉화산,11099,10098,20200109,21197
20200107,6,응암,18790,18754,20200110,37544
20200107,6,역촌,4380,5070,20200110,9450
20200107,6,불광,5030,4827,20200110,9857
20200107,6,독바위,3111,3206,20200110,6317
20200107,6,구산,8210,6548,20200110,14758
20200107,6,새절,14244,13599,20200110,27843
20200107,6,증산,11196,10916,20200110,22112
20200107,6,디지털미디어시티,15367,16909,20200110,32276
20200107,6,월드컵경기장,4321,4543,20200110,8864
20200107,6,마포구청,16031,14690,20200110,30721
20200107,6,망원,15218,16419,20200110,31637
20200107,6,합정,14752,14043,20200110,28795
20200107,6,상수,10192,11148,20200110,21340
20200107,6,광흥창,10610,10593,20200110,21203
20200107,6,대흥,9456,9953,20200110,19409
20200107,6,공덕,21271,20745,20200110,42016
20200107,6,효창공원앞,7900,7235,20200110,15135
20200107,6,삼각지,6992,6189,20200110,13181
20200107,6,녹사평,5172,5139,20200110,10311
20200107,6,이태원,11460,12073,20200110,23533
20200107,6,한강진,8927,10325,20200110,19252
20200107,6,버티고개,2651,2460,20200110,5111
20200107,6,약수,4209,4318,20200110,8527
20200107,6,청구,4218,4617,20200110,8835
20200107,6,신당,9896,10537,20200110,20433
20200107,6,동묘앞,8703,9011,20200110,17714
20200107,6,창신,4119,3326,20200110,7445
20200107,6,보문,8171,7511,20200110,15682
20200107,6,안암,13641,13488,20200110,27129
20200107,6,고려대,9823,9511,20200110,19334
20200107,6,월곡,13085,12876,20200110,25961
20200107,6,상월곡,6829,6172,20200110,13001
20200107,6,돌곶이,9714,9215,20200110,18929
20200107,6,석계,14094,14641,20200110,28735
20200107,6,태릉입구,5819,6816,20200110,12635
20200107,6,화랑대,13577,10283,20200110,23860
20200107,6,봉화산,10959,10062,20200110,21021
20200108,6,응암,19849,19490,20200111,39339
20200108,6,역촌,4453,5131,20200111,9584
20200108,6,불광,5299,5429,20200111,10728
20200108,6,독바위,3124,3200,20200111,6324
20200108,6,연신내,1,0,20200111,1
20200108,6,구산,8590,6463,20200111,15053
20200108,6,새절,14891,14167,20200111,29058
20200108,6,증산,11509,11038,20200111,22547
20200108,6,디지털미디어시티,15770,17365,20200111,33135
20200108,6,월드컵경기장,5044,5275,20200111,10319
20200108,6,마포구청,16584,14912,20200111,31496
20200108,6,망원,15997,17171,20200111,33168
20200108,6,합정,15255,14695,20200111,29950
20200108,6,상수,10561,11744,20200111,22305
20200108,6,광흥창,11068,10847,20200111,21915
20200108,6,대흥,9775,10284,20200111,20059
20200108,6,공덕,21941,21314,20200111,43255
20200108,6,효창공원앞,8002,7240,20200111,15242
20200108,6,삼각지,7039,6133,20200111,13172
20200108,6,녹사평,5420,5454,20200111,10874
20200108,6,이태원,12946,13806,20200111,26752
20200108,6,한강진,8455,9860,20200111,18315
20200108,6,버티고개,2573,2399,20200111,4972
20200108,6,약수,4280,4343,20200111,8623
20200108,6,청구,4281,4700,20200111,8981
20200108,6,신당,10380,10536,20200111,20916
20200108,6,동묘앞,8981,9353,20200111,18334
20200108,6,창신,4053,3253,20200111,7306
20200108,6,보문,8422,7675,20200111,16097
20200108,6,안암,13640,13654,20200111,27294
20200108,6,고려대,9855,9526,20200111,19381
20200108,6,월곡,13484,13309,20200111,26793
20200108,6,상월곡,7046,6308,20200111,13354
20200108,6,돌곶이,10055,9529,20200111,19584
20200108,6,석계,14438,14857,20200111,29295
20200108,6,태릉입구,6166,7053,20200111,13219
20200108,6,화랑대,14000,10574,20200111,24574
20200108,6,봉화산,11291,10069,20200111,21360
20200109,6,응암,19911,19683,20200112,39594
20200109,6,역촌,4568,5253,20200112,9821
20200109,6,불광,5424,5291,20200112,10715
20200109,6,독바위,3320,3468,20200112,6788
20200109,6,구산,8829,6760,20200112,15589
20200109,6,새절,14905,14184,20200112,29089
20200109,6,증산,11652,11191,20200112,22843
20200109,6,디지털미디어시티,16024,17581,20200112,33605
20200109,6,월드컵경기장,5173,5321,20200112,10494
20200109,6,마포구청,16908,15277,20200112,32185
20200109,6,망원,16504,17689,20200112,34193
20200109,6,합정,15817,15031,20200112,30848
20200109,6,상수,10981,12151,20200112,23132
20200109,6,광흥창,11293,10824,20200112,22117
20200109,6,대흥,9833,10270,20200112,20103
20200109,6,공덕,21999,21553,20200112,43552
20200109,6,효창공원앞,8229,7579,20200112,15808
20200109,6,삼각지,7405,6401,20200112,13806
20200109,6,녹사평,5923,5849,20200112,11772
20200109,6,이태원,13483,14648,20200112,28131
20200109,6,한강진,8580,9996,20200112,18576
20200109,6,버티고개,2778,2588,20200112,5366
20200109,6,약수,4374,4476,20200112,8850
20200109,6,청구,4477,4785,20200112,9262
20200109,6,신당,9715,10214,20200112,19929
20200109,6,동묘앞,9516,9807,20200112,19323
20200109,6,창신,4302,3409,20200112,7711
20200109,6,보문,8554,7835,20200112,16389
20200109,6,안암,13818,13458,20200112,27276
20200109,6,고려대,9913,9575,20200112,19488
20200109,6,월곡,13754,13443,20200112,27197
20200109,6,상월곡,8205,7414,20200112,15619
20200109,6,돌곶이,10100,9545,20200112,19645
20200109,6,석계,14598,14958,20200112,29556
20200109,6,태릉입구,6274,7248,20200112,13522
20200109,6,화랑대,14002,10536,20200112,24538
20200109,6,봉화산,11419,10161,20200112,21580
20200109,6,신내,1,0,20200112,1
20200110,6,응암,20275,19648,20200113,39923
20200110,6,역촌,4690,5127,20200113,9817
20200110,6,불광,5475,5327,20200113,10802
20200110,6,독바위,3190,3292,20200113,6482
20200110,6,연신내,1,0,20200113,1
20200110,6,구산,8989,6561,20200113,15550
20200110,6,새절,15527,14479,20200113,30006
20200110,6,증산,11948,11350,20200113,23298
20200110,6,디지털미디어시티,16334,17481,20200113,33815
20200110,6,월드컵경기장,5331,5577,20200113,10908
20200110,6,마포구청,16921,14927,20200113,31848
20200110,6,망원,16677,18324,20200113,35001
20200110,6,합정,16805,16507,20200113,33312
20200110,6,상수,11696,13997,20200113,25693
20200110,6,광흥창,11247,11061,20200113,22308
20200110,6,대흥,9918,10323,20200113,20241
20200110,6,공덕,22785,22455,20200113,45240
20200110,6,효창공원앞,8468,7637,20200113,16105
20200110,6,삼각지,7724,6585,20200113,14309
20200110,6,녹사평,6237,6750,20200113,12987
20200110,6,이태원,15681,21448,20200113,37129
20200110,6,한강진,9111,11153,20200113,20264
20200110,6,버티고개,2757,2554,20200113,5311
20200110,6,약수,4444,4613,20200113,9057
20200110,6,청구,4484,4814,20200113,9298
20200110,6,신당,10742,10976,20200113,21718
20200110,6,동묘앞,9880,10144,20200113,20024
20200110,6,창신,4115,3120,20200113,7235
20200110,6,보문,8762,7758,20200113,16520
20200110,6,안암,13825,13648,20200113,27473
20200110,6,고려대,10234,9669,20200113,19903
20200110,6,월곡,14419,13839,20200113,28258
20200110,6,상월곡,7375,6297,20200113,13672
20200110,6,돌곶이,10332,9483,20200113,19815
20200110,6,석계,15105,15150,20200113,30255
20200110,6,태릉입구,6397,7298,20200113,13695
20200110,6,화랑대,14286,10513,20200113,24799
20200110,6,봉화산,11659,10448,20200113,22107
20200110,6,신내,1,0,20200113,1
20200111,6,응암,15301,14718,20200114,30019
20200111,6,역촌,3273,3723,20200114,6996
20200111,6,불광,4840,4500,20200114,9340
20200111,6,독바위,2333,2551,20200114,4884
20200111,6,연신내,2,0,20200114,2
20200111,6,구산,6516,4858,20200114,11374
20200111,6,새절,11131,10546,20200114,21677
20200111,6,증산,8993,8447,20200114,17440
20200111,6,디지털미디어시티,8787,9092,20200114,17879
20200111,6,월드컵경기장,4919,5204,20200114,10123
20200111,6,마포구청,11312,9888,20200114,21200
20200111,6,망원,14145,15580,20200114,29725
20200111,6,합정,15227,14137,20200114,29364
20200111,6,상수,11070,13610,20200114,24680
20200111,6,광흥창,6752,6274,20200114,13026
20200111,6,대흥,7578,7539,20200114,15117
20200111,6,공덕,12925,12437,20200114,25362
20200111,6,효창공원앞,5765,5139,20200114,10904
20200111,6,삼각지,7224,5385,20200114,12609
20200111,6,녹사평,6098,7068,20200114,13166
20200111,6,이태원,19599,25739,20200114,45338
20200111,6,한강진,9540,11562,20200114,21102
20200111,6,버티고개,1841,1860,20200114,3701
20200111,6,약수,2941,3023,20200114,5964
20200111,6,청구,2934,3101,20200114,6035
20200111,6,신당,8640,6880,20200114,15520
20200111,6,동묘앞,10180,9340,20200114,19520
20200111,6,창신,2560,2047,20200114,4607
20200111,6,보문,6279,5552,20200114,11831
20200111,6,안암,8877,8727,20200114,17604
20200111,6,고려대,7035,6538,20200114,13573
20200111,6,월곡,9633,9175,20200114,18808
20200111,6,상월곡,4680,4090,20200114,8770
20200111,6,돌곶이,6881,6267,20200114,13148
20200111,6,석계,10939,10816,20200114,21755
20200111,6,태릉입구,5033,5637,20200114,10670
20200111,6,화랑대,9216,7104,20200114,16320
20200111,6,봉화산,7313,6907,20200114,14220
20200112,6,응암,10703,10769,20200115,21472
20200112,6,역촌,2586,2858,20200115,5444
20200112,6,불광,4078,3714,20200115,7792
20200112,6,독바위,1757,2227,20200115,3984
20200112,6,구산,4388,3413,20200115,7801
20200112,6,새절,8099,7832,20200115,15931
20200112,6,증산,6554,6489,20200115,13043
20200112,6,디지털미디어시티,6179,6558,20200115,12737
20200112,6,월드컵경기장,3336,3453,20200115,6789
20200112,6,마포구청,8184,7431,20200115,15615
20200112,6,망원,10602,11316,20200115,21918
20200112,6,합정,11132,10159,20200115,21291
20200112,6,상수,7996,8840,20200115,16836
20200112,6,광흥창,4923,4707,20200115,9630
20200112,6,대흥,4457,4585,20200115,9042
20200112,6,공덕,8266,7746,20200115,16012
20200112,6,효창공원앞,3788,3430,20200115,7218
20200112,6,삼각지,4109,3277,20200115,7386
20200112,6,녹사평,4754,4615,20200115,9369
20200112,6,이태원,16705,13872,20200115,30577
20200112,6,한강진,7597,8345,20200115,15942
20200112,6,버티고개,1243,1330,20200115,2573
20200112,6,약수,1997,2016,20200115,4013
20200112,6,청구,1887,1921,20200115,3808
20200112,6,신당,5045,5591,20200115,10636
20200112,6,동묘앞,7737,7370,20200115,15107
20200112,6,창신,1958,1766,20200115,3724
20200112,6,보문,4919,4529,20200115,9448
20200112,6,안암,6241,6658,20200115,12899
20200112,6,고려대,5229,4975,20200115,10204
20200112,6,월곡,6617,6497,20200115,13114
20200112,6,상월곡,4001,3555,20200115,7556
20200112,6,돌곶이,4995,4664,20200115,9659
20200112,6,석계,8010,7996,20200115,16006
20200112,6,태릉입구,3622,4177,20200115,7799
20200112,6,화랑대,6566,5634,20200115,12200
20200112,6,봉화산,5095,4951,20200115,10046
20200113,6,응암,19674,19507,20200116,39181
20200113,6,역촌,4563,5120,20200116,9683
20200113,6,불광,5041,4961,20200116,10002
20200113,6,독바위,3172,3287,20200116,6459
20200113,6,연신내,1,0,20200116,1
20200113,6,구산,8604,6643,20200116,15247
20200113,6,새절,14747,13987,20200116,28734
20200113,6,증산,11425,11054,20200116,22479
20200113,6,디지털미디어시티,16008,17316,20200116,33324
20200113,6,월드컵경기장,4995,5169,20200116,10164
20200113,6,마포구청,16396,14843,20200116,31239
20200113,6,망원,15475,16688,20200116,32163
20200113,6,합정,14992,14102,20200116,29094
20200113,6,상수,10150,11123,20200116,21273
20200113,6,광흥창,10883,10685,20200116,21568
20200113,6,대흥,9703,10138,20200116,19841
20200113,6,공덕,21955,21262,20200116,43217
20200113,6,효창공원앞,7920,7325,20200116,15245
20200113,6,삼각지,6532,5719,20200116,12251
20200113,6,녹사평,5211,5158,20200116,10369
20200113,6,이태원,12730,13011,20200116,25741
20200113,6,한강진,7312,8481,20200116,15793
20200113,6,버티고개,2665,2504,20200116,5169
20200113,6,약수,4511,4506,20200116,9017
20200113,6,청구,4311,4805,20200116,9116
20200113,6,신당,9177,9787,20200116,18964
20200113,6,동묘앞,9364,9798,20200116,19162
20200113,6,창신,4003,3335,20200116,7338
20200113,6,보문,8165,7500,20200116,15665
20200113,6,안암,13128,13279,20200116,26407
20200113,6,고려대,9998,9634,20200116,19632
20200113,6,월곡,13605,13370,20200116,26975
20200113,6,상월곡,6988,6388,20200116,13376
20200113,6,돌곶이,10236,9509,20200116,19745
20200113,6,석계,14200,14754,20200116,28954
20200113,6,태릉입구,6047,6841,20200116,12888
20200113,6,화랑대,13843,10368,20200116,24211
20200113,6,봉화산,11126,10050,20200116,21176
20200113,6,신내,1,0,20200116,1
20200114,6,봉화산,11427,10380,20200117,21807
20200114,6,화랑대,13902,10545,20200117,24447
20200114,6,태릉입구,6122,7004,20200117,13126
20200114,6,석계,14531,14886,20200117,29417
20200114,6,돌곶이,10194,9639,20200117,19833
20200114,6,상월곡,7177,6428,20200117,13605
20200114,6,월곡,13719,13497,20200117,27216
20200114,6,고려대,10135,9719,20200117,19854
20200114,6,안암,13806,13740,20200117,27546
20200114,6,보문,8510,7664,20200117,16174
20200114,6,창신,4084,3359,20200117,7443
20200114,6,동묘앞,9433,9825,20200117,19258
20200114,6,신당,10033,10442,20200117,20475
20200114,6,청구,4477,4819,20200117,9296
20200114,6,약수,4473,4535,20200117,9008
20200114,6,버티고개,2694,2505,20200117,5199
20200114,6,한강진,8484,10062,20200117,18546
20200114,6,이태원,12593,13273,20200117,25866
20200114,6,녹사평,5646,5546,20200117,11192
20200114,6,삼각지,7244,6325,20200117,13569
20200114,6,효창공원앞,8293,7717,20200117,16010
20200114,6,공덕,22086,21643,20200117,43729
20200114,6,대흥,9724,9996,20200117,19720
20200114,6,광흥창,11312,11051,20200117,22363
20200114,6,상수,10571,11767,20200117,22338
20200114,6,합정,15478,14817,20200117,30295
20200114,6,망원,16040,17362,20200117,33402
20200114,6,마포구청,17050,15355,20200117,32405
20200114,6,월드컵경기장,5029,5308,20200117,10337
20200114,6,디지털미디어시티,15838,17489,20200117,33327
20200114,6,증산,11528,11173,20200117,22701
20200114,6,새절,14860,14195,20200117,29055
20200114,6,구산,8453,6546,20200117,14999
20200114,6,독바위,3201,3381,20200117,6582
20200114,6,불광,5191,5175,20200117,10366
20200114,6,역촌,4488,5094,20200117,9582
20200114,6,응암,19762,19547,20200117,39309
20200115,6,약수,4409,4524,20200118,8933
20200115,6,응암,19998,19651,20200118,39649
20200115,6,역촌,4526,5190,20200118,9716
20200115,6,불광,5416,5392,20200118,10808
20200115,6,독바위,3209,3408,20200118,6617
20200115,6,연신내,1,0,20200118,1
20200115,6,구산,8646,6735,20200118,15381
20200115,6,새절,15120,14331,20200118,29451
20200115,6,증산,11561,11221,20200118,22782
20200115,6,디지털미디어시티,15987,17415,20200118,33402
20200115,6,월드컵경기장,5015,5270,20200118,10285
20200115,6,마포구청,17047,15425,20200118,32472
20200115,6,망원,16177,17546,20200118,33723
20200115,6,합정,15758,14923,20200118,30681
20200115,6,상수,10838,12065,20200118,22903
20200115,6,광흥창,11235,11167,20200118,22402
20200115,6,대흥,10271,10688,20200118,20959
20200115,6,공덕,22243,21592,20200118,43835
20200115,6,효창공원앞,7953,7227,20200118,15180
20200115,6,삼각지,7407,6457,20200118,13864
20200115,6,녹사평,5631,5659,20200118,11290
20200115,6,이태원,13151,14085,20200118,27236
20200115,6,한강진,8538,10004,20200118,18542
20200115,6,버티고개,2626,2588,20200118,5214
20200115,6,청구,4477,4812,20200118,9289
20200115,6,신당,10703,10987,20200118,21690
20200115,6,동묘앞,9439,9645,20200118,19084
20200115,6,창신,3987,3161,20200118,7148
20200115,6,보문,8564,7902,20200118,16466
20200115,6,안암,13787,13597,20200118,27384
20200115,6,고려대,9957,9549,20200118,19506
20200115,6,월곡,13853,13453,20200118,27306
20200115,6,상월곡,7296,6564,20200118,13860
20200115,6,돌곶이,10223,9718,20200118,19941
20200115,6,석계,14751,15249,20200118,30000
20200115,6,태릉입구,6202,7024,20200118,13226
20200115,6,화랑대,13881,10703,20200118,24584
20200115,6,봉화산,11495,10411,20200118,21906
20200116,6,봉화산,11427,10329,20200119,21756
20200116,6,화랑대,13928,10425,20200119,24353
20200116,6,태릉입구,6302,7243,20200119,13545
20200116,6,석계,14658,14815,20200119,29473
20200116,6,돌곶이,10333,9455,20200119,19788
20200116,6,상월곡,8157,7609,20200119,15766
20200116,6,월곡,13823,13344,20200119,27167
20200116,6,고려대,10103,9729,20200119,19832
20200116,6,안암,13493,13321,20200119,26814
20200116,6,보문,8601,7677,20200119,16278
20200116,6,창신,4068,3353,20200119,7421
20200116,6,동묘앞,9454,9873,20200119,19327
20200116,6,신당,10157,10382,20200119,20539
20200116,6,청구,4421,4821,20200119,9242
20200116,6,약수,4487,4562,20200119,9049
20200116,6,버티고개,2751,2545,20200119,5296
20200116,6,한강진,8679,10106,20200119,18785
20200116,6,이태원,13614,15272,20200119,28886
20200116,6,녹사평,5917,6004,20200119,11921
20200116,6,삼각지,7554,6545,20200119,14099
20200116,6,효창공원앞,7952,7285,20200119,15237
20200116,6,공덕,22471,21765,20200119,44236
20200116,6,대흥,10089,10600,20200119,20689
20200116,6,광흥창,11322,11216,20200119,22538
20200116,6,상수,10842,12234,20200119,23076
20200116,6,합정,15849,15328,20200119,31177
20200116,6,망원,16677,18077,20200119,34754
20200116,6,마포구청,16823,15200,20200119,32023
20200116,6,월드컵경기장,5138,5405,20200119,10543
20200116,6,디지털미디어시티,15941,17360,20200119,33301
20200116,6,증산,11635,11303,20200119,22938
20200116,6,새절,14990,14281,20200119,29271
20200116,6,구산,8585,6636,20200119,15221
20200116,6,독바위,3222,3311,20200119,6533
20200116,6,불광,5315,5164,20200119,10479
20200116,6,역촌,4509,5132,20200119,9641
20200116,6,응암,20102,19846,20200119,39948
20200117,6,응암,20726,19887,20200120,40613
20200117,6,역촌,4595,5230,20200120,9825
20200117,6,불광,5514,5451,20200120,10965
20200117,6,독바위,3270,3334,20200120,6604
20200117,6,구산,8961,6645,20200120,15606
20200117,6,새절,15525,14264,20200120,29789
20200117,6,증산,11996,11282,20200120,23278
20200117,6,디지털미디어시티,16116,17362,20200120,33478
20200117,6,월드컵경기장,5311,5559,20200120,10870
20200117,6,마포구청,17280,15418,20200120,32698
20200117,6,망원,16931,18750,20200120,35681
20200117,6,합정,17035,16635,20200120,33670
20200117,6,상수,11836,14656,20200120,26492
20200117,6,광흥창,11279,10953,20200120,22232
20200117,6,대흥,10399,10878,20200120,21277
20200117,6,공덕,23321,22725,20200120,46046
20200117,6,효창공원앞,8327,7340,20200120,15667
20200117,6,삼각지,7836,6655,20200120,14491
20200117,6,녹사평,6274,6659,20200120,12933
20200117,6,이태원,16307,22583,20200120,38890
20200117,6,한강진,9166,11081,20200120,20247
20200117,6,버티고개,2748,2566,20200120,5314
20200117,6,약수,4398,4649,20200120,9047
20200117,6,청구,4511,4830,20200120,9341
20200117,6,신당,10864,10948,20200120,21812
20200117,6,동묘앞,9795,10103,20200120,19898
20200117,6,창신,4065,3207,20200120,7272
20200117,6,보문,8693,7753,20200120,16446
20200117,6,안암,14162,13693,20200120,27855
20200117,6,고려대,10345,9664,20200120,20009
20200117,6,월곡,14116,13631,20200120,27747
20200117,6,상월곡,7311,6320,20200120,13631
20200117,6,돌곶이,10269,9441,20200120,19710
20200117,6,석계,15010,15149,20200120,30159
20200117,6,태릉입구,6406,7341,20200120,13747
20200117,6,화랑대,14281,10654,20200120,24935
20200117,6,봉화산,11630,10316,20200120,21946
20200118,6,응암,15132,14805,20200121,29937
20200118,6,역촌,3387,3777,20200121,7164
20200118,6,불광,4776,4364,20200121,9140
20200118,6,독바위,2419,2732,20200121,5151
20200118,6,연신내,1,0,20200121,1
20200118,6,구산,6528,4860,20200121,11388
20200118,6,새절,11209,10639,20200121,21848
20200118,6,증산,9007,8493,20200121,17500
20200118,6,디지털미디어시티,8923,8838,20200121,17761
20200118,6,월드컵경기장,4859,5166,20200121,10025
20200118,6,마포구청,11374,9786,20200121,21160
20200118,6,망원,15048,16251,20200121,31299
20200118,6,합정,15203,14158,20200121,29361
20200118,6,상수,11383,14131,20200121,25514
20200118,6,광흥창,6922,6517,20200121,13439
20200118,6,대흥,6894,7123,20200121,14017
20200118,6,공덕,13226,12564,20200121,25790
20200118,6,효창공원앞,5677,4910,20200121,10587
20200118,6,삼각지,6713,5072,20200121,11785
20200118,6,녹사평,6127,7123,20200121,13250
20200118,6,이태원,19992,26476,20200121,46468
20200118,6,한강진,9619,11647,20200121,21266
20200118,6,버티고개,1916,1897,20200121,3813
20200118,6,약수,3063,3080,20200121,6143
20200118,6,청구,2963,3064,20200121,6027
20200118,6,신당,8561,6920,20200121,15481
20200118,6,동묘앞,10208,9408,20200121,19616
20200118,6,창신,2555,2027,20200121,4582
20200118,6,보문,6464,5759,20200121,12223
20200118,6,안암,9301,8971,20200121,18272
20200118,6,고려대,7317,6968,20200121,14285
20200118,6,월곡,10017,9562,20200121,19579
20200118,6,상월곡,4892,4185,20200121,9077
20200118,6,돌곶이,6958,6501,20200121,13459
20200118,6,석계,11005,10933,20200121,21938
20200118,6,태릉입구,5030,5597,20200121,10627
20200118,6,화랑대,9643,7833,20200121,17476
20200118,6,봉화산,7258,6792,20200121,14050
20200119,6,응암,11023,10956,20200122,21979
20200119,6,역촌,2577,2879,20200122,5456
20200119,6,불광,3791,3347,20200122,7138
20200119,6,독바위,1767,2186,20200122,3953
20200119,6,구산,4571,3450,20200122,8021
20200119,6,새절,7912,7779,20200122,15691
20200119,6,증산,6450,6392,20200122,12842
20200119,6,디지털미디어시티,6201,6494,20200122,12695
20200119,6,월드컵경기장,3780,3936,20200122,7716
20200119,6,마포구청,8196,7329,20200122,15525
20200119,6,망원,10341,11354,20200122,21695
20200119,6,합정,11320,10255,20200122,21575
20200119,6,상수,7925,8530,20200122,16455
20200119,6,광흥창,4998,4850,20200122,9848
20200119,6,대흥,4562,4831,20200122,9393
20200119,6,공덕,8528,7974,20200122,16502
20200119,6,효창공원앞,3857,3316,20200122,7173
20200119,6,삼각지,4020,3076,20200122,7096
20200119,6,녹사평,4518,4470,20200122,8988
20200119,6,이태원,16539,13490,20200122,30029
20200119,6,한강진,7433,8127,20200122,15560
20200119,6,버티고개,1275,1287,20200122,2562
20200119,6,약수,2032,2101,20200122,4133
20200119,6,청구,1998,2019,20200122,4017
20200119,6,신당,5184,5531,20200122,10715
20200119,6,동묘앞,7062,6598,20200122,13660
20200119,6,창신,2008,1728,20200122,3736
20200119,6,보문,4817,4457,20200122,9274
20200119,6,안암,6095,6316,20200122,12411
20200119,6,고려대,4832,4682,20200122,9514
20200119,6,월곡,6841,6583,20200122,13424
20200119,6,상월곡,3882,3445,20200122,7327
20200119,6,돌곶이,5101,4830,20200122,9931
20200119,6,석계,7933,7904,20200122,15837
20200119,6,태릉입구,3532,4020,20200122,7552
20200119,6,화랑대,6084,5031,20200122,11115
20200119,6,봉화산,5167,5010,20200122,10177
20200119,6,신내,1,0,20200122,1
20200120,6,봉화산,11218,10134,20200123,21352
20200120,6,화랑대,13649,10272,20200123,23921
20200120,6,태릉입구,6095,6828,20200123,12923
20200120,6,석계,14526,14881,20200123,29407
20200120,6,돌곶이,10102,9528,20200123,19630
20200120,6,상월곡,7134,6271,20200123,13405
20200120,6,월곡,14192,13606,20200123,27798
20200120,6,고려대,9599,9172,20200123,18771
20200120,6,안암,12707,12862,20200123,25569
20200120,6,보문,8462,7680,20200123,16142
20200120,6,창신,4052,3234,20200123,7286
20200120,6,동묘앞,9493,9979,20200123,19472
20200120,6,신당,9061,9648,20200123,18709
20200120,6,청구,4459,4948,20200123,9407
20200120,6,약수,4509,4479,20200123,8988
20200120,6,버티고개,2649,2494,20200123,5143
20200120,6,한강진,8058,9480,20200123,17538
20200120,6,이태원,12908,13231,20200123,26139
20200120,6,녹사평,5500,5259,20200123,10759
20200120,6,삼각지,6309,5659,20200123,11968
20200120,6,효창공원앞,7932,7262,20200123,15194
20200120,6,공덕,22228,21736,20200123,43964
20200120,6,대흥,10016,10478,20200123,20494
20200120,6,광흥창,11148,11004,20200123,22152
20200120,6,상수,10480,11400,20200123,21880
20200120,6,합정,15164,14376,20200123,29540
20200120,6,망원,16129,17297,20200123,33426
20200120,6,마포구청,16654,14998,20200123,31652
20200120,6,월드컵경기장,4994,5157,20200123,10151
20200120,6,디지털미디어시티,15753,17286,20200123,33039
20200120,6,증산,11491,11171,20200123,22662
20200120,6,새절,14964,14139,20200123,29103
20200120,6,구산,8653,6714,20200123,15367
20200120,6,연신내,3,0,20200123,3
20200120,6,독바위,3247,3365,20200123,6612
20200120,6,불광,5191,5159,20200123,10350
20200120,6,역촌,4597,5095,20200123,9692
20200120,6,응암,19894,19902,20200123,39796
20200121,6,응암,19914,19501,20200124,39415
20200121,6,역촌,4527,5146,20200124,9673
20200121,6,불광,5215,5204,20200124,10419
20200121,6,독바위,3233,3337,20200124,6570
20200121,6,구산,8637,6549,20200124,15186
20200121,6,새절,14822,14140,20200124,28962
20200121,6,증산,11585,11138,20200124,22723
20200121,6,디지털미디어시티,15814,17521,20200124,33335
20200121,6,월드컵경기장,5190,5416,20200124,10606
20200121,6,마포구청,16867,15059,20200124,31926
20200121,6,망원,16434,17696,20200124,34130
20200121,6,합정,15469,14775,20200124,30244
20200121,6,상수,11010,12094,20200124,23104
20200121,6,광흥창,11186,10979,20200124,22165
20200121,6,대흥,10079,10459,20200124,20538
20200121,6,공덕,22287,21665,20200124,43952
20200121,6,효창공원앞,8043,7200,20200124,15243
20200121,6,삼각지,7219,6268,20200124,13487
20200121,6,녹사평,5608,5688,20200124,11296
20200121,6,이태원,12999,13704,20200124,26703
20200121,6,한강진,8579,9963,20200124,18542
20200121,6,버티고개,2694,2482,20200124,5176
20200121,6,약수,4379,4493,20200124,8872
20200121,6,청구,4466,4838,20200124,9304
20200121,6,신당,9591,10049,20200124,19640
20200121,6,동묘앞,9731,9844,20200124,19575
20200121,6,창신,3999,3116,20200124,7115
20200121,6,보문,8348,7573,20200124,15921
20200121,6,안암,12714,12835,20200124,25549
20200121,6,고려대,9229,8827,20200124,18056
20200121,6,월곡,14058,13416,20200124,27474
20200121,6,상월곡,7099,6298,20200124,13397
20200121,6,돌곶이,9947,9411,20200124,19358
20200121,6,석계,14599,14797,20200124,29396
20200121,6,태릉입구,6098,6782,20200124,12880
20200121,6,화랑대,13861,10398,20200124,24259
20200121,6,봉화산,11343,10044,20200124,21387
20200121,6,신내,1,0,20200124,1
20200122,6,응암,20107,19636,20200125,39743
20200122,6,역촌,4487,5047,20200125,9534
20200122,6,불광,5330,5379,20200125,10709
20200122,6,독바위,3215,3298,20200125,6513
20200122,6,구산,8691,6597,20200125,15288
20200122,6,새절,14858,14086,20200125,28944
20200122,6,증산,11608,11154,20200125,22762
20200122,6,디지털미디어시티,15909,17325,20200125,33234
20200122,6,월드컵경기장,5286,5592,20200125,10878
20200122,6,마포구청,16508,14710,20200125,31218
20200122,6,망원,16753,17955,20200125,34708
20200122,6,합정,15813,15081,20200125,30894
20200122,6,상수,10450,11620,20200125,22070
20200122,6,광흥창,11032,10765,20200125,21797
20200122,6,대흥,9975,10217,20200125,20192
20200122,6,공덕,22382,21576,20200125,43958
20200122,6,효창공원앞,8192,7295,20200125,15487
20200122,6,삼각지,6833,6040,20200125,12873
20200122,6,녹사평,5772,5745,20200125,11517
20200122,6,이태원,13414,14571,20200125,27985
20200122,6,한강진,8646,10062,20200125,18708
20200122,6,버티고개,2670,2558,20200125,5228
20200122,6,약수,4299,4365,20200125,8664
20200122,6,청구,4426,4725,20200125,9151
20200122,6,신당,10602,10510,20200125,21112
20200122,6,동묘앞,9602,9630,20200125,19232
20200122,6,창신,3903,3084,20200125,6987
20200122,6,보문,8489,7725,20200125,16214
20200122,6,안암,12290,11776,20200125,24066
20200122,6,고려대,9353,8708,20200125,18061
20200122,6,월곡,13980,13335,20200125,27315
20200122,6,상월곡,7052,6307,20200125,13359
20200122,6,돌곶이,10080,9321,20200125,19401
20200122,6,석계,14607,14553,20200125,29160
20200122,6,태릉입구,6141,6891,20200125,13032
20200122,6,화랑대,13809,10344,20200125,24153
20200122,6,봉화산,11286,10148,20200125,21434
20200123,6,응암,19237,18353,20200126,37590
20200123,6,역촌,4219,4563,20200126,8782
20200123,6,불광,5308,5045,20200126,10353
20200123,6,독바위,3078,2984,20200126,6062
20200123,6,구산,8213,6021,20200126,14234
20200123,6,새절,14301,12980,20200126,27281
20200123,6,증산,11318,10352,20200126,21670
20200123,6,디지털미디어시티,14657,15609,20200126,30266
20200123,6,월드컵경기장,5476,5679,20200126,11155
20200123,6,마포구청,15654,13019,20200126,28673
20200123,6,망원,16426,17866,20200126,34292
20200123,6,합정,15110,14544,20200126,29654
20200123,6,상수,10038,11726,20200126,21764
20200123,6,광흥창,10201,9568,20200126,19769
20200123,6,대흥,9199,9131,20200126,18330
20200123,6,공덕,20242,19470,20200126,39712
20200123,6,효창공원앞,7354,6284,20200126,13638
20200123,6,삼각지,6467,5641,20200126,12108
20200123,6,녹사평,5543,5827,20200126,11370
20200123,6,이태원,14203,19111,20200126,33314
20200123,6,한강진,8173,9675,20200126,17848
20200123,6,버티고개,2480,2337,20200126,4817
20200123,6,약수,3969,4035,20200126,8004
20200123,6,청구,4018,4197,20200126,8215
20200123,6,신당,7986,7166,20200126,15152
20200123,6,동묘앞,8901,8556,20200126,17457
20200123,6,창신,3744,2715,20200126,6459
20200123,6,보문,8130,6670,20200126,14800
20200123,6,안암,11686,10356,20200126,22042
20200123,6,고려대,9157,8011,20200126,17168
20200123,6,월곡,12922,12056,20200126,24978
20200123,6,상월곡,7576,6452,20200126,14028
20200123,6,돌곶이,9186,8288,20200126,17474
20200123,6,석계,13988,13793,20200126,27781
20200123,6,태릉입구,5829,6422,20200126,12251
20200123,6,화랑대,13039,9393,20200126,22432
20200123,6,봉화산,10473,9485,20200126,19958
20200124,6,봉화산,3687,3554,20200127,7241
20200124,6,화랑대,4432,3485,20200127,7917
20200124,6,태릉입구,2346,2522,20200127,4868
20200124,6,석계,6031,5898,20200127,11929
20200124,6,돌곶이,3888,3573,20200127,7461
20200124,6,상월곡,2877,2430,20200127,5307
20200124,6,월곡,5504,4962,20200127,10466
20200124,6,고려대,3950,3073,20200127,7023
20200124,6,안암,4358,3141,20200127,7499
20200124,6,보문,3816,2711,20200127,6527
20200124,6,창신,1448,1143,20200127,2591
20200124,6,동묘앞,5121,4749,20200127,9870
20200124,6,신당,2738,2252,20200127,4990
20200124,6,청구,1447,1461,20200127,2908
20200124,6,약수,1406,1368,20200127,2774
20200124,6,버티고개,895,959,20200127,1854
20200124,6,한강진,3405,4178,20200127,7583
20200124,6,이태원,14401,16446,20200127,30847
20200124,6,녹사평,3081,3436,20200127,6517
20200124,6,삼각지,2679,1843,20200127,4522
20200124,6,효창공원앞,2843,2252,20200127,5095
20200124,6,공덕,6138,5469,20200127,11607
20200124,6,대흥,3124,2788,20200127,5912
20200124,6,광흥창,3130,2715,20200127,5845
20200124,6,상수,4965,5311,20200127,10276
20200124,6,합정,7367,6754,20200127,14121
20200124,6,망원,8665,8485,20200127,17150
20200124,6,마포구청,6296,4776,20200127,11072
20200124,6,월드컵경기장,3641,3592,20200127,7233
20200124,6,디지털미디어시티,4923,4689,20200127,9612
20200124,6,증산,5302,4827,20200127,10129
20200124,6,새절,6355,5743,20200127,12098
20200124,6,구산,3427,2576,20200127,6003
20200124,6,연신내,2,0,20200127,2
20200124,6,독바위,1410,1576,20200127,2986
20200124,6,불광,2943,2667,20200127,5610
20200124,6,역촌,1848,1996,20200127,3844
20200124,6,응암,8753,8155,20200127,16908
20200125,6,응암,7882,7803,20200128,15685
20200125,6,역촌,1777,2110,20200128,3887
20200125,6,불광,2009,2062,20200128,4071
20200125,6,독바위,1302,1443,20200128,2745
20200125,6,구산,3444,2624,20200128,6068
20200125,6,새절,6032,5922,20200128,11954
20200125,6,증산,4732,4788,20200128,9520
20200125,6,디지털미디어시티,4401,4350,20200128,8751
20200125,6,월드컵경기장,2902,2930,20200128,5832
20200125,6,마포구청,5395,4842,20200128,10237
20200125,6,망원,5126,5533,20200128,10659
20200125,6,합정,5372,4890,20200128,10262
20200125,6,상수,3205,4087,20200128,7292
20200125,6,광흥창,2684,2468,20200128,5152
20200125,6,대흥,2296,2456,20200128,4752
20200125,6,공덕,4584,4572,20200128,9156
20200125,6,효창공원앞,2358,2047,20200128,4405
20200125,6,삼각지,2901,1845,20200128,4746
20200125,6,녹사평,2568,2788,20200128,5356
20200125,6,이태원,10919,14817,20200128,25736
20200125,6,한강진,2588,2983,20200128,5571
20200125,6,버티고개,906,932,20200128,1838
20200125,6,약수,1230,1309,20200128,2539
20200125,6,청구,1360,1405,20200128,2765
20200125,6,신당,2021,1808,20200128,3829
20200125,6,동묘앞,4613,4185,20200128,8798
20200125,6,창신,1336,1131,20200128,2467
20200125,6,보문,3277,3075,20200128,6352
20200125,6,안암,2595,2815,20200128,5410
20200125,6,고려대,3181,3177,20200128,6358
20200125,6,월곡,4994,4798,20200128,9792
20200125,6,상월곡,2782,2443,20200128,5225
20200125,6,돌곶이,3670,3496,20200128,7166
20200125,6,석계,5931,5789,20200128,11720
20200125,6,태릉입구,2272,2344,20200128,4616
20200125,6,화랑대,4299,3472,20200128,7771
20200125,6,봉화산,3659,3482,20200128,7141
20200126,6,응암,9237,9239,20200129,18476
20200126,6,역촌,2046,2237,20200129,4283
20200126,6,불광,3315,3109,20200129,6424
20200126,6,독바위,1574,1900,20200129,3474
20200126,6,구산,3880,2895,20200129,6775
20200126,6,새절,6852,6678,20200129,13530
20200126,6,증산,5597,5640,20200129,11237
20200126,6,디지털미디어시티,5027,5142,20200129,10169
20200126,6,월드컵경기장,3382,3449,20200129,6831
20200126,6,마포구청,5802,5639,20200129,11441
20200126,6,망원,7139,8370,20200129,15509
20200126,6,합정,8638,8077,20200129,16715
20200126,6,상수,5328,6666,20200129,11994
20200126,6,광흥창,3545,3508,20200129,7053
20200126,6,대흥,2943,3171,20200129,6114
20200126,6,공덕,5986,5773,20200129,11759
20200126,6,효창공원앞,2793,2531,20200129,5324
20200126,6,삼각지,3248,2237,20200129,5485
20200126,6,녹사평,3538,3783,20200129,7321
20200126,6,이태원,14833,16527,20200129,31360
20200126,6,한강진,4428,5300,20200129,9728
20200126,6,버티고개,1046,1122,20200129,2168
20200126,6,약수,1463,1557,20200129,3020
20200126,6,청구,1617,1704,20200129,3321
20200126,6,신당,4141,3540,20200129,7681
20200126,6,동묘앞,6426,5996,20200129,12422
20200126,6,창신,1596,1454,20200129,3050
20200126,6,보문,3436,3575,20200129,7011
20200126,6,안암,3149,3835,20200129,6984
20200126,6,고려대,3500,3647,20200129,7147
20200126,6,월곡,5111,5352,20200129,10463
20200126,6,상월곡,3098,2795,20200129,5893
20200126,6,돌곶이,4022,3802,20200129,7824
20200126,6,석계,6448,6502,20200129,12950
20200126,6,태릉입구,2629,3042,20200129,5671
20200126,6,화랑대,4960,4178,20200129,9138
20200126,6,봉화산,4323,4022,20200129,8345
20200127,6,응암,9230,9596,20200130,18826
20200127,6,역촌,2037,2283,20200130,4320
20200127,6,불광,3510,3061,20200130,6571
20200127,6,독바위,1500,1761,20200130,3261
20200127,6,구산,3816,2937,20200130,6753
20200127,6,새절,6888,6939,20200130,13827
20200127,6,증산,5651,5634,20200130,11285
20200127,6,디지털미디어시티,5327,5710,20200130,11037
20200127,6,월드컵경기장,3950,3972,20200130,7922
20200127,6,마포구청,6182,6233,20200130,12415
20200127,6,망원,7367,8541,20200130,15908
20200127,6,합정,8718,7847,20200130,16565
20200127,6,상수,5483,6380,20200130,11863
20200127,6,광흥창,3403,3416,20200130,6819
20200127,6,대흥,3221,3621,20200130,6842
20200127,6,공덕,6760,7072,20200130,13832
20200127,6,효창공원앞,2934,2671,20200130,5605
20200127,6,삼각지,2829,2249,20200130,5078
20200127,6,녹사평,3138,3094,20200130,6232
20200127,6,이태원,11946,10098,20200130,22044
20200127,6,한강진,4106,4750,20200130,8856
20200127,6,버티고개,1069,1088,20200130,2157
20200127,6,약수,1614,1620,20200130,3234
20200127,6,청구,1619,1814,20200130,3433
20200127,6,신당,4147,3773,20200130,7920
20200127,6,동묘앞,5346,5081,20200130,10427
20200127,6,창신,1570,1387,20200130,2957
20200127,6,보문,3392,3656,20200130,7048
20200127,6,안암,4273,5405,20200130,9678
20200127,6,고려대,3657,4007,20200130,7664
20200127,6,월곡,5642,5892,20200130,11534
20200127,6,상월곡,2721,2680,20200130,5401
20200127,6,돌곶이,4157,3925,20200130,8082
20200127,6,석계,6489,6833,20200130,13322
20200127,6,태릉입구,2737,3348,20200130,6085
20200127,6,화랑대,5203,4799,20200130,10002
20200127,6,봉화산,4350,4284,20200130,8634
20200128,6,응암,18536,18579,20200131,37115
20200128,6,역촌,4096,4649,20200131,8745
20200128,6,불광,4817,4750,20200131,9567
20200128,6,독바위,2859,3083,20200131,5942
20200128,6,구산,8051,6214,20200131,14265
20200128,6,새절,13613,13043,20200131,26656
20200128,6,증산,10513,10265,20200131,20778
20200128,6,디지털미디어시티,14551,15951,20200131,30502
20200128,6,월드컵경기장,6821,7278,20200131,14099
20200128,6,마포구청,15015,13802,20200131,28817
20200128,6,망원,14282,15785,20200131,30067
20200128,6,합정,13644,13180,20200131,26824
20200128,6,상수,9181,10341,20200131,19522
20200128,6,광흥창,9821,9644,20200131,19465
20200128,6,대흥,8791,9339,20200131,18130
20200128,6,공덕,19421,19020,20200131,38441
20200128,6,효창공원앞,7324,6652,20200131,13976
20200128,6,삼각지,6035,5320,20200131,11355
20200128,6,녹사평,5066,5051,20200131,10117
20200128,6,이태원,11350,11877,20200131,23227
20200128,6,한강진,6990,8054,20200131,15044
20200128,6,버티고개,2365,2338,20200131,4703
20200128,6,약수,3867,3966,20200131,7833
20200128,6,청구,3886,4298,20200131,8184
20200128,6,신당,6881,7987,20200131,14868
20200128,6,동묘앞,7904,8755,20200131,16659
20200128,6,창신,3611,2864,20200131,6475
20200128,6,보문,7428,7143,20200131,14571
20200128,6,안암,10591,11339,20200131,21930
20200128,6,고려대,8052,8064,20200131,16116
20200128,6,월곡,12163,12048,20200131,24211
20200128,6,상월곡,6382,5701,20200131,12083
20200128,6,돌곶이,9020,8485,20200131,17505
20200128,6,석계,13164,13680,20200131,26844
20200128,6,태릉입구,5546,6364,20200131,11910
20200128,6,화랑대,12415,9494,20200131,21909
20200128,6,봉화산,10393,9330,20200131,19723
20200129,6,응암,19273,19108,20200201,38381
20200129,6,역촌,4208,4791,20200201,8999
20200129,6,불광,5019,5021,20200201,10040
20200129,6,독바위,3076,3250,20200201,6326
20200129,6,연신내,1,0,20200201,1
20200129,6,구산,8442,6507,20200201,14949
20200129,6,새절,14556,13739,20200201,28295
20200129,6,증산,11145,10782,20200201,21927
20200129,6,디지털미디어시티,15651,16932,20200201,32583
20200129,6,월드컵경기장,4874,5248,20200201,10122
20200129,6,마포구청,15937,14453,20200201,30390
20200129,6,망원,15127,16285,20200201,31412
20200129,6,합정,14747,14370,20200201,29117
20200129,6,상수,9497,10829,20200201,20326
20200129,6,광흥창,10527,10257,20200201,20784
20200129,6,대흥,9381,9697,20200201,19078
20200129,6,공덕,20916,20398,20200201,41314
20200129,6,효창공원앞,7663,6895,20200201,14558
20200129,6,삼각지,6676,5949,20200201,12625
20200129,6,녹사평,5258,5290,20200201,10548
20200129,6,이태원,11889,12554,20200201,24443
20200129,6,한강진,8037,9411,20200201,17448
20200129,6,버티고개,2496,2416,20200201,4912
20200129,6,약수,4185,4245,20200201,8430
20200129,6,청구,4241,4581,20200201,8822
20200129,6,신당,9741,10078,20200201,19819
20200129,6,동묘앞,9088,9290,20200201,18378
20200129,6,창신,3791,2991,20200201,6782
20200129,6,보문,8113,7553,20200201,15666
20200129,6,안암,11217,11283,20200201,22500
20200129,6,고려대,8557,8470,20200201,17027
20200129,6,월곡,12787,12566,20200201,25353
20200129,6,상월곡,6934,6268,20200201,13202
20200129,6,돌곶이,9405,8827,20200201,18232
20200129,6,석계,13876,14403,20200201,28279
20200129,6,태릉입구,5756,6661,20200201,12417
20200129,6,화랑대,13063,9972,20200201,23035
20200129,6,봉화산,10943,9717,20200201,20660
20200130,6,신내,1,0,20200202,1
20200130,6,봉화산,10876,9777,20200202,20653
20200130,6,화랑대,13290,9906,20200202,23196
20200130,6,태릉입구,5863,6689,20200202,12552
20200130,6,석계,14220,14351,20200202,28571
20200130,6,돌곶이,9594,8999,20200202,18593
20200130,6,상월곡,7421,6878,20200202,14299
20200130,6,월곡,12923,12621,20200202,25544
20200130,6,고려대,9058,8693,20200202,17751
20200130,6,안암,11594,11811,20200202,23405
20200130,6,보문,8127,7494,20200202,15621
20200130,6,창신,3765,2941,20200202,6706
20200130,6,동묘앞,8997,9310,20200202,18307
20200130,6,신당,9158,9619,20200202,18777
20200130,6,청구,4398,4721,20200202,9119
20200130,6,약수,4102,4187,20200202,8289
20200130,6,버티고개,2489,2443,20200202,4932
20200130,6,한강진,8161,9572,20200202,17733
20200130,6,이태원,11940,13027,20200202,24967
20200130,6,녹사평,5441,5444,20200202,10885
20200130,6,삼각지,6767,6000,20200202,12767
20200130,6,효창공원앞,7673,7035,20200202,14708
20200130,6,공덕,21135,20561,20200202,41696
20200130,6,대흥,9470,9927,20200202,19397
20200130,6,광흥창,10671,10476,20200202,21147
20200130,6,상수,9987,11346,20200202,21333
20200130,6,합정,14673,14321,20200202,28994
20200130,6,망원,15642,16889,20200202,32531
20200130,6,마포구청,15968,14320,20200202,30288
20200130,6,월드컵경기장,4752,5079,20200202,9831
20200130,6,디지털미디어시티,15490,16911,20200202,32401
20200130,6,증산,11121,10804,20200202,21925
20200130,6,새절,14287,13494,20200202,27781
20200130,6,구산,8575,6518,20200202,15093
20200130,6,연신내,1,0,20200202,1
20200130,6,독바위,3181,3269,20200202,6450
20200130,6,불광,4933,5066,20200202,9999
20200130,6,역촌,4182,4802,20200202,8984
20200130,6,응암,19267,19122,20200202,38389
20200131,6,응암,19467,18798,20200203,38265
20200131,6,역촌,4257,4836,20200203,9093
20200131,6,불광,5087,5089,20200203,10176
20200131,6,독바위,3172,3152,20200203,6324
20200131,6,구산,8686,6365,20200203,15051
20200131,6,새절,14655,13641,20200203,28296
20200131,6,증산,11395,10787,20200203,22182
20200131,6,디지털미디어시티,15619,16746,20200203,32365
20200131,6,월드컵경기장,4704,5093,20200203,9797
20200131,6,마포구청,16083,14210,20200203,30293
20200131,6,망원,15799,17316,20200203,33115
20200131,6,합정,15552,15315,20200203,30867
20200131,6,상수,10467,12427,20200203,22894
20200131,6,광흥창,10377,10194,20200203,20571
20200131,6,대흥,9567,9967,20200203,19534
20200131,6,공덕,21731,21387,20200203,43118
20200131,6,효창공원앞,8611,7774,20200203,16385
20200131,6,삼각지,7110,6009,20200203,13119
20200131,6,녹사평,5721,6052,20200203,11773
20200131,6,이태원,13334,17338,20200203,30672
20200131,6,한강진,8047,10084,20200203,18131
20200131,6,버티고개,2432,2319,20200203,4751
20200131,6,약수,4152,4343,20200203,8495
20200131,6,청구,4307,4722,20200203,9029
20200131,6,신당,9614,9974,20200203,19588
20200131,6,동묘앞,8963,9173,20200203,18136
20200131,6,창신,3878,2936,20200203,6814
20200131,6,보문,8121,7493,20200203,15614
20200131,6,안암,11219,10989,20200203,22208
20200131,6,고려대,8839,8599,20200203,17438
20200131,6,월곡,12796,12487,20200203,25283
20200131,6,상월곡,6923,6054,20200203,12977
20200131,6,돌곶이,9605,8937,20200203,18542
20200131,6,석계,14132,14201,20200203,28333
20200131,6,태릉입구,5885,6541,20200203,12426
20200131,6,화랑대,13145,9776,20200203,22921
20200131,6,봉화산,10724,9495,20200203,20219
20200201,6,응암,12720,12482,20200204,25202
20200201,6,역촌,2731,3063,20200204,5794
20200201,6,불광,4063,3774,20200204,7837
20200201,6,독바위,2042,2169,20200204,4211
20200201,6,연신내,1,0,20200204,1
20200201,6,구산,5437,4133,20200204,9570
20200201,6,새절,9385,8776,20200204,18161
20200201,6,증산,7580,7176,20200204,14756
20200201,6,디지털미디어시티,7343,7510,20200204,14853
20200201,6,월드컵경기장,3831,4069,20200204,7900
20200201,6,마포구청,9745,8420,20200204,18165
20200201,6,망원,11626,12562,20200204,24188
20200201,6,합정,12314,11781,20200204,24095
20200201,6,상수,8420,10689,20200204,19109
20200201,6,광흥창,5708,5120,20200204,10828
20200201,6,대흥,5827,5915,20200204,11742
20200201,6,공덕,10982,10409,20200204,21391
20200201,6,효창공원앞,4729,4097,20200204,8826
20200201,6,삼각지,4686,3633,20200204,8319
20200201,6,녹사평,5078,5753,20200204,10831
20200201,6,이태원,14142,17703,20200204,31845
20200201,6,한강진,7436,8784,20200204,16220
20200201,6,버티고개,1446,1502,20200204,2948
20200201,6,약수,2558,2525,20200204,5083
20200201,6,청구,2494,2637,20200204,5131
20200201,6,신당,6965,5780,20200204,12745
20200201,6,동묘앞,7418,6913,20200204,14331
20200201,6,창신,2128,1726,20200204,3854
20200201,6,보문,5217,4628,20200204,9845
20200201,6,안암,6580,6539,20200204,13119
20200201,6,고려대,5356,5039,20200204,10395
20200201,6,월곡,7691,7438,20200204,15129
20200201,6,상월곡,3987,3484,20200204,7471
20200201,6,돌곶이,5853,5406,20200204,11259
20200201,6,석계,9055,8925,20200204,17980
20200201,6,태릉입구,3927,4310,20200204,8237
20200201,6,화랑대,7233,5621,20200204,12854
20200201,6,봉화산,5779,5439,20200204,11218
20200202,6,응암,9290,9397,20200205,18687
20200202,6,역촌,1939,2384,20200205,4323
20200202,6,불광,3064,2772,20200205,5836
20200202,6,독바위,1458,1857,20200205,3315
20200202,6,연신내,1,0,20200205,1
20200202,6,구산,3780,2928,20200205,6708
20200202,6,새절,6942,6704,20200205,13646
20200202,6,증산,5510,5581,20200205,11091
20200202,6,디지털미디어시티,5301,5491,20200205,10792
20200202,6,월드컵경기장,3001,3084,20200205,6085
20200202,6,마포구청,6896,6360,20200205,13256
20200202,6,망원,8652,9345,20200205,17997
20200202,6,합정,9538,8537,20200205,18075
20200202,6,상수,6243,7013,20200205,13256
20200202,6,광흥창,4126,3960,20200205,8086
20200202,6,대흥,3769,3907,20200205,7676
20200202,6,공덕,6877,6683,20200205,13560
20200202,6,효창공원앞,3183,2779,20200205,5962
20200202,6,삼각지,3260,2599,20200205,5859
20200202,6,녹사평,4025,3834,20200205,7859
20200202,6,이태원,11879,10214,20200205,22093
20200202,6,한강진,5161,5871,20200205,11032
20200202,6,버티고개,998,1095,20200205,2093
20200202,6,약수,1653,1721,20200205,3374
20200202,6,청구,1668,1753,20200205,3421
20200202,6,신당,3932,4632,20200205,8564
20200202,6,동묘앞,5536,5289,20200205,10825
20200202,6,창신,1664,1503,20200205,3167
20200202,6,보문,3986,3669,20200205,7655
20200202,6,안암,4864,4972,20200205,9836
20200202,6,고려대,3904,3790,20200205,7694
20200202,6,월곡,5536,5457,20200205,10993
20200202,6,상월곡,3084,2869,20200205,5953
20200202,6,돌곶이,4135,4127,20200205,8262
20200202,6,석계,6406,6404,20200205,12810
20200202,6,태릉입구,2921,3230,20200205,6151
20200202,6,화랑대,4968,4340,20200205,9308
20200202,6,봉화산,4115,4005,20200205,8120
20200202,6,신내,1,0,20200205,1
20200203,6,응암,18421,18370,20200206,36791
20200203,6,역촌,4088,4632,20200206,8720
20200203,6,불광,4251,4524,20200206,8775
20200203,6,독바위,2913,3121,20200206,6034
20200203,6,구산,8194,6190,20200206,14384
20200203,6,새절,13724,12920,20200206,26644
20200203,6,증산,10470,10110,20200206,20580
20200203,6,디지털미디어시티,14731,16240,20200206,30971
20200203,6,월드컵경기장,4099,4478,20200206,8577
20200203,6,마포구청,15359,13867,20200206,29226
20200203,6,망원,14224,15305,20200206,29529
20200203,6,합정,13282,12835,20200206,26117
20200203,6,상수,8877,9510,20200206,18387
20200203,6,광흥창,10002,9882,20200206,19884
20200203,6,대흥,9094,9587,20200206,18681
20200203,6,공덕,20434,19871,20200206,40305
20200203,6,효창공원앞,7347,6601,20200206,13948
20200203,6,삼각지,5741,5166,20200206,10907
20200203,6,녹사평,5152,5058,20200206,10210
20200203,6,이태원,11196,11461,20200206,22657
20200203,6,한강진,6600,7860,20200206,14460
20200203,6,버티고개,2431,2345,20200206,4776
20200203,6,약수,3736,3932,20200206,7668
20200203,6,청구,4004,4457,20200206,8461
20200203,6,신당,8404,8911,20200206,17315
20200203,6,동묘앞,8303,8728,20200206,17031
20200203,6,창신,3680,2958,20200206,6638
20200203,6,보문,7636,6947,20200206,14583
20200203,6,안암,10752,10732,20200206,21484
20200203,6,고려대,8419,8140,20200206,16559
20200203,6,월곡,12294,12093,20200206,24387
20200203,6,상월곡,6316,5621,20200206,11937
20200203,6,돌곶이,9319,8659,20200206,17978
20200203,6,석계,13127,13785,20200206,26912
20200203,6,태릉입구,5475,6229,20200206,11704
20200203,6,화랑대,12834,9876,20200206,22710
20200203,6,봉화산,10257,9106,20200206,19363
20200203,6,신내,2,0,20200206,2
20200204,6,응암,18336,18559,20200207,36895
20200204,6,역촌,4051,4736,20200207,8787
20200204,6,불광,4685,4660,20200207,9345
20200204,6,독바위,3007,3244,20200207,6251
20200204,6,연신내,1,0,20200207,1
20200204,6,구산,8130,6312,20200207,14442
20200204,6,새절,13778,13123,20200207,26901
20200204,6,증산,10663,10442,20200207,21105
20200204,6,디지털미디어시티,14881,16598,20200207,31479
20200204,6,월드컵경기장,4108,4391,20200207,8499
20200204,6,마포구청,15462,13963,20200207,29425
20200204,6,망원,14800,16082,20200207,30882
20200204,6,합정,14115,13588,20200207,27703
20200204,6,상수,9402,10385,20200207,19787
20200204,6,광흥창,10232,10093,20200207,20325
20200204,6,대흥,9155,9593,20200207,18748
20200204,6,공덕,20380,19970,20200207,40350
20200204,6,효창공원앞,7459,6830,20200207,14289
20200204,6,삼각지,6163,5474,20200207,11637
20200204,6,녹사평,5263,5253,20200207,10516
20200204,6,이태원,10906,11541,20200207,22447
20200204,6,한강진,7822,9040,20200207,16862
20200204,6,버티고개,2399,2342,20200207,4741
20200204,6,약수,3875,3983,20200207,7858
20200204,6,청구,4097,4488,20200207,8585
20200204,6,신당,9045,9570,20200207,18615
20200204,6,동묘앞,8294,8679,20200207,16973
20200204,6,창신,3823,3055,20200207,6878
20200204,6,보문,7978,7360,20200207,15338
20200204,6,안암,10994,10849,20200207,21843
20200204,6,고려대,8392,8322,20200207,16714
20200204,6,월곡,12070,11856,20200207,23926
20200204,6,상월곡,6438,5774,20200207,12212
20200204,6,돌곶이,8996,8584,20200207,17580
20200204,6,석계,13264,13745,20200207,27009
20200204,6,태릉입구,5544,6200,20200207,11744
20200204,6,화랑대,12380,9609,20200207,21989
20200204,6,봉화산,10354,9201,20200207,19555
20200205,6,응암,17923,17798,20200208,35721
20200205,6,역촌,3977,4569,20200208,8546
20200205,6,불광,4592,4639,20200208,9231
20200205,6,독바위,2928,3069,20200208,5997
20200205,6,구산,7787,6111,20200208,13898
20200205,6,새절,13385,12733,20200208,26118
20200205,6,증산,10282,10020,20200208,20302
20200205,6,디지털미디어시티,14525,16138,20200208,30663
20200205,6,월드컵경기장,4139,4463,20200208,8602
20200205,6,마포구청,15012,13495,20200208,28507
20200205,6,망원,14293,15423,20200208,29716
20200205,6,합정,14074,13351,20200208,27425
20200205,6,상수,9118,10156,20200208,19274
20200205,6,광흥창,9895,9877,20200208,19772
20200205,6,대흥,8787,9283,20200208,18070
20200205,6,공덕,19900,19543,20200208,39443
20200205,6,효창공원앞,7191,6520,20200208,13711
20200205,6,삼각지,6110,5390,20200208,11500
20200205,6,녹사평,5196,5331,20200208,10527
20200205,6,이태원,11026,11382,20200208,22408
20200205,6,한강진,7396,8751,20200208,16147
20200205,6,버티고개,2389,2266,20200208,4655
20200205,6,약수,3806,3791,20200208,7597
20200205,6,청구,3951,4450,20200208,8401
20200205,6,신당,9422,9689,20200208,19111
20200205,6,동묘앞,7866,8236,20200208,16102
20200205,6,창신,3783,2999,20200208,6782
20200205,6,보문,7563,7038,20200208,14601
20200205,6,안암,10569,10561,20200208,21130
20200205,6,고려대,8166,8015,20200208,16181
20200205,6,월곡,11792,11594,20200208,23386
20200205,6,상월곡,6292,5576,20200208,11868
20200205,6,돌곶이,8951,8436,20200208,17387
20200205,6,석계,12884,13380,20200208,26264
20200205,6,태릉입구,5273,5881,20200208,11154
20200205,6,화랑대,12102,9164,20200208,21266
20200205,6,봉화산,9913,8962,20200208,18875
20200206,6,응암,17617,17560,20200209,35177
20200206,6,역촌,3874,4509,20200209,8383
20200206,6,불광,4403,4496,20200209,8899
20200206,6,독바위,2912,3022,20200209,5934
20200206,6,연신내,2,0,20200209,2
20200206,6,구산,8054,6187,20200209,14241
20200206,6,새절,13299,12565,20200209,25864
20200206,6,증산,10360,9957,20200209,20317
20200206,6,디지털미디어시티,14497,16012,20200209,30509
20200206,6,월드컵경기장,4130,4395,20200209,8525
20200206,6,마포구청,14920,13146,20200209,28066
20200206,6,망원,14252,15625,20200209,29877
20200206,6,합정,14040,13314,20200209,27354
20200206,6,상수,9392,10476,20200209,19868
20200206,6,광흥창,9738,9592,20200209,19330
20200206,6,대흥,8763,9306,20200209,18069
20200206,6,공덕,20066,19511,20200209,39577
20200206,6,효창공원앞,7158,6567,20200209,13725
20200206,6,삼각지,6259,5460,20200209,11719
20200206,6,녹사평,5120,5173,20200209,10293
20200206,6,이태원,11213,12196,20200209,23409
20200206,6,한강진,7502,8770,20200209,16272
20200206,6,버티고개,2298,2197,20200209,4495
20200206,6,약수,3847,3820,20200209,7667
20200206,6,청구,3951,4393,20200209,8344
20200206,6,신당,8805,9217,20200209,18022
20200206,6,동묘앞,7844,8361,20200209,16205
20200206,6,창신,3650,2828,20200209,6478
20200206,6,보문,7479,6865,20200209,14344
20200206,6,안암,10240,10204,20200209,20444
20200206,6,고려대,8135,7906,20200209,16041
20200206,6,월곡,11847,11505,20200209,23352
20200206,6,상월곡,6226,5621,20200209,11847
20200206,6,돌곶이,8781,8173,20200209,16954
20200206,6,석계,12760,13040,20200209,25800
20200206,6,태릉입구,5250,5880,20200209,11130
20200206,6,화랑대,11851,9025,20200209,20876
20200206,6,봉화산,9924,8859,20200209,18783
20200207,6,응암,18747,17993,20200210,36740
20200207,6,역촌,4014,4597,20200210,8611
20200207,6,불광,4720,4761,20200210,9481
20200207,6,독바위,3038,3028,20200210,6066
20200207,6,연신내,2,0,20200210,2
20200207,6,구산,8145,6000,20200210,14145
20200207,6,새절,13856,12921,20200210,26777
20200207,6,증산,10660,10098,20200210,20758
20200207,6,디지털미디어시티,14762,16167,20200210,30929
20200207,6,월드컵경기장,4328,4612,20200210,8940
20200207,6,마포구청,15298,13460,20200210,28758
20200207,6,망원,15079,16563,20200210,31642
20200207,6,합정,15083,14755,20200210,29838
20200207,6,상수,10063,12138,20200210,22201
20200207,6,광흥창,10019,9857,20200210,19876
20200207,6,대흥,9061,9497,20200210,18558
20200207,6,공덕,20399,20134,20200210,40533
20200207,6,효창공원앞,7483,6708,20200210,14191
20200207,6,삼각지,6599,5718,20200210,12317
20200207,6,녹사평,5423,5825,20200210,11248
20200207,6,이태원,13140,16903,20200210,30043
20200207,6,한강진,8054,9771,20200210,17825
20200207,6,버티고개,2472,2325,20200210,4797
20200207,6,약수,3958,3987,20200210,7945
20200207,6,청구,3968,4518,20200210,8486
20200207,6,신당,9753,10260,20200210,20013
20200207,6,동묘앞,8283,8571,20200210,16854
20200207,6,창신,3765,2880,20200210,6645
20200207,6,보문,7773,7003,20200210,14776
20200207,6,안암,10617,10422,20200210,21039
20200207,6,고려대,8367,8041,20200210,16408
20200207,6,월곡,12256,11783,20200210,24039
20200207,6,상월곡,6339,5541,20200210,11880
20200207,6,돌곶이,9052,8393,20200210,17445
20200207,6,석계,13337,13502,20200210,26839
20200207,6,태릉입구,5634,6137,20200210,11771
20200207,6,화랑대,12324,9185,20200210,21509
20200207,6,봉화산,10169,8958,20200210,19127
20200208,6,응암,12371,12229,20200211,24600
20200208,6,역촌,2895,3129,20200211,6024
20200208,6,불광,3786,3535,20200211,7321
20200208,6,독바위,2011,2227,20200211,4238
20200208,6,연신내,1,0,20200211,1
20200208,6,구산,5208,3846,20200211,9054
20200208,6,새절,8835,8463,20200211,17298
20200208,6,증산,7539,7097,20200211,14636
20200208,6,디지털미디어시티,7098,7505,20200211,14603
20200208,6,월드컵경기장,3777,4056,20200211,7833
20200208,6,마포구청,9104,7883,20200211,16987
20200208,6,망원,11381,12724,20200211,24105
20200208,6,합정,12021,11368,20200211,23389
20200208,6,상수,8453,10358,20200211,18811
20200208,6,광흥창,5282,4862,20200211,10144
20200208,6,대흥,5246,5095,20200211,10341
20200208,6,공덕,9644,9096,20200211,18740
20200208,6,효창공원앞,4495,3907,20200211,8402
20200208,6,삼각지,4926,3680,20200211,8606
20200208,6,녹사평,5062,5626,20200211,10688
20200208,6,이태원,14452,18295,20200211,32747
20200208,6,한강진,7228,8952,20200211,16180
20200208,6,버티고개,1472,1488,20200211,2960
20200208,6,약수,2514,2516,20200211,5030
20200208,6,청구,2267,2481,20200211,4748
20200208,6,신당,6775,5357,20200211,12132
20200208,6,동묘앞,7027,6661,20200211,13688
20200208,6,창신,2190,1793,20200211,3983
20200208,6,보문,5390,4828,20200211,10218
20200208,6,안암,6739,6570,20200211,13309
20200208,6,고려대,5324,5061,20200211,10385
20200208,6,월곡,7312,7169,20200211,14481
20200208,6,상월곡,3835,3337,20200211,7172
20200208,6,돌곶이,5655,5232,20200211,10887
20200208,6,석계,8694,8581,20200211,17275
20200208,6,태릉입구,3825,4114,20200211,7939
20200208,6,화랑대,6941,5740,20200211,12681
20200208,6,봉화산,5535,5103,20200211,10638
20200209,6,응암,8955,8822,20200212,17777
20200209,6,역촌,1985,2290,20200212,4275
20200209,6,불광,3053,2871,20200212,5924
20200209,6,독바위,1517,1856,20200212,3373
20200209,6,구산,3745,2899,20200212,6644
20200209,6,새절,6524,6492,20200212,13016
20200209,6,증산,5591,5476,20200212,11067
20200209,6,디지털미디어시티,5058,5336,20200212,10394
20200209,6,월드컵경기장,2562,2615,20200212,5177
20200209,6,마포구청,6788,6200,20200212,12988
20200209,6,망원,8508,9029,20200212,17537
20200209,6,합정,9463,8692,20200212,18155
20200209,6,상수,6396,7338,20200212,13734
20200209,6,광흥창,4183,3952,20200212,8135
20200209,6,대흥,3616,3799,20200212,7415
20200209,6,공덕,6442,6187,20200212,12629
20200209,6,효창공원앞,3218,2834,20200212,6052
20200209,6,삼각지,3094,2335,20200212,5429
20200209,6,녹사평,3973,3965,20200212,7938
20200209,6,이태원,12598,10909,20200212,23507
20200209,6,한강진,5889,6597,20200212,12486
20200209,6,버티고개,1051,1132,20200212,2183
20200209,6,약수,1683,1758,20200212,3441
20200209,6,청구,1516,1560,20200212,3076
20200209,6,신당,4193,4898,20200212,9091
20200209,6,동묘앞,5626,5411,20200212,11037
20200209,6,창신,1599,1461,20200212,3060
20200209,6,보문,4079,3748,20200212,7827
20200209,6,안암,4690,4877,20200212,9567
20200209,6,고려대,3738,3812,20200212,7550
20200209,6,월곡,5272,5201,20200212,10473
20200209,6,상월곡,3149,2892,20200212,6041
20200209,6,돌곶이,4150,3836,20200212,7986
20200209,6,석계,6457,6431,20200212,12888
20200209,6,태릉입구,2694,3074,20200212,5768
20200209,6,화랑대,4809,4131,20200212,8940
20200209,6,봉화산,4003,3815,20200212,7818
20200210,6,응암,18341,18161,20200213,36502
20200210,6,역촌,4037,4639,20200213,8676
20200210,6,불광,4522,4612,20200213,9134
20200210,6,독바위,2840,2995,20200213,5835
20200210,6,연신내,1,0,20200213,1
20200210,6,구산,7797,5875,20200213,13672
20200210,6,새절,13685,12842,20200213,26527
20200210,6,증산,10585,10032,20200213,20617
20200210,6,디지털미디어시티,14951,16238,20200213,31189
20200210,6,월드컵경기장,4533,4734,20200213,9267
20200210,6,마포구청,14797,13248,20200213,28045
20200210,6,망원,14127,15383,20200213,29510
20200210,6,합정,13748,13297,20200213,27045
20200210,6,상수,9035,10094,20200213,19129
20200210,6,광흥창,9798,9417,20200213,19215
20200210,6,대흥,8624,8983,20200213,17607
20200210,6,공덕,19555,18999,20200213,38554
20200210,6,효창공원앞,7367,6597,20200213,13964
20200210,6,삼각지,5722,5048,20200213,10770
20200210,6,녹사평,5161,5091,20200213,10252
20200210,6,이태원,11639,11857,20200213,23496
20200210,6,한강진,6946,8194,20200213,15140
20200210,6,버티고개,2480,2343,20200213,4823
20200210,6,약수,3804,3916,20200213,7720
20200210,6,청구,3933,4373,20200213,8306
20200210,6,신당,8351,9078,20200213,17429
20200210,6,동묘앞,8580,8671,20200213,17251
20200210,6,창신,3671,2892,20200213,6563
20200210,6,보문,7614,7096,20200213,14710
20200210,6,안암,10666,10962,20200213,21628
20200210,6,고려대,8329,8010,20200213,16339
20200210,6,월곡,12350,12022,20200213,24372
20200210,6,상월곡,6242,5543,20200213,11785
20200210,6,돌곶이,8935,8474,20200213,17409
20200210,6,석계,12906,13485,20200213,26391
20200210,6,태릉입구,5471,6104,20200213,11575
20200210,6,화랑대,12232,9110,20200213,21342
20200210,6,봉화산,9975,9035,20200213,19010
20200211,6,응암,18850,18444,20200214,37294
20200211,6,역촌,4090,4759,20200214,8849
20200211,6,불광,4654,4743,20200214,9397
20200211,6,독바위,3042,3153,20200214,6195
20200211,6,구산,7898,5994,20200214,13892
20200211,6,새절,13958,13133,20200214,27091
20200211,6,증산,10761,10360,20200214,21121
20200211,6,디지털미디어시티,15127,16690,20200214,31817
20200211,6,월드컵경기장,4841,5139,20200214,9980
20200211,6,마포구청,15510,13669,20200214,29179
20200211,6,망원,14948,16237,20200214,31185
20200211,6,합정,14217,13970,20200214,28187
20200211,6,상수,9315,10679,20200214,19994
20200211,6,광흥창,9606,9491,20200214,19097
20200211,6,대흥,8547,8909,20200214,17456
20200211,6,공덕,20091,19814,20200214,39905
20200211,6,효창공원앞,7303,6757,20200214,14060
20200211,6,삼각지,6328,5525,20200214,11853
20200211,6,녹사평,5576,5627,20200214,11203
20200211,6,이태원,12005,12492,20200214,24497
20200211,6,한강진,7811,9146,20200214,16957
20200211,6,버티고개,2471,2355,20200214,4826
20200211,6,약수,3977,4005,20200214,7982
20200211,6,청구,4070,4473,20200214,8543
20200211,6,신당,9288,9661,20200214,18949
20200211,6,동묘앞,8806,8885,20200214,17691
20200211,6,창신,3730,2881,20200214,6611
20200211,6,보문,7861,7077,20200214,14938
20200211,6,안암,11082,11130,20200214,22212
20200211,6,고려대,8506,8174,20200214,16680
20200211,6,월곡,12278,12023,20200214,24301
20200211,6,상월곡,6445,5706,20200214,12151
20200211,6,돌곶이,9137,8559,20200214,17696
20200211,6,석계,13267,13599,20200214,26866
20200211,6,태릉입구,5597,6485,20200214,12082
20200211,6,화랑대,12511,9405,20200214,21916
20200211,6,봉화산,10423,9299,20200214,19722
20200212,6,응암,18023,17956,20200215,35979
20200212,6,역촌,4035,4649,20200215,8684
20200212,6,불광,4833,4768,20200215,9601
20200212,6,독바위,2881,2972,20200215,5853
20200212,6,구산,7795,5918,20200215,13713
20200212,6,새절,13576,12822,20200215,26398
20200212,6,증산,10509,10072,20200215,20581
20200212,6,디지털미디어시티,14555,16082,20200215,30637
20200212,6,월드컵경기장,4319,4612,20200215,8931
20200212,6,마포구청,15033,13573,20200215,28606
20200212,6,망원,14423,15707,20200215,30130
20200212,6,합정,14115,13630,20200215,27745
20200212,6,상수,9352,10392,20200215,19744
20200212,6,광흥창,9723,9517,20200215,19240
20200212,6,대흥,8465,8863,20200215,17328
20200212,6,공덕,19702,19267,20200215,38969
20200212,6,효창공원앞,7155,6445,20200215,13600
20200212,6,삼각지,6181,5582,20200215,11763
20200212,6,녹사평,5261,5169,20200215,10430
20200212,6,이태원,11345,11850,20200215,23195
20200212,6,한강진,7510,8875,20200215,16385
20200212,6,버티고개,2348,2211,20200215,4559
20200212,6,약수,3876,3887,20200215,7763
20200212,6,청구,4029,4490,20200215,8519
20200212,6,신당,9768,9980,20200215,19748
20200212,6,동묘앞,7947,8229,20200215,16176
20200212,6,창신,3727,2912,20200215,6639
20200212,6,보문,7686,7100,20200215,14786
20200212,6,안암,10551,10638,20200215,21189
20200212,6,고려대,8348,8056,20200215,16404
20200212,6,월곡,12039,11749,20200215,23788
20200212,6,상월곡,6251,5533,20200215,11784
20200212,6,돌곶이,8912,8476,20200215,17388
20200212,6,석계,13042,13505,20200215,26547
20200212,6,태릉입구,5442,6292,20200215,11734
20200212,6,화랑대,12387,9296,20200215,21683
20200212,6,봉화산,10087,9111,20200215,19198
20200213,6,응암,18885,18497,20200216,37382
20200213,6,역촌,4196,4751,20200216,8947
20200213,6,불광,4858,4866,20200216,9724
20200213,6,독바위,2960,3049,20200216,6009
20200213,6,연신내,2,0,20200216,2
20200213,6,구산,7940,6120,20200216,14060
20200213,6,새절,14041,13190,20200216,27231
20200213,6,증산,10877,10320,20200216,21197
20200213,6,디지털미디어시티,14999,16504,20200216,31503
20200213,6,월드컵경기장,4844,5161,20200216,10005
20200213,6,마포구청,15356,13739,20200216,29095
20200213,6,망원,15205,16497,20200216,31702
20200213,6,합정,14826,14490,20200216,29316
20200213,6,상수,9880,11247,20200216,21127
20200213,6,광흥창,10007,9645,20200216,19652
20200213,6,대흥,8568,8972,20200216,17540
20200213,6,공덕,20405,19793,20200216,40198
20200213,6,효창공원앞,7466,6711,20200216,14177
20200213,6,삼각지,6451,5756,20200216,12207
20200213,6,녹사평,5660,5709,20200216,11369
20200213,6,이태원,12616,13973,20200216,26589
20200213,6,한강진,8684,10260,20200216,18944
20200213,6,버티고개,2462,2393,20200216,4855
20200213,6,약수,4006,4037,20200216,8043
20200213,6,청구,4096,4551,20200216,8647
20200213,6,신당,9522,9714,20200216,19236
20200213,6,동묘앞,8714,8852,20200216,17566
20200213,6,창신,3726,2805,20200216,6531
20200213,6,보문,7961,7292,20200216,15253
20200213,6,안암,11032,11091,20200216,22123
20200213,6,고려대,8590,8237,20200216,16827
20200213,6,월곡,12606,12155,20200216,24761
20200213,6,상월곡,6505,5799,20200216,12304
20200213,6,돌곶이,9320,8761,20200216,18081
20200213,6,석계,13570,13936,20200216,27506
20200213,6,태릉입구,5799,6485,20200216,12284
20200213,6,화랑대,12649,9320,20200216,21969
20200213,6,봉화산,10435,9439,20200216,19874
20200214,6,응암,19748,19025,20200217,38773
20200214,6,역촌,4210,4884,20200217,9094
20200214,6,불광,5165,5090,20200217,10255
20200214,6,독바위,3128,3175,20200217,6303
20200214,6,구산,8419,6147,20200217,14566
20200214,6,새절,14458,13347,20200217,27805
20200214,6,증산,11282,10517,20200217,21799
20200214,6,디지털미디어시티,15570,16567,20200217,32137
20200214,6,월드컵경기장,5262,5580,20200217,10842
20200214,6,마포구청,15730,13701,20200217,29431
20200214,6,망원,16134,17903,20200217,34037
20200214,6,합정,16276,15915,20200217,32191
20200214,6,상수,11104,13703,20200217,24807
20200214,6,광흥창,10198,9823,20200217,20021
20200214,6,대흥,9022,9199,20200217,18221
20200214,6,공덕,21125,20857,20200217,41982
20200214,6,효창공원앞,7719,6773,20200217,14492
20200214,6,삼각지,7166,5869,20200217,13035
20200214,6,녹사평,6499,7047,20200217,13546
20200214,6,이태원,16065,21738,20200217,37803
20200214,6,한강진,8605,10795,20200217,19400
20200214,6,버티고개,2580,2347,20200217,4927
20200214,6,약수,4125,4250,20200217,8375
20200214,6,청구,4263,4528,20200217,8791
20200214,6,신당,9976,10206,20200217,20182
20200214,6,동묘앞,9043,9280,20200217,18323
20200214,6,창신,3760,2813,20200217,6573
20200214,6,보문,8213,7388,20200217,15601
20200214,6,안암,11433,11478,20200217,22911
20200214,6,고려대,8997,8342,20200217,17339
20200214,6,월곡,12800,12257,20200217,25057
20200214,6,상월곡,6597,5784,20200217,12381
20200214,6,돌곶이,9434,8736,20200217,18170
20200214,6,석계,14120,14238,20200217,28358
20200214,6,태릉입구,5883,6700,20200217,12583
20200214,6,화랑대,13011,9589,20200217,22600
20200214,6,봉화산,10843,9390,20200217,20233
20200215,6,응암,13463,13261,20200218,26724
20200215,6,역촌,2874,3305,20200218,6179
20200215,6,불광,4379,4023,20200218,8402
20200215,6,독바위,2181,2384,20200218,4565
20200215,6,구산,5706,4275,20200218,9981
20200215,6,새절,9772,9325,20200218,19097
20200215,6,증산,7924,7413,20200218,15337
20200215,6,디지털미디어시티,7848,7912,20200218,15760
20200215,6,월드컵경기장,4469,4590,20200218,9059
20200215,6,마포구청,9821,8445,20200218,18266
20200215,6,망원,12546,14016,20200218,26562
20200215,6,합정,13394,12692,20200218,26086
20200215,6,상수,9586,11646,20200218,21232
20200215,6,광흥창,5322,5009,20200218,10331
20200215,6,대흥,5405,5409,20200218,10814
20200215,6,공덕,11077,10613,20200218,21690
20200215,6,효창공원앞,4813,4069,20200218,8882
20200215,6,삼각지,5482,4009,20200218,9491
20200215,6,녹사평,5651,6585,20200218,12236
20200215,6,이태원,17841,22887,20200218,40728
20200215,6,한강진,7696,9563,20200218,17259
20200215,6,버티고개,1640,1668,20200218,3308
20200215,6,약수,2678,2741,20200218,5419
20200215,6,청구,2537,2761,20200218,5298
20200215,6,신당,7215,5799,20200218,13014
20200215,6,동묘앞,8346,7798,20200218,16144
20200215,6,창신,2346,1818,20200218,4164
20200215,6,보문,5609,4980,20200218,10589
20200215,6,안암,7448,7384,20200218,14832
20200215,6,고려대,5843,5576,20200218,11419
20200215,6,월곡,8074,7830,20200218,15904
20200215,6,상월곡,4122,3482,20200218,7604
20200215,6,돌곶이,6182,5661,20200218,11843
20200215,6,석계,9452,9554,20200218,19006
20200215,6,태릉입구,4293,4573,20200218,8866
20200215,6,화랑대,7611,6102,20200218,13713
20200215,6,봉화산,6351,5908,20200218,12259
20200216,6,응암,9495,9612,20200219,19107
20200216,6,역촌,2250,2475,20200219,4725
20200216,6,불광,3484,3120,20200219,6604
20200216,6,독바위,1413,1697,20200219,3110
20200216,6,연신내,1,0,20200219,1
20200216,6,구산,3996,3020,20200219,7016
20200216,6,새절,6871,6738,20200219,13609
20200216,6,증산,5670,5786,20200219,11456
20200216,6,디지털미디어시티,5246,5557,20200219,10803
20200216,6,월드컵경기장,3134,3282,20200219,6416
20200216,6,마포구청,7074,6331,20200219,13405
20200216,6,망원,8511,9204,20200219,17715
20200216,6,합정,9954,8881,20200219,18835
20200216,6,상수,7096,7932,20200219,15028
20200216,6,광흥창,4167,4073,20200219,8240
20200216,6,대흥,3780,3882,20200219,7662
20200216,6,공덕,6942,6920,20200219,13862
20200216,6,효창공원앞,3250,2943,20200219,6193
20200216,6,삼각지,3288,2604,20200219,5892
20200216,6,녹사평,3861,3882,20200219,7743
20200216,6,이태원,14237,11422,20200219,25659
20200216,6,한강진,5551,6255,20200219,11806
20200216,6,버티고개,1092,1165,20200219,2257
20200216,6,약수,1776,1737,20200219,3513
20200216,6,청구,1549,1695,20200219,3244
20200216,6,신당,4597,5068,20200219,9665
20200216,6,동묘앞,4860,5107,20200219,9967
20200216,6,창신,1690,1508,20200219,3198
20200216,6,보문,3991,3758,20200219,7749
20200216,6,안암,4806,4925,20200219,9731
20200216,6,고려대,4062,3974,20200219,8036
20200216,6,월곡,5607,5583,20200219,11190
20200216,6,상월곡,3244,2990,20200219,6234
20200216,6,돌곶이,4254,4112,20200219,8366
20200216,6,석계,6668,6684,20200219,13352
20200216,6,태릉입구,2733,3271,20200219,6004
20200216,6,화랑대,5252,4443,20200219,9695
20200216,6,봉화산,4510,4331,20200219,8841
20200217,6,응암,18649,18424,20200220,37073
20200217,6,역촌,4165,4816,20200220,8981
20200217,6,불광,4642,4669,20200220,9311
20200217,6,독바위,2969,3046,20200220,6015
20200217,6,연신내,1,0,20200220,1
20200217,6,구산,7789,6060,20200220,13849
20200217,6,새절,13657,12921,20200220,26578
20200217,6,증산,10669,10346,20200220,21015
20200217,6,디지털미디어시티,15055,16719,20200220,31774
20200217,6,월드컵경기장,4137,4390,20200220,8527
20200217,6,마포구청,15277,13616,20200220,28893
20200217,6,망원,14026,15227,20200220,29253
20200217,6,합정,13972,13282,20200220,27254
20200217,6,상수,9354,10200,20200220,19554
20200217,6,광흥창,9958,9770,20200220,19728
20200217,6,대흥,8892,9256,20200220,18148
20200217,6,공덕,20123,19769,20200220,39892
20200217,6,효창공원앞,7410,6722,20200220,14132
20200217,6,삼각지,5995,5258,20200220,11253
20200217,6,녹사평,4861,4867,20200220,9728
20200217,6,이태원,11633,11714,20200220,23347
20200217,6,한강진,6696,7799,20200220,14495
20200217,6,버티고개,2557,2390,20200220,4947
20200217,6,약수,3915,4013,20200220,7928
20200217,6,청구,4254,4541,20200220,8795
20200217,6,신당,9162,9545,20200220,18707
20200217,6,동묘앞,7735,8088,20200220,15823
20200217,6,창신,3703,3036,20200220,6739
20200217,6,보문,7790,7206,20200220,14996
20200217,6,안암,10587,10516,20200220,21103
20200217,6,고려대,8651,8483,20200220,17134
20200217,6,월곡,12312,12097,20200220,24409
20200217,6,상월곡,6408,5697,20200220,12105
20200217,6,돌곶이,9287,8593,20200220,17880
20200217,6,석계,13020,13770,20200220,26790
20200217,6,태릉입구,5374,6137,20200220,11511
20200217,6,화랑대,12356,9570,20200220,21926
20200217,6,봉화산,10303,9310,20200220,19613
20200218,6,응암,18442,18381,20200221,36823
20200218,6,역촌,4052,4663,20200221,8715
20200218,6,불광,4826,4640,20200221,9466
20200218,6,독바위,3014,3104,20200221,6118
20200218,6,연신내,2,0,20200221,2
20200218,6,구산,7854,5948,20200221,13802
20200218,6,새절,13682,12883,20200221,26565
20200218,6,증산,10773,10394,20200221,21167
20200218,6,디지털미디어시티,15012,16536,20200221,31548
20200218,6,월드컵경기장,6499,6818,20200221,13317
20200218,6,마포구청,15488,13732,20200221,29220
20200218,6,망원,14692,16216,20200221,30908
20200218,6,합정,14804,13925,20200221,28729
20200218,6,상수,9697,10837,20200221,20534
20200218,6,광흥창,9807,9656,20200221,19463
20200218,6,대흥,9105,9572,20200221,18677
20200218,6,공덕,20362,19928,20200221,40290
20200218,6,효창공원앞,7412,6703,20200221,14115
20200218,6,삼각지,6320,5636,20200221,11956
20200218,6,녹사평,5268,5395,20200221,10663
20200218,6,이태원,12068,12872,20200221,24940
20200218,6,한강진,7745,8932,20200221,16677
20200218,6,버티고개,2483,2382,20200221,4865
20200218,6,약수,4050,4167,20200221,8217
20200218,6,청구,4221,4439,20200221,8660
20200218,6,신당,9897,10235,20200221,20132
20200218,6,동묘앞,7871,8075,20200221,15946
20200218,6,창신,3681,2810,20200221,6491
20200218,6,보문,7619,7050,20200221,14669
20200218,6,안암,10397,10601,20200221,20998
20200218,6,고려대,8569,8198,20200221,16767
20200218,6,월곡,12042,11734,20200221,23776
20200218,6,상월곡,6372,5597,20200221,11969
20200218,6,돌곶이,8991,8401,20200221,17392
20200218,6,석계,13279,13794,20200221,27073
20200218,6,태릉입구,5513,6233,20200221,11746
20200218,6,화랑대,12396,9452,20200221,21848
20200218,6,봉화산,10372,9312,20200221,19684
20200218,6,신내,1,0,20200221,1
20200219,6,효창공원앞,7717,6909,20200222,14626
20200219,6,응암,18792,18479,20200222,37271
20200219,6,역촌,4158,4656,20200222,8814
20200219,6,불광,4836,4919,20200222,9755
20200219,6,독바위,2957,3050,20200222,6007
20200219,6,구산,7913,6004,20200222,13917
20200219,6,새절,13986,13013,20200222,26999
20200219,6,증산,10802,10544,20200222,21346
20200219,6,디지털미디어시티,14933,16356,20200222,31289
20200219,6,월드컵경기장,4567,4918,20200222,9485
20200219,6,마포구청,15437,13773,20200222,29210
20200219,6,망원,15090,16560,20200222,31650
20200219,6,합정,14589,14101,20200222,28690
20200219,6,상수,9656,10803,20200222,20459
20200219,6,광흥창,10174,9853,20200222,20027
20200219,6,대흥,8973,9284,20200222,18257
20200219,6,공덕,20736,20210,20200222,40946
20200219,6,삼각지,6590,5914,20200222,12504
20200219,6,녹사평,5585,5674,20200222,11259
20200219,6,이태원,12626,13407,20200222,26033
20200219,6,한강진,7804,9336,20200222,17140
20200219,6,버티고개,2464,2377,20200222,4841
20200219,6,약수,4016,4046,20200222,8062
20200219,6,청구,4178,4541,20200222,8719
20200219,6,신당,9897,10234,20200222,20131
20200219,6,동묘앞,7868,8079,20200222,15947
20200219,6,창신,3596,2844,20200222,6440
20200219,6,보문,7735,7111,20200222,14846
20200219,6,안암,10464,10390,20200222,20854
20200219,6,고려대,8574,8392,20200222,16966
20200219,6,월곡,12224,12075,20200222,24299
20200219,6,상월곡,6348,5592,20200222,11940
20200219,6,돌곶이,9125,8590,20200222,17715
20200219,6,석계,13534,13828,20200222,27362
20200219,6,태릉입구,5586,6279,20200222,11865
20200219,6,화랑대,12696,9569,20200222,22265
20200219,6,봉화산,10420,9289,20200222,19709
20200220,6,응암,18462,18208,20200223,36670
20200220,6,역촌,4134,4659,20200223,8793
20200220,6,불광,4818,4780,20200223,9598
20200220,6,독바위,2928,3097,20200223,6025
20200220,6,연신내,2,0,20200223,2
20200220,6,구산,7956,6104,20200223,14060
20200220,6,새절,13723,12715,20200223,26438
20200220,6,증산,10831,10522,20200223,21353
20200220,6,디지털미디어시티,14849,16114,20200223,30963
20200220,6,월드컵경기장,4616,4878,20200223,9494
20200220,6,마포구청,15269,13512,20200223,28781
20200220,6,망원,14956,16603,20200223,31559
20200220,6,합정,14758,14162,20200223,28920
20200220,6,상수,9594,10934,20200223,20528
20200220,6,광흥창,9671,9360,20200223,19031
20200220,6,대흥,8727,9169,20200223,17896
20200220,6,공덕,20387,19803,20200223,40190
20200220,6,효창공원앞,7349,6705,20200223,14054
20200220,6,삼각지,6526,5687,20200223,12213
20200220,6,녹사평,5538,5697,20200223,11235
20200220,6,이태원,12871,14260,20200223,27131
20200220,6,한강진,8627,9871,20200223,18498
20200220,6,버티고개,2466,2299,20200223,4765
20200220,6,약수,3940,3995,20200223,7935
20200220,6,청구,4133,4431,20200223,8564
20200220,6,신당,9263,9546,20200223,18809
20200220,6,동묘앞,7744,8043,20200223,15787
20200220,6,창신,3589,2761,20200223,6350
20200220,6,보문,7733,7000,20200223,14733
20200220,6,안암,10539,10435,20200223,20974
20200220,6,고려대,8654,8255,20200223,16909
20200220,6,월곡,12187,11951,20200223,24138
20200220,6,상월곡,6359,5610,20200223,11969
20200220,6,돌곶이,9115,8592,20200223,17707
20200220,6,석계,13156,13518,20200223,26674
20200220,6,태릉입구,5531,6224,20200223,11755
20200220,6,화랑대,12370,9347,20200223,21717
20200220,6,봉화산,10191,9218,20200223,19409
20200221,6,응암,17972,17529,20200224,35501
20200221,6,역촌,3926,4556,20200224,8482
20200221,6,불광,4434,4387,20200224,8821
20200221,6,독바위,2858,2961,20200224,5819
20200221,6,구산,7672,5748,20200224,13420
20200221,6,새절,13229,12271,20200224,25500
20200221,6,증산,10353,9899,20200224,20252
20200221,6,디지털미디어시티,14540,16019,20200224,30559
20200221,6,월드컵경기장,4517,4747,20200224,9264
20200221,6,마포구청,14989,13366,20200224,28355
20200221,6,망원,14588,15983,20200224,30571
20200221,6,합정,14486,14749,20200224,29235
20200221,6,상수,9948,11764,20200224,21712
20200221,6,광흥창,9449,9339,20200224,18788
20200221,6,대흥,8524,8939,20200224,17463
20200221,6,공덕,19861,20022,20200224,39883
20200221,6,효창공원앞,7295,6708,20200224,14003
20200221,6,삼각지,6446,5707,20200224,12153
20200221,6,녹사평,5611,5926,20200224,11537
20200221,6,이태원,14247,18344,20200224,32591
20200221,6,한강진,8109,9848,20200224,17957
20200221,6,버티고개,2413,2217,20200224,4630
20200221,6,약수,4162,3998,20200224,8160
20200221,6,청구,4038,4344,20200224,8382
20200221,6,신당,9333,9530,20200224,18863
20200221,6,동묘앞,7461,7662,20200224,15123
20200221,6,창신,3435,2697,20200224,6132
20200221,6,보문,7623,6987,20200224,14610
20200221,6,안암,10076,9879,20200224,19955
20200221,6,고려대,8536,8121,20200224,16657
20200221,6,월곡,12006,11582,20200224,23588
20200221,6,상월곡,6262,5442,20200224,11704
20200221,6,돌곶이,8898,8274,20200224,17172
20200221,6,석계,13144,13424,20200224,26568
20200221,6,태릉입구,5542,6224,20200224,11766
20200221,6,화랑대,11917,8739,20200224,20656
20200221,6,봉화산,9944,8799,20200224,18743
20200222,6,응암,10963,10715,20200225,21678
20200222,6,역촌,2242,2583,20200225,4825
20200222,6,불광,3368,3059,20200225,6427
20200222,6,독바위,1618,1831,20200225,3449
20200222,6,구산,4638,3470,20200225,8108
20200222,6,새절,8036,7500,20200225,15536
20200222,6,증산,6524,6065,20200225,12589
20200222,6,디지털미디어시티,6176,6401,20200225,12577
20200222,6,월드컵경기장,3010,3275,20200225,6285
20200222,6,마포구청,8148,6964,20200225,15112
20200222,6,망원,10345,11475,20200225,21820
20200222,6,합정,10284,9975,20200225,20259
20200222,6,상수,7572,9232,20200225,16804
20200222,6,광흥창,4422,4192,20200225,8614
20200222,6,대흥,4579,4695,20200225,9274
20200222,6,공덕,9189,8901,20200225,18090
20200222,6,효창공원앞,3921,3417,20200225,7338
20200222,6,삼각지,4454,3547,20200225,8001
20200222,6,녹사평,4582,5248,20200225,9830
20200222,6,이태원,13256,17088,20200225,30344
20200222,6,한강진,6182,7586,20200225,13768
20200222,6,버티고개,1338,1312,20200225,2650
20200222,6,약수,2340,2324,20200225,4664
20200222,6,청구,2039,2249,20200225,4288
20200222,6,신당,6584,5358,20200225,11942
20200222,6,동묘앞,6296,5747,20200225,12043
20200222,6,창신,1820,1473,20200225,3293
20200222,6,보문,4784,4363,20200225,9147
20200222,6,안암,6320,6046,20200225,12366
20200222,6,고려대,5250,4975,20200225,10225
20200222,6,월곡,6798,6595,20200225,13393
20200222,6,상월곡,3534,3026,20200225,6560
20200222,6,돌곶이,5071,4753,20200225,9824
20200222,6,석계,7862,7714,20200225,15576
20200222,6,태릉입구,3347,3696,20200225,7043
20200222,6,화랑대,5805,4701,20200225,10506
20200222,6,봉화산,4836,4641,20200225,9477
20200223,6,응암,7162,7221,20200226,14383
20200223,6,역촌,1508,1824,20200226,3332
20200223,6,불광,2484,2283,20200226,4767
20200223,6,독바위,1185,1575,20200226,2760
20200223,6,구산,2971,2197,20200226,5168
20200223,6,새절,5172,5065,20200226,10237
20200223,6,증산,4351,4327,20200226,8678
20200223,6,디지털미디어시티,4134,4470,20200226,8604
20200223,6,월드컵경기장,2309,2285,20200226,4594
20200223,6,마포구청,5561,5023,20200226,10584
20200223,6,망원,7204,7690,20200226,14894
20200223,6,합정,7470,6772,20200226,14242
20200223,6,상수,5930,6561,20200226,12491
20200223,6,광흥창,3177,3029,20200226,6206
20200223,6,대흥,2909,3048,20200226,5957
20200223,6,공덕,5492,5188,20200226,10680
20200223,6,효창공원앞,2597,2283,20200226,4880
20200223,6,삼각지,2660,2144,20200226,4804
20200223,6,녹사평,3302,3419,20200226,6721
20200223,6,이태원,11403,9359,20200226,20762
20200223,6,한강진,4815,5366,20200226,10181
20200223,6,버티고개,863,891,20200226,1754
20200223,6,약수,1407,1433,20200226,2840
20200223,6,청구,1383,1413,20200226,2796
20200223,6,신당,3813,4503,20200226,8316
20200223,6,동묘앞,4026,4142,20200226,8168
20200223,6,창신,1290,1111,20200226,2401
20200223,6,보문,3409,3162,20200226,6571
20200223,6,안암,4795,4919,20200226,9714
20200223,6,고려대,3698,3821,20200226,7519
20200223,6,월곡,4447,4493,20200226,8940
20200223,6,상월곡,2600,2360,20200226,4960
20200223,6,돌곶이,3570,3444,20200226,7014
20200223,6,석계,5265,5317,20200226,10582
20200223,6,태릉입구,2361,2724,20200226,5085
20200223,6,화랑대,3925,3368,20200226,7293
20200223,6,봉화산,3293,3168,20200226,6461
20200224,6,응암,15547,15592,20200227,31139
20200224,6,역촌,3390,3973,20200227,7363
20200224,6,불광,3670,3852,20200227,7522
20200224,6,독바위,2387,2533,20200227,4920
20200224,6,구산,6674,4902,20200227,11576
20200224,6,새절,11676,10922,20200227,22598
20200224,6,증산,9224,8902,20200227,18126
20200224,6,디지털미디어시티,13117,14279,20200227,27396
20200224,6,월드컵경기장,3840,4061,20200227,7901
20200224,6,마포구청,12946,11517,20200227,24463
20200224,6,망원,12042,13132,20200227,25174
20200224,6,합정,11407,10920,20200227,22327
20200224,6,상수,7321,7999,20200227,15320
20200224,6,광흥창,8282,8092,20200227,16374
20200224,6,대흥,7346,7653,20200227,14999
20200224,6,공덕,17416,17181,20200227,34597
20200224,6,효창공원앞,6291,5710,20200227,12001
20200224,6,삼각지,4940,4416,20200227,9356
20200224,6,녹사평,4333,4255,20200227,8588
20200224,6,이태원,9448,9644,20200227,19092
20200224,6,한강진,5706,6757,20200227,12463
20200224,6,버티고개,2119,1979,20200227,4098
20200224,6,약수,3513,3507,20200227,7020
20200224,6,청구,3570,4021,20200227,7591
20200224,6,신당,7255,7826,20200227,15081
20200224,6,동묘앞,6595,6954,20200227,13549
20200224,6,창신,3110,2450,20200227,5560
20200224,6,보문,6798,6306,20200227,13104
20200224,6,안암,9229,9457,20200227,18686
20200224,6,고려대,7414,7364,20200227,14778
20200224,6,월곡,10764,10447,20200227,21211
20200224,6,상월곡,5590,4990,20200227,10580
20200224,6,돌곶이,8034,7575,20200227,15609
20200224,6,석계,11386,11960,20200227,23346
20200224,6,태릉입구,4866,5353,20200227,10219
20200224,6,화랑대,10608,8166,20200227,18774
20200224,6,봉화산,8811,7984,20200227,16795
20200225,6,응암,14643,14523,20200228,29166
20200225,6,역촌,3223,3683,20200228,6906
20200225,6,불광,3416,3623,20200228,7039
20200225,6,독바위,2342,2379,20200228,4721
20200225,6,구산,6120,4485,20200228,10605
20200225,6,새절,10943,10213,20200228,21156
20200225,6,증산,8804,8298,20200228,17102
20200225,6,디지털미디어시티,12288,13704,20200228,25992
20200225,6,월드컵경기장,3142,3431,20200228,6573
20200225,6,마포구청,12109,10916,20200228,23025
20200225,6,망원,11254,12172,20200228,23426
20200225,6,합정,10690,10523,20200228,21213
20200225,6,상수,6954,7855,20200228,14809
20200225,6,광흥창,7595,7385,20200228,14980
20200225,6,대흥,6584,6838,20200228,13422
20200225,6,공덕,16118,15990,20200228,32108
20200225,6,효창공원앞,5821,5213,20200228,11034
20200225,6,삼각지,4820,4421,20200228,9241
20200225,6,녹사평,3978,3946,20200228,7924
20200225,6,이태원,8438,8877,20200228,17315
20200225,6,한강진,5653,6483,20200228,12136
20200225,6,버티고개,1950,1825,20200228,3775
20200225,6,약수,3300,3181,20200228,6481
20200225,6,청구,3532,3797,20200228,7329
20200225,6,신당,7595,7920,20200228,15515
20200225,6,동묘앞,6118,6272,20200228,12390
20200225,6,창신,3074,2372,20200228,5446
20200225,6,보문,6363,5914,20200228,12277
20200225,6,안암,8791,8833,20200228,17624
20200225,6,고려대,6926,6751,20200228,13677
20200225,6,월곡,9933,9778,20200228,19711
20200225,6,상월곡,5253,4643,20200228,9896
20200225,6,돌곶이,7375,6977,20200228,14352
20200225,6,석계,10755,11061,20200228,21816
20200225,6,태릉입구,4482,5077,20200228,9559
20200225,6,화랑대,9895,7544,20200228,17439
20200225,6,봉화산,8312,7473,20200228,15785
20200226,6,응암,14747,14741,20200229,29488
20200226,6,역촌,3087,3629,20200229,6716
20200226,6,불광,3633,3798,20200229,7431
20200226,6,독바위,2309,2441,20200229,4750
20200226,6,구산,6147,4466,20200229,10613
20200226,6,새절,11144,10531,20200229,21675
20200226,6,증산,8725,8483,20200229,17208
20200226,6,디지털미디어시티,12361,13357,20200229,25718
20200226,6,월드컵경기장,3550,3789,20200229,7339
20200226,6,마포구청,12084,10774,20200229,22858
20200226,6,망원,11620,12383,20200229,24003
20200226,6,합정,10901,10687,20200229,21588
20200226,6,상수,6984,7808,20200229,14792
20200226,6,광흥창,7692,7624,20200229,15316
20200226,6,대흥,6458,6815,20200229,13273
20200226,6,공덕,16156,15841,20200229,31997
20200226,6,효창공원앞,5942,5238,20200229,11180
20200226,6,삼각지,4709,4205,20200229,8914
20200226,6,녹사평,4099,4256,20200229,8355
20200226,6,이태원,9154,9625,20200229,18779
20200226,6,한강진,5590,6675,20200229,12265
20200226,6,버티고개,1932,1808,20200229,3740
20200226,6,약수,3193,3136,20200229,6329
20200226,6,청구,3473,3828,20200229,7301
20200226,6,신당,7632,7878,20200229,15510
20200226,6,동묘앞,6572,6666,20200229,13238
20200226,6,창신,3056,2329,20200229,5385
20200226,6,보문,6366,5815,20200229,12181
20200226,6,안암,8560,8596,20200229,17156
20200226,6,고려대,6777,6659,20200229,13436
20200226,6,월곡,9962,9747,20200229,19709
20200226,6,상월곡,5321,4700,20200229,10021
20200226,6,돌곶이,7515,7297,20200229,14812
20200226,6,석계,10641,11015,20200229,21656
20200226,6,태릉입구,4531,5085,20200229,9616
20200226,6,화랑대,9804,7388,20200229,17192
20200226,6,봉화산,8300,7368,20200229,15668
20200227,6,응암,14518,14331,20200301,28849
20200227,6,역촌,3089,3673,20200301,6762
20200227,6,불광,3494,3486,20200301,6980
20200227,6,독바위,2297,2384,20200301,4681
20200227,6,구산,5996,4399,20200301,10395
20200227,6,새절,10651,9957,20200301,20608
20200227,6,증산,8589,8331,20200301,16920
20200227,6,디지털미디어시티,11875,13002,20200301,24877
20200227,6,월드컵경기장,3662,3859,20200301,7521
20200227,6,마포구청,11693,10635,20200301,22328
20200227,6,망원,11361,12345,20200301,23706
20200227,6,합정,10623,10541,20200301,21164
20200227,6,상수,6963,7643,20200301,14606
20200227,6,광흥창,7526,7358,20200301,14884
20200227,6,대흥,6387,6774,20200301,13161
20200227,6,공덕,15860,15588,20200301,31448
20200227,6,효창공원앞,5655,5109,20200301,10764
20200227,6,삼각지,4649,4113,20200301,8762
20200227,6,녹사평,4153,4180,20200301,8333
20200227,6,이태원,8623,9259,20200301,17882
20200227,6,한강진,5544,6425,20200301,11969
20200227,6,버티고개,1838,1751,20200301,3589
20200227,6,약수,3006,3202,20200301,6208
20200227,6,청구,3394,3711,20200301,7105
20200227,6,신당,7032,7354,20200301,14386
20200227,6,동묘앞,6361,6587,20200301,12948
20200227,6,창신,2867,2241,20200301,5108
20200227,6,보문,6294,5734,20200301,12028
20200227,6,안암,8336,8378,20200301,16714
20200227,6,고려대,6697,6470,20200301,13167
20200227,6,월곡,9692,9418,20200301,19110
20200227,6,상월곡,5156,4544,20200301,9700
20200227,6,돌곶이,7332,6931,20200301,14263
20200227,6,석계,10436,10695,20200301,21131
20200227,6,태릉입구,4507,4965,20200301,9472
20200227,6,화랑대,9481,7302,20200301,16783
20200227,6,봉화산,7972,7057,20200301,15029
20200228,6,합정,10710,10698,20200302,21408
20200228,6,응암,13871,13657,20200302,27528
20200228,6,역촌,3046,3596,20200302,6642
20200228,6,불광,3365,3299,20200302,6664
20200228,6,독바위,2198,2216,20200302,4414
20200228,6,연신내,2,0,20200302,2
20200228,6,구산,5782,4175,20200302,9957
20200228,6,새절,10400,9659,20200302,20059
20200228,6,증산,8235,7903,20200302,16138
20200228,6,디지털미디어시티,11305,12280,20200302,23585
20200228,6,월드컵경기장,3039,3256,20200302,6295
20200228,6,마포구청,11292,10031,20200302,21323
20200228,6,망원,10862,11942,20200302,22804
20200228,6,상수,6828,8257,20200302,15085
20200228,6,광흥창,7023,6796,20200302,13819
20200228,6,대흥,6249,6486,20200302,12735
20200228,6,공덕,15236,15061,20200302,30297
20200228,6,효창공원앞,5426,4951,20200302,10377
20200228,6,삼각지,4577,4130,20200302,8707
20200228,6,녹사평,3785,3915,20200302,7700
20200228,6,이태원,8949,11066,20200302,20015
20200228,6,한강진,5088,6215,20200302,11303
20200228,6,버티고개,1798,1672,20200302,3470
20200228,6,약수,3002,2971,20200302,5973
20200228,6,청구,3241,3651,20200302,6892
20200228,6,신당,7414,7577,20200302,14991
20200228,6,동묘앞,6067,6253,20200302,12320
20200228,6,창신,2880,2235,20200302,5115
20200228,6,보문,6173,5642,20200302,11815
20200228,6,안암,7707,7549,20200302,15256
20200228,6,고려대,6371,6102,20200302,12473
20200228,6,월곡,9284,9171,20200302,18455
20200228,6,상월곡,5108,4422,20200302,9530
20200228,6,돌곶이,7193,6747,20200302,13940
20200228,6,석계,10247,10589,20200302,20836
20200228,6,태릉입구,4328,4699,20200302,9027
20200228,6,화랑대,9147,6932,20200302,16079
20200228,6,봉화산,7749,6904,20200302,14653
20200229,6,응암,8501,8397,20200303,16898
20200229,6,역촌,1723,1995,20200303,3718
20200229,6,불광,2533,2308,20200303,4841
20200229,6,독바위,1314,1566,20200303,2880
20200229,6,구산,3503,2558,20200303,6061
20200229,6,새절,5968,5652,20200303,11620
20200229,6,증산,4994,4824,20200303,9818
20200229,6,디지털미디어시티,4830,4784,20200303,9614
20200229,6,월드컵경기장,2906,2974,20200303,5880
20200229,6,마포구청,6109,5297,20200303,11406
20200229,6,망원,7728,8435,20200303,16163
20200229,6,합정,7230,7249,20200303,14479
20200229,6,상수,4759,5839,20200303,10598
20200229,6,광흥창,3232,2978,20200303,6210
20200229,6,대흥,3363,3324,20200303,6687
20200229,6,공덕,6711,6452,20200303,13163
20200229,6,효창공원앞,2967,2580,20200303,5547
20200229,6,삼각지,2682,2205,20200303,4887
20200229,6,녹사평,3274,3589,20200303,6863
20200229,6,이태원,8619,10866,20200303,19485
20200229,6,한강진,3523,4680,20200303,8203
20200229,6,버티고개,1010,969,20200303,1979
20200229,6,약수,1725,1802,20200303,3527
20200229,6,청구,1777,1912,20200303,3689
20200229,6,신당,4718,3727,20200303,8445
20200229,6,동묘앞,4785,4246,20200303,9031
20200229,6,창신,1475,1210,20200303,2685
20200229,6,보문,3609,3189,20200303,6798
20200229,6,안암,4314,4196,20200303,8510
20200229,6,고려대,3418,3188,20200303,6606
20200229,6,월곡,5257,5062,20200303,10319
20200229,6,상월곡,2783,2390,20200303,5173
20200229,6,돌곶이,4352,4103,20200303,8455
20200229,6,석계,6120,5903,20200303,12023
20200229,6,태릉입구,2603,2856,20200303,5459
20200229,6,화랑대,4077,3363,20200303,7440
20200229,6,봉화산,3705,3521,20200303,7226
20200301,6,응암,5576,5676,20200304,11252
20200301,6,역촌,1119,1369,20200304,2488
20200301,6,불광,1859,1669,20200304,3528
20200301,6,독바위,952,1326,20200304,2278
20200301,6,구산,2204,1579,20200304,3783
20200301,6,새절,4075,3829,20200304,7904
20200301,6,증산,3434,3395,20200304,6829
20200301,6,디지털미디어시티,3169,3211,20200304,6380
20200301,6,월드컵경기장,2055,1975,20200304,4030
20200301,6,마포구청,4098,3722,20200304,7820
20200301,6,망원,5102,5472,20200304,10574
20200301,6,합정,5192,4673,20200304,9865
20200301,6,상수,3394,3761,20200304,7155
20200301,6,광흥창,2111,2038,20200304,4149
20200301,6,대흥,2102,2171,20200304,4273
20200301,6,공덕,4017,3740,20200304,7757
20200301,6,효창공원앞,1925,1664,20200304,3589
20200301,6,삼각지,1702,1303,20200304,3005
20200301,6,녹사평,2323,2220,20200304,4543
20200301,6,이태원,6861,6045,20200304,12906
20200301,6,한강진,2436,2876,20200304,5312
20200301,6,버티고개,592,617,20200304,1209
20200301,6,약수,1062,1078,20200304,2140
20200301,6,청구,1012,1002,20200304,2014
20200301,6,신당,2520,3252,20200304,5772
20200301,6,동묘앞,3139,3148,20200304,6287
20200301,6,창신,985,895,20200304,1880
20200301,6,보문,2461,2324,20200304,4785
20200301,6,안암,2913,2986,20200304,5899
20200301,6,고려대,2301,2258,20200304,4559
20200301,6,월곡,3560,3362,20200304,6922
20200301,6,상월곡,1811,1650,20200304,3461
20200301,6,돌곶이,4203,3991,20200304,8194
20200301,6,석계,4006,3969,20200304,7975
20200301,6,태릉입구,1765,1945,20200304,3710
20200301,6,화랑대,2684,2224,20200304,4908
20200301,6,봉화산,2509,2355,20200304,4864
20200302,6,응암,14206,14260,20200305,28466
20200302,6,역촌,2968,3478,20200305,6446
20200302,6,불광,3186,3443,20200305,6629
20200302,6,독바위,2197,2360,20200305,4557
20200302,6,연신내,1,0,20200305,1
20200302,6,구산,5896,4369,20200305,10265
20200302,6,새절,10403,9704,20200305,20107
20200302,6,증산,8266,8042,20200305,16308
20200302,6,디지털미디어시티,11261,12395,20200305,23656
20200302,6,월드컵경기장,3409,3559,20200305,6968
20200302,6,마포구청,11284,10270,20200305,21554
20200302,6,망원,10586,11474,20200305,22060
20200302,6,합정,10020,9893,20200305,19913
20200302,6,상수,6051,6735,20200305,12786
20200302,6,광흥창,7159,6992,20200305,14151
20200302,6,대흥,6260,6524,20200305,12784
20200302,6,공덕,15139,14850,20200305,29989
20200302,6,효창공원앞,5643,5074,20200305,10717
20200302,6,삼각지,4294,3795,20200305,8089
20200302,6,녹사평,3610,3507,20200305,7117
20200302,6,이태원,8061,8289,20200305,16350
20200302,6,한강진,4724,5570,20200305,10294
20200302,6,버티고개,1797,1768,20200305,3565
20200302,6,약수,2956,3061,20200305,6017
20200302,6,청구,3262,3647,20200305,6909
20200302,6,신당,6209,6843,20200305,13052
20200302,6,동묘앞,6158,6453,20200305,12611
20200302,6,창신,2877,2216,20200305,5093
20200302,6,보문,6102,5632,20200305,11734
20200302,6,안암,7728,7873,20200305,15601
20200302,6,고려대,6169,5997,20200305,12166
20200302,6,월곡,9002,9007,20200305,18009
20200302,6,상월곡,5021,4376,20200305,9397
20200302,6,돌곶이,7166,6673,20200305,13839
20200302,6,석계,10053,10350,20200305,20403
20200302,6,태릉입구,4301,4747,20200305,9048
20200302,6,화랑대,9250,7072,20200305,16322
20200302,6,봉화산,7665,6885,20200305,14550
20200303,6,응암,14024,14082,20200306,28106
20200303,6,역촌,2953,3591,20200306,6544
20200303,6,불광,3458,3558,20200306,7016
20200303,6,독바위,2186,2332,20200306,4518
20200303,6,연신내,2,0,20200306,2
20200303,6,구산,5977,4300,20200306,10277
20200303,6,새절,10380,9646,20200306,20026
20200303,6,증산,8299,8009,20200306,16308
20200303,6,디지털미디어시티,11291,12349,20200306,23640
20200303,6,월드컵경기장,3425,3630,20200306,7055
20200303,6,마포구청,11269,10171,20200306,21440
20200303,6,망원,11024,11907,20200306,22931
20200303,6,합정,10191,10045,20200306,20236
20200303,6,상수,6253,7007,20200306,13260
20200303,6,광흥창,7023,6837,20200306,13860
20200303,6,대흥,6183,6492,20200306,12675
20200303,6,공덕,14965,14780,20200306,29745
20200303,6,효창공원앞,5645,5040,20200306,10685
20200303,6,삼각지,4557,4024,20200306,8581
20200303,6,녹사평,3781,3859,20200306,7640
20200303,6,이태원,8081,8485,20200306,16566
20200303,6,한강진,5103,5834,20200306,10937
20200303,6,버티고개,1747,1638,20200306,3385
20200303,6,약수,2952,3025,20200306,5977
20200303,6,청구,3219,3553,20200306,6772
20200303,6,신당,6761,7289,20200306,14050
20200303,6,동묘앞,6039,6168,20200306,12207
20200303,6,창신,2780,2263,20200306,5043
20200303,6,보문,6037,5657,20200306,11694
20200303,6,안암,7729,7840,20200306,15569
20200303,6,고려대,6084,5822,20200306,11906
20200303,6,월곡,9111,8912,20200306,18023
20200303,6,상월곡,4912,4390,20200306,9302
20200303,6,돌곶이,7268,6844,20200306,14112
20200303,6,석계,10076,10328,20200306,20404
20200303,6,태릉입구,4262,4647,20200306,8909
20200303,6,화랑대,9107,6965,20200306,16072
20200303,6,봉화산,7634,6883,20200306,14517
20200304,6,응암,13986,13919,20200307,27905
20200304,6,역촌,2945,3608,20200307,6553
20200304,6,불광,3426,3524,20200307,6950
20200304,6,독바위,2177,2306,20200307,4483
20200304,6,구산,5874,4309,20200307,10183
20200304,6,새절,10287,9665,20200307,19952
20200304,6,증산,8285,8070,20200307,16355
20200304,6,디지털미디어시티,11085,12234,20200307,23319
20200304,6,월드컵경기장,3128,3335,20200307,6463
20200304,6,마포구청,11231,10294,20200307,21525
20200304,6,망원,10906,11914,20200307,22820
20200304,6,합정,10690,10195,20200307,20885
20200304,6,상수,6549,7288,20200307,13837
20200304,6,광흥창,6985,6964,20200307,13949
20200304,6,대흥,6019,6455,20200307,12474
20200304,6,공덕,15139,14805,20200307,29944
20200304,6,효창공원앞,5529,4997,20200307,10526
20200304,6,삼각지,4438,3951,20200307,8389
20200304,6,녹사평,3844,3829,20200307,7673
20200304,6,이태원,8351,8888,20200307,17239
20200304,6,한강진,5044,5987,20200307,11031
20200304,6,버티고개,1806,1658,20200307,3464
20200304,6,약수,2923,2943,20200307,5866
20200304,6,청구,3199,3507,20200307,6706
20200304,6,신당,7125,7461,20200307,14586
20200304,6,동묘앞,6126,6265,20200307,12391
20200304,6,창신,2763,2279,20200307,5042
20200304,6,보문,6041,5650,20200307,11691
20200304,6,안암,8067,8085,20200307,16152
20200304,6,고려대,6091,5835,20200307,11926
20200304,6,월곡,9018,8899,20200307,17917
20200304,6,상월곡,4961,4388,20200307,9349
20200304,6,돌곶이,7313,6998,20200307,14311
20200304,6,석계,10098,10395,20200307,20493
20200304,6,태릉입구,4218,4685,20200307,8903
20200304,6,화랑대,9031,6801,20200307,15832
20200304,6,봉화산,7570,6808,20200307,14378
20200305,6,응암,14036,14088,20200308,28124
20200305,6,역촌,2950,3543,20200308,6493
20200305,6,불광,3418,3542,20200308,6960
20200305,6,독바위,2204,2301,20200308,4505
20200305,6,구산,5864,4333,20200308,10197
20200305,6,새절,10396,9701,20200308,20097
20200305,6,증산,8321,8124,20200308,16445
20200305,6,디지털미디어시티,11252,12103,20200308,23355
20200305,6,월드컵경기장,3396,3560,20200308,6956
20200305,6,마포구청,11176,9936,20200308,21112
20200305,6,망원,11110,12324,20200308,23434
20200305,6,합정,10559,10269,20200308,20828
20200305,6,상수,6436,7221,20200308,13657
20200305,6,광흥창,7147,6927,20200308,14074
20200305,6,대흥,6200,6377,20200308,12577
20200305,6,공덕,14933,14659,20200308,29592
20200305,6,효창공원앞,5560,5001,20200308,10561
20200305,6,삼각지,4529,3996,20200308,8525
20200305,6,녹사평,3929,4012,20200308,7941
20200305,6,이태원,8524,9481,20200308,18005
20200305,6,한강진,5114,6177,20200308,11291
20200305,6,버티고개,1763,1711,20200308,3474
20200305,6,약수,2949,2943,20200308,5892
20200305,6,청구,3222,3494,20200308,6716
20200305,6,신당,6790,7239,20200308,14029
20200305,6,동묘앞,6193,6409,20200308,12602
20200305,6,창신,2791,2265,20200308,5056
20200305,6,보문,6055,5532,20200308,11587
20200305,6,안암,7632,7586,20200308,15218
20200305,6,고려대,6025,5828,20200308,11853
20200305,6,월곡,9078,8964,20200308,18042
20200305,6,상월곡,4943,4357,20200308,9300
20200305,6,돌곶이,7119,6752,20200308,13871
20200305,6,석계,10128,10314,20200308,20442
20200305,6,태릉입구,4276,4715,20200308,8991
20200305,6,화랑대,8987,6932,20200308,15919
20200305,6,봉화산,7753,6994,20200308,14747
20200306,6,응암,14574,14330,20200309,28904
20200306,6,역촌,3126,3566,20200309,6692
20200306,6,불광,3536,3621,20200309,7157
20200306,6,독바위,2338,2353,20200309,4691
20200306,6,구산,6266,4474,20200309,10740
20200306,6,새절,10633,9895,20200309,20528
20200306,6,증산,8579,8161,20200309,16740
20200306,6,디지털미디어시티,11444,12233,20200309,23677
20200306,6,월드컵경기장,3593,3745,20200309,7338
20200306,6,마포구청,11546,10155,20200309,21701
20200306,6,망원,11671,13028,20200309,24699
20200306,6,합정,11461,11364,20200309,22825
20200306,6,상수,6858,8277,20200309,15135
20200306,6,광흥창,7090,6786,20200309,13876
20200306,6,대흥,6311,6564,20200309,12875
20200306,6,공덕,15478,15266,20200309,30744
20200306,6,효창공원앞,5716,5003,20200309,10719
20200306,6,삼각지,4736,4070,20200309,8806
20200306,6,녹사평,4240,4496,20200309,8736
20200306,6,이태원,10042,12392,20200309,22434
20200306,6,한강진,5429,6687,20200309,12116
20200306,6,버티고개,1825,1716,20200309,3541
20200306,6,약수,2987,3086,20200309,6073
20200306,6,청구,3274,3681,20200309,6955
20200306,6,신당,7039,7492,20200309,14531
20200306,6,동묘앞,6373,6507,20200309,12880
20200306,6,창신,2892,2198,20200309,5090
20200306,6,보문,6230,5656,20200309,11886
20200306,6,안암,7729,7675,20200309,15404
20200306,6,고려대,6209,5865,20200309,12074
20200306,6,월곡,9465,9099,20200309,18564
20200306,6,상월곡,5003,4313,20200309,9316
20200306,6,돌곶이,7404,6922,20200309,14326
20200306,6,석계,10391,10611,20200309,21002
20200306,6,태릉입구,4447,4916,20200309,9363
20200306,6,화랑대,9172,6859,20200309,16031
20200306,6,봉화산,7734,6866,20200309,14600
20200307,6,응암,9026,8982,20200310,18008
20200307,6,역촌,1824,2100,20200310,3924
20200307,6,불광,2844,2650,20200310,5494
20200307,6,독바위,1435,1704,20200310,3139
20200307,6,구산,3898,2727,20200310,6625
20200307,6,새절,6437,5972,20200310,12409
20200307,6,증산,5639,5357,20200310,10996
20200307,6,디지털미디어시티,4941,5051,20200310,9992
20200307,6,월드컵경기장,3062,3043,20200310,6105
20200307,6,마포구청,6629,5761,20200310,12390
20200307,6,망원,8379,9316,20200310,17695
20200307,6,합정,8193,8027,20200310,16220
20200307,6,상수,5055,6450,20200310,11505
20200307,6,광흥창,3359,3227,20200310,6586
20200307,6,대흥,3588,3597,20200310,7185
20200307,6,공덕,6978,6689,20200310,13667
20200307,6,효창공원앞,3186,2792,20200310,5978
20200307,6,삼각지,2937,2233,20200310,5170
20200307,6,녹사평,3785,4271,20200310,8056
20200307,6,이태원,9991,12468,20200310,22459
20200307,6,한강진,3985,5281,20200310,9266
20200307,6,버티고개,1010,1077,20200310,2087
20200307,6,약수,1890,1933,20200310,3823
20200307,6,청구,1726,1913,20200310,3639
20200307,6,신당,4620,3766,20200310,8386
20200307,6,동묘앞,4985,4530,20200310,9515
20200307,6,창신,1508,1247,20200310,2755
20200307,6,보문,3731,3281,20200310,7012
20200307,6,안암,4426,4289,20200310,8715
20200307,6,고려대,3490,3194,20200310,6684
20200307,6,월곡,5481,5323,20200310,10804
20200307,6,상월곡,2843,2442,20200310,5285
20200307,6,돌곶이,4525,4348,20200310,8873
20200307,6,석계,6407,6121,20200310,12528
20200307,6,태릉입구,2691,2912,20200310,5603
20200307,6,화랑대,4456,3566,20200310,8022
20200307,6,봉화산,3871,3654,20200310,7525
20200308,6,응암,6359,6232,20200311,12591
20200308,6,역촌,1234,1470,20200311,2704
20200308,6,불광,2180,2053,20200311,4233
20200308,6,독바위,1176,1559,20200311,2735
20200308,6,구산,2465,1708,20200311,4173
20200308,6,새절,4426,4247,20200311,8673
20200308,6,증산,3799,3822,20200311,7621
20200308,6,디지털미디어시티,3506,3586,20200311,7092
20200308,6,월드컵경기장,2504,2419,20200311,4923
20200308,6,마포구청,4737,4182,20200311,8919
20200308,6,망원,6451,6849,20200311,13300
20200308,6,합정,6211,5771,20200311,11982
20200308,6,상수,3948,4571,20200311,8519
20200308,6,광흥창,2324,2247,20200311,4571
20200308,6,대흥,2406,2445,20200311,4851
20200308,6,공덕,4404,4264,20200311,8668
20200308,6,효창공원앞,2193,2014,20200311,4207
20200308,6,삼각지,2178,1576,20200311,3754
20200308,6,녹사평,3043,3155,20200311,6198
20200308,6,이태원,8484,7823,20200311,16307
20200308,6,한강진,3330,4053,20200311,7383
20200308,6,버티고개,658,771,20200311,1429
20200308,6,약수,1193,1161,20200311,2354
20200308,6,청구,1060,1083,20200311,2143
20200308,6,신당,2742,3490,20200311,6232
20200308,6,동묘앞,3703,3628,20200311,7331
20200308,6,창신,1060,872,20200311,1932
20200308,6,보문,2675,2557,20200311,5232
20200308,6,안암,3245,3484,20200311,6729
20200308,6,고려대,2580,2458,20200311,5038
20200308,6,월곡,3610,3525,20200311,7135
20200308,6,상월곡,2050,1780,20200311,3830
20200308,6,돌곶이,4365,4247,20200311,8612
20200308,6,석계,4466,4348,20200311,8814
20200308,6,태릉입구,1946,2124,20200311,4070
20200308,6,화랑대,3095,2603,20200311,5698
20200308,6,봉화산,2714,2600,20200311,5314
20200309,6,응암,14696,14755,20200312,29451
20200309,6,역촌,3098,3661,20200312,6759
20200309,6,불광,3482,3651,20200312,7133
20200309,6,독바위,2255,2449,20200312,4704
20200309,6,연신내,2,0,20200312,2
20200309,6,구산,6255,4563,20200312,10818
20200309,6,새절,10730,9891,20200312,20621
20200309,6,증산,8547,8344,20200312,16891
20200309,6,디지털미디어시티,11766,12626,20200312,24392
20200309,6,월드컵경기장,3718,3902,20200312,7620
20200309,6,마포구청,11689,10399,20200312,22088
20200309,6,망원,11192,12217,20200312,23409
20200309,6,합정,10824,10448,20200312,21272
20200309,6,상수,6459,7174,20200312,13633
20200309,6,광흥창,7395,7209,20200312,14604
20200309,6,대흥,6461,6736,20200312,13197
20200309,6,공덕,15613,15346,20200312,30959
20200309,6,효창공원앞,5778,5171,20200312,10949
20200309,6,삼각지,4497,3898,20200312,8395
20200309,6,녹사평,3899,3747,20200312,7646
20200309,6,이태원,8688,9014,20200312,17702
20200309,6,한강진,5021,5859,20200312,10880
20200309,6,버티고개,1878,1753,20200312,3631
20200309,6,약수,2960,3070,20200312,6030
20200309,6,청구,3297,3727,20200312,7024
20200309,6,신당,6213,6968,20200312,13181
20200309,6,동묘앞,6389,6662,20200312,13051
20200309,6,창신,2855,2310,20200312,5165
20200309,6,보문,6068,5638,20200312,11706
20200309,6,안암,7758,7927,20200312,15685
20200309,6,고려대,6177,5992,20200312,12169
20200309,6,월곡,9715,9593,20200312,19308
20200309,6,상월곡,5057,4540,20200312,9597
20200309,6,돌곶이,7487,7049,20200312,14536
20200309,6,석계,10484,10785,20200312,21269
20200309,6,태릉입구,4406,4997,20200312,9403
20200309,6,화랑대,9527,7272,20200312,16799
20200309,6,봉화산,7999,7177,20200312,15176
20200310,6,응암,13963,13907,20200313,27870
20200310,6,역촌,3034,3516,20200313,6550
20200310,6,불광,3293,3445,20200313,6738
20200310,6,독바위,2196,2251,20200313,4447
20200310,6,구산,5915,4429,20200313,10344
20200310,6,새절,10128,9539,20200313,19667
20200310,6,증산,8207,8041,20200313,16248
20200310,6,디지털미디어시티,11207,12167,20200313,23374
20200310,6,월드컵경기장,2910,3212,20200313,6122
20200310,6,마포구청,11344,10162,20200313,21506
20200310,6,망원,10955,11974,20200313,22929
20200310,6,합정,10491,10099,20200313,20590
20200310,6,상수,6410,7315,20200313,13725
20200310,6,광흥창,7241,7104,20200313,14345
20200310,6,대흥,6198,6488,20200313,12686
20200310,6,공덕,15152,14731,20200313,29883
20200310,6,효창공원앞,5487,4955,20200313,10442
20200310,6,삼각지,4420,3953,20200313,8373
20200310,6,녹사평,3612,3653,20200313,7265
20200310,6,이태원,8082,8640,20200313,16722
20200310,6,한강진,5034,5912,20200313,10946
20200310,6,버티고개,1831,1690,20200313,3521
20200310,6,약수,2866,2893,20200313,5759
20200310,6,청구,3225,3514,20200313,6739
20200310,6,신당,6883,7338,20200313,14221
20200310,6,동묘앞,5900,6168,20200313,12068
20200310,6,창신,2883,2221,20200313,5104
20200310,6,보문,5984,5533,20200313,11517
20200310,6,안암,7559,7572,20200313,15131
20200310,6,고려대,5900,5715,20200313,11615
20200310,6,월곡,9278,9000,20200313,18278
20200310,6,상월곡,4893,4381,20200313,9274
20200310,6,돌곶이,7206,6842,20200313,14048
20200310,6,석계,10299,10563,20200313,20862
20200310,6,태릉입구,4393,4830,20200313,9223
20200310,6,화랑대,9233,7021,20200313,16254
20200310,6,봉화산,7748,6986,20200313,14734
20200311,6,응암,14453,14329,20200314,28782
20200311,6,역촌,3034,3604,20200314,6638
20200311,6,불광,3530,3678,20200314,7208
20200311,6,독바위,2280,2486,20200314,4766
20200311,6,연신내,1,0,20200314,1
20200311,6,구산,6060,4391,20200314,10451
20200311,6,새절,10475,9785,20200314,20260
20200311,6,증산,8455,8205,20200314,16660
20200311,6,디지털미디어시티,11532,12495,20200314,24027
20200311,6,월드컵경기장,3448,3701,20200314,7149
20200311,6,마포구청,11481,10289,20200314,21770
20200311,6,망원,11232,12001,20200314,23233
20200311,6,합정,10910,10656,20200314,21566
20200311,6,상수,6766,7637,20200314,14403
20200311,6,광흥창,7275,6984,20200314,14259
20200311,6,대흥,6265,6525,20200314,12790
20200311,6,공덕,15279,14927,20200314,30206
20200311,6,효창공원앞,5697,5211,20200314,10908
20200311,6,삼각지,4749,4149,20200314,8898
20200311,6,녹사평,4132,4253,20200314,8385
20200311,6,이태원,9172,9613,20200314,18785
20200311,6,한강진,5564,6530,20200314,12094
20200311,6,버티고개,1845,1709,20200314,3554
20200311,6,약수,3009,3028,20200314,6037
20200311,6,청구,3340,3807,20200314,7147
20200311,6,신당,7261,7618,20200314,14879
20200311,6,동묘앞,6401,6524,20200314,12925
20200311,6,창신,2893,2336,20200314,5229
20200311,6,보문,6167,5737,20200314,11904
20200311,6,안암,7983,7991,20200314,15974
20200311,6,고려대,6121,5943,20200314,12064
20200311,6,월곡,9575,9366,20200314,18941
20200311,6,상월곡,5087,4499,20200314,9586
20200311,6,돌곶이,7645,7297,20200314,14942
20200311,6,석계,10500,10655,20200314,21155
20200311,6,태릉입구,4461,5069,20200314,9530
20200311,6,화랑대,9544,7246,20200314,16790
20200311,6,봉화산,8007,7159,20200314,15166
20200312,6,응암,14140,14056,20200315,28196
20200312,6,역촌,2915,3437,20200315,6352
20200312,6,불광,3392,3461,20200315,6853
20200312,6,독바위,2295,2389,20200315,4684
20200312,6,구산,5986,4347,20200315,10333
20200312,6,새절,10181,9625,20200315,19806
20200312,6,증산,8252,7975,20200315,16227
20200312,6,디지털미디어시티,11179,12179,20200315,23358
20200312,6,월드컵경기장,3472,3671,20200315,7143
20200312,6,마포구청,11036,10046,20200315,21082
20200312,6,망원,10772,11811,20200315,22583
20200312,6,합정,10423,10308,20200315,20731
20200312,6,상수,6615,7506,20200315,14121
20200312,6,광흥창,6956,6790,20200315,13746
20200312,6,대흥,6096,6389,20200315,12485
20200312,6,공덕,14863,14420,20200315,29283
20200312,6,효창공원앞,5667,5200,20200315,10867
20200312,6,삼각지,4754,4102,20200315,8856
20200312,6,녹사평,4087,4210,20200315,8297
20200312,6,이태원,8882,9619,20200315,18501
20200312,6,한강진,5272,6421,20200315,11693
20200312,6,버티고개,1783,1659,20200315,3442
20200312,6,약수,2928,2954,20200315,5882
20200312,6,청구,3268,3678,20200315,6946
20200312,6,신당,6791,7292,20200315,14083
20200312,6,동묘앞,6245,6354,20200315,12599
20200312,6,창신,2806,2232,20200315,5038
20200312,6,보문,6053,5594,20200315,11647
20200312,6,안암,7874,7976,20200315,15850
20200312,6,고려대,6135,5853,20200315,11988
20200312,6,월곡,9251,9071,20200315,18322
20200312,6,상월곡,4907,4299,20200315,9206
20200312,6,돌곶이,7329,6891,20200315,14220
20200312,6,석계,10330,10458,20200315,20788
20200312,6,태릉입구,4350,4809,20200315,9159
20200312,6,화랑대,9170,7061,20200315,16231
20200312,6,봉화산,7678,6872,20200315,14550
20200313,6,응암,14434,14064,20200316,28498
20200313,6,역촌,3100,3588,20200316,6688
20200313,6,불광,3478,3542,20200316,7020
20200313,6,독바위,2259,2357,20200316,4616
20200313,6,구산,5989,4253,20200316,10242
20200313,6,새절,10454,9623,20200316,20077
20200313,6,증산,8442,8141,20200316,16583
20200313,6,디지털미디어시티,11165,12004,20200316,23169
20200313,6,월드컵경기장,3417,3635,20200316,7052
20200313,6,마포구청,11548,10047,20200316,21595
20200313,6,망원,11460,12790,20200316,24250
20200313,6,합정,11503,11367,20200316,22870
20200313,6,상수,7331,8810,20200316,16141
20200313,6,광흥창,7020,6853,20200316,13873
20200313,6,대흥,6243,6501,20200316,12744
20200313,6,공덕,15272,14868,20200316,30140
20200313,6,효창공원앞,5849,5174,20200316,11023
20200313,6,삼각지,4847,4204,20200316,9051
20200313,6,녹사평,4246,4546,20200316,8792
20200313,6,이태원,9703,12411,20200316,22114
20200313,6,한강진,5412,6694,20200316,12106
20200313,6,버티고개,1810,1693,20200316,3503
20200313,6,약수,2966,3062,20200316,6028
20200313,6,청구,3226,3663,20200316,6889
20200313,6,신당,7295,7647,20200316,14942
20200313,6,동묘앞,6485,6621,20200316,13106
20200313,6,창신,2850,2167,20200316,5017
20200313,6,보문,6197,5626,20200316,11823
20200313,6,안암,8183,7878,20200316,16061
20200313,6,고려대,6325,5937,20200316,12262
20200313,6,월곡,9518,9318,20200316,18836
20200313,6,상월곡,5014,4364,20200316,9378
20200313,6,돌곶이,7605,7072,20200316,14677
20200313,6,석계,10431,10576,20200316,21007
20200313,6,태릉입구,4492,4992,20200316,9484
20200313,6,화랑대,9274,6896,20200316,16170
20200313,6,봉화산,7714,6943,20200316,14657
20200314,6,응암,9142,9019,20200317,18161
20200314,6,역촌,1801,2240,20200317,4041
20200314,6,불광,2809,2660,20200317,5469
20200314,6,독바위,1478,1871,20200317,3349
20200314,6,구산,3886,2813,20200317,6699
20200314,6,새절,6343,5948,20200317,12291
20200314,6,증산,5492,5358,20200317,10850
20200314,6,디지털미디어시티,5041,5164,20200317,10205
20200314,6,월드컵경기장,3102,3123,20200317,6225
20200314,6,마포구청,6571,5606,20200317,12177
20200314,6,망원,8656,9730,20200317,18386
20200314,6,합정,8568,8337,20200317,16905
20200314,6,상수,5806,7042,20200317,12848
20200314,6,광흥창,3509,3257,20200317,6766
20200314,6,대흥,3663,3645,20200317,7308
20200314,6,공덕,6913,6725,20200317,13638
20200314,6,효창공원앞,3273,2871,20200317,6144
20200314,6,삼각지,3035,2341,20200317,5376
20200314,6,녹사평,3864,4584,20200317,8448
20200314,6,이태원,10430,12867,20200317,23297
20200314,6,한강진,5085,6346,20200317,11431
20200314,6,버티고개,1048,1076,20200317,2124
20200314,6,약수,1831,1838,20200317,3669
20200314,6,청구,1805,1872,20200317,3677
20200314,6,신당,5002,3955,20200317,8957
20200314,6,동묘앞,5224,4785,20200317,10009
20200314,6,창신,1558,1214,20200317,2772
20200314,6,보문,3879,3447,20200317,7326
20200314,6,안암,4737,4508,20200317,9245
20200314,6,고려대,3624,3532,20200317,7156
20200314,6,월곡,5537,5312,20200317,10849
20200314,6,상월곡,2901,2621,20200317,5522
20200314,6,돌곶이,4613,4286,20200317,8899
20200314,6,석계,6459,6483,20200317,12942
20200314,6,태릉입구,2956,3175,20200317,6131
20200314,6,화랑대,4651,3835,20200317,8486
20200314,6,봉화산,3885,3755,20200317,7640
20200315,6,응암,6280,6335,20200318,12615
20200315,6,역촌,1227,1434,20200318,2661
20200315,6,불광,2223,1873,20200318,4096
20200315,6,독바위,1050,1486,20200318,2536
20200315,6,구산,2542,1814,20200318,4356
20200315,6,새절,4366,4270,20200318,8636
20200315,6,증산,3730,3662,20200318,7392
20200315,6,디지털미디어시티,3372,3579,20200318,6951
20200315,6,월드컵경기장,2387,2333,20200318,4720
20200315,6,마포구청,4496,4155,20200318,8651
20200315,6,망원,6098,6503,20200318,12601
20200315,6,합정,6151,5581,20200318,11732
20200315,6,상수,3973,4619,20200318,8592
20200315,6,광흥창,2223,2206,20200318,4429
20200315,6,대흥,2382,2489,20200318,4871
20200315,6,공덕,4581,4126,20200318,8707
20200315,6,효창공원앞,2134,1929,20200318,4063
20200315,6,삼각지,1965,1538,20200318,3503
20200315,6,녹사평,2712,2844,20200318,5556
20200315,6,이태원,8507,7466,20200318,15973
20200315,6,한강진,4011,4497,20200318,8508
20200315,6,버티고개,739,813,20200318,1552
20200315,6,약수,1156,1143,20200318,2299
20200315,6,청구,1062,1062,20200318,2124
20200315,6,신당,3084,3776,20200318,6860
20200315,6,동묘앞,3622,3509,20200318,7131
20200315,6,창신,990,909,20200318,1899
20200315,6,보문,2703,2562,20200318,5265
20200315,6,안암,3355,3630,20200318,6985
20200315,6,고려대,2529,2559,20200318,5088
20200315,6,월곡,4039,3874,20200318,7913
20200315,6,상월곡,1971,1892,20200318,3863
20200315,6,돌곶이,4379,4129,20200318,8508
20200315,6,석계,4546,4451,20200318,8997
20200315,6,태릉입구,1989,2218,20200318,4207
20200315,6,화랑대,3090,2665,20200318,5755
20200315,6,봉화산,2732,2622,20200318,5354
20200316,6,공덕,15250,14945,20200319,30195
20200316,6,응암,14325,14311,20200319,28636
20200316,6,역촌,3045,3575,20200319,6620
20200316,6,불광,3443,3617,20200319,7060
20200316,6,독바위,2266,2505,20200319,4771
20200316,6,연신내,2,0,20200319,2
20200316,6,구산,6095,4514,20200319,10609
20200316,6,새절,10316,9776,20200319,20092
20200316,6,증산,8389,8267,20200319,16656
20200316,6,디지털미디어시티,11411,12409,20200319,23820
20200316,6,월드컵경기장,3520,3585,20200319,7105
20200316,6,마포구청,11406,10219,20200319,21625
20200316,6,망원,10839,11698,20200319,22537
20200316,6,합정,10194,9924,20200319,20118
20200316,6,상수,6219,6988,20200319,13207
20200316,6,광흥창,7212,7064,20200319,14276
20200316,6,대흥,6228,6681,20200319,12909
20200316,6,효창공원앞,5720,5211,20200319,10931
20200316,6,삼각지,4410,3859,20200319,8269
20200316,6,녹사평,3636,3551,20200319,7187
20200316,6,이태원,8058,8316,20200319,16374
20200316,6,한강진,4957,5839,20200319,10796
20200316,6,버티고개,1839,1776,20200319,3615
20200316,6,약수,2989,2953,20200319,5942
20200316,6,청구,3257,3630,20200319,6887
20200316,6,신당,6310,6901,20200319,13211
20200316,6,동묘앞,6238,6565,20200319,12803
20200316,6,창신,2863,2351,20200319,5214
20200316,6,보문,6064,5551,20200319,11615
20200316,6,안암,7901,8082,20200319,15983
20200316,6,고려대,6092,6012,20200319,12104
20200316,6,월곡,9633,9381,20200319,19014
20200316,6,상월곡,5097,4552,20200319,9649
20200316,6,돌곶이,7396,6942,20200319,14338
20200316,6,석계,10389,10760,20200319,21149
20200316,6,태릉입구,4402,4929,20200319,9331
20200316,6,화랑대,9455,7235,20200319,16690
20200316,6,봉화산,7887,7060,20200319,14947
20200317,6,응암,14301,14248,20200320,28549
20200317,6,역촌,2951,3498,20200320,6449
20200317,6,불광,3476,3657,20200320,7133
20200317,6,독바위,2254,2347,20200320,4601
20200317,6,연신내,1,0,20200320,1
20200317,6,구산,5985,4293,20200320,10278
20200317,6,새절,10418,9665,20200320,20083
20200317,6,증산,8497,8265,20200320,16762
20200317,6,디지털미디어시티,11350,12215,20200320,23565
20200317,6,월드컵경기장,3384,3479,20200320,6863
20200317,6,마포구청,11419,10145,20200320,21564
20200317,6,망원,10959,12016,20200320,22975
20200317,6,합정,10424,10302,20200320,20726
20200317,6,상수,6454,7331,20200320,13785
20200317,6,광흥창,7021,6809,20200320,13830
20200317,6,대흥,6163,6400,20200320,12563
20200317,6,공덕,15157,14839,20200320,29996
20200317,6,효창공원앞,5814,5249,20200320,11063
20200317,6,삼각지,4593,4011,20200320,8604
20200317,6,녹사평,3758,3866,20200320,7624
20200317,6,이태원,8500,8792,20200320,17292
20200317,6,한강진,5530,6482,20200320,12012
20200317,6,버티고개,1861,1754,20200320,3615
20200317,6,약수,2949,2920,20200320,5869
20200317,6,청구,3217,3615,20200320,6832
20200317,6,신당,6473,7116,20200320,13589
20200317,6,동묘앞,6201,6365,20200320,12566
20200317,6,창신,2859,2262,20200320,5121
20200317,6,보문,6034,5563,20200320,11597
20200317,6,안암,7882,8014,20200320,15896
20200317,6,고려대,6034,5841,20200320,11875
20200317,6,월곡,9350,9179,20200320,18529
20200317,6,상월곡,5034,4451,20200320,9485
20200317,6,돌곶이,7350,6968,20200320,14318
20200317,6,석계,10312,10663,20200320,20975
20200317,6,태릉입구,4436,4898,20200320,9334
20200317,6,화랑대,9327,7109,20200320,16436
20200317,6,봉화산,7788,7065,20200320,14853
20200318,6,응암,14726,14427,20200321,29153
20200318,6,역촌,3082,3659,20200321,6741
20200318,6,불광,3656,3800,20200321,7456
20200318,6,독바위,2352,2486,20200321,4838
20200318,6,구산,6120,4526,20200321,10646
20200318,6,새절,10683,10006,20200321,20689
20200318,6,증산,8558,8404,20200321,16962
20200318,6,디지털미디어시티,11610,12550,20200321,24160
20200318,6,월드컵경기장,3801,3993,20200321,7794
20200318,6,마포구청,11611,10508,20200321,22119
20200318,6,망원,11539,12613,20200321,24152
20200318,6,합정,10927,10884,20200321,21811
20200318,6,상수,6788,7714,20200321,14502
20200318,6,광흥창,7337,7068,20200321,14405
20200318,6,대흥,6457,6818,20200321,13275
20200318,6,공덕,15471,15221,20200321,30692
20200318,6,효창공원앞,5843,5274,20200321,11117
20200318,6,삼각지,4802,4177,20200321,8979
20200318,6,녹사평,4177,4108,20200321,8285
20200318,6,이태원,8717,9243,20200321,17960
20200318,6,한강진,5946,6957,20200321,12903
20200318,6,버티고개,1948,1783,20200321,3731
20200318,6,약수,2976,3049,20200321,6025
20200318,6,청구,3304,3624,20200321,6928
20200318,6,신당,6485,7122,20200321,13607
20200318,6,동묘앞,6506,6776,20200321,13282
20200318,6,창신,2907,2288,20200321,5195
20200318,6,보문,6145,5836,20200321,11981
20200318,6,안암,8044,8034,20200321,16078
20200318,6,고려대,6178,5985,20200321,12163
20200318,6,월곡,9684,9456,20200321,19140
20200318,6,상월곡,5102,4544,20200321,9646
20200318,6,돌곶이,7701,7173,20200321,14874
20200318,6,석계,10637,10945,20200321,21582
20200318,6,태릉입구,4547,5118,20200321,9665
20200318,6,화랑대,9609,7308,20200321,16917
20200318,6,봉화산,7908,7189,20200321,15097
20200319,6,응암,13890,13734,20200322,27624
20200319,6,역촌,2977,3539,20200322,6516
20200319,6,불광,3410,3461,20200322,6871
20200319,6,독바위,2197,2319,20200322,4516
20200319,6,연신내,1,0,20200322,1
20200319,6,구산,5932,4328,20200322,10260
20200319,6,새절,10253,9591,20200322,19844
20200319,6,증산,8180,7950,20200322,16130
20200319,6,디지털미디어시티,11134,12189,20200322,23323
20200319,6,월드컵경기장,2867,3090,20200322,5957
20200319,6,마포구청,11133,10070,20200322,21203
20200319,6,망원,10728,11759,20200322,22487
20200319,6,합정,10549,10166,20200322,20715
20200319,6,상수,6480,7357,20200322,13837
20200319,6,광흥창,7006,6805,20200322,13811
20200319,6,대흥,6039,6383,20200322,12422
20200319,6,공덕,14679,14392,20200322,29071
20200319,6,효창공원앞,5615,4988,20200322,10603
20200319,6,삼각지,4476,3917,20200322,8393
20200319,6,녹사평,3665,3736,20200322,7401
20200319,6,이태원,7958,8733,20200322,16691
20200319,6,한강진,5470,6423,20200322,11893
20200319,6,버티고개,1714,1612,20200322,3326
20200319,6,약수,2851,2937,20200322,5788
20200319,6,청구,3196,3477,20200322,6673
20200319,6,신당,6344,6716,20200322,13060
20200319,6,동묘앞,6085,6164,20200322,12249
20200319,6,창신,2832,2307,20200322,5139
20200319,6,보문,5964,5444,20200322,11408
20200319,6,안암,7691,7742,20200322,15433
20200319,6,고려대,5859,5685,20200322,11544
20200319,6,월곡,9011,8827,20200322,17838
20200319,6,상월곡,4886,4347,20200322,9233
20200319,6,돌곶이,7241,6867,20200322,14108
20200319,6,석계,10110,10369,20200322,20479
20200319,6,태릉입구,4336,4794,20200322,9130
20200319,6,화랑대,9128,6846,20200322,15974
20200319,6,봉화산,7558,6889,20200322,14447
20200320,6,응암,15030,14587,20200323,29617
20200320,6,역촌,3128,3766,20200323,6894
20200320,6,불광,3905,3884,20200323,7789
20200320,6,독바위,2395,2454,20200323,4849
20200320,6,구산,6508,4630,20200323,11138
20200320,6,새절,11230,10357,20200323,21587
20200320,6,증산,8886,8376,20200323,17262
20200320,6,디지털미디어시티,11551,12367,20200323,23918
20200320,6,월드컵경기장,3957,4185,20200323,8142
20200320,6,마포구청,12102,10390,20200323,22492
20200320,6,망원,12188,13709,20200323,25897
20200320,6,합정,12007,11858,20200323,23865
20200320,6,상수,7459,9263,20200323,16722
20200320,6,광흥창,7332,6958,20200323,14290
20200320,6,대흥,6558,6814,20200323,13372
20200320,6,공덕,15828,15444,20200323,31272
20200320,6,효창공원앞,6052,5332,20200323,11384
20200320,6,삼각지,5017,4292,20200323,9309
20200320,6,녹사평,4543,4854,20200323,9397
20200320,6,이태원,10323,12773,20200323,23096
20200320,6,한강진,6171,7585,20200323,13756
20200320,6,버티고개,1957,1811,20200323,3768
20200320,6,약수,3116,3212,20200323,6328
20200320,6,청구,3276,3656,20200323,6932
20200320,6,신당,6724,7114,20200323,13838
20200320,6,동묘앞,6751,6759,20200323,13510
20200320,6,창신,3046,2322,20200323,5368
20200320,6,보문,6404,5942,20200323,12346
20200320,6,안암,8860,8622,20200323,17482
20200320,6,고려대,6642,6191,20200323,12833
20200320,6,월곡,10032,9668,20200323,19700
20200320,6,상월곡,5255,4492,20200323,9747
20200320,6,돌곶이,7861,7351,20200323,15212
20200320,6,석계,10783,10829,20200323,21612
20200320,6,태릉입구,4657,5223,20200323,9880
20200320,6,화랑대,9726,7218,20200323,16944
20200320,6,봉화산,7946,7065,20200323,15011
20200321,6,응암,9552,9387,20200324,18939
20200321,6,역촌,1865,2166,20200324,4031
20200321,6,불광,3027,2873,20200324,5900
20200321,6,독바위,1489,1874,20200324,3363
20200321,6,구산,3955,2819,20200324,6774
20200321,6,새절,6632,6292,20200324,12924
20200321,6,증산,5698,5498,20200324,11196
20200321,6,디지털미디어시티,5353,5275,20200324,10628
20200321,6,월드컵경기장,3665,3581,20200324,7246
20200321,6,마포구청,6861,5771,20200324,12632
20200321,6,망원,9376,10554,20200324,19930
20200321,6,합정,8920,8555,20200324,17475
20200321,6,상수,5836,7422,20200324,13258
20200321,6,광흥창,3525,3268,20200324,6793
20200321,6,대흥,3803,3793,20200324,7596
20200321,6,공덕,7485,7172,20200324,14657
20200321,6,효창공원앞,3415,2913,20200324,6328
20200321,6,삼각지,3121,2333,20200324,5454
20200321,6,녹사평,4205,4650,20200324,8855
20200321,6,이태원,10525,13319,20200324,23844
20200321,6,한강진,5083,6543,20200324,11626
20200321,6,버티고개,1062,1105,20200324,2167
20200321,6,약수,1866,1796,20200324,3662
20200321,6,청구,1855,2012,20200324,3867
20200321,6,신당,4245,3494,20200324,7739
20200321,6,동묘앞,5525,5013,20200324,10538
20200321,6,창신,1586,1303,20200324,2889
20200321,6,보문,4058,3606,20200324,7664
20200321,6,안암,4862,4750,20200324,9612
20200321,6,고려대,3866,3560,20200324,7426
20200321,6,월곡,5839,5661,20200324,11500
20200321,6,상월곡,3076,2720,20200324,5796
20200321,6,돌곶이,4812,4419,20200324,9231
20200321,6,석계,6564,6379,20200324,12943
20200321,6,태릉입구,2965,3241,20200324,6206
20200321,6,화랑대,4854,3975,20200324,8829
20200321,6,봉화산,4202,3942,20200324,8144
20200322,6,응암,6491,6495,20200325,12986
20200322,6,역촌,1355,1617,20200325,2972
20200322,6,불광,2425,2228,20200325,4653
20200322,6,독바위,1176,1718,20200325,2894
20200322,6,구산,2764,1957,20200325,4721
20200322,6,새절,4666,4592,20200325,9258
20200322,6,증산,3881,3999,20200325,7880
20200322,6,디지털미디어시티,3591,3647,20200325,7238
20200322,6,월드컵경기장,2781,2687,20200325,5468
20200322,6,마포구청,4992,4401,20200325,9393
20200322,6,망원,6781,7562,20200325,14343
20200322,6,합정,6601,5852,20200325,12453
20200322,6,상수,4230,4736,20200325,8966
20200322,6,광흥창,2429,2353,20200325,4782
20200322,6,대흥,2505,2655,20200325,5160
20200322,6,공덕,4706,4402,20200325,9108
20200322,6,효창공원앞,2305,2019,20200325,4324
20200322,6,삼각지,2032,1595,20200325,3627
20200322,6,녹사평,3240,3193,20200325,6433
20200322,6,이태원,8753,7754,20200325,16507
20200322,6,한강진,4032,4753,20200325,8785
20200322,6,버티고개,783,846,20200325,1629
20200322,6,약수,1141,1197,20200325,2338
20200322,6,청구,1118,1135,20200325,2253
20200322,6,신당,2626,3363,20200325,5989
20200322,6,동묘앞,4071,4071,20200325,8142
20200322,6,창신,1118,990,20200325,2108
20200322,6,보문,2749,2601,20200325,5350
20200322,6,안암,3585,3748,20200325,7333
20200322,6,고려대,2726,2698,20200325,5424
20200322,6,월곡,3935,3807,20200325,7742
20200322,6,상월곡,2218,1955,20200325,4173
20200322,6,돌곶이,4445,4174,20200325,8619
20200322,6,석계,4619,4795,20200325,9414
20200322,6,태릉입구,2116,2416,20200325,4532
20200322,6,화랑대,3327,2842,20200325,6169
20200322,6,봉화산,2795,2717,20200325,5512
20200323,6,응암,14670,14768,20200326,29438
20200323,6,역촌,3104,3686,20200326,6790
20200323,6,불광,3624,3767,20200326,7391
20200323,6,독바위,2338,2484,20200326,4822
20200323,6,구산,6291,4508,20200326,10799
20200323,6,새절,10807,10096,20200326,20903
20200323,6,증산,8743,8413,20200326,17156
20200323,6,디지털미디어시티,11671,12559,20200326,24230
20200323,6,월드컵경기장,3757,3865,20200326,7622
20200323,6,마포구청,11545,10244,20200326,21789
20200323,6,망원,11115,12029,20200326,23144
20200323,6,합정,10285,10128,20200326,20413
20200323,6,상수,6275,6869,20200326,13144
20200323,6,광흥창,7285,7188,20200326,14473
20200323,6,대흥,6388,6697,20200326,13085
20200323,6,공덕,15240,15046,20200326,30286
20200323,6,효창공원앞,5757,5274,20200326,11031
20200323,6,삼각지,4304,3777,20200326,8081
20200323,6,녹사평,3638,3535,20200326,7173
20200323,6,이태원,7891,8253,20200326,16144
20200323,6,한강진,5103,5885,20200326,10988
20200323,6,버티고개,1800,1818,20200326,3618
20200323,6,약수,3111,3049,20200326,6160
20200323,6,청구,3238,3632,20200326,6870
20200323,6,신당,6167,6832,20200326,12999
20200323,6,동묘앞,6517,6714,20200326,13231
20200323,6,창신,2886,2261,20200326,5147
20200323,6,보문,6153,5700,20200326,11853
20200323,6,안암,7989,8241,20200326,16230
20200323,6,고려대,6221,6015,20200326,12236
20200323,6,월곡,9623,9532,20200326,19155
20200323,6,상월곡,5057,4442,20200326,9499
20200323,6,돌곶이,7500,7142,20200326,14642
20200323,6,석계,10373,10883,20200326,21256
20200323,6,태릉입구,4459,5024,20200326,9483
20200323,6,화랑대,9552,7264,20200326,16816
20200323,6,봉화산,7916,7162,20200326,15078
20200324,6,응암,14711,14575,20200327,29286
20200324,6,역촌,3060,3704,20200327,6764
20200324,6,불광,3577,3735,20200327,7312
20200324,6,독바위,2365,2520,20200327,4885
20200324,6,구산,6183,4510,20200327,10693
20200324,6,새절,10701,9990,20200327,20691
20200324,6,증산,8621,8423,20200327,17044
20200324,6,디지털미디어시티,11518,12529,20200327,24047
20200324,6,월드컵경기장,3994,4125,20200327,8119
20200324,6,마포구청,11668,10403,20200327,22071
20200324,6,망원,11444,12408,20200327,23852
20200324,6,합정,10634,10450,20200327,21084
20200324,6,상수,6459,7217,20200327,13676
20200324,6,광흥창,7243,7064,20200327,14307
20200324,6,대흥,6470,6733,20200327,13203
20200324,6,공덕,15098,14913,20200327,30011
20200324,6,효창공원앞,5749,5242,20200327,10991
20200324,6,삼각지,4587,3957,20200327,8544
20200324,6,녹사평,3983,3932,20200327,7915
20200324,6,이태원,8264,8822,20200327,17086
20200324,6,한강진,5842,6714,20200327,12556
20200324,6,버티고개,1779,1761,20200327,3540
20200324,6,약수,2997,3019,20200327,6016
20200324,6,청구,3255,3603,20200327,6858
20200324,6,신당,6467,6980,20200327,13447
20200324,6,동묘앞,6588,6786,20200327,13374
20200324,6,창신,2902,2344,20200327,5246
20200324,6,보문,6174,5717,20200327,11891
20200324,6,안암,7921,8002,20200327,15923
20200324,6,고려대,6000,5875,20200327,11875
20200324,6,월곡,9468,9234,20200327,18702
20200324,6,상월곡,5089,4480,20200327,9569
20200324,6,돌곶이,7536,7130,20200327,14666
20200324,6,석계,10481,10704,20200327,21185
20200324,6,태릉입구,4524,5042,20200327,9566
20200324,6,화랑대,9554,7279,20200327,16833
20200324,6,봉화산,7816,7134,20200327,14950
20200325,6,응암,14862,14737,20200328,29599
20200325,6,역촌,3163,3739,20200328,6902
20200325,6,불광,3913,4069,20200328,7982
20200325,6,독바위,2327,2551,20200328,4878
20200325,6,구산,6429,4569,20200328,10998
20200325,6,새절,11016,10267,20200328,21283
20200325,6,증산,8645,8430,20200328,17075
20200325,6,디지털미디어시티,11748,12660,20200328,24408
20200325,6,월드컵경기장,4023,4112,20200328,8135
20200325,6,마포구청,11834,10465,20200328,22299
20200325,6,망원,11550,12677,20200328,24227
20200325,6,합정,11073,10744,20200328,21817
20200325,6,상수,6720,7526,20200328,14246
20200325,6,광흥창,7326,7140,20200328,14466
20200325,6,대흥,6309,6683,20200328,12992
20200325,6,공덕,15574,15279,20200328,30853
20200325,6,효창공원앞,6036,5425,20200328,11461
20200325,6,삼각지,4622,4039,20200328,8661
20200325,6,녹사평,4097,4105,20200328,8202
20200325,6,이태원,8649,9047,20200328,17696
20200325,6,한강진,5928,7123,20200328,13051
20200325,6,버티고개,1885,1781,20200328,3666
20200325,6,약수,3023,3012,20200328,6035
20200325,6,청구,3250,3648,20200328,6898
20200325,6,신당,6448,7050,20200328,13498
20200325,6,동묘앞,6670,6849,20200328,13519
20200325,6,창신,2968,2408,20200328,5376
20200325,6,보문,6207,5803,20200328,12010
20200325,6,안암,8133,8183,20200328,16316
20200325,6,고려대,6195,6061,20200328,12256
20200325,6,월곡,9861,9703,20200328,19564
20200325,6,상월곡,5214,4581,20200328,9795
20200325,6,돌곶이,7658,7235,20200328,14893
20200325,6,석계,10914,11056,20200328,21970
20200325,6,태릉입구,4567,5001,20200328,9568
20200325,6,화랑대,9684,7333,20200328,17017
20200325,6,봉화산,7979,7065,20200328,15044
20200326,6,응암,14537,14412,20200329,28949
20200326,6,역촌,3049,3631,20200329,6680
20200326,6,불광,3631,3712,20200329,7343
20200326,6,독바위,2356,2534,20200329,4890
20200326,6,구산,6161,4600,20200329,10761
20200326,6,새절,10628,9925,20200329,20553
20200326,6,증산,8500,8310,20200329,16810
20200326,6,디지털미디어시티,11485,12361,20200329,23846
20200326,6,월드컵경기장,3658,3819,20200329,7477
20200326,6,마포구청,11503,10390,20200329,21893
20200326,6,망원,11005,12179,20200329,23184
20200326,6,합정,10694,10159,20200329,20853
20200326,6,상수,6516,7508,20200329,14024
20200326,6,광흥창,7294,7051,20200329,14345
20200326,6,대흥,6340,6626,20200329,12966
20200326,6,공덕,15239,14888,20200329,30127
20200326,6,효창공원앞,5834,5284,20200329,11118
20200326,6,삼각지,4584,4063,20200329,8647
20200326,6,녹사평,3785,3783,20200329,7568
20200326,6,이태원,8063,8637,20200329,16700
20200326,6,한강진,5688,6588,20200329,12276
20200326,6,버티고개,1835,1768,20200329,3603
20200326,6,약수,2983,3072,20200329,6055
20200326,6,청구,3292,3634,20200329,6926
20200326,6,신당,6467,6815,20200329,13282
20200326,6,동묘앞,6493,6697,20200329,13190
20200326,6,창신,2924,2387,20200329,5311
20200326,6,보문,6094,5685,20200329,11779
20200326,6,안암,8113,8199,20200329,16312
20200326,6,고려대,6086,6005,20200329,12091
20200326,6,월곡,9559,9368,20200329,18927
20200326,6,상월곡,5101,4595,20200329,9696
20200326,6,돌곶이,7501,6976,20200329,14477
20200326,6,석계,10525,10724,20200329,21249
20200326,6,태릉입구,4446,4917,20200329,9363
20200326,6,화랑대,9485,7222,20200329,16707
20200326,6,봉화산,7896,7064,20200329,14960
20200326,6,신내,1,0,20200329,1
20200327,6,응암,15052,14688,20200330,29740
20200327,6,역촌,3243,3789,20200330,7032
20200327,6,불광,3840,3929,20200330,7769
20200327,6,독바위,2335,2435,20200330,4770
20200327,6,구산,6432,4642,20200330,11074
20200327,6,새절,11075,10129,20200330,21204
20200327,6,증산,8839,8480,20200330,17319
20200327,6,디지털미디어시티,11613,12409,20200330,24022
20200327,6,월드컵경기장,3849,4008,20200330,7857
20200327,6,마포구청,11712,10392,20200330,22104
20200327,6,망원,12224,13268,20200330,25492
20200327,6,합정,11650,11853,20200330,23503
20200327,6,상수,7208,8763,20200330,15971
20200327,6,광흥창,7423,7148,20200330,14571
20200327,6,대흥,6516,6680,20200330,13196
20200327,6,공덕,15646,15261,20200330,30907
20200327,6,효창공원앞,5945,5297,20200330,11242
20200327,6,삼각지,4891,4177,20200330,9068
20200327,6,녹사평,4262,4605,20200330,8867
20200327,6,이태원,9843,12015,20200330,21858
20200327,6,한강진,6018,7502,20200330,13520
20200327,6,버티고개,1899,1751,20200330,3650
20200327,6,약수,3155,3133,20200330,6288
20200327,6,청구,3362,3594,20200330,6956
20200327,6,신당,6662,6997,20200330,13659
20200327,6,동묘앞,6943,6862,20200330,13805
20200327,6,창신,2901,2260,20200330,5161
20200327,6,보문,6384,5713,20200330,12097
20200327,6,안암,8914,8569,20200330,17483
20200327,6,고려대,6508,6090,20200330,12598
20200327,6,월곡,9791,9446,20200330,19237
20200327,6,상월곡,5125,4485,20200330,9610
20200327,6,돌곶이,7541,6978,20200330,14519
20200327,6,석계,10758,10877,20200330,21635
20200327,6,태릉입구,4609,5150,20200330,9759
20200327,6,화랑대,9637,7209,20200330,16846
20200327,6,봉화산,8056,7186,20200330,15242
20200328,6,응암,9870,9763,20200331,19633
20200328,6,역촌,1928,2232,20200331,4160
20200328,6,불광,3160,2974,20200331,6134
20200328,6,독바위,1652,1887,20200331,3539
20200328,6,구산,4163,2937,20200331,7100
20200328,6,새절,6930,6530,20200331,13460
20200328,6,증산,5856,5692,20200331,11548
20200328,6,디지털미디어시티,5339,5542,20200331,10881
20200328,6,월드컵경기장,3651,3647,20200331,7298
20200328,6,마포구청,6911,5867,20200331,12778
20200328,6,망원,9575,10712,20200331,20287
20200328,6,합정,9007,8775,20200331,17782
20200328,6,상수,5841,7311,20200331,13152
20200328,6,광흥창,3588,3350,20200331,6938
20200328,6,대흥,3896,3880,20200331,7776
20200328,6,공덕,7536,7037,20200331,14573
20200328,6,효창공원앞,3500,3006,20200331,6506
20200328,6,삼각지,2970,2262,20200331,5232
20200328,6,녹사평,4024,4543,20200331,8567
20200328,6,이태원,10555,12321,20200331,22876
20200328,6,한강진,5006,6530,20200331,11536
20200328,6,버티고개,1106,1111,20200331,2217
20200328,6,약수,1869,1934,20200331,3803
20200328,6,청구,1827,1988,20200331,3815
20200328,6,신당,4206,3288,20200331,7494
20200328,6,동묘앞,5833,5162,20200331,10995
20200328,6,창신,1685,1350,20200331,3035
20200328,6,보문,3980,3594,20200331,7574
20200328,6,안암,4963,4872,20200331,9835
20200328,6,고려대,3925,3561,20200331,7486
20200328,6,월곡,5942,5804,20200331,11746
20200328,6,상월곡,3094,2693,20200331,5787
20200328,6,돌곶이,4573,4309,20200331,8882
20200328,6,석계,6670,6541,20200331,13211
20200328,6,태릉입구,3021,3245,20200331,6266
20200328,6,화랑대,4971,4069,20200331,9040
20200328,6,봉화산,4102,3835,20200331,7937
20200329,6,응암,6827,7030,20200401,13857
20200329,6,역촌,1328,1581,20200401,2909
20200329,6,불광,2429,2265,20200401,4694
20200329,6,독바위,1267,1735,20200401,3002
20200329,6,연신내,1,0,20200401,1
20200329,6,구산,2843,1935,20200401,4778
20200329,6,새절,4816,4680,20200401,9496
20200329,6,증산,4191,4302,20200401,8493
20200329,6,디지털미디어시티,3792,3773,20200401,7565
20200329,6,월드컵경기장,3350,3275,20200401,6625
20200329,6,마포구청,4974,4370,20200401,9344
20200329,6,망원,6795,7341,20200401,14136
20200329,6,합정,6522,5978,20200401,12500
20200329,6,상수,4191,4760,20200401,8951
20200329,6,광흥창,2500,2325,20200401,4825
20200329,6,대흥,2524,2598,20200401,5122
20200329,6,공덕,4929,4547,20200401,9476
20200329,6,효창공원앞,2360,2050,20200401,4410
20200329,6,삼각지,2173,1639,20200401,3812
20200329,6,녹사평,3075,2908,20200401,5983
20200329,6,이태원,7962,7331,20200401,15293
20200329,6,한강진,3850,4531,20200401,8381
20200329,6,버티고개,744,814,20200401,1558
20200329,6,약수,1254,1214,20200401,2468
20200329,6,청구,1187,1144,20200401,2331
20200329,6,신당,2716,3571,20200401,6287
20200329,6,동묘앞,4183,4101,20200401,8284
20200329,6,창신,1072,977,20200401,2049
20200329,6,보문,2841,2713,20200401,5554
20200329,6,안암,3442,3696,20200401,7138
20200329,6,고려대,2650,2596,20200401,5246
20200329,6,월곡,4231,4047,20200401,8278
20200329,6,상월곡,2264,1992,20200401,4256
20200329,6,돌곶이,4450,4162,20200401,8612
20200329,6,석계,4714,4737,20200401,9451
20200329,6,태릉입구,2076,2341,20200401,4417
20200329,6,화랑대,3436,2856,20200401,6292
20200329,6,봉화산,2938,2831,20200401,5769
20200330,6,응암,14932,14924,20200402,29856
20200330,6,역촌,3135,3669,20200402,6804
20200330,6,불광,3684,3983,20200402,7667
20200330,6,독바위,2331,2469,20200402,4800
20200330,6,구산,6365,4643,20200402,11008
20200330,6,새절,11029,10291,20200402,21320
20200330,6,증산,8740,8609,20200402,17349
20200330,6,디지털미디어시티,11752,12692,20200402,24444
20200330,6,월드컵경기장,3854,4050,20200402,7904
20200330,6,마포구청,11747,10471,20200402,22218
20200330,6,망원,11149,12076,20200402,23225
20200330,6,합정,10613,10266,20200402,20879
20200330,6,상수,5940,6723,20200402,12663
20200330,6,광흥창,7513,7241,20200402,14754
20200330,6,대흥,6468,6816,20200402,13284
20200330,6,공덕,15516,15145,20200402,30661
20200330,6,효창공원앞,5997,5346,20200402,11343
20200330,6,삼각지,4541,3897,20200402,8438
20200330,6,녹사평,3758,3591,20200402,7349
20200330,6,이태원,7820,8133,20200402,15953
20200330,6,한강진,5135,6026,20200402,11161
20200330,6,버티고개,1855,1822,20200402,3677
20200330,6,약수,3150,3103,20200402,6253
20200330,6,청구,3216,3604,20200402,6820
20200330,6,신당,6194,6909,20200402,13103
20200330,6,동묘앞,6656,6892,20200402,13548
20200330,6,창신,2966,2419,20200402,5385
20200330,6,보문,6197,5811,20200402,12008
20200330,6,안암,7834,8050,20200402,15884
20200330,6,고려대,6203,6074,20200402,12277
20200330,6,월곡,9655,9508,20200402,19163
20200330,6,상월곡,5167,4576,20200402,9743
20200330,6,돌곶이,7632,7216,20200402,14848
20200330,6,석계,10512,10979,20200402,21491
20200330,6,태릉입구,4456,4982,20200402,9438
20200330,6,화랑대,9764,7383,20200402,17147
20200330,6,봉화산,8069,7226,20200402,15295
20200331,6,응암,15011,14861,20200403,29872
20200331,6,역촌,3145,3729,20200403,6874
20200331,6,불광,3801,3825,20200403,7626
20200331,6,독바위,2419,2564,20200403,4983
20200331,6,구산,6360,4518,20200403,10878
20200331,6,새절,11039,10278,20200403,21317
20200331,6,증산,8871,8735,20200403,17606
20200331,6,디지털미디어시티,11840,12652,20200403,24492
20200331,6,월드컵경기장,4044,4140,20200403,8184
20200331,6,마포구청,11837,10522,20200403,22359
20200331,6,망원,11457,12587,20200403,24044
20200331,6,합정,10842,10572,20200403,21414
20200331,6,상수,6421,7323,20200403,13744
20200331,6,광흥창,7400,7127,20200403,14527
20200331,6,대흥,6414,6744,20200403,13158
20200331,6,공덕,15745,15365,20200403,31110
20200331,6,효창공원앞,6008,5453,20200403,11461
20200331,6,삼각지,4609,4130,20200403,8739
20200331,6,녹사평,3923,3925,20200403,7848
20200331,6,이태원,8030,8569,20200403,16599
20200331,6,한강진,5839,6664,20200403,12503
20200331,6,버티고개,1836,1777,20200403,3613
20200331,6,약수,3169,3086,20200403,6255
20200331,6,청구,3302,3586,20200403,6888
20200331,6,신당,6319,6803,20200403,13122
20200331,6,동묘앞,6617,6753,20200403,13370
20200331,6,창신,3003,2352,20200403,5355
20200331,6,보문,6236,5796,20200403,12032
20200331,6,안암,8131,8036,20200403,16167
20200331,6,고려대,6320,6194,20200403,12514
20200331,6,월곡,9706,9514,20200403,19220
20200331,6,상월곡,5186,4629,20200403,9815
20200331,6,돌곶이,7588,7109,20200403,14697
20200331,6,석계,10794,10956,20200403,21750
20200331,6,태릉입구,4550,5126,20200403,9676
20200331,6,화랑대,9723,7375,20200403,17098
20200331,6,봉화산,8004,7282,20200403,15286
20200401,6,응암,15242,14934,20200404,30176
20200401,6,역촌,3119,3810,20200404,6929
20200401,6,불광,3795,3897,20200404,7692
20200401,6,독바위,2442,2565,20200404,5007
20200401,6,연신내,1,0,20200404,1
20200401,6,구산,6401,4617,20200404,11018
20200401,6,새절,11172,10552,20200404,21724
20200401,6,증산,9016,8859,20200404,17875
20200401,6,디지털미디어시티,11833,12850,20200404,24683
20200401,6,월드컵경기장,4054,4199,20200404,8253
20200401,6,마포구청,11824,10593,20200404,22417
20200401,6,망원,11643,12596,20200404,24239
20200401,6,합정,11161,10684,20200404,21845
20200401,6,상수,6528,7481,20200404,14009
20200401,6,광흥창,7390,7199,20200404,14589
20200401,6,대흥,6578,6736,20200404,13314
20200401,6,공덕,15777,15391,20200404,31168
20200401,6,효창공원앞,6021,5540,20200404,11561
20200401,6,삼각지,4630,4143,20200404,8773
20200401,6,녹사평,3880,3905,20200404,7785
20200401,6,이태원,8281,8763,20200404,17044
20200401,6,한강진,5455,6425,20200404,11880
20200401,6,버티고개,1856,1727,20200404,3583
20200401,6,약수,3188,3120,20200404,6308
20200401,6,청구,3284,3585,20200404,6869
20200401,6,신당,6450,6781,20200404,13231
20200401,6,동묘앞,6520,6653,20200404,13173
20200401,6,창신,2987,2355,20200404,5342
20200401,6,보문,6351,5826,20200404,12177
20200401,6,안암,8134,8340,20200404,16474
20200401,6,고려대,6305,6126,20200404,12431
20200401,6,월곡,9729,9449,20200404,19178
20200401,6,상월곡,5212,4659,20200404,9871
20200401,6,돌곶이,7649,7216,20200404,14865
20200401,6,석계,10758,10846,20200404,21604
20200401,6,태릉입구,4595,5128,20200404,9723
20200401,6,화랑대,9766,7374,20200404,17140
20200401,6,봉화산,7952,7140,20200404,15092
20200402,6,응암,15218,15066,20200405,30284
20200402,6,역촌,3151,3646,20200405,6797
20200402,6,불광,3608,3858,20200405,7466
20200402,6,독바위,2330,2508,20200405,4838
20200402,6,구산,6404,4587,20200405,10991
20200402,6,새절,11260,10628,20200405,21888
20200402,6,증산,8807,8597,20200405,17404
20200402,6,디지털미디어시티,11667,12741,20200405,24408
20200402,6,월드컵경기장,4166,4182,20200405,8348
20200402,6,마포구청,11902,10596,20200405,22498
20200402,6,망원,11566,12740,20200405,24306
20200402,6,합정,10975,10967,20200405,21942
20200402,6,상수,6596,7424,20200405,14020
20200402,6,광흥창,7350,7137,20200405,14487
20200402,6,대흥,6332,6759,20200405,13091
20200402,6,공덕,15506,15172,20200405,30678
20200402,6,효창공원앞,5967,5412,20200405,11379
20200402,6,삼각지,4545,4058,20200405,8603
20200402,6,녹사평,3950,3949,20200405,7899
20200402,6,이태원,8149,8763,20200405,16912
20200402,6,한강진,5451,6628,20200405,12079
20200402,6,버티고개,1857,1717,20200405,3574
20200402,6,약수,3073,3117,20200405,6190
20200402,6,청구,3237,3631,20200405,6868
20200402,6,신당,6357,6927,20200405,13284
20200402,6,동묘앞,6664,6595,20200405,13259
20200402,6,창신,2926,2356,20200405,5282
20200402,6,보문,6304,5799,20200405,12103
20200402,6,안암,8005,8209,20200405,16214
20200402,6,고려대,6183,5934,20200405,12117
20200402,6,월곡,9696,9459,20200405,19155
20200402,6,상월곡,5178,4624,20200405,9802
20200402,6,돌곶이,7635,7043,20200405,14678
20200402,6,석계,10659,10856,20200405,21515
20200402,6,태릉입구,4552,5122,20200405,9674
20200402,6,화랑대,9870,7505,20200405,17375
20200402,6,봉화산,8149,7203,20200405,15352
20200403,6,응암,15486,14991,20200406,30477
20200403,6,역촌,3190,3662,20200406,6852
20200403,6,불광,3717,3875,20200406,7592
20200403,6,독바위,2461,2489,20200406,4950
20200403,6,연신내,1,0,20200406,1
20200403,6,구산,6487,4549,20200406,11036
20200403,6,새절,11379,10605,20200406,21984
20200403,6,증산,9145,8879,20200406,18024
20200403,6,디지털미디어시티,11849,12547,20200406,24396
20200403,6,월드컵경기장,4120,4197,20200406,8317
20200403,6,마포구청,12149,10592,20200406,22741
20200403,6,망원,12350,13553,20200406,25903
20200403,6,합정,11700,12064,20200406,23764
20200403,6,상수,7106,8881,20200406,15987
20200403,6,광흥창,7507,7225,20200406,14732
20200403,6,대흥,6663,6706,20200406,13369
20200403,6,공덕,15857,15806,20200406,31663
20200403,6,효창공원앞,6089,5483,20200406,11572
20200403,6,삼각지,5001,4296,20200406,9297
20200403,6,녹사평,4218,4538,20200406,8756
20200403,6,이태원,9530,11767,20200406,21297
20200403,6,한강진,5838,7257,20200406,13095
20200403,6,버티고개,1901,1709,20200406,3610
20200403,6,약수,3057,3115,20200406,6172
20200403,6,청구,3356,3646,20200406,7002
20200403,6,신당,6457,6996,20200406,13453
20200403,6,동묘앞,6931,7004,20200406,13935
20200403,6,창신,3062,2404,20200406,5466
20200403,6,보문,6553,5861,20200406,12414
20200403,6,안암,8796,8710,20200406,17506
20200403,6,고려대,6637,6229,20200406,12866
20200403,6,월곡,10034,9556,20200406,19590
20200403,6,상월곡,5350,4641,20200406,9991
20200403,6,돌곶이,7689,6994,20200406,14683
20200403,6,석계,10873,10990,20200406,21863
20200403,6,태릉입구,4660,5234,20200406,9894
20200403,6,화랑대,9937,7343,20200406,17280
20200403,6,봉화산,8086,7153,20200406,15239
20200404,6,응암,10077,10130,20200407,20207
20200404,6,역촌,1889,2228,20200407,4117
20200404,6,불광,3175,2946,20200407,6121
20200404,6,독바위,1604,1945,20200407,3549
20200404,6,구산,4010,2884,20200407,6894
20200404,6,새절,7214,6899,20200407,14113
20200404,6,증산,6204,6183,20200407,12387
20200404,6,디지털미디어시티,5529,5525,20200407,11054
20200404,6,월드컵경기장,3632,3703,20200407,7335
20200404,6,마포구청,7065,6007,20200407,13072
20200404,6,망원,9600,10903,20200407,20503
20200404,6,합정,9294,8897,20200407,18191
20200404,6,상수,5680,7248,20200407,12928
20200404,6,광흥창,3625,3391,20200407,7016
20200404,6,대흥,3879,3908,20200407,7787
20200404,6,공덕,7408,7184,20200407,14592
20200404,6,효창공원앞,3447,3053,20200407,6500
20200404,6,삼각지,2932,2315,20200407,5247
20200404,6,녹사평,3897,4322,20200407,8219
20200404,6,이태원,10263,11897,20200407,22160
20200404,6,한강진,4509,5794,20200407,10303
20200404,6,버티고개,1140,1152,20200407,2292
20200404,6,약수,1915,1916,20200407,3831
20200404,6,청구,1988,2049,20200407,4037
20200404,6,신당,4151,3271,20200407,7422
20200404,6,동묘앞,5608,4980,20200407,10588
20200404,6,창신,1630,1372,20200407,3002
20200404,6,보문,4086,3647,20200407,7733
20200404,6,안암,5137,4875,20200407,10012
20200404,6,고려대,3820,3621,20200407,7441
20200404,6,월곡,5933,5823,20200407,11756
20200404,6,상월곡,3122,2614,20200407,5736
20200404,6,돌곶이,4642,4327,20200407,8969
20200404,6,석계,6772,6589,20200407,13361
20200404,6,태릉입구,3081,3329,20200407,6410
20200404,6,화랑대,4955,4113,20200407,9068
20200404,6,봉화산,4171,3940,20200407,8111
20200405,6,응암,7143,7351,20200408,14494
20200405,6,역촌,1342,1621,20200408,2963
20200405,6,불광,2341,2180,20200408,4521
20200405,6,독바위,1157,1555,20200408,2712
20200405,6,구산,2882,2111,20200408,4993
20200405,6,새절,4975,4989,20200408,9964
20200405,6,증산,4411,4409,20200408,8820
20200405,6,디지털미디어시티,3822,3865,20200408,7687
20200405,6,월드컵경기장,3059,3041,20200408,6100
20200405,6,마포구청,5041,4525,20200408,9566
20200405,6,망원,6654,7225,20200408,13879
20200405,6,합정,6543,5987,20200408,12530
20200405,6,상수,4050,4625,20200408,8675
20200405,6,광흥창,2572,2450,20200408,5022
20200405,6,대흥,2599,2639,20200408,5238
20200405,6,공덕,4730,4437,20200408,9167
20200405,6,효창공원앞,2401,2101,20200408,4502
20200405,6,삼각지,1943,1499,20200408,3442
20200405,6,녹사평,2826,2946,20200408,5772
20200405,6,이태원,7728,6964,20200408,14692
20200405,6,한강진,3127,3803,20200408,6930
20200405,6,버티고개,712,802,20200408,1514
20200405,6,약수,1179,1197,20200408,2376
20200405,6,청구,1184,1147,20200408,2331
20200405,6,신당,2285,3133,20200408,5418
20200405,6,동묘앞,4156,4006,20200408,8162
20200405,6,창신,1141,949,20200408,2090
20200405,6,보문,2781,2670,20200408,5451
20200405,6,안암,3347,3605,20200408,6952
20200405,6,고려대,2848,2795,20200408,5643
20200405,6,월곡,4126,3967,20200408,8093
20200405,6,상월곡,2198,1954,20200408,4152
20200405,6,돌곶이,4224,4080,20200408,8304
20200405,6,석계,4811,4854,20200408,9665
20200405,6,태릉입구,2099,2421,20200408,4520
20200405,6,화랑대,3332,2948,20200408,6280
20200405,6,봉화산,2886,2747,20200408,5633
20200406,6,응암,15511,15447,20200409,30958
20200406,6,역촌,3171,3715,20200409,6886
20200406,6,불광,3754,3979,20200409,7733
20200406,6,독바위,2386,2559,20200409,4945
20200406,6,연신내,2,0,20200409,2
20200406,6,구산,6510,4827,20200409,11337
20200406,6,새절,11353,10687,20200409,22040
20200406,6,증산,9017,8775,20200409,17792
20200406,6,디지털미디어시티,12018,12912,20200409,24930
20200406,6,월드컵경기장,3962,4129,20200409,8091
20200406,6,마포구청,12039,10669,20200409,22708
20200406,6,망원,11357,12243,20200409,23600
20200406,6,합정,10699,10488,20200409,21187
20200406,6,상수,6322,7120,20200409,13442
20200406,6,광흥창,7637,7491,20200409,15128
20200406,6,대흥,6510,6911,20200409,13421
20200406,6,공덕,15940,15834,20200409,31774
20200406,6,효창공원앞,6092,5480,20200409,11572
20200406,6,삼각지,4592,4020,20200409,8612
20200406,6,녹사평,3664,3584,20200409,7248
20200406,6,이태원,7685,8096,20200409,15781
20200406,6,한강진,5125,5867,20200409,10992
20200406,6,버티고개,1951,1842,20200409,3793
20200406,6,약수,3192,3084,20200409,6276
20200406,6,청구,3336,3698,20200409,7034
20200406,6,신당,6617,7205,20200409,13822
20200406,6,동묘앞,6770,7073,20200409,13843
20200406,6,창신,3028,2421,20200409,5449
20200406,6,보문,6309,5857,20200409,12166
20200406,6,안암,8114,8412,20200409,16526
20200406,6,고려대,6400,6301,20200409,12701
20200406,6,월곡,9994,9880,20200409,19874
20200406,6,상월곡,5378,4716,20200409,10094
20200406,6,돌곶이,7729,7254,20200409,14983
20200406,6,석계,10913,11271,20200409,22184
20200406,6,태릉입구,4522,4987,20200409,9509
20200406,6,화랑대,10190,7687,20200409,17877
20200406,6,봉화산,8264,7461,20200409,15725
20200407,6,응암,15322,15388,20200410,30710
20200407,6,역촌,3168,3723,20200410,6891
20200407,6,불광,3827,3863,20200410,7690
20200407,6,독바위,2438,2532,20200410,4970
20200407,6,구산,6443,4636,20200410,11079
20200407,6,새절,11352,10758,20200410,22110
20200407,6,증산,9167,8972,20200410,18139
20200407,6,디지털미디어시티,12041,12978,20200410,25019
20200407,6,월드컵경기장,3912,4136,20200410,8048
20200407,6,마포구청,12245,11026,20200410,23271
20200407,6,망원,11674,12642,20200410,24316
20200407,6,합정,10927,10770,20200410,21697
20200407,6,상수,6675,7610,20200410,14285
20200407,6,광흥창,7635,7294,20200410,14929
20200407,6,대흥,6662,7012,20200410,13674
20200407,6,공덕,16086,15795,20200410,31881
20200407,6,효창공원앞,6132,5458,20200410,11590
20200407,6,삼각지,4778,4149,20200410,8927
20200407,6,녹사평,3807,3854,20200410,7661
20200407,6,이태원,8003,8351,20200410,16354
20200407,6,한강진,5417,6420,20200410,11837
20200407,6,버티고개,1859,1859,20200410,3718
20200407,6,약수,3101,3133,20200410,6234
20200407,6,청구,3323,3686,20200410,7009
20200407,6,신당,6612,7287,20200410,13899
20200407,6,동묘앞,6907,6937,20200410,13844
20200407,6,창신,3035,2496,20200410,5531
20200407,6,보문,6387,5955,20200410,12342
20200407,6,안암,8293,8354,20200410,16647
20200407,6,고려대,6426,6355,20200410,12781
20200407,6,월곡,9832,9593,20200410,19425
20200407,6,상월곡,5319,4705,20200410,10024
20200407,6,돌곶이,7763,7294,20200410,15057
20200407,6,석계,10982,11078,20200410,22060
20200407,6,태릉입구,4542,5098,20200410,9640
20200407,6,화랑대,10080,7759,20200410,17839
20200407,6,봉화산,8142,7428,20200410,15570
20200408,6,응암,15452,15226,20200411,30678
20200408,6,역촌,3085,3659,20200411,6744
20200408,6,불광,3954,3995,20200411,7949
20200408,6,독바위,2423,2558,20200411,4981
20200408,6,연신내,3,0,20200411,3
20200408,6,구산,6485,4695,20200411,11180
20200408,6,새절,11467,10813,20200411,22280
20200408,6,증산,8965,8787,20200411,17752
20200408,6,디지털미디어시티,12154,13137,20200411,25291
20200408,6,월드컵경기장,3895,4054,20200411,7949
20200408,6,마포구청,12190,11022,20200411,23212
20200408,6,망원,11819,12932,20200411,24751
20200408,6,합정,11417,11157,20200411,22574
20200408,6,상수,6927,7726,20200411,14653
20200408,6,광흥창,7721,7632,20200411,15353
20200408,6,대흥,6728,7105,20200411,13833
20200408,6,공덕,16139,15837,20200411,31976
20200408,6,효창공원앞,6212,5611,20200411,11823
20200408,6,삼각지,4823,4248,20200411,9071
20200408,6,녹사평,4048,4086,20200411,8134
20200408,6,이태원,8148,8514,20200411,16662
20200408,6,한강진,5726,6711,20200411,12437
20200408,6,버티고개,1906,1822,20200411,3728
20200408,6,약수,3182,3187,20200411,6369
20200408,6,청구,3343,3737,20200411,7080
20200408,6,신당,6845,7344,20200411,14189
20200408,6,동묘앞,6822,6920,20200411,13742
20200408,6,창신,3187,2590,20200411,5777
20200408,6,보문,6341,5925,20200411,12266
20200408,6,안암,8283,8429,20200411,16712
20200408,6,고려대,6518,6282,20200411,12800
20200408,6,월곡,9934,9634,20200411,19568
20200408,6,상월곡,5364,4690,20200411,10054
20200408,6,돌곶이,7900,7448,20200411,15348
20200408,6,석계,10935,11234,20200411,22169
20200408,6,태릉입구,4603,5158,20200411,9761
20200408,6,화랑대,10191,7792,20200411,17983
20200408,6,봉화산,8351,7488,20200411,15839
20200409,6,응암,15288,15082,20200412,30370
20200409,6,역촌,3094,3700,20200412,6794
20200409,6,불광,3836,3907,20200412,7743
20200409,6,독바위,2420,2568,20200412,4988
20200409,6,구산,6398,4684,20200412,11082
20200409,6,새절,11307,10602,20200412,21909
20200409,6,증산,8986,8700,20200412,17686
20200409,6,디지털미디어시티,11954,12949,20200412,24903
20200409,6,월드컵경기장,3962,4131,20200412,8093
20200409,6,마포구청,12332,11111,20200412,23443
20200409,6,망원,12010,13084,20200412,25094
20200409,6,합정,11232,11166,20200412,22398
20200409,6,상수,6903,7767,20200412,14670
20200409,6,광흥창,7603,7394,20200412,14997
20200409,6,대흥,6676,7018,20200412,13694
20200409,6,공덕,15749,15532,20200412,31281
20200409,6,효창공원앞,6173,5497,20200412,11670
20200409,6,삼각지,4917,4247,20200412,9164
20200409,6,녹사평,3867,3919,20200412,7786
20200409,6,이태원,7897,8380,20200412,16277
20200409,6,한강진,5580,6817,20200412,12397
20200409,6,버티고개,1896,1843,20200412,3739
20200409,6,약수,3290,3213,20200412,6503
20200409,6,청구,3428,3708,20200412,7136
20200409,6,신당,6689,7150,20200412,13839
20200409,6,동묘앞,6851,6935,20200412,13786
20200409,6,창신,3157,2599,20200412,5756
20200409,6,보문,6539,6034,20200412,12573
20200409,6,안암,8305,8395,20200412,16700
20200409,6,고려대,6462,6336,20200412,12798
20200409,6,월곡,9952,9580,20200412,19532
20200409,6,상월곡,5356,4757,20200412,10113
20200409,6,돌곶이,7636,7104,20200412,14740
20200409,6,석계,10907,11148,20200412,22055
20200409,6,태릉입구,4597,5100,20200412,9697
20200409,6,화랑대,10101,7577,20200412,17678
20200409,6,봉화산,8181,7348,20200412,15529
20200410,6,응암,15840,15354,20200413,31194
20200410,6,역촌,3250,3724,20200413,6974
20200410,6,불광,3954,4054,20200413,8008
20200410,6,독바위,2435,2560,20200413,4995
20200410,6,연신내,1,0,20200413,1
20200410,6,구산,6751,4707,20200413,11458
20200410,6,새절,11585,10644,20200413,22229
20200410,6,증산,9140,8620,20200413,17760
20200410,6,디지털미디어시티,11655,12585,20200413,24240
20200410,6,월드컵경기장,3978,4246,20200413,8224
20200410,6,마포구청,12385,10568,20200413,22953
20200410,6,망원,12339,13835,20200413,26174
20200410,6,합정,12032,12268,20200413,24300
20200410,6,상수,7483,9023,20200413,16506
20200410,6,광흥창,7849,7465,20200413,15314
20200410,6,대흥,6731,6798,20200413,13529
20200410,6,공덕,16324,16205,20200413,32529
20200410,6,효창공원앞,6368,5549,20200413,11917
20200410,6,삼각지,4894,4254,20200413,9148
20200410,6,녹사평,4246,4442,20200413,8688
20200410,6,이태원,8668,10109,20200413,18777
20200410,6,한강진,5831,7244,20200413,13075
20200410,6,버티고개,1933,1787,20200413,3720
20200410,6,약수,3284,3257,20200413,6541
20200410,6,청구,3584,3809,20200413,7393
20200410,6,신당,6535,7078,20200413,13613
20200410,6,동묘앞,7059,7144,20200413,14203
20200410,6,창신,3108,2446,20200413,5554
20200410,6,보문,6712,6054,20200413,12766
20200410,6,안암,8942,8898,20200413,17840
20200410,6,고려대,6983,6536,20200413,13519
20200410,6,월곡,10208,9770,20200413,19978
20200410,6,상월곡,5524,4722,20200413,10246
20200410,6,돌곶이,7910,7322,20200413,15232
20200410,6,석계,11309,11282,20200413,22591
20200410,6,태릉입구,4828,5295,20200413,10123
20200410,6,화랑대,10235,7651,20200413,17886
20200410,6,봉화산,8333,7379,20200413,15712
20200411,6,응암,10411,10287,20200414,20698
20200411,6,역촌,1918,2306,20200414,4224
20200411,6,불광,3319,3150,20200414,6469
20200411,6,독바위,1695,1985,20200414,3680
20200411,6,구산,4278,3142,20200414,7420
20200411,6,새절,7314,6967,20200414,14281
20200411,6,증산,6317,6105,20200414,12422
20200411,6,디지털미디어시티,5601,5608,20200414,11209
20200411,6,월드컵경기장,3793,3911,20200414,7704
20200411,6,마포구청,7265,6223,20200414,13488
20200411,6,망원,9952,10934,20200414,20886
20200411,6,합정,9197,9100,20200414,18297
20200411,6,상수,5869,7526,20200414,13395
20200411,6,광흥창,4027,3567,20200414,7594
20200411,6,대흥,3978,4066,20200414,8044
20200411,6,공덕,7781,7489,20200414,15270
20200411,6,효창공원앞,3784,3343,20200414,7127
20200411,6,삼각지,3125,2381,20200414,5506
20200411,6,녹사평,3849,4182,20200414,8031
20200411,6,이태원,9106,10227,20200414,19333
20200411,6,한강진,4609,5945,20200414,10554
20200411,6,버티고개,1163,1187,20200414,2350
20200411,6,약수,2068,1980,20200414,4048
20200411,6,청구,2073,2082,20200414,4155
20200411,6,신당,4115,3281,20200414,7396
20200411,6,동묘앞,6109,5462,20200414,11571
20200411,6,창신,1690,1318,20200414,3008
20200411,6,보문,4263,3770,20200414,8033
20200411,6,안암,5147,4920,20200414,10067
20200411,6,고려대,4182,3935,20200414,8117
20200411,6,월곡,6003,5786,20200414,11789
20200411,6,상월곡,3276,2901,20200414,6177
20200411,6,돌곶이,4907,4510,20200414,9417
20200411,6,석계,7010,6885,20200414,13895
20200411,6,태릉입구,3155,3331,20200414,6486
20200411,6,화랑대,5090,4419,20200414,9509
20200411,6,봉화산,4330,4099,20200414,8429
20200412,6,응암,6807,7023,20200415,13830
20200412,6,역촌,1438,1620,20200415,3058
20200412,6,불광,2503,2375,20200415,4878
20200412,6,독바위,1267,1652,20200415,2919
20200412,6,구산,2830,2083,20200415,4913
20200412,6,새절,5048,4881,20200415,9929
20200412,6,증산,4234,4301,20200415,8535
20200412,6,디지털미디어시티,3825,3939,20200415,7764
20200412,6,월드컵경기장,2513,2575,20200415,5088
20200412,6,마포구청,5259,4645,20200415,9904
20200412,6,망원,6949,7481,20200415,14430
20200412,6,합정,6524,5870,20200415,12394
20200412,6,상수,4133,4712,20200415,8845
20200412,6,광흥창,2651,2539,20200415,5190
20200412,6,대흥,2640,2741,20200415,5381
20200412,6,공덕,4899,4604,20200415,9503
20200412,6,효창공원앞,2435,2217,20200415,4652
20200412,6,삼각지,2150,1537,20200415,3687
20200412,6,녹사평,2838,2829,20200415,5667
20200412,6,이태원,7214,6469,20200415,13683
20200412,6,한강진,3193,3845,20200415,7038
20200412,6,버티고개,821,862,20200415,1683
20200412,6,약수,1226,1279,20200415,2505
20200412,6,청구,1234,1231,20200415,2465
20200412,6,신당,2521,3298,20200415,5819
20200412,6,동묘앞,4647,4513,20200415,9160
20200412,6,창신,1193,1037,20200415,2230
20200412,6,보문,2873,2665,20200415,5538
20200412,6,안암,3494,3654,20200415,7148
20200412,6,고려대,2823,2804,20200415,5627
20200412,6,월곡,4113,4049,20200415,8162
20200412,6,상월곡,2345,2065,20200415,4410
20200412,6,돌곶이,4610,4424,20200415,9034
20200412,6,석계,4932,4944,20200415,9876
20200412,6,태릉입구,2134,2417,20200415,4551
20200412,6,화랑대,3432,2963,20200415,6395
20200412,6,봉화산,3034,2878,20200415,5912
20200413,6,응암,15479,15417,20200416,30896
20200413,6,역촌,3208,3771,20200416,6979
20200413,6,불광,3847,3966,20200416,7813
20200413,6,독바위,2495,2625,20200416,5120
20200413,6,구산,6580,4790,20200416,11370
20200413,6,새절,11521,10847,20200416,22368
20200413,6,증산,9028,8789,20200416,17817
20200413,6,디지털미디어시티,12197,13011,20200416,25208
20200413,6,월드컵경기장,4104,4228,20200416,8332
20200413,6,마포구청,12285,10804,20200416,23089
20200413,6,망원,11727,12777,20200416,24504
20200413,6,합정,10852,10759,20200416,21611
20200413,6,상수,6511,7332,20200416,13843
20200413,6,광흥창,7853,7725,20200416,15578
20200413,6,대흥,6655,6916,20200416,13571
20200413,6,공덕,16458,16378,20200416,32836
20200413,6,효창공원앞,6266,5591,20200416,11857
20200413,6,삼각지,4625,4082,20200416,8707
20200413,6,녹사평,3756,3634,20200416,7390
20200413,6,이태원,7625,7891,20200416,15516
20200413,6,한강진,5247,6201,20200416,11448
20200413,6,버티고개,1960,1867,20200416,3827
20200413,6,약수,3136,3238,20200416,6374
20200413,6,청구,3460,3771,20200416,7231
20200413,6,신당,6465,7091,20200416,13556
20200413,6,동묘앞,6933,7153,20200416,14086
20200413,6,창신,3098,2544,20200416,5642
20200413,6,보문,6472,5985,20200416,12457
20200413,6,안암,8266,8535,20200416,16801
20200413,6,고려대,6393,6293,20200416,12686
20200413,6,월곡,10170,9849,20200416,20019
20200413,6,상월곡,5362,4837,20200416,10199
20200413,6,돌곶이,8088,7599,20200416,15687
20200413,6,석계,10894,11213,20200416,22107
20200413,6,태릉입구,4643,5241,20200416,9884
20200413,6,화랑대,10221,7826,20200416,18047
20200413,6,봉화산,8434,7569,20200416,16003
20200414,6,응암,15790,15217,20200417,31007
20200414,6,역촌,3244,3821,20200417,7065
20200414,6,불광,4015,4147,20200417,8162
20200414,6,독바위,2531,2584,20200417,5115
20200414,6,연신내,3,0,20200417,3
20200414,6,구산,6822,4782,20200417,11604
20200414,6,새절,11841,10866,20200417,22707
20200414,6,증산,9359,8772,20200417,18131
20200414,6,디지털미디어시티,12343,13208,20200417,25551
20200414,6,월드컵경기장,4379,4474,20200417,8853
20200414,6,마포구청,12684,11083,20200417,23767
20200414,6,망원,12381,13627,20200417,26008
20200414,6,합정,11829,12193,20200417,24022
20200414,6,상수,7203,8726,20200417,15929
20200414,6,광흥창,7828,7506,20200417,15334
20200414,6,대흥,6868,7154,20200417,14022
20200414,6,공덕,17088,17038,20200417,34126
20200414,6,효창공원앞,6439,5842,20200417,12281
20200414,6,삼각지,5209,4625,20200417,9834
20200414,6,녹사평,4192,4175,20200417,8367
20200414,6,이태원,8190,9524,20200417,17714
20200414,6,한강진,5581,6978,20200417,12559
20200414,6,버티고개,2025,1845,20200417,3870
20200414,6,약수,3272,3231,20200417,6503
20200414,6,청구,3650,3838,20200417,7488
20200414,6,신당,6931,7506,20200417,14437
20200414,6,동묘앞,7610,8307,20200417,15917
20200414,6,창신,3184,2460,20200417,5644
20200414,6,보문,6643,6094,20200417,12737
20200414,6,안암,8794,8821,20200417,17615
20200414,6,고려대,6710,6382,20200417,13092
20200414,6,월곡,10463,9862,20200417,20325
20200414,6,상월곡,5522,4718,20200417,10240
20200414,6,돌곶이,8604,7728,20200417,16332
20200414,6,석계,14782,11907,20200417,26689
20200414,6,태릉입구,4867,5376,20200417,10243
20200414,6,화랑대,10403,7702,20200417,18105
20200414,6,봉화산,8419,7454,20200417,15873
20200415,6,응암,9177,9143,20200418,18320
20200415,6,역촌,1868,2214,20200418,4082
20200415,6,불광,2983,2774,20200418,5757
20200415,6,독바위,1465,1823,20200418,3288
20200415,6,연신내,1,0,20200418,1
20200415,6,구산,3849,2823,20200418,6672
20200415,6,새절,6559,6362,20200418,12921
20200415,6,증산,5535,5531,20200418,11066
20200415,6,디지털미디어시티,5020,5304,20200418,10324
20200415,6,월드컵경기장,3648,3890,20200418,7538
20200415,6,마포구청,6592,5811,20200418,12403
20200415,6,망원,8813,9532,20200418,18345
20200415,6,합정,7913,7457,20200418,15370
20200415,6,상수,4787,5770,20200418,10557
20200415,6,광흥창,3531,3475,20200418,7006
20200415,6,대흥,3576,3556,20200418,7132
20200415,6,공덕,6532,6469,20200418,13001
20200415,6,효창공원앞,3448,3016,20200418,6464
20200415,6,삼각지,2660,1986,20200418,4646
20200415,6,녹사평,3485,3408,20200418,6893
20200415,6,이태원,7741,7595,20200418,15336
20200415,6,한강진,4072,5182,20200418,9254
20200415,6,버티고개,999,1064,20200418,2063
20200415,6,약수,1729,1736,20200418,3465
20200415,6,청구,2007,2211,20200418,4218
20200415,6,신당,4679,4753,20200418,9432
20200415,6,동묘앞,5271,4969,20200418,10240
20200415,6,창신,1552,1446,20200418,2998
20200415,6,보문,3807,3574,20200418,7381
20200415,6,안암,4442,4494,20200418,8936
20200415,6,고려대,3563,3320,20200418,6883
20200415,6,월곡,5568,5486,20200418,11054
20200415,6,상월곡,3171,2758,20200418,5929
20200415,6,돌곶이,4821,4398,20200418,9219
20200415,6,석계,6692,6601,20200418,13293
20200415,6,태릉입구,2832,3227,20200418,6059
20200415,6,화랑대,4739,4040,20200418,8779
20200415,6,봉화산,4017,3850,20200418,7867
20200416,6,응암,15617,15362,20200419,30979
20200416,6,역촌,3213,3758,20200419,6971
20200416,6,불광,3859,3959,20200419,7818
20200416,6,독바위,2449,2618,20200419,5067
20200416,6,구산,6637,4806,20200419,11443
20200416,6,새절,11521,10679,20200419,22200
20200416,6,증산,9014,8760,20200419,17774
20200416,6,디지털미디어시티,12198,13208,20200419,25406
20200416,6,월드컵경기장,4155,4239,20200419,8394
20200416,6,마포구청,12388,10937,20200419,23325
20200416,6,망원,12400,13834,20200419,26234
20200416,6,합정,11360,11149,20200419,22509
20200416,6,상수,6929,7849,20200419,14778
20200416,6,광흥창,7851,7646,20200419,15497
20200416,6,대흥,6811,7181,20200419,13992
20200416,6,공덕,16816,16461,20200419,33277
20200416,6,효창공원앞,6317,5583,20200419,11900
20200416,6,삼각지,5019,4362,20200419,9381
20200416,6,녹사평,4204,4160,20200419,8364
20200416,6,이태원,8495,8850,20200419,17345
20200416,6,한강진,5703,6864,20200419,12567
20200416,6,버티고개,1980,1863,20200419,3843
20200416,6,약수,3142,3221,20200419,6363
20200416,6,청구,3547,3780,20200419,7327
20200416,6,신당,6714,7309,20200419,14023
20200416,6,동묘앞,6866,7193,20200419,14059
20200416,6,창신,3072,2520,20200419,5592
20200416,6,보문,6522,6016,20200419,12538
20200416,6,안암,8504,8567,20200419,17071
20200416,6,고려대,6691,6508,20200419,13199
20200416,6,월곡,10094,9768,20200419,19862
20200416,6,상월곡,5496,4892,20200419,10388
20200416,6,돌곶이,8168,7588,20200419,15756
20200416,6,석계,10982,11423,20200419,22405
20200416,6,태릉입구,4859,5284,20200419,10143
20200416,6,화랑대,10332,7765,20200419,18097
20200416,6,봉화산,8435,7530,20200419,15965
20200417,6,응암,15290,14842,20200420,30132
20200417,6,역촌,3222,3659,20200420,6881
20200417,6,불광,3816,3954,20200420,7770
20200417,6,독바위,2464,2427,20200420,4891
20200417,6,구산,6504,4632,20200420,11136
20200417,6,새절,11393,10493,20200420,21886
20200417,6,증산,8933,8391,20200420,17324
20200417,6,디지털미디어시티,11899,12897,20200420,24796
20200417,6,월드컵경기장,3317,3584,20200420,6901
20200417,6,마포구청,12223,10707,20200420,22930
20200417,6,망원,12122,13503,20200420,25625
20200417,6,합정,11492,11710,20200420,23202
20200417,6,상수,7140,8894,20200420,16034
20200417,6,광흥창,7745,7375,20200420,15120
20200417,6,대흥,6902,7055,20200420,13957
20200417,6,공덕,16653,16405,20200420,33058
20200417,6,효창공원앞,6167,5512,20200420,11679
20200417,6,삼각지,4993,4397,20200420,9390
20200417,6,녹사평,3978,4285,20200420,8263
20200417,6,이태원,8523,9859,20200420,18382
20200417,6,한강진,5637,6873,20200420,12510
20200417,6,버티고개,1975,1808,20200420,3783
20200417,6,약수,3152,3247,20200420,6399
20200417,6,청구,3521,3724,20200420,7245
20200417,6,신당,6655,7184,20200420,13839
20200417,6,동묘앞,6533,6730,20200420,13263
20200417,6,창신,3129,2292,20200420,5421
20200417,6,보문,6648,5915,20200420,12563
20200417,6,안암,8857,8863,20200420,17720
20200417,6,고려대,6844,6302,20200420,13146
20200417,6,월곡,10107,9620,20200420,19727
20200417,6,상월곡,5510,4697,20200420,10207
20200417,6,돌곶이,8055,7323,20200420,15378
20200417,6,석계,11243,11356,20200420,22599
20200417,6,태릉입구,4689,5160,20200420,9849
20200417,6,화랑대,10278,7665,20200420,17943
20200417,6,봉화산,8273,7322,20200420,15595
20200418,6,응암,10841,10546,20200421,21387
20200418,6,역촌,2098,2523,20200421,4621
20200418,6,불광,3503,3440,20200421,6943
20200418,6,독바위,1895,2286,20200421,4181
20200418,6,구산,4521,3268,20200421,7789
20200418,6,새절,7795,7257,20200421,15052
20200418,6,증산,6609,6280,20200421,12889
20200418,6,디지털미디어시티,6071,6013,20200421,12084
20200418,6,월드컵경기장,4437,4666,20200421,9103
20200418,6,마포구청,8193,6661,20200421,14854
20200418,6,망원,10883,12212,20200421,23095
20200418,6,합정,10009,9743,20200421,19752
20200418,6,상수,6123,8027,20200421,14150
20200418,6,광흥창,4203,3814,20200421,8017
20200418,6,대흥,4259,4303,20200421,8562
20200418,6,공덕,8107,7861,20200421,15968
20200418,6,효창공원앞,3923,3328,20200421,7251
20200418,6,삼각지,3611,2685,20200421,6296
20200418,6,녹사평,4508,5005,20200421,9513
20200418,6,이태원,11308,13236,20200421,24544
20200418,6,한강진,5091,6815,20200421,11906
20200418,6,버티고개,1216,1342,20200421,2558
20200418,6,약수,2039,2217,20200421,4256
20200418,6,청구,2060,2136,20200421,4196
20200418,6,신당,4562,3720,20200421,8282
20200418,6,동묘앞,6495,6107,20200421,12602
20200418,6,창신,1815,1521,20200421,3336
20200418,6,보문,4425,3866,20200421,8291
20200418,6,안암,5510,5412,20200421,10922
20200418,6,고려대,4702,4331,20200421,9033
20200418,6,월곡,6632,6319,20200421,12951
20200418,6,상월곡,3525,3128,20200421,6653
20200418,6,돌곶이,5161,4736,20200421,9897
20200418,6,석계,7663,7412,20200421,15075
20200418,6,태릉입구,3418,3748,20200421,7166
20200418,6,화랑대,5694,4627,20200421,10321
20200418,6,봉화산,4778,4529,20200421,9307
20200419,6,응암,6991,7015,20200422,14006
20200419,6,역촌,1464,1693,20200422,3157
20200419,6,불광,2420,2216,20200422,4636
20200419,6,독바위,1228,1603,20200422,2831
20200419,6,구산,2895,2260,20200422,5155
20200419,6,새절,4965,4933,20200422,9898
20200419,6,증산,4109,4319,20200422,8428
20200419,6,디지털미디어시티,3797,3863,20200422,7660
20200419,6,월드컵경기장,2899,2769,20200422,5668
20200419,6,마포구청,5038,4678,20200422,9716
20200419,6,망원,6776,7150,20200422,13926
20200419,6,합정,6326,5840,20200422,12166
20200419,6,상수,4211,4755,20200422,8966
20200419,6,광흥창,2690,2590,20200422,5280
20200419,6,대흥,2664,2772,20200422,5436
20200419,6,공덕,4963,4751,20200422,9714
20200419,6,효창공원앞,2375,2106,20200422,4481
20200419,6,삼각지,2031,1558,20200422,3589
20200419,6,녹사평,2688,2679,20200422,5367
20200419,6,이태원,7447,6905,20200422,14352
20200419,6,한강진,3305,3829,20200422,7134
20200419,6,버티고개,778,906,20200422,1684
20200419,6,약수,1269,1250,20200422,2519
20200419,6,청구,1149,1281,20200422,2430
20200419,6,신당,2657,3334,20200422,5991
20200419,6,동묘앞,4324,4199,20200422,8523
20200419,6,창신,1162,1068,20200422,2230
20200419,6,보문,2805,2692,20200422,5497
20200419,6,안암,3591,3738,20200422,7329
20200419,6,고려대,2742,2901,20200422,5643
20200419,6,월곡,4417,4340,20200422,8757
20200419,6,상월곡,2386,2178,20200422,4564
20200419,6,돌곶이,4262,4044,20200422,8306
20200419,6,석계,5080,5067,20200422,10147
20200419,6,태릉입구,2233,2506,20200422,4739
20200419,6,화랑대,3554,3135,20200422,6689
20200419,6,봉화산,3059,2979,20200422,6038
20200420,6,응암,15642,15599,20200423,31241
20200420,6,역촌,3348,3900,20200423,7248
20200420,6,불광,3863,3985,20200423,7848
20200420,6,독바위,2481,2623,20200423,5104
20200420,6,구산,6765,5041,20200423,11806
20200420,6,새절,11688,10935,20200423,22623
20200420,6,증산,9092,8949,20200423,18041
20200420,6,디지털미디어시티,12356,13438,20200423,25794
20200420,6,월드컵경기장,3718,3890,20200423,7608
20200420,6,마포구청,12583,11072,20200423,23655
20200420,6,망원,11930,12973,20200423,24903
20200420,6,합정,10992,10840,20200423,21832
20200420,6,상수,6601,7255,20200423,13856
20200420,6,광흥창,8101,7962,20200423,16063
20200420,6,대흥,6838,7299,20200423,14137
20200420,6,공덕,16840,16510,20200423,33350
20200420,6,효창공원앞,6289,5729,20200423,12018
20200420,6,삼각지,4902,4267,20200423,9169
20200420,6,녹사평,3699,3615,20200423,7314
20200420,6,이태원,7943,8229,20200423,16172
20200420,6,한강진,5509,6579,20200423,12088
20200420,6,버티고개,1977,1888,20200423,3865
20200420,6,약수,3332,3349,20200423,6681
20200420,6,청구,3448,3859,20200423,7307
20200420,6,신당,6660,7231,20200423,13891
20200420,6,동묘앞,7031,7251,20200423,14282
20200420,6,창신,3176,2542,20200423,5718
20200420,6,보문,6579,6175,20200423,12754
20200420,6,안암,8365,8697,20200423,17062
20200420,6,고려대,6721,6624,20200423,13345
20200420,6,월곡,10286,10020,20200423,20306
20200420,6,상월곡,5591,4918,20200423,10509
20200420,6,돌곶이,8365,7938,20200423,16303
20200420,6,석계,11200,11701,20200423,22901
20200420,6,태릉입구,4708,5235,20200423,9943
20200420,6,화랑대,10373,7942,20200423,18315
20200420,6,봉화산,8629,7737,20200423,16366
20200421,6,응암,15939,15760,20200424,31699
20200421,6,역촌,3362,3930,20200424,7292
20200421,6,불광,3995,4125,20200424,8120
20200421,6,독바위,2568,2794,20200424,5362
20200421,6,구산,6801,5011,20200424,11812
20200421,6,새절,11630,11223,20200424,22853
20200421,6,증산,9313,9094,20200424,18407
20200421,6,디지털미디어시티,12564,13699,20200424,26263
20200421,6,월드컵경기장,3883,4052,20200424,7935
20200421,6,마포구청,12681,11492,20200424,24173
20200421,6,망원,12829,13700,20200424,26529
20200421,6,합정,11559,11446,20200424,23005
20200421,6,상수,7194,8079,20200424,15273
20200421,6,광흥창,8164,8142,20200424,16306
20200421,6,대흥,6956,7282,20200424,14238
20200421,6,공덕,17133,16897,20200424,34030
20200421,6,효창공원앞,6398,5835,20200424,12233
20200421,6,삼각지,5123,4563,20200424,9686
20200421,6,녹사평,3899,3999,20200424,7898
20200421,6,이태원,8361,8704,20200424,17065
20200421,6,한강진,6028,7191,20200424,13219
20200421,6,버티고개,2063,1944,20200424,4007
20200421,6,약수,3341,3361,20200424,6702
20200421,6,청구,3543,3939,20200424,7482
20200421,6,신당,7076,7402,20200424,14478
20200421,6,동묘앞,7224,7459,20200424,14683
20200421,6,창신,3208,2622,20200424,5830
20200421,6,보문,6640,6152,20200424,12792
20200421,6,안암,8854,9053,20200424,17907
20200421,6,고려대,6803,6660,20200424,13463
20200421,6,월곡,10416,10114,20200424,20530
20200421,6,상월곡,5600,5009,20200424,10609
20200421,6,돌곶이,8252,7725,20200424,15977
20200421,6,석계,11355,11753,20200424,23108
20200421,6,태릉입구,4728,5304,20200424,10032
20200421,6,화랑대,10525,8042,20200424,18567
20200421,6,봉화산,8691,7825,20200424,16516
20200422,6,응암,15815,15816,20200425,31631
20200422,6,역촌,3274,3848,20200425,7122
20200422,6,불광,4681,4686,20200425,9367
20200422,6,독바위,2559,2767,20200425,5326
20200422,6,구산,6723,4998,20200425,11721
20200422,6,새절,11787,11124,20200425,22911
20200422,6,증산,9383,9057,20200425,18440
20200422,6,디지털미디어시티,12450,13517,20200425,25967
20200422,6,월드컵경기장,3642,3878,20200425,7520
20200422,6,마포구청,12640,11381,20200425,24021
20200422,6,망원,12547,13877,20200425,26424
20200422,6,합정,11600,11507,20200425,23107
20200422,6,상수,7094,8098,20200425,15192
20200422,6,광흥창,8263,8092,20200425,16355
20200422,6,대흥,6985,7411,20200425,14396
20200422,6,공덕,16994,16728,20200425,33722
20200422,6,효창공원앞,6322,5737,20200425,12059
20200422,6,삼각지,5133,4590,20200425,9723
20200422,6,녹사평,3945,4010,20200425,7955
20200422,6,이태원,8485,9024,20200425,17509
20200422,6,한강진,6206,7241,20200425,13447
20200422,6,버티고개,1980,1931,20200425,3911
20200422,6,약수,3261,3260,20200425,6521
20200422,6,청구,3486,3954,20200425,7440
20200422,6,신당,7056,7460,20200425,14516
20200422,6,동묘앞,7075,7103,20200425,14178
20200422,6,창신,3230,2630,20200425,5860
20200422,6,보문,6658,6208,20200425,12866
20200422,6,안암,8779,8978,20200425,17757
20200422,6,고려대,6740,6583,20200425,13323
20200422,6,월곡,10261,9895,20200425,20156
20200422,6,상월곡,5641,4975,20200425,10616
20200422,6,돌곶이,8581,8036,20200425,16617
20200422,6,석계,11412,11811,20200425,23223
20200422,6,태릉입구,4808,5314,20200425,10122
20200422,6,화랑대,10463,8034,20200425,18497
20200422,6,봉화산,8610,7798,20200425,16408
20200423,6,응암,16139,15923,20200426,32062
20200423,6,역촌,3441,3988,20200426,7429
20200423,6,불광,4193,4272,20200426,8465
20200423,6,독바위,2591,2766,20200426,5357
20200423,6,구산,6972,5106,20200426,12078
20200423,6,새절,11879,11048,20200426,22927
20200423,6,증산,9392,9239,20200426,18631
20200423,6,디지털미디어시티,12548,13737,20200426,26285
20200423,6,월드컵경기장,4016,4339,20200426,8355
20200423,6,마포구청,13107,11436,20200426,24543
20200423,6,망원,12862,14148,20200426,27010
20200423,6,합정,11808,11632,20200426,23440
20200423,6,상수,7179,8397,20200426,15576
20200423,6,광흥창,8138,7983,20200426,16121
20200423,6,대흥,7088,7367,20200426,14455
20200423,6,공덕,17387,17053,20200426,34440
20200423,6,효창공원앞,6546,5845,20200426,12391
20200423,6,삼각지,5201,4586,20200426,9787
20200423,6,녹사평,4252,4307,20200426,8559
20200423,6,이태원,9091,9734,20200426,18825
20200423,6,한강진,6531,7834,20200426,14365
20200423,6,버티고개,2048,1967,20200426,4015
20200423,6,약수,3338,3409,20200426,6747
20200423,6,청구,3586,3918,20200426,7504
20200423,6,신당,6999,7298,20200426,14297
20200423,6,동묘앞,7121,7269,20200426,14390
20200423,6,창신,3286,2607,20200426,5893
20200423,6,보문,6912,6303,20200426,13215
20200423,6,안암,8960,9140,20200426,18100
20200423,6,고려대,6901,6649,20200426,13550
20200423,6,월곡,10376,10130,20200426,20506
20200423,6,상월곡,5748,5064,20200426,10812
20200423,6,돌곶이,8479,7891,20200426,16370
20200423,6,석계,11514,11701,20200426,23215
20200423,6,태릉입구,5042,5443,20200426,10485
20200423,6,화랑대,10685,8028,20200426,18713
20200423,6,봉화산,8644,7794,20200426,16438
20200424,6,응암,16603,16140,20200427,32743
20200424,6,역촌,3535,4090,20200427,7625
20200424,6,불광,4333,4507,20200427,8840
20200424,6,독바위,2694,2693,20200427,5387
20200424,6,구산,7353,5193,20200427,12546
20200424,6,새절,12281,11293,20200427,23574
20200424,6,증산,9813,9235,20200427,19048
20200424,6,디지털미디어시티,12911,13634,20200427,26545
20200424,6,월드컵경기장,4115,4319,20200427,8434
20200424,6,마포구청,13371,11484,20200427,24855
20200424,6,망원,13551,15087,20200427,28638
20200424,6,합정,12441,13126,20200427,25567
20200424,6,상수,7887,9927,20200427,17814
20200424,6,광흥창,8515,8059,20200427,16574
20200424,6,대흥,7469,7726,20200427,15195
20200424,6,공덕,17911,17896,20200427,35807
20200424,6,효창공원앞,6623,5790,20200427,12413
20200424,6,삼각지,5561,4880,20200427,10441
20200424,6,녹사평,4780,5181,20200427,9961
20200424,6,이태원,10491,13625,20200427,24116
20200424,6,한강진,7162,8902,20200427,16064
20200424,6,버티고개,2190,1986,20200427,4176
20200424,6,약수,3491,3527,20200427,7018
20200424,6,청구,3676,4000,20200427,7676
20200424,6,신당,7110,7571,20200427,14681
20200424,6,동묘앞,7641,7634,20200427,15275
20200424,6,창신,3233,2498,20200427,5731
20200424,6,보문,7105,6418,20200427,13523
20200424,6,안암,9697,9456,20200427,19153
20200424,6,고려대,7315,6790,20200427,14105
20200424,6,월곡,10979,10477,20200427,21456
20200424,6,상월곡,5877,4957,20200427,10834
20200424,6,돌곶이,8633,7953,20200427,16586
20200424,6,석계,12035,12104,20200427,24139
20200424,6,태릉입구,5227,5735,20200427,10962
20200424,6,화랑대,10948,8088,20200427,19036
20200424,6,봉화산,8735,7835,20200427,16570
20200425,6,응암,11287,10982,20200428,22269
20200425,6,역촌,2309,2606,20200428,4915
20200425,6,불광,3600,3629,20200428,7229
20200425,6,독바위,1788,2096,20200428,3884
20200425,6,구산,4792,3522,20200428,8314
20200425,6,새절,8141,7348,20200428,15489
20200425,6,증산,6750,6372,20200428,13122
20200425,6,디지털미디어시티,6241,6280,20200428,12521
20200425,6,월드컵경기장,4018,4328,20200428,8346
20200425,6,마포구청,8180,6863,20200428,15043
20200425,6,망원,10828,12296,20200428,23124
20200425,6,합정,10221,10163,20200428,20384
20200425,6,상수,6704,8839,20200428,15543
20200425,6,광흥창,4214,3936,20200428,8150
20200425,6,대흥,4568,4404,20200428,8972
20200425,6,공덕,9000,8369,20200428,17369
20200425,6,효창공원앞,4008,3478,20200428,7486
20200425,6,삼각지,3945,3152,20200428,7097
20200425,6,녹사평,4775,5502,20200428,10277
20200425,6,이태원,12511,15469,20200428,27980
20200425,6,한강진,6363,8135,20200428,14498
20200425,6,버티고개,1354,1391,20200428,2745
20200425,6,약수,2172,2290,20200428,4462
20200425,6,청구,2056,2249,20200428,4305
20200425,6,신당,4704,3901,20200428,8605
20200425,6,동묘앞,6979,6286,20200428,13265
20200425,6,창신,1924,1488,20200428,3412
20200425,6,보문,4667,4135,20200428,8802
20200425,6,안암,5515,5451,20200428,10966
20200425,6,고려대,4572,3983,20200428,8555
20200425,6,월곡,6913,6651,20200428,13564
20200425,6,상월곡,3596,3109,20200428,6705
20200425,6,돌곶이,5409,4807,20200428,10216
20200425,6,석계,7746,7695,20200428,15441
20200425,6,태릉입구,3539,3952,20200428,7491
20200425,6,화랑대,5814,4937,20200428,10751
20200425,6,봉화산,4959,4552,20200428,9511
20200426,6,응암,7970,7952,20200429,15922
20200426,6,역촌,1693,1962,20200429,3655
20200426,6,불광,3119,2874,20200429,5993
20200426,6,독바위,1486,2055,20200429,3541
20200426,6,구산,3385,2508,20200429,5893
20200426,6,새절,5790,5636,20200429,11426
20200426,6,증산,4902,4880,20200429,9782
20200426,6,디지털미디어시티,4345,4715,20200429,9060
20200426,6,월드컵경기장,3468,3499,20200429,6967
20200426,6,마포구청,5947,5265,20200429,11212
20200426,6,망원,8245,8976,20200429,17221
20200426,6,합정,7417,6917,20200429,14334
20200426,6,상수,5055,5728,20200429,10783
20200426,6,광흥창,3223,3056,20200429,6279
20200426,6,대흥,3019,3078,20200429,6097
20200426,6,공덕,5695,5259,20200429,10954
20200426,6,효창공원앞,2863,2473,20200429,5336
20200426,6,삼각지,2485,1945,20200429,4430
20200426,6,녹사평,3845,3870,20200429,7715
20200426,6,이태원,10186,8961,20200429,19147
20200426,6,한강진,4914,5849,20200429,10763
20200426,6,버티고개,903,940,20200429,1843
20200426,6,약수,1370,1435,20200429,2805
20200426,6,청구,1426,1477,20200429,2903
20200426,6,신당,2917,3704,20200429,6621
20200426,6,동묘앞,5634,5594,20200429,11228
20200426,6,창신,1403,1224,20200429,2627
20200426,6,보문,3384,3175,20200429,6559
20200426,6,안암,3947,4216,20200429,8163
20200426,6,고려대,3162,3141,20200429,6303
20200426,6,월곡,4722,4624,20200429,9346
20200426,6,상월곡,2670,2422,20200429,5092
20200426,6,돌곶이,4865,4711,20200429,9576
20200426,6,석계,5881,5927,20200429,11808
20200426,6,태릉입구,2592,2829,20200429,5421
20200426,6,화랑대,4213,3624,20200429,7837
20200426,6,봉화산,3544,3476,20200429,7020
20200426,6,신내,1,0,20200429,1
20200427,6,응암,16524,16184,20200430,32708
20200427,6,역촌,3410,4069,20200430,7479
20200427,6,불광,4092,4303,20200430,8395
20200427,6,독바위,2605,2722,20200430,5327
20200427,6,구산,7179,5288,20200430,12467
20200427,6,새절,12123,11321,20200430,23444
20200427,6,증산,9624,9405,20200430,19029
20200427,6,디지털미디어시티,12789,13882,20200430,26671
20200427,6,월드컵경기장,4309,4497,20200430,8806
20200427,6,마포구청,13079,11628,20200430,24707
20200427,6,망원,12492,13358,20200430,25850
20200427,6,합정,11337,11363,20200430,22700
20200427,6,상수,6846,7779,20200430,14625
20200427,6,광흥창,8288,8107,20200430,16395
20200427,6,대흥,7094,7434,20200430,14528
20200427,6,공덕,17559,17332,20200430,34891
20200427,6,효창공원앞,6566,5797,20200430,12363
20200427,6,삼각지,5084,4418,20200430,9502
20200427,6,녹사평,4083,3974,20200430,8057
20200427,6,이태원,8406,8765,20200430,17171
20200427,6,한강진,5942,7086,20200430,13028
20200427,6,버티고개,2100,1984,20200430,4084
20200427,6,약수,3450,3469,20200430,6919
20200427,6,청구,3581,4019,20200430,7600
20200427,6,신당,6955,7534,20200430,14489
20200427,6,동묘앞,7367,7583,20200430,14950
20200427,6,창신,3253,2628,20200430,5881
20200427,6,보문,6874,6290,20200430,13164
20200427,6,안암,8686,9012,20200430,17698
20200427,6,고려대,6902,6789,20200430,13691
20200427,6,월곡,10893,10528,20200430,21421
20200427,6,상월곡,5779,5052,20200430,10831
20200427,6,돌곶이,8606,7945,20200430,16551
20200427,6,석계,11637,11936,20200430,23573
20200427,6,태릉입구,4871,5464,20200430,10335
20200427,6,화랑대,10884,8283,20200430,19167
20200427,6,봉화산,8829,7973,20200430,16802
20200428,6,응암,16493,16271,20200501,32764
20200428,6,역촌,3458,4023,20200501,7481
20200428,6,불광,4167,4361,20200501,8528
20200428,6,독바위,2622,2778,20200501,5400
20200428,6,연신내,1,0,20200501,1
20200428,6,구산,7013,5148,20200501,12161
20200428,6,새절,12317,11315,20200501,23632
20200428,6,증산,9761,9361,20200501,19122
20200428,6,디지털미디어시티,13060,14167,20200501,27227
20200428,6,월드컵경기장,4486,4601,20200501,9087
20200428,6,마포구청,13246,11485,20200501,24731
20200428,6,망원,13074,14341,20200501,27415
20200428,6,합정,12093,12093,20200501,24186
20200428,6,상수,7295,8529,20200501,15824
20200428,6,광흥창,8412,8215,20200501,16627
20200428,6,대흥,7341,7759,20200501,15100
20200428,6,공덕,17974,17876,20200501,35850
20200428,6,효창공원앞,6558,5926,20200501,12484
20200428,6,삼각지,5315,4642,20200501,9957
20200428,6,녹사평,4304,4313,20200501,8617
20200428,6,이태원,8837,9325,20200501,18162
20200428,6,한강진,6790,8064,20200501,14854
20200428,6,버티고개,2065,2015,20200501,4080
20200428,6,약수,3404,3512,20200501,6916
20200428,6,청구,3651,4071,20200501,7722
20200428,6,신당,7154,7686,20200501,14840
20200428,6,동묘앞,7460,7655,20200501,15115
20200428,6,창신,3303,2555,20200501,5858
20200428,6,보문,6966,6405,20200501,13371
20200428,6,안암,9024,9216,20200501,18240
20200428,6,고려대,7037,6761,20200501,13798
20200428,6,월곡,10850,10459,20200501,21309
20200428,6,상월곡,5860,5092,20200501,10952
20200428,6,돌곶이,8673,8117,20200501,16790
20200428,6,석계,11977,12248,20200501,24225
20200428,6,태릉입구,5053,5634,20200501,10687
20200428,6,화랑대,10986,8179,20200501,19165
20200428,6,봉화산,8982,7980,20200501,16962
20200429,6,대흥,7436,7664,20200502,15100
20200429,6,응암,17258,16394,20200502,33652
20200429,6,역촌,3553,4062,20200502,7615
20200429,6,불광,4467,4492,20200502,8959
20200429,6,독바위,2698,2747,20200502,5445
20200429,6,구산,7320,5162,20200502,12482
20200429,6,새절,12800,11660,20200502,24460
20200429,6,증산,10080,9487,20200502,19567
20200429,6,디지털미디어시티,13480,14338,20200502,27818
20200429,6,월드컵경기장,5028,5046,20200502,10074
20200429,6,마포구청,14107,11756,20200502,25863
20200429,6,망원,13791,15171,20200502,28962
20200429,6,합정,12787,13064,20200502,25851
20200429,6,상수,7779,9444,20200502,17223
20200429,6,광흥창,8615,8244,20200502,16859
20200429,6,공덕,18524,18212,20200502,36736
20200429,6,효창공원앞,6877,6028,20200502,12905
20200429,6,삼각지,5724,4925,20200502,10649
20200429,6,녹사평,4828,5127,20200502,9955
20200429,6,이태원,10149,12539,20200502,22688
20200429,6,한강진,7377,8779,20200502,16156
20200429,6,버티고개,2247,2030,20200502,4277
20200429,6,약수,3560,3594,20200502,7154
20200429,6,청구,3716,4107,20200502,7823
20200429,6,신당,7404,8014,20200502,15418
20200429,6,동묘앞,7771,7908,20200502,15679
20200429,6,창신,3418,2566,20200502,5984
20200429,6,보문,7188,6352,20200502,13540
20200429,6,안암,9363,9477,20200502,18840
20200429,6,고려대,7343,6933,20200502,14276
20200429,6,월곡,11229,10564,20200502,21793
20200429,6,상월곡,6065,5062,20200502,11127
20200429,6,돌곶이,9050,8240,20200502,17290
20200429,6,석계,12606,12409,20200502,25015
20200429,6,태릉입구,5192,5759,20200502,10951
20200429,6,화랑대,11179,8163,20200502,19342
20200429,6,봉화산,9154,8004,20200502,17158
20200430,6,응암,10328,9708,20200503,20036
20200430,6,역촌,2113,2422,20200503,4535
20200430,6,불광,3229,3199,20200503,6428
20200430,6,독바위,1692,2115,20200503,3807
20200430,6,연신내,1,0,20200503,1
20200430,6,구산,4157,3010,20200503,7167
20200430,6,새절,7500,6772,20200503,14272
20200430,6,증산,6278,5878,20200503,12156
20200430,6,디지털미디어시티,5743,5667,20200503,11410
20200430,6,월드컵경기장,4757,4813,20200503,9570
20200430,6,마포구청,7428,6108,20200503,13536
20200430,6,망원,10334,11523,20200503,21857
20200430,6,합정,8915,8779,20200503,17694
20200430,6,상수,5889,6964,20200503,12853
20200430,6,광흥창,3980,3530,20200503,7510
20200430,6,대흥,3797,3832,20200503,7629
20200430,6,공덕,7241,6848,20200503,14089
20200430,6,효창공원앞,3795,3184,20200503,6979
20200430,6,삼각지,3254,2404,20200503,5658
20200430,6,녹사평,4439,4954,20200503,9393
20200430,6,이태원,10847,12516,20200503,23363
20200430,6,한강진,5650,7161,20200503,12811
20200430,6,버티고개,1157,1161,20200503,2318
20200430,6,약수,1802,1824,20200503,3626
20200430,6,청구,2110,2261,20200503,4371
20200430,6,신당,4804,4968,20200503,9772
20200430,6,동묘앞,6454,6124,20200503,12578
20200430,6,창신,1748,1421,20200503,3169
20200430,6,보문,4611,4084,20200503,8695
20200430,6,안암,4929,5044,20200503,9973
20200430,6,고려대,3891,3562,20200503,7453
20200430,6,월곡,6153,5882,20200503,12035
20200430,6,상월곡,3520,2869,20200503,6389
20200430,6,돌곶이,5139,4621,20200503,9760
20200430,6,석계,7453,7229,20200503,14682
20200430,6,태릉입구,3293,3557,20200503,6850
20200430,6,화랑대,5511,4565,20200503,10076
20200430,6,봉화산,4561,4308,20200503,8869
20200501,6,봉화산,5121,4789,20200504,9910
20200501,6,화랑대,6277,4906,20200504,11183
20200501,6,태릉입구,3601,3904,20200504,7505
20200501,6,석계,8187,7981,20200504,16168
20200501,6,돌곶이,5691,5216,20200504,10907
20200501,6,상월곡,3699,3245,20200504,6944
20200501,6,월곡,6961,6443,20200504,13404
20200501,6,고려대,4823,4364,20200504,9187
20200501,6,안암,6189,6060,20200504,12249
20200501,6,보문,4699,4164,20200504,8863
20200501,6,창신,1902,1571,20200504,3473
20200501,6,동묘앞,7001,6595,20200504,13596
20200501,6,신당,5429,5625,20200504,11054
20200501,6,청구,2280,2640,20200504,4920
20200501,6,약수,2248,2256,20200504,4504
20200501,6,버티고개,1287,1305,20200504,2592
20200501,6,한강진,5288,6924,20200504,12212
20200501,6,이태원,11533,14452,20200504,25985
20200501,6,녹사평,4733,5047,20200504,9780
20200501,6,삼각지,3972,3065,20200504,7037
20200501,6,효창공원앞,4289,3598,20200504,7887
20200501,6,공덕,8898,8381,20200504,17279
20200501,6,대흥,4682,4794,20200504,9476
20200501,6,광흥창,4577,4140,20200504,8717
20200501,6,상수,6230,7685,20200504,13915
20200501,6,합정,9251,9319,20200504,18570
20200501,6,망원,11041,12551,20200504,23592
20200501,6,마포구청,8075,6878,20200504,14953
20200501,6,월드컵경기장,4307,4516,20200504,8823
20200501,6,디지털미디어시티,6249,6128,20200504,12377
20200501,6,증산,6814,6390,20200504,13204
20200501,6,새절,8174,7542,20200504,15716
20200501,6,구산,4812,3566,20200504,8378
20200501,6,독바위,1823,2113,20200504,3936
20200501,6,불광,3542,3404,20200504,6946
20200501,6,역촌,2407,2800,20200504,5207
20200501,6,응암,11393,10641,20200504,22034
20200502,6,창신,1726,1412,20200505,3138
20200502,6,응암,10293,9977,20200505,20270
20200502,6,역촌,2079,2394,20200505,4473
20200502,6,불광,3390,3273,20200505,6663
20200502,6,독바위,1681,1937,20200505,3618
20200502,6,구산,4473,3106,20200505,7579
20200502,6,새절,7409,6950,20200505,14359
20200502,6,증산,6302,5939,20200505,12241
20200502,6,디지털미디어시티,5509,5515,20200505,11024
20200502,6,월드컵경기장,4067,4266,20200505,8333
20200502,6,마포구청,7205,6238,20200505,13443
20200502,6,망원,10251,11576,20200505,21827
20200502,6,합정,9325,8987,20200505,18312
20200502,6,상수,5922,7844,20200505,13766
20200502,6,광흥창,3954,3509,20200505,7463
20200502,6,대흥,4056,4071,20200505,8127
20200502,6,공덕,7790,7287,20200505,15077
20200502,6,효창공원앞,3602,3215,20200505,6817
20200502,6,삼각지,3643,2743,20200505,6386
20200502,6,녹사평,4498,5007,20200505,9505
20200502,6,이태원,12485,16013,20200505,28498
20200502,6,한강진,5589,7289,20200505,12878
20200502,6,버티고개,1217,1221,20200505,2438
20200502,6,약수,1953,2075,20200505,4028
20200502,6,청구,1951,2048,20200505,3999
20200502,6,신당,4455,3592,20200505,8047
20200502,6,동묘앞,7119,6459,20200505,13578
20200502,6,보문,4337,3768,20200505,8105
20200502,6,안암,4935,4809,20200505,9744
20200502,6,고려대,4197,3819,20200505,8016
20200502,6,월곡,6281,6010,20200505,12291
20200502,6,상월곡,3322,2793,20200505,6115
20200502,6,돌곶이,5049,4658,20200505,9707
20200502,6,석계,7411,7410,20200505,14821
20200502,6,태릉입구,3181,3550,20200505,6731
20200502,6,화랑대,5453,4526,20200505,9979
20200502,6,봉화산,4630,4349,20200505,8979
20200503,6,봉화산,3660,3487,20200506,7147
20200503,6,화랑대,4141,3742,20200506,7883
20200503,6,태릉입구,2480,2935,20200506,5415
20200503,6,석계,5903,5906,20200506,11809
20200503,6,돌곶이,4735,4513,20200506,9248
20200503,6,상월곡,2759,2422,20200506,5181
20200503,6,월곡,4961,4914,20200506,9875
20200503,6,고려대,3068,3155,20200506,6223
20200503,6,안암,3845,4160,20200506,8005
20200503,6,보문,3291,3225,20200506,6516
20200503,6,창신,1375,1221,20200506,2596
20200503,6,동묘앞,5598,5452,20200506,11050
20200503,6,신당,2630,3303,20200506,5933
20200503,6,청구,1384,1435,20200506,2819
20200503,6,약수,1441,1431,20200506,2872
20200503,6,버티고개,865,899,20200506,1764
20200503,6,한강진,4303,5414,20200506,9717
20200503,6,이태원,10445,9602,20200506,20047
20200503,6,녹사평,3686,3747,20200506,7433
20200503,6,삼각지,2502,1785,20200506,4287
20200503,6,효창공원앞,2873,2580,20200506,5453
20200503,6,공덕,5687,5557,20200506,11244
20200503,6,대흥,3061,3141,20200506,6202
20200503,6,광흥창,3516,3307,20200506,6823
20200503,6,상수,4612,5284,20200506,9896
20200503,6,합정,7472,7134,20200506,14606
20200503,6,망원,7962,9004,20200506,16966
20200503,6,마포구청,5814,5215,20200506,11029
20200503,6,월드컵경기장,3787,3980,20200506,7767
20200503,6,디지털미디어시티,4335,4514,20200506,8849
20200503,6,증산,4944,5060,20200506,10004
20200503,6,새절,5954,5648,20200506,11602
20200503,6,구산,3411,2409,20200506,5820
20200503,6,연신내,1,0,20200506,1
20200503,6,독바위,1475,1867,20200506,3342
20200503,6,불광,2818,2714,20200506,5532
20200503,6,역촌,1732,1973,20200506,3705
20200503,6,응암,8211,8521,20200506,16732
20200504,6,봉화산,7988,7174,20200507,15162
20200504,6,화랑대,9499,7200,20200507,16699
20200504,6,태릉입구,4626,5128,20200507,9754
20200504,6,석계,10978,11154,20200507,22132
20200504,6,돌곶이,8042,7612,20200507,15654
20200504,6,상월곡,5309,4645,20200507,9954
20200504,6,월곡,9689,9407,20200507,19096
20200504,6,고려대,6496,6164,20200507,12660
20200504,6,안암,8472,8776,20200507,17248
20200504,6,보문,6247,5576,20200507,11823
20200504,6,창신,2865,2212,20200507,5077
20200504,6,동묘앞,7619,7811,20200507,15430
20200504,6,신당,6543,7259,20200507,13802
20200504,6,청구,3324,3691,20200507,7015
20200504,6,약수,3107,3221,20200507,6328
20200504,6,버티고개,1847,1792,20200507,3639
20200504,6,한강진,5710,7247,20200507,12957
20200504,6,이태원,10470,12988,20200507,23458
20200504,6,녹사평,4609,4858,20200507,9467
20200504,6,삼각지,4867,3991,20200507,8858
20200504,6,효창공원앞,6006,5373,20200507,11379
20200504,6,공덕,14529,14461,20200507,28990
20200504,6,대흥,6506,6703,20200507,13209
20200504,6,광흥창,7323,7034,20200507,14357
20200504,6,상수,6943,8279,20200507,15222
20200504,6,합정,11142,11189,20200507,22331
20200504,6,망원,12327,13653,20200507,25980
20200504,6,마포구청,11548,10183,20200507,21731
20200504,6,월드컵경기장,4333,4739,20200507,9072
20200504,6,디지털미디어시티,10718,11117,20200507,21835
20200504,6,증산,8910,8483,20200507,17393
20200504,6,새절,11167,10294,20200507,21461
20200504,6,구산,6534,4773,20200507,11307
20200504,6,독바위,2398,2432,20200507,4830
20200504,6,불광,4268,4342,20200507,8610
20200504,6,역촌,3193,3700,20200507,6893
20200504,6,응암,15196,14723,20200507,29919
20200505,6,공덕,6322,6049,20200508,12371
20200505,6,응암,9136,9158,20200508,18294
20200505,6,역촌,1824,2231,20200508,4055
20200505,6,불광,3038,2885,20200508,5923
20200505,6,독바위,1468,1798,20200508,3266
20200505,6,연신내,1,0,20200508,1
20200505,6,구산,3859,2869,20200508,6728
20200505,6,새절,6668,6350,20200508,13018
20200505,6,증산,5471,5508,20200508,10979
20200505,6,디지털미디어시티,4839,5162,20200508,10001
20200505,6,월드컵경기장,4090,4079,20200508,8169
20200505,6,마포구청,6644,5741,20200508,12385
20200505,6,망원,8850,9847,20200508,18697
20200505,6,합정,8140,7779,20200508,15919
20200505,6,상수,5082,6091,20200508,11173
20200505,6,광흥창,3318,3159,20200508,6477
20200505,6,대흥,3376,3525,20200508,6901
20200505,6,효창공원앞,3207,2811,20200508,6018
20200505,6,삼각지,2650,2014,20200508,4664
20200505,6,녹사평,3866,3911,20200508,7777
20200505,6,이태원,9745,9336,20200508,19081
20200505,6,한강진,5095,6284,20200508,11379
20200505,6,버티고개,1016,1057,20200508,2073
20200505,6,약수,1583,1624,20200508,3207
20200505,6,청구,1944,2094,20200508,4038
20200505,6,신당,4625,4707,20200508,9332
20200505,6,동묘앞,6178,6016,20200508,12194
20200505,6,창신,1614,1274,20200508,2888
20200505,6,보문,3685,3532,20200508,7217
20200505,6,안암,4250,4510,20200508,8760
20200505,6,고려대,3529,3429,20200508,6958
20200505,6,월곡,5569,5589,20200508,11158
20200505,6,상월곡,3134,2789,20200508,5923
20200505,6,돌곶이,4611,4478,20200508,9089
20200505,6,석계,6567,6553,20200508,13120
20200505,6,태릉입구,2869,3279,20200508,6148
20200505,6,화랑대,4973,4234,20200508,9207
20200505,6,봉화산,4046,3846,20200508,7892
20200506,6,응암,17200,16877,20200509,34077
20200506,6,역촌,3788,4322,20200509,8110
20200506,6,불광,4447,4690,20200509,9137
20200506,6,독바위,2777,2940,20200509,5717
20200506,6,연신내,1,0,20200509,1
20200506,6,구산,7412,5372,20200509,12784
20200506,6,새절,12701,11946,20200509,24647
20200506,6,증산,9969,9681,20200509,19650
20200506,6,디지털미디어시티,13596,14591,20200509,28187
20200506,6,월드컵경기장,4762,4964,20200509,9726
20200506,6,마포구청,13841,12049,20200509,25890
20200506,6,망원,13490,14839,20200509,28329
20200506,6,합정,12519,12311,20200509,24830
20200506,6,상수,7379,8611,20200509,15990
20200506,6,광흥창,8937,8671,20200509,17608
20200506,6,대흥,7640,7968,20200509,15608
20200506,6,공덕,17921,17786,20200509,35707
20200506,6,효창공원앞,7017,6249,20200509,13266
20200506,6,삼각지,5512,4813,20200509,10325
20200506,6,녹사평,4701,4614,20200509,9315
20200506,6,이태원,9492,9873,20200509,19365
20200506,6,한강진,6956,8323,20200509,15279
20200506,6,버티고개,2177,2107,20200509,4284
20200506,6,약수,3561,3562,20200509,7123
20200506,6,청구,3705,4087,20200509,7792
20200506,6,신당,7240,8014,20200509,15254
20200506,6,동묘앞,7751,7696,20200509,15447
20200506,6,창신,3435,2736,20200509,6171
20200506,6,보문,7048,6526,20200509,13574
20200506,6,안암,9393,9616,20200509,19009
20200506,6,고려대,7449,7295,20200509,14744
20200506,6,월곡,11260,10940,20200509,22200
20200506,6,상월곡,6073,5425,20200509,11498
20200506,6,돌곶이,9387,8910,20200509,18297
20200506,6,석계,12267,12608,20200509,24875
20200506,6,태릉입구,5168,5722,20200509,10890
20200506,6,화랑대,11394,8689,20200509,20083
20200506,6,봉화산,9340,8343,20200509,17683
20200507,6,망원,13621,14963,20200510,28584
20200507,6,응암,17257,16887,20200510,34144
20200507,6,역촌,3684,4289,20200510,7973
20200507,6,불광,4474,4643,20200510,9117
20200507,6,독바위,2788,2844,20200510,5632
20200507,6,연신내,1,0,20200510,1
20200507,6,구산,7419,5269,20200510,12688
20200507,6,새절,12854,11990,20200510,24844
20200507,6,증산,10079,9892,20200510,19971
20200507,6,디지털미디어시티,13660,14583,20200510,28243
20200507,6,월드컵경기장,4741,4888,20200510,9629
20200507,6,마포구청,13960,12244,20200510,26204
20200507,6,합정,12540,12624,20200510,25164
20200507,6,상수,7604,8673,20200510,16277
20200507,6,광흥창,8893,8554,20200510,17447
20200507,6,대흥,7742,8120,20200510,15862
20200507,6,공덕,18517,18380,20200510,36897
20200507,6,효창공원앞,7071,6260,20200510,13331
20200507,6,삼각지,5620,4814,20200510,10434
20200507,6,녹사평,4596,4586,20200510,9182
20200507,6,이태원,8999,9599,20200510,18598
20200507,6,한강진,7009,8426,20200510,15435
20200507,6,버티고개,2189,2092,20200510,4281
20200507,6,약수,3507,3603,20200510,7110
20200507,6,청구,3822,4120,20200510,7942
20200507,6,신당,7211,7870,20200510,15081
20200507,6,동묘앞,7651,7925,20200510,15576
20200507,6,창신,3468,2716,20200510,6184
20200507,6,보문,7230,6607,20200510,13837
20200507,6,안암,9861,9877,20200510,19738
20200507,6,고려대,7471,7051,20200510,14522
20200507,6,월곡,11588,11042,20200510,22630
20200507,6,상월곡,6159,5420,20200510,11579
20200507,6,돌곶이,9121,8566,20200510,17687
20200507,6,석계,12423,12735,20200510,25158
20200507,6,태릉입구,5346,5939,20200510,11285
20200507,6,화랑대,11494,8759,20200510,20253
20200507,6,봉화산,9332,8332,20200510,17664
20200507,6,신내,1,0,20200510,1
20200508,6,응암,17581,17772,20200511,35353
20200508,6,역촌,3759,4611,20200511,8370
20200508,6,불광,4596,4754,20200511,9350
20200508,6,독바위,2862,2867,20200511,5729
20200508,6,연신내,1,0,20200511,1
20200508,6,구산,7510,5713,20200511,13223
20200508,6,새절,13158,12473,20200511,25631
20200508,6,증산,10383,10125,20200511,20508
20200508,6,디지털미디어시티,13775,14938,20200511,28713
20200508,6,월드컵경기장,5021,4900,20200511,9921
20200508,6,마포구청,14793,12627,20200511,27420
20200508,6,망원,14422,15817,20200511,30239
20200508,6,합정,13252,13058,20200511,26310
20200508,6,광흥창,9236,8848,20200511,18084
20200508,6,대흥,8005,8241,20200511,16246
20200508,6,공덕,18764,18690,20200511,37454
20200508,6,효창공원앞,7079,6307,20200511,13386
20200508,6,삼각지,5705,4933,20200511,10638
20200508,6,녹사평,4523,4322,20200511,8845
20200508,6,이태원,8296,8862,20200511,17158
20200508,6,한강진,7233,8226,20200511,15459
20200508,6,버티고개,2354,2168,20200511,4522
20200508,6,약수,3674,3702,20200511,7376
20200508,6,청구,3951,4254,20200511,8205
20200508,6,신당,7495,7794,20200511,15289
20200508,6,동묘앞,7989,8098,20200511,16087
20200508,6,창신,3476,2745,20200511,6221
20200508,6,보문,7415,6827,20200511,14242
20200508,6,안암,10591,10112,20200511,20703
20200508,6,고려대,7990,7478,20200511,15468
20200508,6,월곡,11762,11385,20200511,23147
20200508,6,상월곡,6299,5421,20200511,11720
20200508,6,돌곶이,9420,8981,20200511,18401
20200508,6,석계,12805,13355,20200511,26160
20200508,6,태릉입구,5344,5982,20200511,11326
20200508,6,화랑대,11773,8658,20200511,20431
20200508,6,봉화산,9358,8657,20200511,18015
20200508,6,상수,8215,9426,20200511,17641
20200509,6,응암,10307,10128,20200512,20435
20200509,6,역촌,2266,2540,20200512,4806
20200509,6,불광,3228,3067,20200512,6295
20200509,6,독바위,1613,1651,20200512,3264
20200509,6,구산,4544,3314,20200512,7858
20200509,6,새절,7529,7088,20200512,14617
20200509,6,증산,6334,6103,20200512,12437
20200509,6,디지털미디어시티,5566,5592,20200512,11158
20200509,6,월드컵경기장,2846,3140,20200512,5986
20200509,6,마포구청,7347,6355,20200512,13702
20200509,6,망원,9431,10488,20200512,19919
20200509,6,합정,8860,8822,20200512,17682
20200509,6,상수,6025,7770,20200512,13795
20200509,6,광흥창,4315,3996,20200512,8311
20200509,6,대흥,4256,4207,20200512,8463
20200509,6,공덕,7921,7672,20200512,15593
20200509,6,효창공원앞,3526,3040,20200512,6566
20200509,6,삼각지,3009,2428,20200512,5437
20200509,6,녹사평,2641,2826,20200512,5467
20200509,6,이태원,5289,5516,20200512,10805
20200509,6,한강진,4336,5095,20200512,9431
20200509,6,버티고개,1203,1107,20200512,2310
20200509,6,약수,1875,1985,20200512,3860
20200509,6,청구,2028,2137,20200512,4165
20200509,6,신당,4906,3996,20200512,8902
20200509,6,동묘앞,5137,4880,20200512,10017
20200509,6,창신,1852,1431,20200512,3283
20200509,6,보문,4253,3777,20200512,8030
20200509,6,안암,5452,5581,20200512,11033
20200509,6,고려대,4318,4139,20200512,8457
20200509,6,월곡,6295,6139,20200512,12434
20200509,6,상월곡,3307,2867,20200512,6174
20200509,6,돌곶이,5031,4635,20200512,9666
20200509,6,석계,7571,7406,20200512,14977
20200509,6,태릉입구,3143,3441,20200512,6584
20200509,6,화랑대,5336,4283,20200512,9619
20200509,6,봉화산,4663,4338,20200512,9001
20200510,6,응암,8224,8383,20200513,16607
20200510,6,역촌,1749,2114,20200513,3863
20200510,6,불광,3044,2879,20200513,5923
20200510,6,독바위,1411,1775,20200513,3186
20200510,6,구산,3486,2550,20200513,6036
20200510,6,새절,6233,5957,20200513,12190
20200510,6,증산,5102,5045,20200513,10147
20200510,6,디지털미디어시티,4584,4727,20200513,9311
20200510,6,월드컵경기장,2958,3068,20200513,6026
20200510,6,마포구청,6098,5653,20200513,11751
20200510,6,망원,8302,9136,20200513,17438
20200510,6,합정,7441,6888,20200513,14329
20200510,6,상수,4506,5477,20200513,9983
20200510,6,광흥창,3614,3408,20200513,7022
20200510,6,대흥,3027,3137,20200513,6164
20200510,6,공덕,5584,5345,20200513,10929
20200510,6,효창공원앞,3003,2636,20200513,5639
20200510,6,삼각지,2303,1874,20200513,4177
20200510,6,녹사평,2177,2082,20200513,4259
20200510,6,이태원,4188,4027,20200513,8215
20200510,6,한강진,2880,3286,20200513,6166
20200510,6,버티고개,937,1004,20200513,1941
20200510,6,약수,1360,1408,20200513,2768
20200510,6,청구,1404,1466,20200513,2870
20200510,6,신당,2919,3662,20200513,6581
20200510,6,동묘앞,5181,5126,20200513,10307
20200510,6,창신,1460,1328,20200513,2788
20200510,6,보문,3462,3304,20200513,6766
20200510,6,안암,4298,4889,20200513,9187
20200510,6,고려대,3367,3302,20200513,6669
20200510,6,월곡,4872,4820,20200513,9692
20200510,6,상월곡,2863,2537,20200513,5400
20200510,6,돌곶이,4817,4728,20200513,9545
20200510,6,석계,5986,5912,20200513,11898
20200510,6,태릉입구,2670,2934,20200513,5604
20200510,6,화랑대,4417,4015,20200513,8432
20200510,6,봉화산,3686,3415,20200513,7101
20200511,6,봉화산,9146,8253,20200514,17399
20200511,6,화랑대,11383,8726,20200514,20109
20200511,6,태릉입구,5135,5743,20200514,10878
20200511,6,석계,12170,12571,20200514,24741
20200511,6,돌곶이,8878,8246,20200514,17124
20200511,6,상월곡,6039,5326,20200514,11365
20200511,6,월곡,11212,11032,20200514,22244
20200511,6,고려대,7546,7382,20200514,14928
20200511,6,안암,10080,10493,20200514,20573
20200511,6,보문,6876,6522,20200514,13398
20200511,6,창신,3388,2651,20200514,6039
20200511,6,동묘앞,7388,7519,20200514,14907
20200511,6,신당,7058,7770,20200514,14828
20200511,6,청구,3775,4188,20200514,7963
20200511,6,약수,3561,3477,20200514,7038
20200511,6,버티고개,2151,1977,20200514,4128
20200511,6,한강진,5512,6510,20200514,12022
20200511,6,이태원,6335,6412,20200514,12747
20200511,6,녹사평,3543,3521,20200514,7064
20200511,6,삼각지,4828,4147,20200514,8975
20200511,6,효창공원앞,6733,6010,20200514,12743
20200511,6,공덕,18018,17810,20200514,35828
20200511,6,대흥,7502,7858,20200514,15360
20200511,6,광흥창,8734,8569,20200514,17303
20200511,6,상수,6896,7639,20200514,14535
20200511,6,합정,11551,11442,20200514,22993
20200511,6,망원,12846,13826,20200514,26672
20200511,6,마포구청,13694,12111,20200514,25805
20200511,6,월드컵경기장,4572,4915,20200514,9487
20200511,6,디지털미디어시티,13392,14470,20200514,27862
20200511,6,증산,9979,9588,20200514,19567
20200511,6,새절,12584,11830,20200514,24414
20200511,6,구산,7279,5302,20200514,12581
20200511,6,독바위,2646,2746,20200514,5392
20200511,6,불광,4254,4400,20200514,8654
20200511,6,역촌,3651,4252,20200514,7903
20200511,6,응암,17144,16886,20200514,34030
20200512,6,응암,16960,16783,20200515,33743
20200512,6,역촌,3940,4530,20200515,8470
20200512,6,불광,4340,4304,20200515,8644
20200512,6,독바위,2649,2757,20200515,5406
20200512,6,구산,7179,5229,20200515,12408
20200512,6,새절,12443,11729,20200515,24172
20200512,6,증산,9823,9598,20200515,19421
20200512,6,디지털미디어시티,13298,14447,20200515,27745
20200512,6,월드컵경기장,4359,4561,20200515,8920
20200512,6,마포구청,13604,12111,20200515,25715
20200512,6,망원,13193,14255,20200515,27448
20200512,6,합정,11781,11782,20200515,23563
20200512,6,상수,7026,7939,20200515,14965
20200512,6,광흥창,8558,8343,20200515,16901
20200512,6,대흥,7544,7838,20200515,15382
20200512,6,공덕,18188,18173,20200515,36361
20200512,6,효창공원앞,6782,6089,20200515,12871
20200512,6,삼각지,4873,4236,20200515,9109
20200512,6,녹사평,3560,3518,20200515,7078
20200512,6,이태원,5966,6024,20200515,11990
20200512,6,한강진,6244,7133,20200515,13377
20200512,6,버티고개,2122,2045,20200515,4167
20200512,6,약수,3348,3463,20200515,6811
20200512,6,청구,3820,4158,20200515,7978
20200512,6,신당,7396,7930,20200515,15326
20200512,6,동묘앞,7437,7439,20200515,14876
20200512,6,창신,3344,2607,20200515,5951
20200512,6,보문,6908,6417,20200515,13325
20200512,6,안암,9954,10236,20200515,20190
20200512,6,고려대,7321,7086,20200515,14407
20200512,6,월곡,10957,10714,20200515,21671
20200512,6,상월곡,5960,5264,20200515,11224
20200512,6,돌곶이,8465,8048,20200515,16513
20200512,6,석계,12023,12338,20200515,24361
20200512,6,태릉입구,5123,5769,20200515,10892
20200512,6,화랑대,11227,8586,20200515,19813
20200512,6,봉화산,9066,8178,20200515,17244
20200513,6,신내,1,0,20200516,1
20200513,6,봉화산,9203,8268,20200516,17471
20200513,6,화랑대,11410,8693,20200516,20103
20200513,6,태릉입구,5093,5782,20200516,10875
20200513,6,석계,12212,12534,20200516,24746
20200513,6,돌곶이,8674,8211,20200516,16885
20200513,6,상월곡,6024,5274,20200516,11298
20200513,6,월곡,11046,10801,20200516,21847
20200513,6,고려대,7652,7413,20200516,15065
20200513,6,안암,10114,10240,20200516,20354
20200513,6,보문,6974,6500,20200516,13474
20200513,6,창신,3418,2725,20200516,6143
20200513,6,동묘앞,7456,7629,20200516,15085
20200513,6,신당,7314,7847,20200516,15161
20200513,6,청구,3799,4237,20200516,8036
20200513,6,약수,3399,3536,20200516,6935
20200513,6,버티고개,2141,2001,20200516,4142
20200513,6,한강진,6060,7033,20200516,13093
20200513,6,이태원,5563,5595,20200516,11158
20200513,6,녹사평,3621,3574,20200516,7195
20200513,6,삼각지,5149,4406,20200516,9555
20200513,6,효창공원앞,6940,6128,20200516,13068
20200513,6,공덕,18278,18050,20200516,36328
20200513,6,대흥,7629,7887,20200516,15516
20200513,6,광흥창,8816,8487,20200516,17303
20200513,6,상수,7130,7954,20200516,15084
20200513,6,합정,11921,11629,20200516,23550
20200513,6,망원,13405,14888,20200516,28293
20200513,6,마포구청,13771,12138,20200516,25909
20200513,6,월드컵경기장,4692,4910,20200516,9602
20200513,6,디지털미디어시티,13408,14420,20200516,27828
20200513,6,증산,9956,9680,20200516,19636
20200513,6,새절,12591,11850,20200516,24441
20200513,6,구산,7051,5132,20200516,12183
20200513,6,연신내,1,0,20200516,1
20200513,6,독바위,2635,2742,20200516,5377
20200513,6,불광,4407,4590,20200516,8997
20200513,6,역촌,3825,4598,20200516,8423
20200513,6,응암,17201,16722,20200516,33923
20200514,6,봉화산,9092,8120,20200517,17212
20200514,6,화랑대,11173,8518,20200517,19691
20200514,6,태릉입구,5234,5773,20200517,11007
20200514,6,석계,12106,12335,20200517,24441
20200514,6,돌곶이,8510,8066,20200517,16576
20200514,6,상월곡,6047,5305,20200517,11352
20200514,6,월곡,11121,10806,20200517,21927
20200514,6,고려대,7579,7345,20200517,14924
20200514,6,안암,9970,10081,20200517,20051
20200514,6,보문,7018,6493,20200517,13511
20200514,6,창신,3373,2662,20200517,6035
20200514,6,동묘앞,7419,7492,20200517,14911
20200514,6,신당,7234,7722,20200517,14956
20200514,6,청구,3791,4111,20200517,7902
20200514,6,약수,3424,3487,20200517,6911
20200514,6,버티고개,2148,2039,20200517,4187
20200514,6,한강진,5961,6864,20200517,12825
20200514,6,이태원,5417,5468,20200517,10885
20200514,6,녹사평,3585,3484,20200517,7069
20200514,6,삼각지,5001,4382,20200517,9383
20200514,6,효창공원앞,6663,5915,20200517,12578
20200514,6,공덕,17899,17763,20200517,35662
20200514,6,대흥,7473,7724,20200517,15197
20200514,6,광흥창,8506,8222,20200517,16728
20200514,6,상수,7031,7733,20200517,14764
20200514,6,합정,11546,11551,20200517,23097
20200514,6,망원,12995,14407,20200517,27402
20200514,6,마포구청,13508,11985,20200517,25493
20200514,6,월드컵경기장,4515,4667,20200517,9182
20200514,6,디지털미디어시티,13175,14164,20200517,27339
20200514,6,증산,9748,9534,20200517,19282
20200514,6,새절,12602,11688,20200517,24290
20200514,6,구산,7032,5226,20200517,12258
20200514,6,독바위,2712,2812,20200517,5524
20200514,6,불광,4131,4325,20200517,8456
20200514,6,역촌,3605,4290,20200517,7895
20200514,6,응암,16850,16555,20200517,33405
20200515,6,봉화산,8762,7956,20200518,16718
20200515,6,화랑대,11078,8324,20200518,19402
20200515,6,태릉입구,4941,5628,20200518,10569
20200515,6,석계,11950,12190,20200518,24140
20200515,6,돌곶이,8448,7940,20200518,16388
20200515,6,상월곡,5922,5154,20200518,11076
20200515,6,월곡,10962,10632,20200518,21594
20200515,6,고려대,7656,7260,20200518,14916
20200515,6,안암,10522,10421,20200518,20943
20200515,6,보문,6922,6262,20200518,13184
20200515,6,창신,3302,2602,20200518,5904
20200515,6,동묘앞,6850,7004,20200518,13854
20200515,6,신당,7307,7726,20200518,15033
20200515,6,청구,3635,4010,20200518,7645
20200515,6,약수,3390,3545,20200518,6935
20200515,6,버티고개,2065,1842,20200518,3907
20200515,6,한강진,5724,6820,20200518,12544
20200515,6,이태원,5559,5607,20200518,11166
20200515,6,녹사평,3473,3411,20200518,6884
20200515,6,삼각지,5061,4477,20200518,9538
20200515,6,효창공원앞,6642,5808,20200518,12450
20200515,6,공덕,17995,17993,20200518,35988
20200515,6,대흥,7427,7707,20200518,15134
20200515,6,광흥창,8479,8351,20200518,16830
20200515,6,상수,7196,8104,20200518,15300
20200515,6,합정,11704,11552,20200518,23256
20200515,6,망원,13164,14641,20200518,27805
20200515,6,마포구청,13377,11943,20200518,25320
20200515,6,월드컵경기장,3698,3921,20200518,7619
20200515,6,디지털미디어시티,12571,13576,20200518,26147
20200515,6,증산,9582,9227,20200518,18809
20200515,6,새절,12301,11708,20200518,24009
20200515,6,구산,7012,5122,20200518,12134
20200515,6,독바위,2586,2602,20200518,5188
20200515,6,불광,4064,4166,20200518,8230
20200515,6,역촌,3663,4156,20200518,7819
20200515,6,응암,16530,16021,20200518,32551
20200516,6,응암,10975,10772,20200519,21747
20200516,6,역촌,2327,2643,20200519,4970
20200516,6,불광,3377,3308,20200519,6685
20200516,6,독바위,1754,1918,20200519,3672
20200516,6,연신내,1,0,20200519,1
20200516,6,구산,4729,3484,20200519,8213
20200516,6,새절,8266,7644,20200519,15910
20200516,6,증산,6823,6380,20200519,13203
20200516,6,디지털미디어시티,6270,6389,20200519,12659
20200516,6,월드컵경기장,3812,4192,20200519,8004
20200516,6,마포구청,8098,6869,20200519,14967
20200516,6,망원,10326,11464,20200519,21790
20200516,6,합정,8694,8541,20200519,17235
20200516,6,상수,4983,6069,20200519,11052
20200516,6,광흥창,4499,4204,20200519,8703
20200516,6,대흥,4275,4227,20200519,8502
20200516,6,공덕,8773,8416,20200519,17189
20200516,6,효창공원앞,4005,3456,20200519,7461
20200516,6,삼각지,3127,2482,20200519,5609
20200516,6,녹사평,2316,2483,20200519,4799
20200516,6,이태원,4123,3987,20200519,8110
20200516,6,한강진,3956,4462,20200519,8418
20200516,6,버티고개,1296,1225,20200519,2521
20200516,6,약수,2085,2222,20200519,4307
20200516,6,청구,2156,2344,20200519,4500
20200516,6,신당,5315,4267,20200519,9582
20200516,6,동묘앞,6680,5984,20200519,12664
20200516,6,창신,1861,1495,20200519,3356
20200516,6,보문,4712,4369,20200519,9081
20200516,6,안암,6242,6082,20200519,12324
20200516,6,고려대,4733,4385,20200519,9118
20200516,6,월곡,6933,6636,20200519,13569
20200516,6,상월곡,3669,3255,20200519,6924
20200516,6,봉화산,5016,4582,20200519,9598
20200516,6,화랑대,6425,5186,20200519,11611
20200516,6,태릉입구,3675,3939,20200519,7614
20200516,6,석계,8065,7782,20200519,15847
20200516,6,돌곶이,5379,4930,20200519,10309
20200517,6,신내,2,0,20200520,2
20200517,6,봉화산,3660,3542,20200520,7202
20200517,6,화랑대,4281,3778,20200520,8059
20200517,6,태릉입구,2807,3170,20200520,5977
20200517,6,석계,6021,5922,20200520,11943
20200517,6,돌곶이,4916,4734,20200520,9650
20200517,6,상월곡,3029,2691,20200520,5720
20200517,6,월곡,5289,5088,20200520,10377
20200517,6,고려대,3445,3360,20200520,6805
20200517,6,안암,4406,4839,20200520,9245
20200517,6,보문,3607,3273,20200520,6880
20200517,6,창신,1472,1289,20200520,2761
20200517,6,동묘앞,5623,5373,20200520,10996
20200517,6,신당,3039,3895,20200520,6934
20200517,6,청구,1437,1525,20200520,2962
20200517,6,약수,1425,1451,20200520,2876
20200517,6,버티고개,919,1005,20200520,1924
20200517,6,한강진,2874,3189,20200520,6063
20200517,6,이태원,3528,3396,20200520,6924
20200517,6,녹사평,1859,1760,20200520,3619
20200517,6,삼각지,2243,1788,20200520,4031
20200517,6,효창공원앞,3018,2636,20200520,5654
20200517,6,공덕,5955,5591,20200520,11546
20200517,6,대흥,3051,3108,20200520,6159
20200517,6,광흥창,3552,3506,20200520,7058
20200517,6,상수,3829,4517,20200520,8346
20200517,6,합정,7010,6422,20200520,13432
20200517,6,망원,8085,8903,20200520,16988
20200517,6,마포구청,6110,5509,20200520,11619
20200517,6,월드컵경기장,3961,4087,20200520,8048
20200517,6,디지털미디어시티,4628,4806,20200520,9434
20200517,6,증산,5157,5085,20200520,10242
20200517,6,새절,6048,5836,20200520,11884
20200517,6,구산,3287,2478,20200520,5765
20200517,6,독바위,1527,1953,20200520,3480
20200517,6,불광,2842,2645,20200520,5487
20200517,6,역촌,1732,2014,20200520,3746
20200517,6,응암,8343,8476,20200520,16819
20200518,6,봉화산,8822,8051,20200521,16873
20200518,6,화랑대,10974,8433,20200521,19407
20200518,6,태릉입구,5047,5541,20200521,10588
20200518,6,석계,11732,12382,20200521,24114
20200518,6,돌곶이,8346,7963,20200521,16309
20200518,6,상월곡,5942,5431,20200521,11373
20200518,6,월곡,10938,10773,20200521,21711
20200518,6,고려대,7285,7326,20200521,14611
20200518,6,안암,9484,9740,20200521,19224
20200518,6,보문,6823,6414,20200521,13237
20200518,6,창신,3235,2747,20200521,5982
20200518,6,동묘앞,7123,7380,20200521,14503
20200518,6,신당,7028,7662,20200521,14690
20200518,6,청구,3541,4130,20200521,7671
20200518,6,약수,3430,3481,20200521,6911
20200518,6,버티고개,2050,2038,20200521,4088
20200518,6,한강진,5192,6168,20200521,11360
20200518,6,이태원,5716,5660,20200521,11376
20200518,6,녹사평,3457,3305,20200521,6762
20200518,6,삼각지,4728,4228,20200521,8956
20200518,6,효창공원앞,6503,5958,20200521,12461
20200518,6,공덕,17573,17348,20200521,34921
20200518,6,대흥,7453,7751,20200521,15204
20200518,6,광흥창,8567,8578,20200521,17145
20200518,6,상수,6516,6973,20200521,13489
20200518,6,합정,10704,10505,20200521,21209
20200518,6,망원,12108,13267,20200521,25375
20200518,6,마포구청,13338,11916,20200521,25254
20200518,6,월드컵경기장,3863,3996,20200521,7859
20200518,6,디지털미디어시티,12897,14010,20200521,26907
20200518,6,증산,9418,9330,20200521,18748
20200518,6,새절,12228,11521,20200521,23749
20200518,6,구산,6891,5367,20200521,12258
20200518,6,연신내,1,0,20200521,1
20200518,6,독바위,2555,2693,20200521,5248
20200518,6,불광,4053,4200,20200521,8253
20200518,6,역촌,3617,4378,20200521,7995
20200518,6,응암,16355,16351,20200521,32706
20200519,6,신내,1,0,20200522,1
20200519,6,봉화산,8789,7866,20200522,16655
20200519,6,화랑대,11063,8425,20200522,19488
20200519,6,태릉입구,5090,5706,20200522,10796
20200519,6,석계,11888,12053,20200522,23941
20200519,6,돌곶이,8270,7752,20200522,16022
20200519,6,상월곡,5946,5316,20200522,11262
20200519,6,월곡,10772,10467,20200522,21239
20200519,6,고려대,7163,6868,20200522,14031
20200519,6,안암,10032,10239,20200522,20271
20200519,6,보문,6940,6362,20200522,13302
20200519,6,창신,3326,2656,20200522,5982
20200519,6,동묘앞,7043,7177,20200522,14220
20200519,6,신당,7175,7663,20200522,14838
20200519,6,청구,3753,4099,20200522,7852
20200519,6,약수,3434,3526,20200522,6960
20200519,6,버티고개,2085,2012,20200522,4097
20200519,6,한강진,5833,6717,20200522,12550
20200519,6,이태원,5768,5832,20200522,11600
20200519,6,녹사평,3456,3378,20200522,6834
20200519,6,삼각지,4974,4521,20200522,9495
20200519,6,효창공원앞,6642,5863,20200522,12505
20200519,6,공덕,17438,17378,20200522,34816
20200519,6,대흥,7427,7647,20200522,15074
20200519,6,광흥창,8428,8257,20200522,16685
20200519,6,상수,6875,7533,20200522,14408
20200519,6,합정,11258,11275,20200522,22533
20200519,6,망원,12703,13938,20200522,26641
20200519,6,마포구청,13478,11759,20200522,25237
20200519,6,월드컵경기장,4064,4339,20200522,8403
20200519,6,디지털미디어시티,13008,14260,20200522,27268
20200519,6,증산,9656,9412,20200522,19068
20200519,6,새절,12384,11414,20200522,23798
20200519,6,구산,6752,5100,20200522,11852
20200519,6,독바위,2626,2622,20200522,5248
20200519,6,불광,4038,4196,20200522,8234
20200519,6,역촌,3556,4150,20200522,7706
20200519,6,응암,16453,16151,20200522,32604
20200520,6,봉화산,9320,8303,20200523,17623
20200520,6,화랑대,11576,8775,20200523,20351
20200520,6,태릉입구,5430,6274,20200523,11704
20200520,6,석계,12378,12765,20200523,25143
20200520,6,돌곶이,9203,8681,20200523,17884
20200520,6,상월곡,6372,5593,20200523,11965
20200520,6,월곡,11433,11084,20200523,22517
20200520,6,고려대,7903,7789,20200523,15692
20200520,6,안암,10017,10166,20200523,20183
20200520,6,보문,7202,6582,20200523,13784
20200520,6,창신,3528,2808,20200523,6336
20200520,6,동묘앞,7835,7802,20200523,15637
20200520,6,신당,7764,8249,20200523,16013
20200520,6,청구,3810,4285,20200523,8095
20200520,6,약수,3521,3543,20200523,7064
20200520,6,버티고개,2152,2080,20200523,4232
20200520,6,한강진,6079,7150,20200523,13229
20200520,6,이태원,5985,6126,20200523,12111
20200520,6,녹사평,3961,3720,20200523,7681
20200520,6,삼각지,5495,4796,20200523,10291
20200520,6,효창공원앞,6912,6244,20200523,13156
20200520,6,공덕,18464,18226,20200523,36690
20200520,6,대흥,7743,8067,20200523,15810
20200520,6,광흥창,8910,8751,20200523,17661
20200520,6,상수,7167,8065,20200523,15232
20200520,6,합정,12049,11935,20200523,23984
20200520,6,망원,13679,14986,20200523,28665
20200520,6,마포구청,14034,12379,20200523,26413
20200520,6,월드컵경기장,4728,4942,20200523,9670
20200520,6,디지털미디어시티,13715,14694,20200523,28409
20200520,6,증산,10117,9709,20200523,19826
20200520,6,새절,13050,12221,20200523,25271
20200520,6,구산,7165,5405,20200523,12570
20200520,6,연신내,1,0,20200523,1
20200520,6,독바위,2757,2927,20200523,5684
20200520,6,불광,4493,4645,20200523,9138
20200520,6,역촌,3763,4454,20200523,8217
20200520,6,응암,17384,17063,20200523,34447
20200521,6,역촌,3697,4357,20200524,8054
20200521,6,불광,4513,4478,20200524,8991
20200521,6,독바위,2753,2897,20200524,5650
20200521,6,구산,7170,5324,20200524,12494
20200521,6,새절,12801,12083,20200524,24884
20200521,6,증산,10014,9903,20200524,19917
20200521,6,디지털미디어시티,13489,14667,20200524,28156
20200521,6,월드컵경기장,4927,5182,20200524,10109
20200521,6,마포구청,13915,12212,20200524,26127
20200521,6,망원,13687,15065,20200524,28752
20200521,6,합정,11970,11978,20200524,23948
20200521,6,상수,7023,7986,20200524,15009
20200521,6,광흥창,8980,8702,20200524,17682
20200521,6,대흥,7798,8175,20200524,15973
20200521,6,공덕,18602,18234,20200524,36836
20200521,6,효창공원앞,6978,6256,20200524,13234
20200521,6,삼각지,5401,4689,20200524,10090
20200521,6,녹사평,3991,3756,20200524,7747
20200521,6,이태원,6363,6466,20200524,12829
20200521,6,한강진,6106,7282,20200524,13388
20200521,6,버티고개,2174,2096,20200524,4270
20200521,6,약수,3472,3676,20200524,7148
20200521,6,청구,3897,4211,20200524,8108
20200521,6,신당,7453,7948,20200524,15401
20200521,6,동묘앞,7728,7833,20200524,15561
20200521,6,창신,3421,2781,20200524,6202
20200521,6,보문,7232,6662,20200524,13894
20200521,6,안암,10354,10425,20200524,20779
20200521,6,고려대,7620,7588,20200524,15208
20200521,6,월곡,11536,11107,20200524,22643
20200521,6,상월곡,6182,5599,20200524,11781
20200521,6,돌곶이,8965,8415,20200524,17380
20200521,6,석계,12676,12646,20200524,25322
20200521,6,태릉입구,5571,6304,20200524,11875
20200521,6,화랑대,11536,8723,20200524,20259
20200521,6,봉화산,9147,8226,20200524,17373
20200521,6,응암,17378,16922,20200524,34300
20200522,6,상수,7560,9041,20200525,16601
20200522,6,응암,17615,16876,20200525,34491
20200522,6,역촌,3718,4397,20200525,8115
20200522,6,불광,4404,4523,20200525,8927
20200522,6,독바위,2759,2816,20200525,5575
20200522,6,구산,7352,5391,20200525,12743
20200522,6,새절,13052,12164,20200525,25216
20200522,6,증산,10219,9963,20200525,20182
20200522,6,디지털미디어시티,13710,14634,20200525,28344
20200522,6,월드컵경기장,4779,5050,20200525,9829
20200522,6,마포구청,14226,12313,20200525,26539
20200522,6,망원,14216,16022,20200525,30238
20200522,6,합정,12682,12965,20200525,25647
20200522,6,광흥창,9034,8713,20200525,17747
20200522,6,대흥,7789,8137,20200525,15926
20200522,6,공덕,18657,18327,20200525,36984
20200522,6,효창공원앞,6867,5925,20200525,12792
20200522,6,삼각지,5632,4774,20200525,10406
20200522,6,녹사평,4045,3838,20200525,7883
20200522,6,이태원,6897,7033,20200525,13930
20200522,6,한강진,6365,7554,20200525,13919
20200522,6,버티고개,2322,2130,20200525,4452
20200522,6,약수,3671,3778,20200525,7449
20200522,6,청구,3891,4260,20200525,8151
20200522,6,신당,7557,8317,20200525,15874
20200522,6,동묘앞,7765,7752,20200525,15517
20200522,6,창신,3428,2654,20200525,6082
20200522,6,보문,7416,6710,20200525,14126
20200522,6,안암,10976,10872,20200525,21848
20200522,6,고려대,8046,7516,20200525,15562
20200522,6,월곡,11873,11259,20200525,23132
20200522,6,상월곡,6411,5448,20200525,11859
20200522,6,돌곶이,9079,8299,20200525,17378
20200522,6,석계,12814,12972,20200525,25786
20200522,6,태릉입구,5595,6266,20200525,11861
20200522,6,화랑대,11603,8621,20200525,20224
20200522,6,봉화산,9291,8242,20200525,17533
20200523,6,응암,12162,11848,20200526,24010
20200523,6,역촌,2579,2870,20200526,5449
20200523,6,불광,3820,3732,20200526,7552
20200523,6,독바위,2047,2353,20200526,4400
20200523,6,연신내,1,0,20200526,1
20200523,6,구산,4970,3750,20200526,8720
20200523,6,새절,8760,8218,20200526,16978
20200523,6,증산,7388,7011,20200526,14399
20200523,6,디지털미디어시티,6963,7119,20200526,14082
20200523,6,월드컵경기장,5015,5438,20200526,10453
20200523,6,마포구청,8902,7569,20200526,16471
20200523,6,망원,11934,13470,20200526,25404
20200523,6,합정,10464,9992,20200526,20456
20200523,6,상수,5992,7313,20200526,13305
20200523,6,광흥창,4782,4433,20200526,9215
20200523,6,대흥,4911,4952,20200526,9863
20200523,6,공덕,9481,9045,20200526,18526
20200523,6,효창공원앞,4543,3820,20200526,8363
20200523,6,삼각지,3755,3042,20200526,6797
20200523,6,녹사평,2782,2713,20200526,5495
20200523,6,이태원,5126,5310,20200526,10436
20200523,6,한강진,4323,5013,20200526,9336
20200523,6,버티고개,1343,1402,20200526,2745
20200523,6,약수,2357,2454,20200526,4811
20200523,6,청구,2307,2426,20200526,4733
20200523,6,신당,5737,4670,20200526,10407
20200523,6,동묘앞,7446,6849,20200526,14295
20200523,6,창신,2044,1590,20200526,3634
20200523,6,보문,4988,4510,20200526,9498
20200523,6,안암,6674,6470,20200526,13144
20200523,6,고려대,5206,4875,20200526,10081
20200523,6,월곡,7376,7070,20200526,14446
20200523,6,상월곡,3928,3423,20200526,7351
20200523,6,돌곶이,5964,5491,20200526,11455
20200523,6,석계,8738,8527,20200526,17265
20200523,6,태릉입구,4339,5173,20200526,9512
20200523,6,화랑대,7184,5877,20200526,13061
20200523,6,봉화산,5477,5110,20200526,10587
20200523,6,신내,1,0,20200526,1
20200524,6,봉화산,3491,3314,20200527,6805
20200524,6,화랑대,4525,3983,20200527,8508
20200524,6,태릉입구,2982,3350,20200527,6332
20200524,6,석계,5881,5690,20200527,11571
20200524,6,돌곶이,4828,4726,20200527,9554
20200524,6,상월곡,2868,2590,20200527,5458
20200524,6,월곡,4857,4743,20200527,9600
20200524,6,고려대,3368,3297,20200527,6665
20200524,6,안암,4598,4931,20200527,9529
20200524,6,보문,3532,3306,20200527,6838
20200524,6,창신,1385,1300,20200527,2685
20200524,6,동묘앞,4956,4841,20200527,9797
20200524,6,신당,3053,3886,20200527,6939
20200524,6,청구,1455,1454,20200527,2909
20200524,6,약수,1358,1484,20200527,2842
20200524,6,버티고개,905,983,20200527,1888
20200524,6,한강진,2862,3314,20200527,6176
20200524,6,이태원,4645,4375,20200527,9020
20200524,6,녹사평,2019,1884,20200527,3903
20200524,6,삼각지,2197,1765,20200527,3962
20200524,6,효창공원앞,2945,2541,20200527,5486
20200524,6,공덕,5684,5335,20200527,11019
20200524,6,대흥,3099,3131,20200527,6230
20200524,6,광흥창,3382,3237,20200527,6619
20200524,6,상수,4073,4800,20200527,8873
20200524,6,합정,6975,6336,20200527,13311
20200524,6,망원,7947,8808,20200527,16755
20200524,6,마포구청,5949,5230,20200527,11179
20200524,6,월드컵경기장,2806,2947,20200527,5753
20200524,6,디지털미디어시티,4433,4474,20200527,8907
20200524,6,증산,4988,4871,20200527,9859
20200524,6,새절,5589,5546,20200527,11135
20200524,6,구산,3015,2323,20200527,5338
20200524,6,연신내,2,0,20200527,2
20200524,6,독바위,1419,1631,20200527,3050
20200524,6,불광,2752,2637,20200527,5389
20200524,6,역촌,1765,2008,20200527,3773
20200524,6,응암,7851,7895,20200527,15746
20200525,6,봉화산,9064,8191,20200528,17255
20200525,6,화랑대,11619,8939,20200528,20558
20200525,6,태릉입구,5485,6198,20200528,11683
20200525,6,석계,12294,12702,20200528,24996
20200525,6,돌곶이,9004,8436,20200528,17440
20200525,6,상월곡,6195,5567,20200528,11762
20200525,6,월곡,11497,11136,20200528,22633
20200525,6,고려대,7740,7529,20200528,15269
20200525,6,안암,9911,10384,20200528,20295
20200525,6,보문,6997,6567,20200528,13564
20200525,6,창신,3434,2840,20200528,6274
20200525,6,동묘앞,7701,7740,20200528,15441
20200525,6,신당,7341,7969,20200528,15310
20200525,6,청구,3797,4251,20200528,8048
20200525,6,약수,3604,3632,20200528,7236
20200525,6,버티고개,2127,2127,20200528,4254
20200525,6,한강진,5696,6615,20200528,12311
20200525,6,이태원,6760,6723,20200528,13483
20200525,6,녹사평,3652,3591,20200528,7243
20200525,6,삼각지,5054,4519,20200528,9573
20200525,6,효창공원앞,6829,6149,20200528,12978
20200525,6,공덕,18386,18142,20200528,36528
20200525,6,대흥,7793,8178,20200528,15971
20200525,6,광흥창,8760,8550,20200528,17310
20200525,6,상수,6835,7526,20200528,14361
20200525,6,합정,11773,11458,20200528,23231
20200525,6,망원,13092,14273,20200528,27365
20200525,6,마포구청,13759,12031,20200528,25790
20200525,6,월드컵경기장,4771,4902,20200528,9673
20200525,6,디지털미디어시티,13503,14731,20200528,28234
20200525,6,증산,10097,9815,20200528,19912
20200525,6,새절,12812,12037,20200528,24849
20200525,6,구산,7155,5505,20200528,12660
20200525,6,독바위,2715,2865,20200528,5580
20200525,6,불광,4339,4468,20200528,8807
20200525,6,역촌,3717,4305,20200528,8022
20200525,6,응암,17384,17107,20200528,34491
20200526,6,봉화산,9215,8368,20200529,17583
20200526,6,화랑대,11701,8966,20200529,20667
20200526,6,태릉입구,5424,6128,20200529,11552
20200526,6,석계,12407,12931,20200529,25338
20200526,6,돌곶이,8942,8440,20200529,17382
20200526,6,상월곡,6170,5463,20200529,11633
20200526,6,월곡,11529,11174,20200529,22703
20200526,6,고려대,7820,7430,20200529,15250
20200526,6,안암,10248,10548,20200529,20796
20200526,6,보문,7164,6695,20200529,13859
20200526,6,창신,3554,2847,20200529,6401
20200526,6,동묘앞,7622,7762,20200529,15384
20200526,6,신당,7560,8190,20200529,15750
20200526,6,청구,3853,4262,20200529,8115
20200526,6,약수,3619,3688,20200529,7307
20200526,6,버티고개,2162,2132,20200529,4294
20200526,6,한강진,6489,7440,20200529,13929
20200526,6,이태원,6666,6853,20200529,13519
20200526,6,녹사평,3806,3790,20200529,7596
20200526,6,삼각지,5453,4847,20200529,10300
20200526,6,효창공원앞,7107,6258,20200529,13365
20200526,6,공덕,18536,18226,20200529,36762
20200526,6,대흥,8003,8424,20200529,16427
20200526,6,광흥창,8756,8564,20200529,17320
20200526,6,상수,7320,8056,20200529,15376
20200526,6,합정,12125,12075,20200529,24200
20200526,6,망원,13219,14470,20200529,27689
20200526,6,마포구청,14021,12517,20200529,26538
20200526,6,월드컵경기장,4586,4634,20200529,9220
20200526,6,디지털미디어시티,13600,14717,20200529,28317
20200526,6,증산,10111,9996,20200529,20107
20200526,6,새절,12929,12275,20200529,25204
20200526,6,구산,7171,5494,20200529,12665
20200526,6,연신내,3,0,20200529,3
20200526,6,독바위,2710,2880,20200529,5590
20200526,6,불광,4356,4451,20200529,8807
20200526,6,역촌,3728,4249,20200529,7977
20200526,6,응암,17305,17136,20200529,34441
20200527,6,봉화산,9337,8342,20200530,17679
20200527,6,화랑대,11898,9050,20200530,20948
20200527,6,태릉입구,5504,6504,20200530,12008
20200527,6,석계,12844,12900,20200530,25744
20200527,6,돌곶이,9377,8799,20200530,18176
20200527,6,상월곡,6339,5543,20200530,11882
20200527,6,월곡,11610,11333,20200530,22943
20200527,6,고려대,8021,7703,20200530,15724
20200527,6,안암,10352,10631,20200530,20983
20200527,6,보문,7296,6646,20200530,13942
20200527,6,창신,3574,2925,20200530,6499
20200527,6,동묘앞,7723,7943,20200530,15666
20200527,6,신당,7815,8473,20200530,16288
20200527,6,청구,3784,4302,20200530,8086
20200527,6,약수,3573,3630,20200530,7203
20200527,6,버티고개,2198,2156,20200530,4354
20200527,6,한강진,6490,7582,20200530,14072
20200527,6,이태원,6799,6870,20200530,13669
20200527,6,녹사평,4104,3891,20200530,7995
20200527,6,삼각지,5557,4941,20200530,10498
20200527,6,효창공원앞,7134,6310,20200530,13444
20200527,6,공덕,18634,18478,20200530,37112
20200527,6,대흥,8025,8402,20200530,16427
20200527,6,광흥창,9118,8862,20200530,17980
20200527,6,상수,7341,8149,20200530,15490
20200527,6,합정,12393,12102,20200530,24495
20200527,6,망원,13943,15281,20200530,29224
20200527,6,마포구청,14205,12568,20200530,26773
20200527,6,월드컵경기장,4931,5290,20200530,10221
20200527,6,디지털미디어시티,13636,14947,20200530,28583
20200527,6,증산,10212,9808,20200530,20020
20200527,6,새절,12985,12250,20200530,25235
20200527,6,구산,7504,5606,20200530,13110
20200527,6,연신내,1,0,20200530,1
20200527,6,독바위,2781,2938,20200530,5719
20200527,6,불광,4629,4921,20200530,9550
20200527,6,역촌,3738,4358,20200530,8096
20200527,6,응암,17611,17319,20200530,34930
20200528,6,봉화산,9148,8107,20200531,17255
20200528,6,화랑대,11729,8827,20200531,20556
20200528,6,태릉입구,5379,6206,20200531,11585
20200528,6,석계,12484,12635,20200531,25119
20200528,6,돌곶이,9156,8521,20200531,17677
20200528,6,상월곡,6282,5562,20200531,11844
20200528,6,월곡,11428,11184,20200531,22612
20200528,6,고려대,7918,7385,20200531,15303
20200528,6,안암,10436,10560,20200531,20996
20200528,6,보문,7271,6586,20200531,13857
20200528,6,창신,3516,2833,20200531,6349
20200528,6,동묘앞,7588,7730,20200531,15318
20200528,6,신당,7647,8340,20200531,15987
20200528,6,청구,3816,4226,20200531,8042
20200528,6,약수,3583,3639,20200531,7222
20200528,6,버티고개,2219,2151,20200531,4370
20200528,6,한강진,6527,7610,20200531,14137
20200528,6,이태원,6902,6945,20200531,13847
20200528,6,녹사평,4024,3912,20200531,7936
20200528,6,삼각지,5568,4907,20200531,10475
20200528,6,효창공원앞,7131,6324,20200531,13455
20200528,6,공덕,18514,18235,20200531,36749
20200528,6,대흥,7899,8195,20200531,16094
20200528,6,광흥창,8765,8556,20200531,17321
20200528,6,상수,7206,8204,20200531,15410
20200528,6,합정,11906,11800,20200531,23706
20200528,6,망원,13514,14863,20200531,28377
20200528,6,마포구청,14041,12233,20200531,26274
20200528,6,월드컵경기장,4814,5059,20200531,9873
20200528,6,디지털미디어시티,13566,14785,20200531,28351
20200528,6,증산,10061,9761,20200531,19822
20200528,6,새절,12867,12044,20200531,24911
20200528,6,구산,7315,5488,20200531,12803
20200528,6,연신내,1,0,20200531,1
20200528,6,독바위,2759,2836,20200531,5595
20200528,6,불광,4338,4472,20200531,8810
20200528,6,역촌,3679,4255,20200531,7934
20200528,6,응암,17119,16847,20200531,33966
20200529,6,응암,17627,17026,20200601,34653
20200529,6,역촌,3792,4351,20200601,8143
20200529,6,불광,4469,4576,20200601,9045
20200529,6,독바위,2796,2892,20200601,5688
20200529,6,구산,7429,5463,20200601,12892
20200529,6,새절,13111,11991,20200601,25102
20200529,6,증산,10144,9683,20200601,19827
20200529,6,디지털미디어시티,13441,14589,20200601,28030
20200529,6,월드컵경기장,4813,5175,20200601,9988
20200529,6,마포구청,14147,12294,20200601,26441
20200529,6,망원,13999,15911,20200601,29910
20200529,6,합정,12566,12897,20200601,25463
20200529,6,상수,7709,9082,20200601,16791
20200529,6,광흥창,8872,8577,20200601,17449
20200529,6,대흥,8113,8364,20200601,16477
20200529,6,공덕,18749,18439,20200601,37188
20200529,6,효창공원앞,7065,6161,20200601,13226
20200529,6,삼각지,5728,5017,20200601,10745
20200529,6,녹사평,4245,4128,20200601,8373
20200529,6,이태원,7014,7393,20200601,14407
20200529,6,한강진,6688,7951,20200601,14639
20200529,6,버티고개,2262,2132,20200601,4394
20200529,6,약수,3536,3629,20200601,7165
20200529,6,청구,3805,4239,20200601,8044
20200529,6,신당,7858,8306,20200601,16164
20200529,6,동묘앞,7947,7937,20200601,15884
20200529,6,창신,3506,2640,20200601,6146
20200529,6,보문,7482,6634,20200601,14116
20200529,6,안암,11006,10823,20200601,21829
20200529,6,고려대,8078,7497,20200601,15575
20200529,6,월곡,11767,11187,20200601,22954
20200529,6,상월곡,6411,5457,20200601,11868
20200529,6,돌곶이,9140,8512,20200601,17652
20200529,6,석계,12911,12914,20200601,25825
20200529,6,태릉입구,5482,6375,20200601,11857
20200529,6,화랑대,11778,8898,20200601,20676
20200529,6,봉화산,9161,8262,20200601,17423
20200530,6,응암,11523,10964,20200602,22487
20200530,6,역촌,2561,2758,20200602,5319
20200530,6,불광,3675,3651,20200602,7326
20200530,6,독바위,1858,2148,20200602,4006
20200530,6,연신내,1,0,20200602,1
20200530,6,구산,4807,3632,20200602,8439
20200530,6,새절,8742,8077,20200602,16819
20200530,6,증산,7290,6803,20200602,14093
20200530,6,디지털미디어시티,6569,6457,20200602,13026
20200530,6,월드컵경기장,4370,4698,20200602,9068
20200530,6,마포구청,8512,7240,20200602,15752
20200530,6,망원,11278,12784,20200602,24062
20200530,6,합정,9961,9818,20200602,19779
20200530,6,상수,5745,7132,20200602,12877
20200530,6,광흥창,4593,4139,20200602,8732
20200530,6,대흥,4446,4610,20200602,9056
20200530,6,공덕,9016,8428,20200602,17444
20200530,6,효창공원앞,4268,3623,20200602,7891
20200530,6,삼각지,3739,2965,20200602,6704
20200530,6,녹사평,2941,2883,20200602,5824
20200530,6,이태원,5352,5425,20200602,10777
20200530,6,한강진,4710,5655,20200602,10365
20200530,6,버티고개,1288,1364,20200602,2652
20200530,6,약수,2231,2384,20200602,4615
20200530,6,청구,2220,2426,20200602,4646
20200530,6,신당,5295,4240,20200602,9535
20200530,6,동묘앞,7125,6664,20200602,13789
20200530,6,창신,1994,1678,20200602,3672
20200530,6,보문,5133,4437,20200602,9570
20200530,6,안암,6584,6296,20200602,12880
20200530,6,고려대,5074,4640,20200602,9714
20200530,6,월곡,7110,6811,20200602,13921
20200530,6,상월곡,3781,3300,20200602,7081
20200530,6,돌곶이,5783,5234,20200602,11017
20200530,6,석계,9057,8631,20200602,17688
20200530,6,태릉입구,3996,4559,20200602,8555
20200530,6,화랑대,6422,5253,20200602,11675
20200530,6,봉화산,5241,4906,20200602,10147
20200531,6,봉화산,3533,3420,20200603,6953
20200531,6,화랑대,4354,3739,20200603,8093
20200531,6,태릉입구,2974,3415,20200603,6389
20200531,6,석계,6313,6119,20200603,12432
20200531,6,돌곶이,5167,5006,20200603,10173
20200531,6,상월곡,2927,2647,20200603,5574
20200531,6,월곡,5180,5123,20200603,10303
20200531,6,고려대,3416,3272,20200603,6688
20200531,6,안암,4558,4995,20200603,9553
20200531,6,보문,3540,3395,20200603,6935
20200531,6,창신,1462,1306,20200603,2768
20200531,6,동묘앞,5267,5164,20200603,10431
20200531,6,신당,2964,3641,20200603,6605
20200531,6,청구,1406,1488,20200603,2894
20200531,6,약수,1388,1491,20200603,2879
20200531,6,버티고개,973,991,20200603,1964
20200531,6,한강진,3598,4189,20200603,7787
20200531,6,이태원,4233,4083,20200603,8316
20200531,6,녹사평,2317,2138,20200603,4455
20200531,6,삼각지,2492,1969,20200603,4461
20200531,6,효창공원앞,2869,2494,20200603,5363
20200531,6,공덕,5903,5516,20200603,11419
20200531,6,대흥,3082,3168,20200603,6250
20200531,6,광흥창,3769,3608,20200603,7377
20200531,6,상수,4213,4843,20200603,9056
20200531,6,합정,7385,6754,20200603,14139
20200531,6,망원,8063,8830,20200603,16893
20200531,6,마포구청,6092,5418,20200603,11510
20200531,6,월드컵경기장,3688,3761,20200603,7449
20200531,6,디지털미디어시티,4469,4671,20200603,9140
20200531,6,증산,5031,5070,20200603,10101
20200531,6,새절,5998,5855,20200603,11853
20200531,6,구산,3170,2391,20200603,5561
20200531,6,독바위,1515,1839,20200603,3354
20200531,6,불광,2897,2713,20200603,5610
20200531,6,역촌,1682,2003,20200603,3685
20200531,6,응암,8057,8160,20200603,16217
20200101,7,부평구청,4647,3983,20200104,8630
20200101,7,굴포천,4424,4720,20200104,9144
20200101,7,삼산체육관,2094,2043,20200104,4137
20200101,7,상동,7062,6914,20200104,13976
20200101,7,부천시청,5832,5755,20200104,11587
20200101,7,신중동,5575,5614,20200104,11189
20200101,7,춘의,3384,3295,20200104,6679
20200101,7,부천종합운동장,2195,1906,20200104,4101
20200101,7,까치울,3294,3282,20200104,6576
20200101,7,온수,3687,4049,20200104,7736
20200101,7,천왕,3948,4009,20200104,7957
20200101,7,광명사거리,13125,13078,20200104,26203
20200101,7,철산,10109,10483,20200104,20592
20200101,7,가산디지털단지,11215,10506,20200104,21721
20200101,7,남구로,7947,7748,20200104,15695
20200101,7,대림,8976,8590,20200104,17566
20200101,7,신풍,5497,5349,20200104,10846
20200101,7,보라매,3585,3783,20200104,7368
20200101,7,신대방삼거리,7029,7086,20200104,14115
20200101,7,장승배기,4565,4692,20200104,9257
20200101,7,상도,4627,5089,20200104,9716
20200101,7,숭실대입구,5030,5654,20200104,10684
20200101,7,남성,5026,5232,20200104,10258
20200101,7,이수,7439,7441,20200104,14880
20200101,7,내방,4137,4217,20200104,8354
20200101,7,고속터미널,12492,8223,20200104,20715
20200101,7,반포,2709,2716,20200104,5425
20200101,7,논현,5385,5505,20200104,10890
20200101,7,학동,4954,4441,20200104,9395
20200101,7,강남구청,3549,3802,20200104,7351
20200101,7,청담,5780,6240,20200104,12020
20200101,7,뚝섬유원지,4087,3983,20200104,8070
20200101,7,건대입구,8665,9179,20200104,17844
20200101,7,어린이대공원,5557,5607,20200104,11164
20200101,7,군자,7162,5506,20200104,12668
20200101,7,중곡,4468,4313,20200104,8781
20200101,7,용마산,3000,3095,20200104,6095
20200101,7,사가정,8084,8016,20200104,16100
20200101,7,면목,7131,7299,20200104,14430
20200101,7,상봉,8539,8004,20200104,16543
20200101,7,중화,5154,5209,20200104,10363
20200101,7,먹골,4750,4810,20200104,9560
20200101,7,태릉입구,4074,3803,20200104,7877
20200101,7,공릉,5622,5847,20200104,11469
20200101,7,하계,8542,8370,20200104,16912
20200101,7,중계,6414,6157,20200104,12571
20200101,7,노원,9371,9960,20200104,19331
20200101,7,마들,5578,5435,20200104,11013
20200101,7,수락산,6448,6564,20200104,13012
20200101,7,도봉산,4028,5811,20200104,9839
20200101,7,장암,919,524,20200104,1443
20200102,7,장암,2585,832,20200105,3417
20200102,7,도봉산,9587,10966,20200105,20553
20200102,7,수락산,13676,13631,20200105,27307
20200102,7,마들,13244,12600,20200105,25844
20200102,7,노원,23653,24935,20200105,48588
20200102,7,중계,16312,14863,20200105,31175
20200102,7,하계,20011,19001,20200105,39012
20200102,7,공릉,12852,12726,20200105,25578
20200102,7,태릉입구,8800,8277,20200105,17077
20200102,7,먹골,11138,10878,20200105,22016
20200102,7,중화,12234,11796,20200105,24030
20200102,7,상봉,18478,17539,20200105,36017
20200102,7,면목,16517,16077,20200105,32594
20200102,7,사가정,16914,16854,20200105,33768
20200102,7,용마산,6500,6037,20200105,12537
20200102,7,중곡,10749,9974,20200105,20723
20200102,7,군자,15815,12596,20200105,28411
20200102,7,어린이대공원,12742,12743,20200105,25485
20200102,7,건대입구,15499,16705,20200105,32204
20200102,7,뚝섬유원지,7903,7593,20200105,15496
20200102,7,청담,22667,25402,20200105,48069
20200102,7,강남구청,17578,19535,20200105,37113
20200102,7,학동,25655,27954,20200105,53609
20200102,7,논현,22503,24636,20200105,47139
20200102,7,반포,6680,6615,20200105,13295
20200102,7,고속터미널,21345,17051,20200105,38396
20200102,7,내방,15677,16096,20200105,31773
20200102,7,이수,17758,17655,20200105,35413
20200102,7,남성,12702,11879,20200105,24581
20200102,7,숭실대입구,13711,14010,20200105,27721
20200102,7,상도,11816,11687,20200105,23503
20200102,7,장승배기,11356,11132,20200105,22488
20200102,7,신대방삼거리,18174,17493,20200105,35667
20200102,7,보라매,10195,10428,20200105,20623
20200102,7,신풍,12217,11524,20200105,23741
20200102,7,대림,9694,9550,20200105,19244
20200102,7,남구로,18259,19214,20200105,37473
20200102,7,가산디지털단지,48928,49299,20200105,98227
20200102,7,철산,25304,25710,20200105,51014
20200102,7,광명사거리,26911,26027,20200105,52938
20200102,7,천왕,11013,9918,20200105,20931
20200102,7,온수,11343,10733,20200105,22076
20200102,7,까치울,7929,7466,20200105,15395
20200102,7,부천종합운동장,5069,4196,20200105,9265
20200102,7,춘의,10439,10300,20200105,20739
20200102,7,신중동,16345,15856,20200105,32201
20200102,7,부천시청,13710,13654,20200105,27364
20200102,7,상동,15154,15620,20200105,30774
20200102,7,삼산체육관,5666,5145,20200105,10811
20200102,7,굴포천,10057,10608,20200105,20665
20200102,7,부평구청,13146,10593,20200105,23739
20200103,7,장암,2628,923,20200106,3551
20200103,7,도봉산,9913,11344,20200106,21257
20200103,7,수락산,14310,14000,20200106,28310
20200103,7,마들,13813,12836,20200106,26649
20200103,7,노원,24845,27051,20200106,51896
20200103,7,중계,17199,15308,20200106,32507
20200103,7,하계,21131,19527,20200106,40658
20200103,7,공릉,14148,14225,20200106,28373
20200103,7,태릉입구,9386,8505,20200106,17891
20200103,7,먹골,11852,11380,20200106,23232
20200103,7,중화,12907,12390,20200106,25297
20200103,7,상봉,19547,18694,20200106,38241
20200103,7,면목,17486,16759,20200106,34245
20200103,7,사가정,17753,17613,20200106,35366
20200103,7,용마산,6766,6394,20200106,13160
20200103,7,중곡,11291,10432,20200106,21723
20200103,7,군자,16640,13007,20200106,29647
20200103,7,어린이대공원,14464,13749,20200106,28213
20200103,7,건대입구,16666,18131,20200106,34797
20200103,7,뚝섬유원지,7894,7599,20200106,15493
20200103,7,청담,23418,26570,20200106,49988
20200103,7,강남구청,17800,20226,20200106,38026
20200103,7,학동,27005,29192,20200106,56197
20200103,7,논현,23466,26338,20200106,49804
20200103,7,반포,7188,6929,20200106,14117
20200103,7,고속터미널,23341,18503,20200106,41844
20200103,7,내방,16485,16844,20200106,33329
20200103,7,이수,19298,19425,20200106,38723
20200103,7,남성,13164,11945,20200106,25109
20200103,7,숭실대입구,14955,14627,20200106,29582
20200103,7,상도,12652,11909,20200106,24561
20200103,7,장승배기,12209,11678,20200106,23887
20200103,7,신대방삼거리,19114,18007,20200106,37121
20200103,7,보라매,10822,10720,20200106,21542
20200103,7,신풍,12886,12096,20200106,24982
20200103,7,대림,9996,10364,20200106,20360
20200103,7,남구로,18340,19948,20200106,38288
20200103,7,가산디지털단지,49822,50314,20200106,100136
20200103,7,철산,26700,27641,20200106,54341
20200103,7,광명사거리,28429,27558,20200106,55987
20200103,7,천왕,11613,10203,20200106,21816
20200103,7,온수,11551,10822,20200106,22373
20200103,7,까치울,8228,7600,20200106,15828
20200103,7,부천종합운동장,5305,4296,20200106,9601
20200103,7,춘의,10829,10433,20200106,21262
20200103,7,신중동,17138,17266,20200106,34404
20200103,7,부천시청,14542,14424,20200106,28966
20200103,7,상동,16247,17011,20200106,33258
20200103,7,삼산체육관,5796,5119,20200106,10915
20200103,7,굴포천,10353,10974,20200106,21327
20200103,7,부평구청,13627,10865,20200106,24492
20200104,7,장암,1745,940,20200107,2685
20200104,7,도봉산,7218,9552,20200107,16770
20200104,7,수락산,11288,10857,20200107,22145
20200104,7,마들,9585,8821,20200107,18406
20200104,7,노원,18491,19957,20200107,38448
20200104,7,중계,11792,10692,20200107,22484
20200104,7,하계,15493,14405,20200107,29898
20200104,7,공릉,9999,9971,20200107,19970
20200104,7,태릉입구,7466,6535,20200107,14001
20200104,7,먹골,9252,8668,20200107,17920
20200104,7,중화,9023,8622,20200107,17645
20200104,7,상봉,15094,14458,20200107,29552
20200104,7,면목,12724,11932,20200107,24656
20200104,7,사가정,13796,13253,20200107,27049
20200104,7,용마산,4792,4753,20200107,9545
20200104,7,중곡,7748,7120,20200107,14868
20200104,7,군자,12375,9163,20200107,21538
20200104,7,어린이대공원,15874,16199,20200107,32073
20200104,7,건대입구,14751,16074,20200107,30825
20200104,7,뚝섬유원지,6361,6172,20200107,12533
20200104,7,청담,13076,14074,20200107,27150
20200104,7,강남구청,10654,11757,20200107,22411
20200104,7,학동,12661,13501,20200107,26162
20200104,7,논현,13150,14924,20200107,28074
20200104,7,반포,5390,4961,20200107,10351
20200104,7,고속터미널,20839,16063,20200107,36902
20200104,7,내방,8939,8754,20200107,17693
20200104,7,이수,14563,14005,20200107,28568
20200104,7,남성,9052,8368,20200107,17420
20200104,7,숭실대입구,9716,9325,20200107,19041
20200104,7,상도,8671,7923,20200107,16594
20200104,7,장승배기,8369,8014,20200107,16383
20200104,7,신대방삼거리,12761,11817,20200107,24578
20200104,7,보라매,6873,6626,20200107,13499
20200104,7,신풍,9202,8877,20200107,18079
20200104,7,대림,9491,10265,20200107,19756
20200104,7,남구로,10329,10855,20200107,21184
20200104,7,가산디지털단지,17112,15715,20200107,32827
20200104,7,철산,19128,19505,20200107,38633
20200104,7,광명사거리,21627,21533,20200107,43160
20200104,7,천왕,7212,6562,20200107,13774
20200104,7,온수,6371,6461,20200107,12832
20200104,7,까치울,5799,5570,20200107,11369
20200104,7,부천종합운동장,3544,3097,20200107,6641
20200104,7,춘의,5727,5402,20200107,11129
20200104,7,신중동,11750,11874,20200107,23624
20200104,7,부천시청,10937,10631,20200107,21568
20200104,7,상동,12824,13057,20200107,25881
20200104,7,삼산체육관,4264,3842,20200107,8106
20200104,7,굴포천,7352,7540,20200107,14892
20200104,7,부평구청,8606,7259,20200107,15865
20200105,7,장암,1337,818,20200108,2155
20200105,7,도봉산,5601,8192,20200108,13793
20200105,7,수락산,9126,9084,20200108,18210
20200105,7,마들,6303,5763,20200108,12066
20200105,7,노원,13460,13603,20200108,27063
20200105,7,중계,9149,8514,20200108,17663
20200105,7,하계,11447,10923,20200108,22370
20200105,7,공릉,7314,7521,20200108,14835
20200105,7,태릉입구,5339,4890,20200108,10229
20200105,7,먹골,6267,6103,20200108,12370
20200105,7,중화,6932,6813,20200108,13745
20200105,7,상봉,11236,10633,20200108,21869
20200105,7,면목,9378,9199,20200108,18577
20200105,7,사가정,10089,9881,20200108,19970
20200105,7,용마산,3602,3917,20200108,7519
20200105,7,중곡,5982,5558,20200108,11540
20200105,7,군자,9107,6953,20200108,16060
20200105,7,어린이대공원,8892,9003,20200108,17895
20200105,7,건대입구,10431,10958,20200108,21389
20200105,7,뚝섬유원지,5379,5294,20200108,10673
20200105,7,청담,7722,8097,20200108,15819
20200105,7,강남구청,6065,6442,20200108,12507
20200105,7,학동,8589,8785,20200108,17374
20200105,7,논현,7145,7654,20200108,14799
20200105,7,반포,3597,3664,20200108,7261
20200105,7,고속터미널,16836,11758,20200108,28594
20200105,7,내방,5635,5787,20200108,11422
20200105,7,이수,9900,9548,20200108,19448
20200105,7,남성,6399,6421,20200108,12820
20200105,7,숭실대입구,6968,7291,20200108,14259
20200105,7,상도,6268,6413,20200108,12681
20200105,7,장승배기,6105,6119,20200108,12224
20200105,7,신대방삼거리,9221,8991,20200108,18212
20200105,7,보라매,4708,4664,20200108,9372
20200105,7,신풍,7128,6926,20200108,14054
20200105,7,대림,10725,10323,20200108,21048
20200105,7,남구로,9142,8730,20200108,17872
20200105,7,가산디지털단지,12713,11763,20200108,24476
20200105,7,철산,13224,13334,20200108,26558
20200105,7,광명사거리,16118,15764,20200108,31882
20200105,7,천왕,5284,5070,20200108,10354
20200105,7,온수,4839,5091,20200108,9930
20200105,7,까치울,4347,4203,20200108,8550
20200105,7,부천종합운동장,2498,2379,20200108,4877
20200105,7,춘의,4080,3785,20200108,7865
20200105,7,신중동,8010,7819,20200108,15829
20200105,7,부천시청,7510,7419,20200108,14929
20200105,7,상동,8649,8621,20200108,17270
20200105,7,삼산체육관,2802,2582,20200108,5384
20200105,7,굴포천,5482,5576,20200108,11058
20200105,7,부평구청,6135,5110,20200108,11245
20200106,7,장암,2742,776,20200109,3518
20200106,7,도봉산,9734,10809,20200109,20543
20200106,7,수락산,13861,13953,20200109,27814
20200106,7,마들,13280,12740,20200109,26020
20200106,7,노원,23649,24603,20200109,48252
20200106,7,중계,16869,15695,20200109,32564
20200106,7,하계,20533,19681,20200109,40214
20200106,7,공릉,13699,13705,20200109,27404
20200106,7,태릉입구,9059,8538,20200109,17597
20200106,7,먹골,11619,11385,20200109,23004
20200106,7,중화,12647,12435,20200109,25082
20200106,7,상봉,18824,17621,20200109,36445
20200106,7,면목,17000,16448,20200109,33448
20200106,7,사가정,17232,17308,20200109,34540
20200106,7,용마산,6717,6439,20200109,13156
20200106,7,중곡,11036,10303,20200109,21339
20200106,7,군자,16168,12820,20200109,28988
20200106,7,어린이대공원,13581,13101,20200109,26682
20200106,7,건대입구,16048,17295,20200109,33343
20200106,7,뚝섬유원지,7297,7060,20200109,14357
20200106,7,청담,23172,26330,20200109,49502
20200106,7,강남구청,17523,19523,20200109,37046
20200106,7,학동,27328,29092,20200109,56420
20200106,7,논현,23144,25436,20200109,48580
20200106,7,반포,7044,7008,20200109,14052
20200106,7,고속터미널,21153,17215,20200109,38368
20200106,7,내방,16259,16743,20200109,33002
20200106,7,이수,18293,17872,20200109,36165
20200106,7,남성,12967,12081,20200109,25048
20200106,7,숭실대입구,16104,16042,20200109,32146
20200106,7,상도,12412,12104,20200109,24516
20200106,7,장승배기,12012,11705,20200109,23717
20200106,7,신대방삼거리,18972,18414,20200109,37386
20200106,7,보라매,10917,10907,20200109,21824
20200106,7,신풍,12828,12309,20200109,25137
20200106,7,대림,10241,10139,20200109,20380
20200106,7,남구로,18920,20307,20200109,39227
20200106,7,가산디지털단지,51719,51373,20200109,103092
20200106,7,철산,25268,26131,20200109,51399
20200106,7,광명사거리,27363,26887,20200109,54250
20200106,7,천왕,11183,10242,20200109,21425
20200106,7,온수,11560,10953,20200109,22513
20200106,7,까치울,7936,7555,20200109,15491
20200106,7,부천종합운동장,5133,4274,20200109,9407
20200106,7,춘의,10557,10340,20200109,20897
20200106,7,신중동,16572,16282,20200109,32854
20200106,7,부천시청,13823,13801,20200109,27624
20200106,7,상동,15455,15703,20200109,31158
20200106,7,삼산체육관,5618,4997,20200109,10615
20200106,7,굴포천,10162,10736,20200109,20898
20200106,7,부평구청,13633,10887,20200109,24520
20200107,7,장암,2600,795,20200110,3395
20200107,7,도봉산,9302,10555,20200110,19857
20200107,7,수락산,13392,13558,20200110,26950
20200107,7,마들,12980,12489,20200110,25469
20200107,7,노원,22676,23741,20200110,46417
20200107,7,중계,17032,15845,20200110,32877
20200107,7,하계,20850,19846,20200110,40696
20200107,7,공릉,13323,13215,20200110,26538
20200107,7,태릉입구,9148,8620,20200110,17768
20200107,7,먹골,11495,11389,20200110,22884
20200107,7,중화,12585,12207,20200110,24792
20200107,7,상봉,18158,17058,20200110,35216
20200107,7,면목,16613,16193,20200110,32806
20200107,7,사가정,16851,17030,20200110,33881
20200107,7,용마산,6717,6270,20200110,12987
20200107,7,중곡,11059,10360,20200110,21419
20200107,7,군자,16012,12767,20200110,28779
20200107,7,어린이대공원,13887,13372,20200110,27259
20200107,7,건대입구,16029,17043,20200110,33072
20200107,7,뚝섬유원지,7100,6857,20200110,13957
20200107,7,청담,22985,26050,20200110,49035
20200107,7,강남구청,18071,19978,20200110,38049
20200107,7,학동,26813,28653,20200110,55466
20200107,7,논현,22819,25013,20200110,47832
20200107,7,반포,7005,6729,20200110,13734
20200107,7,고속터미널,20111,17107,20200110,37218
20200107,7,내방,16261,16628,20200110,32889
20200107,7,이수,18186,17931,20200110,36117
20200107,7,남성,12815,11895,20200110,24710
20200107,7,숭실대입구,15868,16107,20200110,31975
20200107,7,상도,12213,11919,20200110,24132
20200107,7,장승배기,11773,11590,20200110,23363
20200107,7,신대방삼거리,18575,17934,20200110,36509
20200107,7,보라매,10549,10718,20200110,21267
20200107,7,신풍,12291,11794,20200110,24085
20200107,7,대림,9773,9920,20200110,19693
20200107,7,남구로,18526,19496,20200110,38022
20200107,7,가산디지털단지,51290,51012,20200110,102302
20200107,7,철산,24983,25922,20200110,50905
20200107,7,광명사거리,26176,25760,20200110,51936
20200107,7,천왕,10800,9780,20200110,20580
20200107,7,온수,11213,10623,20200110,21836
20200107,7,까치울,7794,7264,20200110,15058
20200107,7,부천종합운동장,4890,4151,20200110,9041
20200107,7,춘의,10335,10235,20200110,20570
20200107,7,신중동,16338,16225,20200110,32563
20200107,7,부천시청,13627,13407,20200110,27034
20200107,7,상동,15175,15679,20200110,30854
20200107,7,삼산체육관,5696,5128,20200110,10824
20200107,7,굴포천,9900,10553,20200110,20453
20200107,7,부평구청,13180,10758,20200110,23938
20200108,7,뚝섬유원지,7647,7334,20200111,14981
20200108,7,장암,2658,812,20200111,3470
20200108,7,도봉산,9709,11122,20200111,20831
20200108,7,수락산,13961,13998,20200111,27959
20200108,7,마들,13567,12924,20200111,26491
20200108,7,노원,23419,24926,20200111,48345
20200108,7,중계,17814,16506,20200111,34320
20200108,7,하계,21342,20378,20200111,41720
20200108,7,공릉,13643,13624,20200111,27267
20200108,7,태릉입구,9335,8814,20200111,18149
20200108,7,먹골,11619,11367,20200111,22986
20200108,7,중화,12707,12361,20200111,25068
20200108,7,상봉,19083,18249,20200111,37332
20200108,7,면목,17141,16728,20200111,33869
20200108,7,사가정,17174,17222,20200111,34396
20200108,7,용마산,6764,6375,20200111,13139
20200108,7,중곡,11350,10709,20200111,22059
20200108,7,군자,16743,13065,20200111,29808
20200108,7,어린이대공원,14073,13630,20200111,27703
20200108,7,건대입구,16438,17409,20200111,33847
20200108,7,청담,23714,26534,20200111,50248
20200108,7,강남구청,18439,20594,20200111,39033
20200108,7,학동,27202,29345,20200111,56547
20200108,7,논현,23286,25760,20200111,49046
20200108,7,반포,7550,7347,20200111,14897
20200108,7,고속터미널,20389,17237,20200111,37626
20200108,7,내방,16482,16907,20200111,33389
20200108,7,이수,19001,18807,20200111,37808
20200108,7,남성,13188,12208,20200111,25396
20200108,7,숭실대입구,15547,15402,20200111,30949
20200108,7,상도,13005,12421,20200111,25426
20200108,7,장승배기,11950,11576,20200111,23526
20200108,7,신대방삼거리,19268,18365,20200111,37633
20200108,7,보라매,11084,11333,20200111,22417
20200108,7,신풍,12929,12380,20200111,25309
20200108,7,대림,10156,10085,20200111,20241
20200108,7,남구로,18324,19693,20200111,38017
20200108,7,가산디지털단지,50955,51111,20200111,102066
20200108,7,철산,26421,26939,20200111,53360
20200108,7,광명사거리,28019,27457,20200111,55476
20200108,7,천왕,11355,10388,20200111,21743
20200108,7,온수,11676,11115,20200111,22791
20200108,7,까치울,8235,7834,20200111,16069
20200108,7,부천종합운동장,5135,4356,20200111,9491
20200108,7,춘의,10759,10417,20200111,21176
20200108,7,신중동,17026,16782,20200111,33808
20200108,7,부천시청,14362,14258,20200111,28620
20200108,7,상동,16070,16649,20200111,32719
20200108,7,삼산체육관,6088,5362,20200111,11450
20200108,7,굴포천,10268,10824,20200111,21092
20200108,7,부평구청,13509,11082,20200111,24591
20200109,7,장암,2719,914,20200112,3633
20200109,7,도봉산,9932,11413,20200112,21345
20200109,7,수락산,14344,14429,20200112,28773
20200109,7,마들,13832,13036,20200112,26868
20200109,7,노원,24017,25452,20200112,49469
20200109,7,중계,17624,15982,20200112,33606
20200109,7,하계,21014,19859,20200112,40873
20200109,7,공릉,13775,13744,20200112,27519
20200109,7,태릉입구,9437,8907,20200112,18344
20200109,7,먹골,11985,11744,20200112,23729
20200109,7,중화,12796,12524,20200112,25320
20200109,7,상봉,19320,18497,20200112,37817
20200109,7,면목,17351,16801,20200112,34152
20200109,7,사가정,17496,17648,20200112,35144
20200109,7,용마산,6853,6443,20200112,13296
20200109,7,중곡,11338,10531,20200112,21869
20200109,7,군자,16820,13023,20200112,29843
20200109,7,어린이대공원,14397,14009,20200112,28406
20200109,7,건대입구,17203,18067,20200112,35270
20200109,7,뚝섬유원지,8012,7823,20200112,15835
20200109,7,청담,23721,27140,20200112,50861
20200109,7,강남구청,18520,20611,20200112,39131
20200109,7,학동,27002,29820,20200112,56822
20200109,7,논현,23745,26052,20200112,49797
20200109,7,반포,7195,7092,20200112,14287
20200109,7,고속터미널,20734,17341,20200112,38075
20200109,7,내방,16678,17200,20200112,33878
20200109,7,이수,19416,18916,20200112,38332
20200109,7,남성,13381,12367,20200112,25748
20200109,7,숭실대입구,14894,14757,20200112,29651
20200109,7,상도,12868,12131,20200112,24999
20200109,7,장승배기,12434,12044,20200112,24478
20200109,7,신대방삼거리,19219,18474,20200112,37693
20200109,7,보라매,11243,11296,20200112,22539
20200109,7,신풍,12833,12361,20200112,25194
20200109,7,대림,9806,9783,20200112,19589
20200109,7,남구로,18502,19843,20200112,38345
20200109,7,가산디지털단지,50862,51370,20200112,102232
20200109,7,철산,26344,26938,20200112,53282
20200109,7,광명사거리,27902,27261,20200112,55163
20200109,7,천왕,11429,10414,20200112,21843
20200109,7,온수,11699,10860,20200112,22559
20200109,7,까치울,8169,7701,20200112,15870
20200109,7,부천종합운동장,5236,4456,20200112,9692
20200109,7,춘의,10765,10491,20200112,21256
20200109,7,신중동,16941,16838,20200112,33779
20200109,7,부천시청,14379,14169,20200112,28548
20200109,7,상동,16086,16492,20200112,32578
20200109,7,삼산체육관,5826,5190,20200112,11016
20200109,7,굴포천,10527,11014,20200112,21541
20200109,7,부평구청,13676,11073,20200112,24749
20200110,7,장암,2798,945,20200113,3743
20200110,7,도봉산,10156,11427,20200113,21583
20200110,7,수락산,14750,14476,20200113,29226
20200110,7,마들,14275,13285,20200113,27560
20200110,7,노원,24913,27209,20200113,52122
20200110,7,중계,17751,15762,20200113,33513
20200110,7,하계,21693,20115,20200113,41808
20200110,7,공릉,14426,14213,20200113,28639
20200110,7,태릉입구,9795,8945,20200113,18740
20200110,7,먹골,12297,11909,20200113,24206
20200110,7,중화,13430,12862,20200113,26292
20200110,7,상봉,20322,19559,20200113,39881
20200110,7,면목,17889,16938,20200113,34827
20200110,7,사가정,18240,18191,20200113,36431
20200110,7,용마산,6890,6387,20200113,13277
20200110,7,중곡,11691,10694,20200113,22385
20200110,7,군자,17663,13628,20200113,31291
20200110,7,어린이대공원,14646,14008,20200113,28654
20200110,7,건대입구,17177,18923,20200113,36100
20200110,7,뚝섬유원지,8229,7874,20200113,16103
20200110,7,청담,23692,26875,20200113,50567
20200110,7,강남구청,18676,21215,20200113,39891
20200110,7,학동,27360,29843,20200113,57203
20200110,7,논현,24404,27698,20200113,52102
20200110,7,반포,7690,7365,20200113,15055
20200110,7,고속터미널,24428,19582,20200113,44010
20200110,7,내방,16938,17311,20200113,34249
20200110,7,이수,20303,20155,20200113,40458
20200110,7,남성,13510,12188,20200113,25698
20200110,7,숭실대입구,18033,17777,20200113,35810
20200110,7,상도,13195,12228,20200113,25423
20200110,7,장승배기,12609,12070,20200113,24679
20200110,7,신대방삼거리,19877,18603,20200113,38480
20200110,7,보라매,11287,11359,20200113,22646
20200110,7,신풍,13000,12404,20200113,25404
20200110,7,대림,9953,10177,20200113,20130
20200110,7,남구로,18526,20000,20200113,38526
20200110,7,가산디지털단지,51492,51422,20200113,102914
20200110,7,철산,27444,28442,20200113,55886
20200110,7,광명사거리,28851,28205,20200113,57056
20200110,7,천왕,11844,10416,20200113,22260
20200110,7,온수,11854,10985,20200113,22839
20200110,7,까치울,8377,7765,20200113,16142
20200110,7,부천종합운동장,5479,4534,20200113,10013
20200110,7,춘의,10961,10574,20200113,21535
20200110,7,신중동,17716,17780,20200113,35496
20200110,7,부천시청,14968,15010,20200113,29978
20200110,7,상동,16732,17562,20200113,34294
20200110,7,삼산체육관,6276,5730,20200113,12006
20200110,7,굴포천,10694,11378,20200113,22072
20200110,7,부평구청,14241,11429,20200113,25670
20200111,7,장암,1644,952,20200114,2596
20200111,7,도봉산,7360,9620,20200114,16980
20200111,7,수락산,11903,11489,20200114,23392
20200111,7,마들,9961,9302,20200114,19263
20200111,7,노원,19259,20636,20200114,39895
20200111,7,중계,11719,10572,20200114,22291
20200111,7,하계,15565,14520,20200114,30085
20200111,7,공릉,10524,10234,20200114,20758
20200111,7,태릉입구,7458,6683,20200114,14141
20200111,7,먹골,9745,9259,20200114,19004
20200111,7,중화,9625,9032,20200114,18657
20200111,7,상봉,16303,15567,20200114,31870
20200111,7,면목,13365,12412,20200114,25777
20200111,7,사가정,14222,13514,20200114,27736
20200111,7,용마산,5123,4786,20200114,9909
20200111,7,중곡,8021,7410,20200114,15431
20200111,7,군자,12657,9442,20200114,22099
20200111,7,어린이대공원,11337,10902,20200114,22239
20200111,7,건대입구,15420,16742,20200114,32162
20200111,7,뚝섬유원지,6961,6858,20200114,13819
20200111,7,청담,13904,14916,20200114,28820
20200111,7,강남구청,11978,13224,20200114,25202
20200111,7,학동,14113,15014,20200114,29127
20200111,7,논현,14039,15881,20200114,29920
20200111,7,반포,5622,5391,20200114,11013
20200111,7,고속터미널,22977,16693,20200114,39670
20200111,7,내방,9373,9351,20200114,18724
20200111,7,이수,15327,15091,20200114,30418
20200111,7,남성,9492,8560,20200114,18052
20200111,7,숭실대입구,10774,10512,20200114,21286
20200111,7,상도,9458,8563,20200114,18021
20200111,7,장승배기,8949,8552,20200114,17501
20200111,7,신대방삼거리,13499,12478,20200114,25977
20200111,7,보라매,8034,7512,20200114,15546
20200111,7,신풍,9919,9667,20200114,19586
20200111,7,대림,9655,10597,20200114,20252
20200111,7,남구로,10566,11172,20200114,21738
20200111,7,가산디지털단지,18338,16629,20200114,34967
20200111,7,철산,21036,21341,20200114,42377
20200111,7,광명사거리,22673,22418,20200114,45091
20200111,7,천왕,7521,6811,20200114,14332
20200111,7,온수,6801,6801,20200114,13602
20200111,7,까치울,6125,5713,20200114,11838
20200111,7,부천종합운동장,3761,3278,20200114,7039
20200111,7,춘의,6076,5658,20200114,11734
20200111,7,신중동,12460,12371,20200114,24831
20200111,7,부천시청,11743,11662,20200114,23405
20200111,7,상동,14243,14631,20200114,28874
20200111,7,삼산체육관,4333,4012,20200114,8345
20200111,7,굴포천,7976,8205,20200114,16181
20200111,7,부평구청,9250,7524,20200114,16774
20200112,7,장암,1320,795,20200115,2115
20200112,7,도봉산,5654,8460,20200115,14114
20200112,7,수락산,9353,9363,20200115,18716
20200112,7,마들,6537,6026,20200115,12563
20200112,7,노원,13835,13863,20200115,27698
20200112,7,중계,9358,8744,20200115,18102
20200112,7,하계,11968,11391,20200115,23359
20200112,7,공릉,7777,7875,20200115,15652
20200112,7,태릉입구,5806,5303,20200115,11109
20200112,7,먹골,6598,6509,20200115,13107
20200112,7,중화,7042,6953,20200115,13995
20200112,7,상봉,11519,10735,20200115,22254
20200112,7,면목,9724,9544,20200115,19268
20200112,7,사가정,10373,10096,20200115,20469
20200112,7,용마산,3715,3839,20200115,7554
20200112,7,중곡,6130,5694,20200115,11824
20200112,7,군자,9689,7217,20200115,16906
20200112,7,어린이대공원,8460,8362,20200115,16822
20200112,7,건대입구,10965,11482,20200115,22447
20200112,7,뚝섬유원지,5542,5445,20200115,10987
20200112,7,청담,8103,8763,20200115,16866
20200112,7,강남구청,6704,7040,20200115,13744
20200112,7,학동,7300,7520,20200115,14820
20200112,7,논현,7867,8479,20200115,16346
20200112,7,반포,3478,3586,20200115,7064
20200112,7,고속터미널,16736,12653,20200115,29389
20200112,7,내방,5721,5997,20200115,11718
20200112,7,이수,10221,9800,20200115,20021
20200112,7,남성,6504,6496,20200115,13000
20200112,7,숭실대입구,7669,7799,20200115,15468
20200112,7,상도,9315,8500,20200115,17815
20200112,7,장승배기,6298,6349,20200115,12647
20200112,7,신대방삼거리,9535,9370,20200115,18905
20200112,7,보라매,4900,4789,20200115,9689
20200112,7,신풍,8117,7752,20200115,15869
20200112,7,대림,11409,10863,20200115,22272
20200112,7,남구로,9557,9371,20200115,18928
20200112,7,가산디지털단지,13516,12513,20200115,26029
20200112,7,철산,13951,13994,20200115,27945
20200112,7,광명사거리,16982,16631,20200115,33613
20200112,7,천왕,5205,5128,20200115,10333
20200112,7,온수,4961,5057,20200115,10018
20200112,7,까치울,4424,4351,20200115,8775
20200112,7,부천종합운동장,2545,2245,20200115,4790
20200112,7,춘의,4261,4089,20200115,8350
20200112,7,신중동,8413,8341,20200115,16754
20200112,7,부천시청,7767,7501,20200115,15268
20200112,7,상동,8963,8612,20200115,17575
20200112,7,삼산체육관,2838,2829,20200115,5667
20200112,7,굴포천,5574,5672,20200115,11246
20200112,7,부평구청,6355,5422,20200115,11777
20200113,7,장암,2796,850,20200116,3646
20200113,7,도봉산,9789,11136,20200116,20925
20200113,7,수락산,14209,14089,20200116,28298
20200113,7,마들,13370,12862,20200116,26232
20200113,7,노원,23773,24892,20200116,48665
20200113,7,중계,17405,15949,20200116,33354
20200113,7,하계,20395,19391,20200116,39786
20200113,7,공릉,13549,13692,20200116,27241
20200113,7,태릉입구,9150,8719,20200116,17869
20200113,7,먹골,11801,11550,20200116,23351
20200113,7,중화,12810,12423,20200116,25233
20200113,7,상봉,19279,18247,20200116,37526
20200113,7,면목,17108,16608,20200116,33716
20200113,7,사가정,17564,17492,20200116,35056
20200113,7,용마산,6793,6436,20200116,13229
20200113,7,중곡,11161,10398,20200116,21559
20200113,7,군자,16464,12914,20200116,29378
20200113,7,어린이대공원,13533,13129,20200116,26662
20200113,7,건대입구,16007,16907,20200116,32914
20200113,7,뚝섬유원지,7766,7578,20200116,15344
20200113,7,청담,23517,26369,20200116,49886
20200113,7,강남구청,17627,19892,20200116,37519
20200113,7,학동,26621,28797,20200116,55418
20200113,7,논현,23779,25771,20200116,49550
20200113,7,반포,7080,6939,20200116,14019
20200113,7,고속터미널,20970,17298,20200116,38268
20200113,7,내방,16479,16964,20200116,33443
20200113,7,이수,18652,18185,20200116,36837
20200113,7,남성,13101,12353,20200116,25454
20200113,7,숭실대입구,14529,14768,20200116,29297
20200113,7,상도,12572,12181,20200116,24753
20200113,7,장승배기,12116,11954,20200116,24070
20200113,7,신대방삼거리,19036,18238,20200116,37274
20200113,7,보라매,11200,11201,20200116,22401
20200113,7,신풍,12770,12262,20200116,25032
20200113,7,대림,10214,9927,20200116,20141
20200113,7,남구로,18870,19963,20200116,38833
20200113,7,가산디지털단지,51347,51384,20200116,102731
20200113,7,철산,25758,26295,20200116,52053
20200113,7,광명사거리,27657,27046,20200116,54703
20200113,7,천왕,11231,10248,20200116,21479
20200113,7,온수,11644,10830,20200116,22474
20200113,7,까치울,8071,7598,20200116,15669
20200113,7,부천종합운동장,5217,4247,20200116,9464
20200113,7,춘의,10658,10487,20200116,21145
20200113,7,신중동,16807,16568,20200116,33375
20200113,7,부천시청,14131,14135,20200116,28266
20200113,7,상동,15722,16070,20200116,31792
20200113,7,삼산체육관,5695,5129,20200116,10824
20200113,7,굴포천,10269,10877,20200116,21146
20200113,7,부평구청,13743,11094,20200116,24837
20200114,7,부평구청,13881,11212,20200117,25093
20200114,7,굴포천,10352,10916,20200117,21268
20200114,7,삼산체육관,6089,5557,20200117,11646
20200114,7,상동,15970,16329,20200117,32299
20200114,7,부천시청,14207,14248,20200117,28455
20200114,7,신중동,17112,16837,20200117,33949
20200114,7,춘의,10856,10585,20200117,21441
20200114,7,부천종합운동장,5245,4383,20200117,9628
20200114,7,까치울,8007,7813,20200117,15820
20200114,7,온수,11603,10966,20200117,22569
20200114,7,천왕,11353,10314,20200117,21667
20200114,7,광명사거리,27757,27136,20200117,54893
20200114,7,철산,26357,27177,20200117,53534
20200114,7,가산디지털단지,51544,51903,20200117,103447
20200114,7,남구로,18459,19686,20200117,38145
20200114,7,대림,10021,10163,20200117,20184
20200114,7,신풍,12809,12259,20200117,25068
20200114,7,보라매,11078,11084,20200117,22162
20200114,7,신대방삼거리,19187,18535,20200117,37722
20200114,7,장승배기,12346,12163,20200117,24509
20200114,7,상도,12822,12330,20200117,25152
20200114,7,숭실대입구,15051,14874,20200117,29925
20200114,7,남성,13153,12318,20200117,25471
20200114,7,이수,19209,18709,20200117,37918
20200114,7,내방,16780,17287,20200117,34067
20200114,7,고속터미널,21377,18031,20200117,39408
20200114,7,반포,7163,6955,20200117,14118
20200114,7,논현,23843,26232,20200117,50075
20200114,7,학동,27369,29833,20200117,57202
20200114,7,강남구청,18258,20182,20200117,38440
20200114,7,청담,23751,26915,20200117,50666
20200114,7,뚝섬유원지,8054,7757,20200117,15811
20200114,7,건대입구,16681,17362,20200117,34043
20200114,7,어린이대공원,14076,13487,20200117,27563
20200114,7,군자,16730,13162,20200117,29892
20200114,7,중곡,11230,10523,20200117,21753
20200114,7,용마산,6837,6407,20200117,13244
20200114,7,사가정,17450,17490,20200117,34940
20200114,7,면목,17027,16632,20200117,33659
20200114,7,상봉,19332,18463,20200117,37795
20200114,7,중화,12762,12504,20200117,25266
20200114,7,먹골,11714,11397,20200117,23111
20200114,7,태릉입구,9506,8847,20200117,18353
20200114,7,공릉,13704,13622,20200117,27326
20200114,7,하계,21637,20485,20200117,42122
20200114,7,중계,17419,16003,20200117,33422
20200114,7,노원,23977,25249,20200117,49226
20200114,7,마들,13490,12800,20200117,26290
20200114,7,수락산,14219,14378,20200117,28597
20200114,7,도봉산,9930,11417,20200117,21347
20200114,7,장암,2743,910,20200117,3653
20200115,7,장암,2753,873,20200118,3626
20200115,7,도봉산,9703,11294,20200118,20997
20200115,7,수락산,14380,14461,20200118,28841
20200115,7,마들,13670,13031,20200118,26701
20200115,7,노원,23981,25208,20200118,49189
20200115,7,중계,18123,16690,20200118,34813
20200115,7,하계,21572,20502,20200118,42074
20200115,7,공릉,13798,13752,20200118,27550
20200115,7,태릉입구,9304,8631,20200118,17935
20200115,7,먹골,11845,11375,20200118,23220
20200115,7,중화,12846,12507,20200118,25353
20200115,7,상봉,19542,18600,20200118,38142
20200115,7,면목,17430,16943,20200118,34373
20200115,7,사가정,17691,17699,20200118,35390
20200115,7,용마산,6943,6494,20200118,13437
20200115,7,중곡,11596,10775,20200118,22371
20200115,7,군자,16889,13351,20200118,30240
20200115,7,어린이대공원,14253,13719,20200118,27972
20200115,7,건대입구,16863,17869,20200118,34732
20200115,7,뚝섬유원지,8162,7811,20200118,15973
20200115,7,청담,23844,26853,20200118,50697
20200115,7,강남구청,18416,20608,20200118,39024
20200115,7,학동,27360,29795,20200118,57155
20200115,7,논현,23919,26427,20200118,50346
20200115,7,반포,7462,7254,20200118,14716
20200115,7,고속터미널,21203,18199,20200118,39402
20200115,7,내방,16810,17244,20200118,34054
20200115,7,이수,19080,18929,20200118,38009
20200115,7,남성,13263,12165,20200118,25428
20200115,7,숭실대입구,14788,14709,20200118,29497
20200115,7,상도,13007,12498,20200118,25505
20200115,7,장승배기,12311,11943,20200118,24254
20200115,7,신대방삼거리,19113,18409,20200118,37522
20200115,7,보라매,10973,11360,20200118,22333
20200115,7,신풍,12857,12401,20200118,25258
20200115,7,대림,10023,10023,20200118,20046
20200115,7,남구로,18598,20045,20200118,38643
20200115,7,가산디지털단지,51709,51616,20200118,103325
20200115,7,철산,26324,27192,20200118,53516
20200115,7,광명사거리,28191,27641,20200118,55832
20200115,7,천왕,11641,10515,20200118,22156
20200115,7,온수,11814,11134,20200118,22948
20200115,7,까치울,8101,7802,20200118,15903
20200115,7,부천종합운동장,5195,4317,20200118,9512
20200115,7,춘의,10952,10687,20200118,21639
20200115,7,신중동,17119,17037,20200118,34156
20200115,7,부천시청,14310,14390,20200118,28700
20200115,7,상동,16160,16676,20200118,32836
20200115,7,삼산체육관,5831,5270,20200118,11101
20200115,7,굴포천,10382,10950,20200118,21332
20200115,7,부평구청,13854,11232,20200118,25086
20200116,7,부평구청,13833,11117,20200119,24950
20200116,7,굴포천,10509,10981,20200119,21490
20200116,7,삼산체육관,5754,5181,20200119,10935
20200116,7,상동,16195,16589,20200119,32784
20200116,7,부천시청,14436,14505,20200119,28941
20200116,7,신중동,17078,16907,20200119,33985
20200116,7,춘의,10896,10691,20200119,21587
20200116,7,부천종합운동장,5230,4328,20200119,9558
20200116,7,까치울,8187,7796,20200119,15983
20200116,7,온수,11723,10888,20200119,22611
20200116,7,천왕,11409,10459,20200119,21868
20200116,7,광명사거리,27947,27476,20200119,55423
20200116,7,철산,26402,26836,20200119,53238
20200116,7,가산디지털단지,51436,51895,20200119,103331
20200116,7,남구로,18225,19699,20200119,37924
20200116,7,대림,10028,10033,20200119,20061
20200116,7,신풍,12742,12166,20200119,24908
20200116,7,보라매,11109,11142,20200119,22251
20200116,7,신대방삼거리,19358,18634,20200119,37992
20200116,7,장승배기,12351,11979,20200119,24330
20200116,7,상도,12734,12091,20200119,24825
20200116,7,숭실대입구,14722,14559,20200119,29281
20200116,7,남성,13270,12309,20200119,25579
20200116,7,이수,19280,18822,20200119,38102
20200116,7,내방,16888,17286,20200119,34174
20200116,7,고속터미널,20996,18076,20200119,39072
20200116,7,반포,7195,7101,20200119,14296
20200116,7,논현,23771,26005,20200119,49776
20200116,7,학동,27459,30379,20200119,57838
20200116,7,강남구청,18604,20951,20200119,39555
20200116,7,청담,23578,26934,20200119,50512
20200116,7,뚝섬유원지,8318,8016,20200119,16334
20200116,7,건대입구,16608,17373,20200119,33981
20200116,7,어린이대공원,14020,13388,20200119,27408
20200116,7,군자,16826,13189,20200119,30015
20200116,7,중곡,11299,10569,20200119,21868
20200116,7,용마산,6771,6516,20200119,13287
20200116,7,사가정,17790,17625,20200119,35415
20200116,7,면목,17393,16905,20200119,34298
20200116,7,상봉,19594,18600,20200119,38194
20200116,7,중화,12849,12323,20200119,25172
20200116,7,먹골,12001,11880,20200119,23881
20200116,7,태릉입구,9485,8905,20200119,18390
20200116,7,공릉,13750,13781,20200119,27531
20200116,7,하계,21278,20198,20200119,41476
20200116,7,중계,17376,15945,20200119,33321
20200116,7,노원,23651,24882,20200119,48533
20200116,7,마들,13938,13158,20200119,27096
20200116,7,수락산,14416,14200,20200119,28616
20200116,7,도봉산,9930,11538,20200119,21468
20200116,7,장암,2777,865,20200119,3642
20200117,7,장암,2828,989,20200120,3817
20200117,7,도봉산,10073,11334,20200120,21407
20200117,7,수락산,14627,14445,20200120,29072
20200117,7,마들,14125,13044,20200120,27169
20200117,7,노원,25054,27339,20200120,52393
20200117,7,중계,17865,15803,20200120,33668
20200117,7,하계,21616,19860,20200120,41476
20200117,7,공릉,14379,14218,20200120,28597
20200117,7,태릉입구,9723,8862,20200120,18585
20200117,7,먹골,12022,11576,20200120,23598
20200117,7,중화,13145,12683,20200120,25828
20200117,7,상봉,20192,19573,20200120,39765
20200117,7,면목,17922,16906,20200120,34828
20200117,7,사가정,18200,17830,20200120,36030
20200117,7,용마산,7096,6459,20200120,13555
20200117,7,중곡,11635,10656,20200120,22291
20200117,7,군자,17435,13573,20200120,31008
20200117,7,어린이대공원,14360,13778,20200120,28138
20200117,7,건대입구,17461,18788,20200120,36249
20200117,7,뚝섬유원지,8165,7907,20200120,16072
20200117,7,청담,24331,27721,20200120,52052
20200117,7,강남구청,18493,21334,20200120,39827
20200117,7,학동,27406,30193,20200120,57599
20200117,7,논현,24906,27834,20200120,52740
20200117,7,반포,7727,7132,20200120,14859
20200117,7,고속터미널,25008,20099,20200120,45107
20200117,7,내방,16910,17460,20200120,34370
20200117,7,이수,20107,19988,20200120,40095
20200117,7,남성,13446,12133,20200120,25579
20200117,7,숭실대입구,15389,15004,20200120,30393
20200117,7,상도,13294,12634,20200120,25928
20200117,7,장승배기,12587,11986,20200120,24573
20200117,7,신대방삼거리,19822,18881,20200120,38703
20200117,7,보라매,11129,11103,20200120,22232
20200117,7,신풍,12942,12376,20200120,25318
20200117,7,대림,10108,10350,20200120,20458
20200117,7,남구로,18301,19761,20200120,38062
20200117,7,가산디지털단지,51411,51553,20200120,102964
20200117,7,철산,27428,28284,20200120,55712
20200117,7,광명사거리,28718,28127,20200120,56845
20200117,7,천왕,12039,10531,20200120,22570
20200117,7,온수,11831,11113,20200120,22944
20200117,7,까치울,8457,7850,20200120,16307
20200117,7,부천종합운동장,5311,4416,20200120,9727
20200117,7,춘의,11088,10598,20200120,21686
20200117,7,신중동,17697,17762,20200120,35459
20200117,7,부천시청,14896,14970,20200120,29866
20200117,7,상동,16782,17593,20200120,34375
20200117,7,삼산체육관,5874,5239,20200120,11113
20200117,7,굴포천,10537,11134,20200120,21671
20200117,7,부평구청,14112,11326,20200120,25438
20200118,7,장암,1810,991,20200121,2801
20200118,7,도봉산,7135,9583,20200121,16718
20200118,7,수락산,11788,11370,20200121,23158
20200118,7,마들,10016,9287,20200121,19303
20200118,7,노원,18933,20166,20200121,39099
20200118,7,중계,11681,10357,20200121,22038
20200118,7,하계,15711,14551,20200121,30262
20200118,7,공릉,10822,10382,20200121,21204
20200118,7,태릉입구,7826,7074,20200121,14900
20200118,7,먹골,9001,8710,20200121,17711
20200118,7,중화,9596,8918,20200121,18514
20200118,7,상봉,15764,15223,20200121,30987
20200118,7,면목,13388,12449,20200121,25837
20200118,7,사가정,14178,13579,20200121,27757
20200118,7,용마산,5161,4855,20200121,10016
20200118,7,중곡,8092,7336,20200121,15428
20200118,7,군자,12572,9224,20200121,21796
20200118,7,어린이대공원,11669,11421,20200121,23090
20200118,7,건대입구,14692,16464,20200121,31156
20200118,7,뚝섬유원지,7257,7008,20200121,14265
20200118,7,청담,13598,14677,20200121,28275
20200118,7,강남구청,12039,13315,20200121,25354
20200118,7,학동,12719,13633,20200121,26352
20200118,7,논현,14276,16105,20200121,30381
20200118,7,반포,5728,5299,20200121,11027
20200118,7,고속터미널,22159,16631,20200121,38790
20200118,7,내방,9574,9542,20200121,19116
20200118,7,이수,14953,14940,20200121,29893
20200118,7,남성,9145,8300,20200121,17445
20200118,7,숭실대입구,10276,10087,20200121,20363
20200118,7,상도,9449,8620,20200121,18069
20200118,7,장승배기,8868,8358,20200121,17226
20200118,7,신대방삼거리,13339,12422,20200121,25761
20200118,7,보라매,7223,7075,20200121,14298
20200118,7,신풍,9720,9213,20200121,18933
20200118,7,대림,9884,10521,20200121,20405
20200118,7,남구로,10560,11241,20200121,21801
20200118,7,가산디지털단지,18565,17248,20200121,35813
20200118,7,철산,20135,20580,20200121,40715
20200118,7,광명사거리,22520,22404,20200121,44924
20200118,7,천왕,7727,6912,20200121,14639
20200118,7,온수,6961,6913,20200121,13874
20200118,7,까치울,6087,5834,20200121,11921
20200118,7,부천종합운동장,3606,3088,20200121,6694
20200118,7,춘의,6060,5772,20200121,11832
20200118,7,신중동,12336,12241,20200121,24577
20200118,7,부천시청,11209,10998,20200121,22207
20200118,7,상동,13099,13252,20200121,26351
20200118,7,삼산체육관,4131,3926,20200121,8057
20200118,7,굴포천,8101,8322,20200121,16423
20200118,7,부평구청,8911,7434,20200121,16345
20200119,7,장암,1302,756,20200122,2058
20200119,7,도봉산,5457,7705,20200122,13162
20200119,7,수락산,9106,9016,20200122,18122
20200119,7,마들,6550,6070,20200122,12620
20200119,7,노원,13572,13736,20200122,27308
20200119,7,중계,9320,8755,20200122,18075
20200119,7,하계,11653,11004,20200122,22657
20200119,7,공릉,7580,7686,20200122,15266
20200119,7,태릉입구,5631,5089,20200122,10720
20200119,7,먹골,6398,6202,20200122,12600
20200119,7,중화,7201,7018,20200122,14219
20200119,7,상봉,11352,10782,20200122,22134
20200119,7,면목,9586,9298,20200122,18884
20200119,7,사가정,10237,9903,20200122,20140
20200119,7,용마산,3479,3682,20200122,7161
20200119,7,중곡,6103,5714,20200122,11817
20200119,7,군자,9616,7303,20200122,16919
20200119,7,어린이대공원,8375,8183,20200122,16558
20200119,7,건대입구,10704,11314,20200122,22018
20200119,7,뚝섬유원지,5057,4998,20200122,10055
20200119,7,청담,8150,8574,20200122,16724
20200119,7,강남구청,6452,6807,20200122,13259
20200119,7,학동,7292,7651,20200122,14943
20200119,7,논현,7620,8062,20200122,15682
20200119,7,반포,3706,3778,20200122,7484
20200119,7,고속터미널,15713,12157,20200122,27870
20200119,7,내방,5868,6257,20200122,12125
20200119,7,이수,10383,9551,20200122,19934
20200119,7,남성,6529,6424,20200122,12953
20200119,7,숭실대입구,7054,7215,20200122,14269
20200119,7,상도,6486,6223,20200122,12709
20200119,7,장승배기,6285,6260,20200122,12545
20200119,7,신대방삼거리,9329,9265,20200122,18594
20200119,7,보라매,4889,4826,20200122,9715
20200119,7,신풍,7595,7373,20200122,14968
20200119,7,대림,11067,10462,20200122,21529
20200119,7,남구로,8937,8782,20200122,17719
20200119,7,가산디지털단지,13365,12281,20200122,25646
20200119,7,철산,13613,13665,20200122,27278
20200119,7,광명사거리,16617,16194,20200122,32811
20200119,7,천왕,5259,5109,20200122,10368
20200119,7,온수,4980,5029,20200122,10009
20200119,7,까치울,4276,4256,20200122,8532
20200119,7,부천종합운동장,2564,2246,20200122,4810
20200119,7,춘의,4196,3946,20200122,8142
20200119,7,신중동,8184,8139,20200122,16323
20200119,7,부천시청,7825,7819,20200122,15644
20200119,7,상동,8966,8689,20200122,17655
20200119,7,삼산체육관,4740,4624,20200122,9364
20200119,7,굴포천,5935,5997,20200122,11932
20200119,7,부평구청,6050,5185,20200122,11235
20200120,7,부평구청,13782,11101,20200123,24883
20200120,7,굴포천,10273,10854,20200123,21127
20200120,7,삼산체육관,5660,5050,20200123,10710
20200120,7,상동,15717,16282,20200123,31999
20200120,7,부천시청,14085,13910,20200123,27995
20200120,7,신중동,16828,16642,20200123,33470
20200120,7,춘의,10845,10545,20200123,21390
20200120,7,부천종합운동장,5136,4273,20200123,9409
20200120,7,까치울,8062,7524,20200123,15586
20200120,7,온수,11685,11078,20200123,22763
20200120,7,천왕,11708,10662,20200123,22370
20200120,7,광명사거리,28101,27678,20200123,55779
20200120,7,철산,26200,26902,20200123,53102
20200120,7,가산디지털단지,51809,52143,20200123,103952
20200120,7,남구로,18801,19961,20200123,38762
20200120,7,대림,10344,10183,20200123,20527
20200120,7,신풍,12823,12262,20200123,25085
20200120,7,보라매,11177,11221,20200123,22398
20200120,7,신대방삼거리,19352,18536,20200123,37888
20200120,7,장승배기,12427,12152,20200123,24579
20200120,7,상도,12440,11945,20200123,24385
20200120,7,숭실대입구,14527,14579,20200123,29106
20200120,7,남성,13131,12418,20200123,25549
20200120,7,이수,18839,18575,20200123,37414
20200120,7,내방,16720,17117,20200123,33837
20200120,7,고속터미널,21416,18059,20200123,39475
20200120,7,반포,7286,7097,20200123,14383
20200120,7,논현,23953,26271,20200123,50224
20200120,7,학동,26958,28990,20200123,55948
20200120,7,강남구청,17895,20064,20200123,37959
20200120,7,청담,23379,26498,20200123,49877
20200120,7,뚝섬유원지,8057,7823,20200123,15880
20200120,7,건대입구,16126,17048,20200123,33174
20200120,7,어린이대공원,13022,12591,20200123,25613
20200120,7,군자,16722,13174,20200123,29896
20200120,7,중곡,11256,10439,20200123,21695
20200120,7,용마산,6881,6494,20200123,13375
20200120,7,사가정,17822,17770,20200123,35592
20200120,7,면목,17430,17059,20200123,34489
20200120,7,상봉,19270,18281,20200123,37551
20200120,7,중화,12713,12358,20200123,25071
20200120,7,먹골,11918,11732,20200123,23650
20200120,7,태릉입구,9235,8528,20200123,17763
20200120,7,공릉,13693,13801,20200123,27494
20200120,7,하계,20760,19696,20200123,40456
20200120,7,중계,17367,15994,20200123,33361
20200120,7,노원,24511,25711,20200123,50222
20200120,7,마들,13684,12943,20200123,26627
20200120,7,수락산,14216,14298,20200123,28514
20200120,7,도봉산,9919,11314,20200123,21233
20200120,7,장암,2853,826,20200123,3679
20200121,7,장암,2747,834,20200124,3581
20200121,7,도봉산,9787,11429,20200124,21216
20200121,7,수락산,14135,14201,20200124,28336
20200121,7,마들,13575,12949,20200124,26524
20200121,7,노원,24073,25300,20200124,49373
20200121,7,중계,17186,15748,20200124,32934
20200121,7,하계,21685,20260,20200124,41945
20200121,7,공릉,13897,13632,20200124,27529
20200121,7,태릉입구,9306,8799,20200124,18105
20200121,7,먹골,11895,11579,20200124,23474
20200121,7,중화,12879,12525,20200124,25404
20200121,7,상봉,19782,18784,20200124,38566
20200121,7,면목,17534,16992,20200124,34526
20200121,7,사가정,17766,17688,20200124,35454
20200121,7,용마산,6788,6363,20200124,13151
20200121,7,중곡,11347,10632,20200124,21979
20200121,7,군자,16709,13111,20200124,29820
20200121,7,어린이대공원,13869,13255,20200124,27124
20200121,7,건대입구,16127,17088,20200124,33215
20200121,7,뚝섬유원지,8032,7812,20200124,15844
20200121,7,청담,23838,27022,20200124,50860
20200121,7,강남구청,18496,20656,20200124,39152
20200121,7,학동,28010,30362,20200124,58372
20200121,7,논현,24304,26271,20200124,50575
20200121,7,반포,7437,7289,20200124,14726
20200121,7,고속터미널,21142,18899,20200124,40041
20200121,7,내방,17095,17357,20200124,34452
20200121,7,이수,18981,18908,20200124,37889
20200121,7,남성,13320,12213,20200124,25533
20200121,7,숭실대입구,14893,14610,20200124,29503
20200121,7,상도,12715,12141,20200124,24856
20200121,7,장승배기,12248,11872,20200124,24120
20200121,7,신대방삼거리,19461,18682,20200124,38143
20200121,7,보라매,11456,11534,20200124,22990
20200121,7,신풍,12737,12227,20200124,24964
20200121,7,대림,10453,10563,20200124,21016
20200121,7,남구로,18636,19835,20200124,38471
20200121,7,가산디지털단지,51498,51907,20200124,103405
20200121,7,철산,26330,27095,20200124,53425
20200121,7,광명사거리,28383,27765,20200124,56148
20200121,7,천왕,11622,10559,20200124,22181
20200121,7,온수,11881,10927,20200124,22808
20200121,7,까치울,8018,7584,20200124,15602
20200121,7,부천종합운동장,5286,4390,20200124,9676
20200121,7,춘의,10882,10623,20200124,21505
20200121,7,신중동,16878,16815,20200124,33693
20200121,7,부천시청,14294,14319,20200124,28613
20200121,7,상동,15952,16470,20200124,32422
20200121,7,삼산체육관,5866,5205,20200124,11071
20200121,7,굴포천,10357,10924,20200124,21281
20200121,7,부평구청,13553,11094,20200124,24647
20200122,7,장암,2707,809,20200125,3516
20200122,7,도봉산,9962,11305,20200125,21267
20200122,7,수락산,14262,14025,20200125,28287
20200122,7,마들,14006,13067,20200125,27073
20200122,7,노원,23395,25129,20200125,48524
20200122,7,중계,18048,16495,20200125,34543
20200122,7,하계,21236,20020,20200125,41256
20200122,7,공릉,13986,13324,20200125,27310
20200122,7,태릉입구,9294,8617,20200125,17911
20200122,7,먹골,11753,11210,20200125,22963
20200122,7,중화,12764,12459,20200125,25223
20200122,7,상봉,19667,19153,20200125,38820
20200122,7,면목,17536,17101,20200125,34637
20200122,7,사가정,17591,17701,20200125,35292
20200122,7,용마산,6876,7000,20200125,13876
20200122,7,중곡,11337,10750,20200125,22087
20200122,7,군자,17134,13479,20200125,30613
20200122,7,어린이대공원,13609,13030,20200125,26639
20200122,7,건대입구,16337,17144,20200125,33481
20200122,7,뚝섬유원지,8007,8196,20200125,16203
20200122,7,청담,23001,26627,20200125,49628
20200122,7,강남구청,18481,20957,20200125,39438
20200122,7,학동,27285,29303,20200125,56588
20200122,7,논현,23974,25860,20200125,49834
20200122,7,반포,7367,6975,20200125,14342
20200122,7,고속터미널,20238,19113,20200125,39351
20200122,7,내방,16316,17272,20200125,33588
20200122,7,이수,19193,18947,20200125,38140
20200122,7,남성,13044,11957,20200125,25001
20200122,7,숭실대입구,14496,13877,20200125,28373
20200122,7,상도,12370,11263,20200125,23633
20200122,7,장승배기,11912,11346,20200125,23258
20200122,7,신대방삼거리,19014,17990,20200125,37004
20200122,7,보라매,11321,11915,20200125,23236
20200122,7,신풍,12607,12289,20200125,24896
20200122,7,대림,10646,10988,20200125,21634
20200122,7,남구로,18138,19383,20200125,37521
20200122,7,가산디지털단지,51642,51361,20200125,103003
20200122,7,철산,25331,25894,20200125,51225
20200122,7,광명사거리,27649,27175,20200125,54824
20200122,7,천왕,11604,10185,20200125,21789
20200122,7,온수,11549,10578,20200125,22127
20200122,7,까치울,7724,7376,20200125,15100
20200122,7,부천종합운동장,5054,4287,20200125,9341
20200122,7,춘의,10254,10203,20200125,20457
20200122,7,신중동,15976,16179,20200125,32155
20200122,7,부천시청,13751,13545,20200125,27296
20200122,7,상동,14901,15182,20200125,30083
20200122,7,삼산체육관,5419,4782,20200125,10201
20200122,7,굴포천,9738,10355,20200125,20093
20200122,7,부평구청,13473,10980,20200125,24453
20200123,7,장암,2460,840,20200126,3300
20200123,7,도봉산,9352,10856,20200126,20208
20200123,7,수락산,13798,13358,20200126,27156
20200123,7,마들,13287,12239,20200126,25526
20200123,7,노원,23501,25934,20200126,49435
20200123,7,중계,16405,14197,20200126,30602
20200123,7,하계,20225,18578,20200126,38803
20200123,7,공릉,13759,12446,20200126,26205
20200123,7,태릉입구,8783,7831,20200126,16614
20200123,7,먹골,11533,10825,20200126,22358
20200123,7,중화,12203,11455,20200126,23658
20200123,7,상봉,19215,18410,20200126,37625
20200123,7,면목,16955,16014,20200126,32969
20200123,7,사가정,16903,16421,20200126,33324
20200123,7,용마산,6441,5708,20200126,12149
20200123,7,중곡,10834,9622,20200126,20456
20200123,7,군자,16323,11742,20200126,28065
20200123,7,어린이대공원,12830,10957,20200126,23787
20200123,7,건대입구,16297,17065,20200126,33362
20200123,7,뚝섬유원지,7802,7360,20200126,15162
20200123,7,청담,20790,23316,20200126,44106
20200123,7,강남구청,16804,18398,20200126,35202
20200123,7,학동,24191,26011,20200126,50202
20200123,7,논현,21963,24239,20200126,46202
20200123,7,반포,7169,6809,20200126,13978
20200123,7,고속터미널,19199,23751,20200126,42950
20200123,7,내방,15621,15622,20200126,31243
20200123,7,이수,18372,17642,20200126,36014
20200123,7,남성,12762,10897,20200126,23659
20200123,7,숭실대입구,13474,12261,20200126,25735
20200123,7,상도,11973,10115,20200126,22088
20200123,7,장승배기,11913,10939,20200126,22852
20200123,7,신대방삼거리,19333,16677,20200126,36010
20200123,7,보라매,10430,9857,20200126,20287
20200123,7,신풍,12077,11160,20200126,23237
20200123,7,대림,11928,12512,20200126,24440
20200123,7,남구로,18236,18886,20200126,37122
20200123,7,가산디지털단지,46975,45374,20200126,92349
20200123,7,철산,25757,26978,20200126,52735
20200123,7,광명사거리,28771,28863,20200126,57634
20200123,7,천왕,11410,9844,20200126,21254
20200123,7,온수,11253,10396,20200126,21649
20200123,7,까치울,7541,6993,20200126,14534
20200123,7,부천종합운동장,4887,4085,20200126,8972
20200123,7,춘의,9884,9556,20200126,19440
20200123,7,신중동,16154,15844,20200126,31998
20200123,7,부천시청,14340,14268,20200126,28608
20200123,7,상동,15075,16181,20200126,31256
20200123,7,삼산체육관,5338,4778,20200126,10116
20200123,7,굴포천,9855,10352,20200126,20207
20200123,7,부평구청,13123,10529,20200126,23652
20200124,7,부평구청,4705,4210,20200127,8915
20200124,7,굴포천,4366,4598,20200127,8964
20200124,7,삼산체육관,2046,1956,20200127,4002
20200124,7,상동,6127,6477,20200127,12604
20200124,7,부천시청,6276,6117,20200127,12393
20200124,7,신중동,5388,4923,20200127,10311
20200124,7,춘의,3503,3415,20200127,6918
20200124,7,부천종합운동장,1918,1763,20200127,3681
20200124,7,까치울,3115,2980,20200127,6095
20200124,7,온수,3960,3952,20200127,7912
20200124,7,천왕,4345,3859,20200127,8204
20200124,7,광명사거리,14556,14653,20200127,29209
20200124,7,철산,9969,9507,20200127,19476
20200124,7,가산디지털단지,11030,9273,20200127,20303
20200124,7,남구로,7444,7472,20200127,14916
20200124,7,대림,9770,9692,20200127,19462
20200124,7,신풍,5362,4906,20200127,10268
20200124,7,보라매,3665,2987,20200127,6652
20200124,7,신대방삼거리,7776,5945,20200127,13721
20200124,7,장승배기,5039,4205,20200127,9244
20200124,7,상도,4781,3494,20200127,8275
20200124,7,숭실대입구,5442,4198,20200127,9640
20200124,7,남성,5148,4154,20200127,9302
20200124,7,이수,7299,6135,20200127,13434
20200124,7,내방,4587,4151,20200127,8738
20200124,7,고속터미널,9970,13642,20200127,23612
20200124,7,반포,2811,2669,20200127,5480
20200124,7,논현,5748,5450,20200127,11198
20200124,7,학동,4430,3894,20200127,8324
20200124,7,강남구청,3610,3477,20200127,7087
20200124,7,청담,5087,5153,20200127,10240
20200124,7,뚝섬유원지,4005,3761,20200127,7766
20200124,7,건대입구,7041,6867,20200127,13908
20200124,7,어린이대공원,5615,4094,20200127,9709
20200124,7,군자,6915,4266,20200127,11181
20200124,7,중곡,4666,4036,20200127,8702
20200124,7,용마산,2863,2685,20200127,5548
20200124,7,사가정,7969,7393,20200127,15362
20200124,7,면목,8003,7247,20200127,15250
20200124,7,상봉,8938,8212,20200127,17150
20200124,7,중화,5245,4821,20200127,10066
20200124,7,먹골,4930,4484,20200127,9414
20200124,7,태릉입구,3871,3146,20200127,7017
20200124,7,공릉,5726,4903,20200127,10629
20200124,7,하계,8567,7537,20200127,16104
20200124,7,중계,6595,5552,20200127,12147
20200124,7,노원,8900,9216,20200127,18116
20200124,7,마들,6076,5366,20200127,11442
20200124,7,수락산,6295,6240,20200127,12535
20200124,7,도봉산,3752,5277,20200127,9029
20200124,7,장암,756,473,20200127,1229
20200125,7,장암,1114,530,20200128,1644
20200125,7,도봉산,3812,5229,20200128,9041
20200125,7,수락산,6402,6159,20200128,12561
20200125,7,마들,5838,5547,20200128,11385
20200125,7,노원,6864,7585,20200128,14449
20200125,7,중계,6255,5942,20200128,12197
20200125,7,하계,7438,6921,20200128,14359
20200125,7,공릉,4803,4786,20200128,9589
20200125,7,태릉입구,3458,3035,20200128,6493
20200125,7,먹골,4240,4320,20200128,8560
20200125,7,중화,4683,4700,20200128,9383
20200125,7,상봉,7025,6586,20200128,13611
20200125,7,면목,7194,7047,20200128,14241
20200125,7,사가정,7525,7205,20200128,14730
20200125,7,용마산,2724,2915,20200128,5639
20200125,7,중곡,4125,4112,20200128,8237
20200125,7,군자,5668,4275,20200128,9943
20200125,7,어린이대공원,4273,4133,20200128,8406
20200125,7,건대입구,5027,5683,20200128,10710
20200125,7,뚝섬유원지,3943,3697,20200128,7640
20200125,7,청담,3663,3879,20200128,7542
20200125,7,강남구청,1968,2155,20200128,4123
20200125,7,학동,2482,2601,20200128,5083
20200125,7,논현,3413,3760,20200128,7173
20200125,7,반포,1606,1376,20200128,2982
20200125,7,고속터미널,16006,7488,20200128,23494
20200125,7,내방,3064,2953,20200128,6017
20200125,7,이수,5108,5091,20200128,10199
20200125,7,남성,4210,4115,20200128,8325
20200125,7,숭실대입구,4088,4487,20200128,8575
20200125,7,상도,3627,3618,20200128,7245
20200125,7,장승배기,4234,4218,20200128,8452
20200125,7,신대방삼거리,6108,6296,20200128,12404
20200125,7,보라매,3074,3052,20200128,6126
20200125,7,신풍,4898,4852,20200128,9750
20200125,7,대림,7627,7724,20200128,15351
20200125,7,남구로,7518,7612,20200128,15130
20200125,7,가산디지털단지,8123,7241,20200128,15364
20200125,7,철산,8590,9131,20200128,17721
20200125,7,광명사거리,12074,11954,20200128,24028
20200125,7,천왕,3540,3290,20200128,6830
20200125,7,온수,3383,3564,20200128,6947
20200125,7,까치울,2857,2768,20200128,5625
20200125,7,부천종합운동장,1934,1820,20200128,3754
20200125,7,춘의,3324,3070,20200128,6394
20200125,7,신중동,4484,4654,20200128,9138
20200125,7,부천시청,4069,4218,20200128,8287
20200125,7,상동,4722,4785,20200128,9507
20200125,7,삼산체육관,1892,1842,20200128,3734
20200125,7,굴포천,4099,4179,20200128,8278
20200125,7,부평구청,4620,3776,20200128,8396
20200126,7,장암,1103,622,20200129,1725
20200126,7,도봉산,4870,7096,20200129,11966
20200126,7,수락산,7913,7669,20200129,15582
20200126,7,마들,5234,5108,20200129,10342
20200126,7,노원,11795,13039,20200129,24834
20200126,7,중계,7880,7535,20200129,15415
20200126,7,하계,9582,9200,20200129,18782
20200126,7,공릉,5583,6124,20200129,11707
20200126,7,태릉입구,4322,3983,20200129,8305
20200126,7,먹골,5088,5151,20200129,10239
20200126,7,중화,5897,5871,20200129,11768
20200126,7,상봉,9139,8895,20200129,18034
20200126,7,면목,7759,7867,20200129,15626
20200126,7,사가정,8711,8492,20200129,17203
20200126,7,용마산,3024,3309,20200129,6333
20200126,7,중곡,4836,4782,20200129,9618
20200126,7,군자,6761,6186,20200129,12947
20200126,7,어린이대공원,5384,6178,20200129,11562
20200126,7,건대입구,8015,9191,20200129,17206
20200126,7,뚝섬유원지,4832,4824,20200129,9656
20200126,7,청담,4669,5240,20200129,9909
20200126,7,강남구청,3076,3674,20200129,6750
20200126,7,학동,3775,4386,20200129,8161
20200126,7,논현,4618,5631,20200129,10249
20200126,7,반포,2662,2463,20200129,5125
20200126,7,고속터미널,23110,8089,20200129,31199
20200126,7,내방,4079,4450,20200129,8529
20200126,7,이수,7407,7713,20200129,15120
20200126,7,남성,4835,5148,20200129,9983
20200126,7,숭실대입구,4869,5768,20200129,10637
20200126,7,상도,4200,4591,20200129,8791
20200126,7,장승배기,4783,5140,20200129,9923
20200126,7,신대방삼거리,6936,7746,20200129,14682
20200126,7,보라매,3363,3723,20200129,7086
20200126,7,신풍,5830,5602,20200129,11432
20200126,7,대림,9308,9846,20200129,19154
20200126,7,남구로,7977,7774,20200129,15751
20200126,7,가산디지털단지,11596,11082,20200129,22678
20200126,7,철산,10989,11487,20200129,22476
20200126,7,광명사거리,14197,13831,20200129,28028
20200126,7,천왕,4445,4273,20200129,8718
20200126,7,온수,4025,4213,20200129,8238
20200126,7,까치울,3654,3525,20200129,7179
20200126,7,부천종합운동장,2334,1970,20200129,4304
20200126,7,춘의,3628,3319,20200129,6947
20200126,7,신중동,6732,7051,20200129,13783
20200126,7,부천시청,5356,5556,20200129,10912
20200126,7,상동,6985,6816,20200129,13801
20200126,7,삼산체육관,2379,2134,20200129,4513
20200126,7,굴포천,4717,4932,20200129,9649
20200126,7,부평구청,5285,4240,20200129,9525
20200127,7,장암,1156,549,20200130,1705
20200127,7,도봉산,4757,6413,20200130,11170
20200127,7,수락산,7681,7472,20200130,15153
20200127,7,마들,5786,5707,20200130,11493
20200127,7,노원,12798,13644,20200130,26442
20200127,7,중계,6954,6342,20200130,13296
20200127,7,하계,9523,9166,20200130,18689
20200127,7,공릉,6117,6979,20200130,13096
20200127,7,태릉입구,4641,4650,20200130,9291
20200127,7,먹골,5193,5358,20200130,10551
20200127,7,중화,5699,5637,20200130,11336
20200127,7,상봉,9957,9698,20200130,19655
20200127,7,면목,8118,8088,20200130,16206
20200127,7,사가정,8610,8567,20200130,17177
20200127,7,용마산,3102,3276,20200130,6378
20200127,7,중곡,5010,5083,20200130,10093
20200127,7,군자,7690,6740,20200130,14430
20200127,7,어린이대공원,5561,6468,20200130,12029
20200127,7,건대입구,9191,10333,20200130,19524
20200127,7,뚝섬유원지,4008,3900,20200130,7908
20200127,7,청담,6433,7236,20200130,13669
20200127,7,강남구청,4327,4919,20200130,9246
20200127,7,학동,5192,5622,20200130,10814
20200127,7,논현,6364,7328,20200130,13692
20200127,7,반포,3318,3223,20200130,6541
20200127,7,고속터미널,23321,8898,20200130,32219
20200127,7,내방,5123,5505,20200130,10628
20200127,7,이수,8478,8818,20200130,17296
20200127,7,남성,5373,5752,20200130,11125
20200127,7,숭실대입구,5501,6248,20200130,11749
20200127,7,상도,4670,5231,20200130,9901
20200127,7,장승배기,4937,5206,20200130,10143
20200127,7,신대방삼거리,7571,8200,20200130,15771
20200127,7,보라매,3614,4173,20200130,7787
20200127,7,신풍,5846,5721,20200130,11567
20200127,7,대림,7666,7276,20200130,14942
20200127,7,남구로,7330,7071,20200130,14401
20200127,7,가산디지털단지,11518,11416,20200130,22934
20200127,7,철산,11567,11847,20200130,23414
20200127,7,광명사거리,14472,13894,20200130,28366
20200127,7,천왕,4711,4620,20200130,9331
20200127,7,온수,4187,4308,20200130,8495
20200127,7,까치울,3976,3828,20200130,7804
20200127,7,부천종합운동장,2403,2066,20200130,4469
20200127,7,춘의,3902,3710,20200130,7612
20200127,7,신중동,6943,6976,20200130,13919
20200127,7,부천시청,7403,7365,20200130,14768
20200127,7,상동,7909,7548,20200130,15457
20200127,7,삼산체육관,2737,2583,20200130,5320
20200127,7,굴포천,5159,5303,20200130,10462
20200127,7,부평구청,5736,4598,20200130,10334
20200128,7,장암,2559,810,20200131,3369
20200128,7,도봉산,9101,10200,20200131,19301
20200128,7,수락산,13165,13059,20200131,26224
20200128,7,마들,12323,11856,20200131,24179
20200128,7,노원,22292,23819,20200131,46111
20200128,7,중계,15937,14598,20200131,30535
20200128,7,하계,19405,18670,20200131,38075
20200128,7,공릉,12430,12706,20200131,25136
20200128,7,태릉입구,8247,7914,20200131,16161
20200128,7,먹골,10954,10764,20200131,21718
20200128,7,중화,11926,11541,20200131,23467
20200128,7,상봉,17811,17056,20200131,34867
20200128,7,면목,15883,15488,20200131,31371
20200128,7,사가정,16189,16433,20200131,32622
20200128,7,용마산,6227,5900,20200131,12127
20200128,7,중곡,10431,9762,20200131,20193
20200128,7,군자,15082,12116,20200131,27198
20200128,7,어린이대공원,11564,11624,20200131,23188
20200128,7,건대입구,13410,14768,20200131,28178
20200128,7,뚝섬유원지,7114,6922,20200131,14036
20200128,7,청담,21360,23828,20200131,45188
20200128,7,강남구청,16764,18585,20200131,35349
20200128,7,학동,24515,26275,20200131,50790
20200128,7,논현,21277,23136,20200131,44413
20200128,7,반포,6423,6337,20200131,12760
20200128,7,고속터미널,22964,15291,20200131,38255
20200128,7,내방,15130,15550,20200131,30680
20200128,7,이수,16988,16885,20200131,33873
20200128,7,남성,11714,11123,20200131,22837
20200128,7,숭실대입구,12675,13080,20200131,25755
20200128,7,상도,11225,11370,20200131,22595
20200128,7,장승배기,11092,10940,20200131,22032
20200128,7,신대방삼거리,17486,17063,20200131,34549
20200128,7,보라매,10025,10279,20200131,20304
20200128,7,신풍,11280,10857,20200131,22137
20200128,7,대림,8608,8236,20200131,16844
20200128,7,남구로,16909,17593,20200131,34502
20200128,7,가산디지털단지,46780,47148,20200131,93928
20200128,7,철산,23503,24279,20200131,47782
20200128,7,광명사거리,24988,24176,20200131,49164
20200128,7,천왕,10515,9745,20200131,20260
20200128,7,온수,10684,10069,20200131,20753
20200128,7,까치울,7451,7001,20200131,14452
20200128,7,부천종합운동장,4857,3973,20200131,8830
20200128,7,춘의,9812,9654,20200131,19466
20200128,7,신중동,15448,15106,20200131,30554
20200128,7,부천시청,12809,12885,20200131,25694
20200128,7,상동,14253,14650,20200131,28903
20200128,7,삼산체육관,5195,4589,20200131,9784
20200128,7,굴포천,9578,9975,20200131,19553
20200128,7,부평구청,12424,10124,20200131,22548
20200129,7,장암,2734,877,20200201,3611
20200129,7,도봉산,9653,11165,20200201,20818
20200129,7,수락산,13573,13760,20200201,27333
20200129,7,마들,13286,12487,20200201,25773
20200129,7,노원,22688,24467,20200201,47155
20200129,7,중계,17236,15914,20200201,33150
20200129,7,하계,20296,19145,20200201,39441
20200129,7,공릉,13064,13214,20200201,26278
20200129,7,태릉입구,8888,8386,20200201,17274
20200129,7,먹골,11290,10895,20200201,22185
20200129,7,중화,12348,12074,20200201,24422
20200129,7,상봉,18715,17738,20200201,36453
20200129,7,면목,16693,16120,20200201,32813
20200129,7,사가정,16896,17075,20200201,33971
20200129,7,용마산,6653,6332,20200201,12985
20200129,7,중곡,11110,10389,20200201,21499
20200129,7,군자,16174,12786,20200201,28960
20200129,7,어린이대공원,12364,11986,20200201,24350
20200129,7,건대입구,13926,14977,20200201,28903
20200129,7,뚝섬유원지,7659,7423,20200201,15082
20200129,7,청담,22766,25699,20200201,48465
20200129,7,강남구청,17846,19918,20200201,37764
20200129,7,학동,26686,28734,20200201,55420
20200129,7,논현,22999,24936,20200201,47935
20200129,7,반포,6827,6639,20200201,13466
20200129,7,고속터미널,19769,15689,20200201,35458
20200129,7,내방,15861,16494,20200201,32355
20200129,7,이수,18075,17736,20200201,35811
20200129,7,남성,12500,11599,20200201,24099
20200129,7,숭실대입구,13344,13362,20200201,26706
20200129,7,상도,11678,11317,20200201,22995
20200129,7,장승배기,11427,11025,20200201,22452
20200129,7,신대방삼거리,18256,17632,20200201,35888
20200129,7,보라매,10664,10749,20200201,21413
20200129,7,신풍,12149,11572,20200201,23721
20200129,7,대림,8087,7967,20200201,16054
20200129,7,남구로,17508,18510,20200201,36018
20200129,7,가산디지털단지,49712,50337,20200201,100049
20200129,7,철산,24702,25408,20200201,50110
20200129,7,광명사거리,26241,25373,20200201,51614
20200129,7,천왕,11203,10290,20200201,21493
20200129,7,온수,11374,10719,20200201,22093
20200129,7,까치울,7692,7442,20200201,15134
20200129,7,부천종합운동장,5140,4200,20200201,9340
20200129,7,춘의,10355,10063,20200201,20418
20200129,7,신중동,15954,15883,20200201,31837
20200129,7,부천시청,13640,13611,20200201,27251
20200129,7,상동,14854,15521,20200201,30375
20200129,7,삼산체육관,5548,4944,20200201,10492
20200129,7,굴포천,9746,10333,20200201,20079
20200129,7,부평구청,12961,10516,20200201,23477
20200130,7,부평구청,13161,10746,20200202,23907
20200130,7,굴포천,9809,10322,20200202,20131
20200130,7,삼산체육관,5410,4860,20200202,10270
20200130,7,상동,14741,15058,20200202,29799
20200130,7,부천시청,13480,13498,20200202,26978
20200130,7,신중동,15949,15829,20200202,31778
20200130,7,춘의,10127,9989,20200202,20116
20200130,7,부천종합운동장,5221,4322,20200202,9543
20200130,7,까치울,7758,7310,20200202,15068
20200130,7,온수,11282,10589,20200202,21871
20200130,7,천왕,11133,10163,20200202,21296
20200130,7,광명사거리,26018,25569,20200202,51587
20200130,7,철산,24416,25118,20200202,49534
20200130,7,가산디지털단지,49804,50790,20200202,100594
20200130,7,남구로,17249,18349,20200202,35598
20200130,7,대림,7822,7678,20200202,15500
20200130,7,신풍,11967,11431,20200202,23398
20200130,7,보라매,10473,10480,20200202,20953
20200130,7,신대방삼거리,18356,17638,20200202,35994
20200130,7,장승배기,11479,11218,20200202,22697
20200130,7,상도,11793,11310,20200202,23103
20200130,7,숭실대입구,13174,13214,20200202,26388
20200130,7,남성,12523,11678,20200202,24201
20200130,7,이수,18020,17742,20200202,35762
20200130,7,내방,15774,16483,20200202,32257
20200130,7,고속터미널,19626,16019,20200202,35645
20200130,7,반포,6798,6605,20200202,13403
20200130,7,논현,22915,25331,20200202,48246
20200130,7,학동,26507,29028,20200202,55535
20200130,7,강남구청,17798,19864,20200202,37662
20200130,7,청담,23028,26002,20200202,49030
20200130,7,뚝섬유원지,7751,7582,20200202,15333
20200130,7,건대입구,14083,15006,20200202,29089
20200130,7,어린이대공원,12288,12047,20200202,24335
20200130,7,군자,16060,12781,20200202,28841
20200130,7,중곡,11160,10417,20200202,21577
20200130,7,용마산,6617,6132,20200202,12749
20200130,7,사가정,16946,16942,20200202,33888
20200130,7,면목,16611,16159,20200202,32770
20200130,7,상봉,18675,17740,20200202,36415
20200130,7,중화,12288,11893,20200202,24181
20200130,7,먹골,11389,11108,20200202,22497
20200130,7,태릉입구,9005,8440,20200202,17445
20200130,7,공릉,13218,13092,20200202,26310
20200130,7,하계,20051,18877,20200202,38928
20200130,7,중계,16830,15485,20200202,32315
20200130,7,노원,22891,24097,20200202,46988
20200130,7,마들,13299,12699,20200202,25998
20200130,7,수락산,13707,13783,20200202,27490
20200130,7,도봉산,9661,11195,20200202,20856
20200130,7,장암,2734,854,20200202,3588
20200131,7,장암,2768,884,20200203,3652
20200131,7,도봉산,9555,10948,20200203,20503
20200131,7,수락산,13913,13589,20200203,27502
20200131,7,마들,13292,12453,20200203,25745
20200131,7,노원,23020,25070,20200203,48090
20200131,7,중계,16600,14585,20200203,31185
20200131,7,하계,20447,19051,20200203,39498
20200131,7,공릉,13149,13240,20200203,26389
20200131,7,태릉입구,8672,8109,20200203,16781
20200131,7,먹골,11255,10744,20200203,21999
20200131,7,중화,12208,11962,20200203,24170
20200131,7,상봉,19050,18371,20200203,37421
20200131,7,면목,16623,15826,20200203,32449
20200131,7,사가정,16835,16666,20200203,33501
20200131,7,용마산,6665,6080,20200203,12745
20200131,7,중곡,11087,10301,20200203,21388
20200131,7,군자,16314,12803,20200203,29117
20200131,7,어린이대공원,12921,12469,20200203,25390
20200131,7,건대입구,14059,15186,20200203,29245
20200131,7,뚝섬유원지,7621,7283,20200203,14904
20200131,7,청담,23034,26239,20200203,49273
20200131,7,강남구청,17681,20118,20200203,37799
20200131,7,학동,26050,28623,20200203,54673
20200131,7,논현,22750,25615,20200203,48365
20200131,7,반포,6742,6576,20200203,13318
20200131,7,고속터미널,20292,16424,20200203,36716
20200131,7,내방,15883,16386,20200203,32269
20200131,7,이수,18625,18732,20200203,37357
20200131,7,남성,12663,11509,20200203,24172
20200131,7,숭실대입구,13499,13169,20200203,26668
20200131,7,상도,12021,11099,20200203,23120
20200131,7,장승배기,11549,11147,20200203,22696
20200131,7,신대방삼거리,18496,17589,20200203,36085
20200131,7,보라매,10652,10644,20200203,21296
20200131,7,신풍,12041,11402,20200203,23443
20200131,7,대림,7747,7697,20200203,15444
20200131,7,남구로,17077,18588,20200203,35665
20200131,7,가산디지털단지,49763,50155,20200203,99918
20200131,7,철산,25341,26369,20200203,51710
20200131,7,광명사거리,26291,25765,20200203,52056
20200131,7,천왕,11361,9990,20200203,21351
20200131,7,온수,11382,10680,20200203,22062
20200131,7,까치울,7909,7344,20200203,15253
20200131,7,부천종합운동장,5209,4388,20200203,9597
20200131,7,춘의,10308,9897,20200203,20205
20200131,7,신중동,16102,16178,20200203,32280
20200131,7,부천시청,13680,13796,20200203,27476
20200131,7,상동,15074,15811,20200203,30885
20200131,7,삼산체육관,5466,4765,20200203,10231
20200131,7,굴포천,10093,10608,20200203,20701
20200131,7,부평구청,13407,10667,20200203,24074
20200201,7,장암,1435,689,20200204,2124
20200201,7,도봉산,6089,8113,20200204,14202
20200201,7,수락산,10031,9667,20200204,19698
20200201,7,마들,8254,7778,20200204,16032
20200201,7,노원,15955,17050,20200204,33005
20200201,7,중계,9831,8982,20200204,18813
20200201,7,하계,12784,11864,20200204,24648
20200201,7,공릉,8746,8657,20200204,17403
20200201,7,태릉입구,6322,5673,20200204,11995
20200201,7,먹골,7828,7531,20200204,15359
20200201,7,중화,8168,7622,20200204,15790
20200201,7,상봉,13398,12807,20200204,26205
20200201,7,면목,11078,10535,20200204,21613
20200201,7,사가정,11844,11580,20200204,23424
20200201,7,용마산,4353,4219,20200204,8572
20200201,7,중곡,6749,6205,20200204,12954
20200201,7,군자,10890,8150,20200204,19040
20200201,7,어린이대공원,10946,10957,20200204,21903
20200201,7,건대입구,11246,11730,20200204,22976
20200201,7,뚝섬유원지,5303,5187,20200204,10490
20200201,7,청담,11816,12570,20200204,24386
20200201,7,강남구청,10187,11072,20200204,21259
20200201,7,학동,11036,11675,20200204,22711
20200201,7,논현,11592,13152,20200204,24744
20200201,7,반포,4435,4265,20200204,8700
20200201,7,고속터미널,15403,11972,20200204,27375
20200201,7,내방,7670,7784,20200204,15454
20200201,7,이수,12569,12186,20200204,24755
20200201,7,남성,7688,7254,20200204,14942
20200201,7,숭실대입구,8254,8078,20200204,16332
20200201,7,상도,7608,6959,20200204,14567
20200201,7,장승배기,7440,7081,20200204,14521
20200201,7,신대방삼거리,11517,10652,20200204,22169
20200201,7,보라매,6403,6218,20200204,12621
20200201,7,신풍,7766,7549,20200204,15315
20200201,7,대림,5837,5968,20200204,11805
20200201,7,남구로,8423,8797,20200204,17220
20200201,7,가산디지털단지,14267,13219,20200204,27486
20200201,7,철산,16257,16584,20200204,32841
20200201,7,광명사거리,18013,17806,20200204,35819
20200201,7,천왕,6213,5737,20200204,11950
20200201,7,온수,5829,5683,20200204,11512
20200201,7,까치울,4903,4733,20200204,9636
20200201,7,부천종합운동장,3015,2700,20200204,5715
20200201,7,춘의,5256,5123,20200204,10379
20200201,7,신중동,9675,9721,20200204,19396
20200201,7,부천시청,8926,8864,20200204,17790
20200201,7,상동,10165,10450,20200204,20615
20200201,7,삼산체육관,3394,3211,20200204,6605
20200201,7,굴포천,6602,6813,20200204,13415
20200201,7,부평구청,7361,6178,20200204,13539
20200202,7,장암,1123,670,20200205,1793
20200202,7,도봉산,4730,7063,20200205,11793
20200202,7,수락산,7672,7679,20200205,15351
20200202,7,마들,5395,5043,20200205,10438
20200202,7,노원,11179,11561,20200205,22740
20200202,7,중계,7789,7310,20200205,15099
20200202,7,하계,9652,9086,20200205,18738
20200202,7,공릉,6283,6472,20200205,12755
20200202,7,태릉입구,4731,4355,20200205,9086
20200202,7,먹골,5264,5342,20200205,10606
20200202,7,중화,6004,5867,20200205,11871
20200202,7,상봉,9751,9158,20200205,18909
20200202,7,면목,7713,7635,20200205,15348
20200202,7,사가정,8505,8305,20200205,16810
20200202,7,용마산,3158,3280,20200205,6438
20200202,7,중곡,5197,4928,20200205,10125
20200202,7,군자,7713,5986,20200205,13699
20200202,7,어린이대공원,6479,6432,20200205,12911
20200202,7,건대입구,7921,8146,20200205,16067
20200202,7,뚝섬유원지,4016,3912,20200205,7928
20200202,7,청담,6863,7358,20200205,14221
20200202,7,강남구청,5894,6242,20200205,12136
20200202,7,학동,6186,6575,20200205,12761
20200202,7,논현,6565,6967,20200205,13532
20200202,7,반포,2873,2964,20200205,5837
20200202,7,고속터미널,11255,8590,20200205,19845
20200202,7,내방,4841,5038,20200205,9879
20200202,7,이수,8400,8115,20200205,16515
20200202,7,남성,5414,5393,20200205,10807
20200202,7,숭실대입구,5916,6040,20200205,11956
20200202,7,상도,5171,5142,20200205,10313
20200202,7,장승배기,5180,5202,20200205,10382
20200202,7,신대방삼거리,8013,7877,20200205,15890
20200202,7,보라매,3931,3894,20200205,7825
20200202,7,신풍,6031,5929,20200205,11960
20200202,7,대림,4965,4494,20200205,9459
20200202,7,남구로,6502,6196,20200205,12698
20200202,7,가산디지털단지,9082,8593,20200205,17675
20200202,7,철산,11000,10980,20200205,21980
20200202,7,광명사거리,13043,12629,20200205,25672
20200202,7,천왕,4293,4223,20200205,8516
20200202,7,온수,4087,4285,20200205,8372
20200202,7,까치울,3526,3402,20200205,6928
20200202,7,부천종합운동장,2139,1859,20200205,3998
20200202,7,춘의,3632,3491,20200205,7123
20200202,7,신중동,6148,5972,20200205,12120
20200202,7,부천시청,5490,5374,20200205,10864
20200202,7,상동,6461,6396,20200205,12857
20200202,7,삼산체육관,2527,2420,20200205,4947
20200202,7,굴포천,4494,4462,20200205,8956
20200202,7,부평구청,4770,4216,20200205,8986
20200203,7,장암,2753,806,20200206,3559
20200203,7,도봉산,9161,10590,20200206,19751
20200203,7,수락산,12859,13056,20200206,25915
20200203,7,마들,12441,12021,20200206,24462
20200203,7,노원,21845,22769,20200206,44614
20200203,7,중계,15939,14795,20200206,30734
20200203,7,하계,18614,17660,20200206,36274
20200203,7,공릉,12554,12571,20200206,25125
20200203,7,태릉입구,8460,7715,20200206,16175
20200203,7,먹골,10936,10736,20200206,21672
20200203,7,중화,11731,11361,20200206,23092
20200203,7,상봉,17970,16780,20200206,34750
20200203,7,면목,15872,15453,20200206,31325
20200203,7,사가정,16207,16283,20200206,32490
20200203,7,용마산,6252,6023,20200206,12275
20200203,7,중곡,10841,10012,20200206,20853
20200203,7,군자,15102,11978,20200206,27080
20200203,7,어린이대공원,12121,11902,20200206,24023
20200203,7,건대입구,12860,13902,20200206,26762
20200203,7,뚝섬유원지,6959,6872,20200206,13831
20200203,7,청담,22244,24851,20200206,47095
20200203,7,강남구청,16757,18652,20200206,35409
20200203,7,학동,25613,27469,20200206,53082
20200203,7,논현,21933,24071,20200206,46004
20200203,7,반포,6095,6090,20200206,12185
20200203,7,고속터미널,16874,14215,20200206,31089
20200203,7,내방,15070,15522,20200206,30592
20200203,7,이수,16694,16481,20200206,33175
20200203,7,남성,11935,11166,20200206,23101
20200203,7,숭실대입구,12676,12823,20200206,25499
20200203,7,상도,11000,10789,20200206,21789
20200203,7,장승배기,10916,10644,20200206,21560
20200203,7,신대방삼거리,17439,16856,20200206,34295
20200203,7,보라매,10325,10301,20200206,20626
20200203,7,신풍,11227,10779,20200206,22006
20200203,7,대림,7526,7384,20200206,14910
20200203,7,남구로,17070,18009,20200206,35079
20200203,7,가산디지털단지,48603,49437,20200206,98040
20200203,7,철산,22875,23336,20200206,46211
20200203,7,광명사거리,24565,24044,20200206,48609
20200203,7,천왕,10524,9659,20200206,20183
20200203,7,온수,10866,10194,20200206,21060
20200203,7,까치울,7097,6799,20200206,13896
20200203,7,부천종합운동장,4703,3871,20200206,8574
20200203,7,춘의,9790,9640,20200206,19430
20200203,7,신중동,14544,14342,20200206,28886
20200203,7,부천시청,11897,11666,20200206,23563
20200203,7,상동,12889,13287,20200206,26176
20200203,7,삼산체육관,4967,4391,20200206,9358
20200203,7,굴포천,9125,9655,20200206,18780
20200203,7,부평구청,12460,10119,20200206,22579
20200204,7,장암,2709,851,20200207,3560
20200204,7,도봉산,9337,10793,20200207,20130
20200204,7,수락산,12981,13381,20200207,26362
20200204,7,마들,12573,12295,20200207,24868
20200204,7,노원,21108,22066,20200207,43174
20200204,7,중계,16108,14908,20200207,31016
20200204,7,하계,19210,18310,20200207,37520
20200204,7,공릉,12535,12632,20200207,25167
20200204,7,태릉입구,8329,7609,20200207,15938
20200204,7,먹골,10767,10558,20200207,21325
20200204,7,중화,11816,11548,20200207,23364
20200204,7,상봉,17914,16858,20200207,34772
20200204,7,면목,15940,15646,20200207,31586
20200204,7,사가정,16266,16318,20200207,32584
20200204,7,용마산,6382,6097,20200207,12479
20200204,7,중곡,10774,10093,20200207,20867
20200204,7,군자,15355,12200,20200207,27555
20200204,7,어린이대공원,12347,12044,20200207,24391
20200204,7,건대입구,12906,13800,20200207,26706
20200204,7,뚝섬유원지,7138,7038,20200207,14176
20200204,7,청담,22570,25349,20200207,47919
20200204,7,강남구청,17324,19218,20200207,36542
20200204,7,학동,25901,27786,20200207,53687
20200204,7,논현,21856,24269,20200207,46125
20200204,7,반포,6432,6294,20200207,12726
20200204,7,고속터미널,16008,14081,20200207,30089
20200204,7,내방,15219,15773,20200207,30992
20200204,7,이수,17203,16704,20200207,33907
20200204,7,남성,12110,11279,20200207,23389
20200204,7,숭실대입구,12504,12623,20200207,25127
20200204,7,상도,11312,10921,20200207,22233
20200204,7,장승배기,11026,10820,20200207,21846
20200204,7,신대방삼거리,17887,17110,20200207,34997
20200204,7,보라매,10429,10669,20200207,21098
20200204,7,신풍,11317,10959,20200207,22276
20200204,7,대림,7334,7248,20200207,14582
20200204,7,남구로,16914,18083,20200207,34997
20200204,7,가산디지털단지,49428,49163,20200207,98591
20200204,7,철산,23373,24238,20200207,47611
20200204,7,광명사거리,24546,24105,20200207,48651
20200204,7,천왕,10456,9685,20200207,20141
20200204,7,온수,10879,10066,20200207,20945
20200204,7,까치울,7015,6726,20200207,13741
20200204,7,부천종합운동장,4759,3998,20200207,8757
20200204,7,춘의,9865,9608,20200207,19473
20200204,7,신중동,14605,14564,20200207,29169
20200204,7,부천시청,11774,11747,20200207,23521
20200204,7,상동,13298,13730,20200207,27028
20200204,7,삼산체육관,5033,4493,20200207,9526
20200204,7,굴포천,9065,9893,20200207,18958
20200204,7,부평구청,12399,10206,20200207,22605
20200205,7,장암,2564,736,20200208,3300
20200205,7,도봉산,8762,10130,20200208,18892
20200205,7,수락산,12370,12450,20200208,24820
20200205,7,마들,12064,11612,20200208,23676
20200205,7,노원,20117,21060,20200208,41177
20200205,7,중계,16154,14975,20200208,31129
20200205,7,하계,18248,17509,20200208,35757
20200205,7,공릉,11981,11937,20200208,23918
20200205,7,태릉입구,8089,7568,20200208,15657
20200205,7,먹골,10550,10321,20200208,20871
20200205,7,중화,11532,11292,20200208,22824
20200205,7,상봉,17525,16564,20200208,34089
20200205,7,면목,15471,15254,20200208,30725
20200205,7,사가정,15604,15659,20200208,31263
20200205,7,용마산,6181,5862,20200208,12043
20200205,7,중곡,10463,9857,20200208,20320
20200205,7,군자,15077,12053,20200208,27130
20200205,7,어린이대공원,11529,11203,20200208,22732
20200205,7,건대입구,12530,13411,20200208,25941
20200205,7,뚝섬유원지,6745,6670,20200208,13415
20200205,7,청담,22195,24989,20200208,47184
20200205,7,강남구청,17198,19267,20200208,36465
20200205,7,학동,25899,28056,20200208,53955
20200205,7,논현,21826,23895,20200208,45721
20200205,7,반포,6320,6292,20200208,12612
20200205,7,고속터미널,15503,13590,20200208,29093
20200205,7,내방,14907,15510,20200208,30417
20200205,7,이수,16704,16352,20200208,33056
20200205,7,남성,11766,10900,20200208,22666
20200205,7,숭실대입구,12337,12281,20200208,24618
20200205,7,상도,11012,10706,20200208,21718
20200205,7,장승배기,10594,10402,20200208,20996
20200205,7,신대방삼거리,17386,16627,20200208,34013
20200205,7,보라매,10141,10030,20200208,20171
20200205,7,신풍,11171,10664,20200208,21835
20200205,7,대림,7035,6919,20200208,13954
20200205,7,남구로,16356,17650,20200208,34006
20200205,7,가산디지털단지,48461,48723,20200208,97184
20200205,7,철산,22701,23367,20200208,46068
20200205,7,광명사거리,23786,23440,20200208,47226
20200205,7,천왕,10379,9509,20200208,19888
20200205,7,온수,10860,9966,20200208,20826
20200205,7,까치울,7029,6593,20200208,13622
20200205,7,부천종합운동장,4535,3824,20200208,8359
20200205,7,춘의,9694,9550,20200208,19244
20200205,7,신중동,14353,14237,20200208,28590
20200205,7,부천시청,11710,11721,20200208,23431
20200205,7,상동,12994,13312,20200208,26306
20200205,7,삼산체육관,4777,4371,20200208,9148
20200205,7,굴포천,8856,9411,20200208,18267
20200205,7,부평구청,12178,9866,20200208,22044
20200206,7,장암,2559,763,20200209,3322
20200206,7,도봉산,8780,9955,20200209,18735
20200206,7,수락산,12432,12518,20200209,24950
20200206,7,마들,11933,11570,20200209,23503
20200206,7,노원,19739,21077,20200209,40816
20200206,7,중계,15299,13861,20200209,29160
20200206,7,하계,18318,17272,20200209,35590
20200206,7,공릉,12015,12136,20200209,24151
20200206,7,태릉입구,7853,7311,20200209,15164
20200206,7,먹골,10337,10113,20200209,20450
20200206,7,중화,11304,11050,20200209,22354
20200206,7,상봉,17452,16251,20200209,33703
20200206,7,면목,15310,14935,20200209,30245
20200206,7,사가정,15274,15410,20200209,30684
20200206,7,용마산,6179,5738,20200209,11917
20200206,7,중곡,10166,9507,20200209,19673
20200206,7,군자,15008,11773,20200209,26781
20200206,7,어린이대공원,11418,11181,20200209,22599
20200206,7,건대입구,12716,13339,20200209,26055
20200206,7,뚝섬유원지,6706,6570,20200209,13276
20200206,7,청담,21489,24370,20200209,45859
20200206,7,강남구청,17093,19288,20200209,36381
20200206,7,학동,25463,27617,20200209,53080
20200206,7,논현,21198,23520,20200209,44718
20200206,7,반포,6238,6091,20200209,12329
20200206,7,고속터미널,15629,13753,20200209,29382
20200206,7,내방,14685,15097,20200209,29782
20200206,7,이수,16416,16189,20200209,32605
20200206,7,남성,11627,10834,20200209,22461
20200206,7,숭실대입구,12179,11990,20200209,24169
20200206,7,상도,10845,10482,20200209,21327
20200206,7,장승배기,10545,10216,20200209,20761
20200206,7,신대방삼거리,17234,16529,20200209,33763
20200206,7,보라매,9843,9820,20200209,19663
20200206,7,신풍,10792,10320,20200209,21112
20200206,7,대림,6694,6642,20200209,13336
20200206,7,남구로,16195,17263,20200209,33458
20200206,7,가산디지털단지,47784,48433,20200209,96217
20200206,7,철산,22732,23336,20200209,46068
20200206,7,광명사거리,23969,23544,20200209,47513
20200206,7,천왕,10322,9507,20200209,19829
20200206,7,온수,10780,9887,20200209,20667
20200206,7,까치울,7051,6689,20200209,13740
20200206,7,부천종합운동장,4461,3717,20200209,8178
20200206,7,춘의,9622,9412,20200209,19034
20200206,7,신중동,14441,14091,20200209,28532
20200206,7,부천시청,11512,11486,20200209,22998
20200206,7,상동,12976,13341,20200209,26317
20200206,7,삼산체육관,5057,4527,20200209,9584
20200206,7,굴포천,8853,9433,20200209,18286
20200206,7,부평구청,12058,9881,20200209,21939
20200207,7,장암,2584,820,20200210,3404
20200207,7,도봉산,8994,10284,20200210,19278
20200207,7,수락산,13169,12991,20200210,26160
20200207,7,마들,12597,11908,20200210,24505
20200207,7,노원,21217,23504,20200210,44721
20200207,7,중계,16034,14212,20200210,30246
20200207,7,하계,18952,17572,20200210,36524
20200207,7,공릉,12992,12838,20200210,25830
20200207,7,태릉입구,8401,7735,20200210,16136
20200207,7,먹골,10897,10452,20200210,21349
20200207,7,중화,11793,11428,20200210,23221
20200207,7,상봉,18342,17295,20200210,35637
20200207,7,면목,16116,15537,20200210,31653
20200207,7,사가정,16186,16125,20200210,32311
20200207,7,용마산,6410,5842,20200210,12252
20200207,7,중곡,10546,9821,20200210,20367
20200207,7,군자,15629,12138,20200210,27767
20200207,7,어린이대공원,11988,11406,20200210,23394
20200207,7,건대입구,13139,14415,20200210,27554
20200207,7,뚝섬유원지,7268,7144,20200210,14412
20200207,7,청담,21988,24874,20200210,46862
20200207,7,강남구청,17307,19727,20200210,37034
20200207,7,학동,25234,27449,20200210,52683
20200207,7,논현,21933,24891,20200210,46824
20200207,7,반포,6712,6434,20200210,13146
20200207,7,고속터미널,17938,14973,20200210,32911
20200207,7,내방,14966,15453,20200210,30419
20200207,7,이수,17571,17666,20200210,35237
20200207,7,남성,11937,11046,20200210,22983
20200207,7,숭실대입구,12821,12445,20200210,25266
20200207,7,상도,11335,10640,20200210,21975
20200207,7,장승배기,11055,10623,20200210,21678
20200207,7,신대방삼거리,18001,16952,20200210,34953
20200207,7,보라매,10242,10116,20200210,20358
20200207,7,신풍,11269,10814,20200210,22083
20200207,7,대림,6950,7008,20200210,13958
20200207,7,남구로,16381,17494,20200210,33875
20200207,7,가산디지털단지,48482,48501,20200210,96983
20200207,7,철산,24153,25176,20200210,49329
20200207,7,광명사거리,24848,24687,20200210,49535
20200207,7,천왕,10761,9681,20200210,20442
20200207,7,온수,11004,10260,20200210,21264
20200207,7,까치울,7370,6883,20200210,14253
20200207,7,부천종합운동장,4902,3978,20200210,8880
20200207,7,춘의,9904,9684,20200210,19588
20200207,7,신중동,15046,15042,20200210,30088
20200207,7,부천시청,12272,12455,20200210,24727
20200207,7,상동,13748,14417,20200210,28165
20200207,7,삼산체육관,4906,4349,20200210,9255
20200207,7,굴포천,9078,9649,20200210,18727
20200207,7,부평구청,12642,10157,20200210,22799
20200208,7,장암,1348,765,20200211,2113
20200208,7,도봉산,5829,8041,20200211,13870
20200208,7,수락산,9829,9435,20200211,19264
20200208,7,마들,8233,7706,20200211,15939
20200208,7,노원,16143,17161,20200211,33304
20200208,7,중계,9805,8691,20200211,18496
20200208,7,하계,12309,11424,20200211,23733
20200208,7,공릉,8867,8627,20200211,17494
20200208,7,태릉입구,6046,5485,20200211,11531
20200208,7,먹골,7908,7743,20200211,15651
20200208,7,중화,7877,7480,20200211,15357
20200208,7,상봉,13128,12880,20200211,26008
20200208,7,면목,10827,10250,20200211,21077
20200208,7,사가정,11822,11395,20200211,23217
20200208,7,용마산,4200,4101,20200211,8301
20200208,7,중곡,6670,6162,20200211,12832
20200208,7,군자,10499,7746,20200211,18245
20200208,7,어린이대공원,9699,9540,20200211,19239
20200208,7,건대입구,11148,11774,20200211,22922
20200208,7,뚝섬유원지,5125,5045,20200211,10170
20200208,7,청담,11611,12419,20200211,24030
20200208,7,강남구청,10190,11015,20200211,21205
20200208,7,학동,10806,11294,20200211,22100
20200208,7,논현,11399,12636,20200211,24035
20200208,7,반포,4514,4187,20200211,8701
20200208,7,고속터미널,14144,11050,20200211,25194
20200208,7,내방,7554,7590,20200211,15144
20200208,7,이수,12246,11935,20200211,24181
20200208,7,남성,7794,7065,20200211,14859
20200208,7,숭실대입구,8092,7899,20200211,15991
20200208,7,상도,7329,6852,20200211,14181
20200208,7,장승배기,7208,6782,20200211,13990
20200208,7,신대방삼거리,11219,10412,20200211,21631
20200208,7,보라매,6040,5857,20200211,11897
20200208,7,신풍,7396,7268,20200211,14664
20200208,7,대림,5443,5624,20200211,11067
20200208,7,남구로,8071,8459,20200211,16530
20200208,7,가산디지털단지,13047,11951,20200211,24998
20200208,7,철산,15653,16165,20200211,31818
20200208,7,광명사거리,17229,17061,20200211,34290
20200208,7,천왕,5985,5541,20200211,11526
20200208,7,온수,5456,5384,20200211,10840
20200208,7,까치울,4791,4755,20200211,9546
20200208,7,부천종합운동장,3046,2582,20200211,5628
20200208,7,춘의,4768,4516,20200211,9284
20200208,7,신중동,9246,9046,20200211,18292
20200208,7,부천시청,8207,8251,20200211,16458
20200208,7,상동,10207,10368,20200211,20575
20200208,7,삼산체육관,3359,3172,20200211,6531
20200208,7,굴포천,6263,6543,20200211,12806
20200208,7,부평구청,6892,5774,20200211,12666
20200209,7,장암,1143,617,20200212,1760
20200209,7,도봉산,4780,6930,20200212,11710
20200209,7,수락산,7930,7941,20200212,15871
20200209,7,마들,5414,5105,20200212,10519
20200209,7,노원,11499,11752,20200212,23251
20200209,7,중계,7681,7321,20200212,15002
20200209,7,하계,9742,9065,20200212,18807
20200209,7,공릉,6483,6411,20200212,12894
20200209,7,태릉입구,4617,4142,20200212,8759
20200209,7,먹골,5442,5353,20200212,10795
20200209,7,중화,6024,5833,20200212,11857
20200209,7,상봉,9171,8541,20200212,17712
20200209,7,면목,7801,7851,20200212,15652
20200209,7,사가정,8416,8138,20200212,16554
20200209,7,용마산,3090,3216,20200212,6306
20200209,7,중곡,5091,4835,20200212,9926
20200209,7,군자,7806,5888,20200212,13694
20200209,7,어린이대공원,6180,6067,20200212,12247
20200209,7,건대입구,7576,7938,20200212,15514
20200209,7,뚝섬유원지,3989,3817,20200212,7806
20200209,7,청담,6758,7140,20200212,13898
20200209,7,강남구청,5799,6197,20200212,11996
20200209,7,학동,5955,6288,20200212,12243
20200209,7,논현,6450,6838,20200212,13288
20200209,7,반포,2796,2843,20200212,5639
20200209,7,고속터미널,11279,8570,20200212,19849
20200209,7,내방,4841,5109,20200212,9950
20200209,7,이수,8547,8136,20200212,16683
20200209,7,남성,5228,5292,20200212,10520
20200209,7,숭실대입구,5655,6030,20200212,11685
20200209,7,상도,5217,5165,20200212,10382
20200209,7,장승배기,5074,5090,20200212,10164
20200209,7,신대방삼거리,7825,7630,20200212,15455
20200209,7,보라매,3949,3794,20200212,7743
20200209,7,신풍,5631,5374,20200212,11005
20200209,7,대림,4487,4176,20200212,8663
20200209,7,남구로,6123,6034,20200212,12157
20200209,7,가산디지털단지,8880,8238,20200212,17118
20200209,7,철산,10934,10892,20200212,21826
20200209,7,광명사거리,12468,12056,20200212,24524
20200209,7,천왕,4209,4181,20200212,8390
20200209,7,온수,3948,4016,20200212,7964
20200209,7,까치울,3466,3335,20200212,6801
20200209,7,부천종합운동장,2137,1904,20200212,4041
20200209,7,춘의,3133,2943,20200212,6076
20200209,7,신중동,6442,6265,20200212,12707
20200209,7,부천시청,5670,5538,20200212,11208
20200209,7,상동,6369,6202,20200212,12571
20200209,7,삼산체육관,2165,2019,20200212,4184
20200209,7,굴포천,4157,4244,20200212,8401
20200209,7,부평구청,4733,4076,20200212,8809
20200210,7,장암,2652,766,20200213,3418
20200210,7,도봉산,8983,10358,20200213,19341
20200210,7,수락산,12822,12985,20200213,25807
20200210,7,마들,12353,11741,20200213,24094
20200210,7,노원,20161,21525,20200213,41686
20200210,7,중계,15843,14444,20200213,30287
20200210,7,하계,18277,17376,20200213,35653
20200210,7,공릉,12276,12336,20200213,24612
20200210,7,태릉입구,8084,7708,20200213,15792
20200210,7,먹골,10620,10226,20200213,20846
20200210,7,중화,11531,11332,20200213,22863
20200210,7,상봉,17893,16897,20200213,34790
20200210,7,면목,15778,15257,20200213,31035
20200210,7,사가정,16135,16257,20200213,32392
20200210,7,용마산,6298,5991,20200213,12289
20200210,7,중곡,10478,9716,20200213,20194
20200210,7,군자,15009,12145,20200213,27154
20200210,7,어린이대공원,11287,11031,20200213,22318
20200210,7,건대입구,12289,13495,20200213,25784
20200210,7,뚝섬유원지,7049,6927,20200213,13976
20200210,7,청담,21590,24144,20200213,45734
20200210,7,강남구청,16802,18715,20200213,35517
20200210,7,학동,25420,27116,20200213,52536
20200210,7,논현,22185,24183,20200213,46368
20200210,7,반포,6284,6175,20200213,12459
20200210,7,고속터미널,16862,13872,20200213,30734
20200210,7,내방,14891,15366,20200213,30257
20200210,7,이수,16785,16578,20200213,33363
20200210,7,남성,11865,11103,20200213,22968
20200210,7,숭실대입구,12617,12754,20200213,25371
20200210,7,상도,11035,10598,20200213,21633
20200210,7,장승배기,10771,10548,20200213,21319
20200210,7,신대방삼거리,17198,16561,20200213,33759
20200210,7,보라매,10357,10377,20200213,20734
20200210,7,신풍,11169,10579,20200213,21748
20200210,7,대림,7367,7147,20200213,14514
20200210,7,남구로,16806,17855,20200213,34661
20200210,7,가산디지털단지,48601,49702,20200213,98303
20200210,7,철산,23431,24061,20200213,47492
20200210,7,광명사거리,24681,23921,20200213,48602
20200210,7,천왕,10569,9795,20200213,20364
20200210,7,온수,11138,10355,20200213,21493
20200210,7,까치울,7263,7024,20200213,14287
20200210,7,부천종합운동장,4819,4000,20200213,8819
20200210,7,춘의,9905,9789,20200213,19694
20200210,7,신중동,14459,14254,20200213,28713
20200210,7,부천시청,11544,11347,20200213,22891
20200210,7,상동,13205,13532,20200213,26737
20200210,7,삼산체육관,5044,4384,20200213,9428
20200210,7,굴포천,8980,9532,20200213,18512
20200210,7,부평구청,12344,9932,20200213,22276
20200211,7,장암,2739,869,20200214,3608
20200211,7,도봉산,9509,11149,20200214,20658
20200211,7,수락산,13419,13452,20200214,26871
20200211,7,마들,12649,11926,20200214,24575
20200211,7,노원,21837,23460,20200214,45297
20200211,7,중계,16237,14818,20200214,31055
20200211,7,하계,19375,18317,20200214,37692
20200211,7,공릉,12687,12465,20200214,25152
20200211,7,태릉입구,8485,7885,20200214,16370
20200211,7,먹골,10850,10491,20200214,21341
20200211,7,중화,11908,11633,20200214,23541
20200211,7,상봉,18147,17278,20200214,35425
20200211,7,면목,16387,15860,20200214,32247
20200211,7,사가정,16438,16523,20200214,32961
20200211,7,용마산,6363,6012,20200214,12375
20200211,7,중곡,10732,9924,20200214,20656
20200211,7,군자,15513,12255,20200214,27768
20200211,7,어린이대공원,11616,11348,20200214,22964
20200211,7,건대입구,13379,14242,20200214,27621
20200211,7,뚝섬유원지,7867,7658,20200214,15525
20200211,7,청담,22255,25044,20200214,47299
20200211,7,강남구청,17472,19494,20200214,36966
20200211,7,학동,25789,28027,20200214,53816
20200211,7,논현,22709,24703,20200214,47412
20200211,7,반포,6458,6228,20200214,12686
20200211,7,고속터미널,16937,14729,20200214,31666
20200211,7,내방,15161,15610,20200214,30771
20200211,7,이수,17702,17203,20200214,34905
20200211,7,남성,12260,11377,20200214,23637
20200211,7,숭실대입구,12884,12960,20200214,25844
20200211,7,상도,11220,10718,20200214,21938
20200211,7,장승배기,11029,10628,20200214,21657
20200211,7,신대방삼거리,17727,16985,20200214,34712
20200211,7,보라매,10563,10614,20200214,21177
20200211,7,신풍,11242,10765,20200214,22007
20200211,7,대림,7321,7312,20200214,14633
20200211,7,남구로,17021,18168,20200214,35189
20200211,7,가산디지털단지,49091,50071,20200214,99162
20200211,7,철산,23844,24596,20200214,48440
20200211,7,광명사거리,25125,24440,20200214,49565
20200211,7,천왕,10711,9814,20200214,20525
20200211,7,온수,11242,10428,20200214,21670
20200211,7,까치울,7741,7255,20200214,14996
20200211,7,부천종합운동장,5046,4196,20200214,9242
20200211,7,춘의,10262,10012,20200214,20274
20200211,7,신중동,15326,15285,20200214,30611
20200211,7,부천시청,12548,12745,20200214,25293
20200211,7,상동,13994,14271,20200214,28265
20200211,7,삼산체육관,5159,4596,20200214,9755
20200211,7,굴포천,9424,9911,20200214,19335
20200211,7,부평구청,12766,10427,20200214,23193
20200212,7,장암,2561,778,20200215,3339
20200212,7,도봉산,8912,10206,20200215,19118
20200212,7,수락산,12622,12814,20200215,25436
20200212,7,마들,12100,11633,20200215,23733
20200212,7,노원,20792,22164,20200215,42956
20200212,7,중계,16311,15175,20200215,31486
20200212,7,하계,18798,17601,20200215,36399
20200212,7,공릉,12147,12237,20200215,24384
20200212,7,태릉입구,8196,7632,20200215,15828
20200212,7,먹골,10589,10433,20200215,21022
20200212,7,중화,11729,11501,20200215,23230
20200212,7,상봉,17539,16749,20200215,34288
20200212,7,면목,15833,15362,20200215,31195
20200212,7,사가정,15833,15900,20200215,31733
20200212,7,용마산,6224,5721,20200215,11945
20200212,7,중곡,10464,9852,20200215,20316
20200212,7,군자,15342,12175,20200215,27517
20200212,7,어린이대공원,11459,11292,20200215,22751
20200212,7,건대입구,13229,14157,20200215,27386
20200212,7,뚝섬유원지,6637,6425,20200215,13062
20200212,7,청담,21512,24416,20200215,45928
20200212,7,강남구청,17152,19298,20200215,36450
20200212,7,학동,25510,27466,20200215,52976
20200212,7,논현,21883,23928,20200215,45811
20200212,7,반포,6392,6241,20200215,12633
20200212,7,고속터미널,16355,14228,20200215,30583
20200212,7,내방,15109,15638,20200215,30747
20200212,7,이수,17228,16975,20200215,34203
20200212,7,남성,11927,11121,20200215,23048
20200212,7,숭실대입구,12594,12538,20200215,25132
20200212,7,상도,11001,10629,20200215,21630
20200212,7,장승배기,10620,10333,20200215,20953
20200212,7,신대방삼거리,17337,16561,20200215,33898
20200212,7,보라매,10339,10438,20200215,20777
20200212,7,신풍,11094,10660,20200215,21754
20200212,7,대림,7022,7178,20200215,14200
20200212,7,남구로,16641,17598,20200215,34239
20200212,7,가산디지털단지,48415,48869,20200215,97284
20200212,7,철산,23524,24231,20200215,47755
20200212,7,광명사거리,24416,23865,20200215,48281
20200212,7,천왕,10499,9708,20200215,20207
20200212,7,온수,11111,10248,20200215,21359
20200212,7,까치울,7402,7004,20200215,14406
20200212,7,부천종합운동장,4667,3838,20200215,8505
20200212,7,춘의,9968,9761,20200215,19729
20200212,7,신중동,14938,14588,20200215,29526
20200212,7,부천시청,12315,12427,20200215,24742
20200212,7,상동,13753,14237,20200215,27990
20200212,7,삼산체육관,4977,4435,20200215,9412
20200212,7,굴포천,9115,9730,20200215,18845
20200212,7,부평구청,12450,10118,20200215,22568
20200213,7,천왕,10801,9826,20200216,20627
20200213,7,장암,2694,881,20200216,3575
20200213,7,도봉산,9390,10972,20200216,20362
20200213,7,수락산,13514,13394,20200216,26908
20200213,7,마들,12775,12236,20200216,25011
20200213,7,노원,21941,23594,20200216,45535
20200213,7,중계,16306,14749,20200216,31055
20200213,7,하계,19432,18329,20200216,37761
20200213,7,공릉,12741,12649,20200216,25390
20200213,7,태릉입구,8598,8247,20200216,16845
20200213,7,먹골,11129,10798,20200216,21927
20200213,7,중화,11867,11512,20200216,23379
20200213,7,상봉,18684,17773,20200216,36457
20200213,7,면목,16139,15625,20200216,31764
20200213,7,사가정,16548,16527,20200216,33075
20200213,7,용마산,6511,6101,20200216,12612
20200213,7,중곡,10606,9874,20200216,20480
20200213,7,군자,15688,12401,20200216,28089
20200213,7,어린이대공원,11893,11549,20200216,23442
20200213,7,건대입구,13950,15026,20200216,28976
20200213,7,뚝섬유원지,7477,7239,20200216,14716
20200213,7,청담,21955,25177,20200216,47132
20200213,7,강남구청,17427,19636,20200216,37063
20200213,7,학동,25809,28179,20200216,53988
20200213,7,논현,22337,24553,20200216,46890
20200213,7,반포,6529,6359,20200216,12888
20200213,7,고속터미널,17495,15248,20200216,32743
20200213,7,내방,15403,15894,20200216,31297
20200213,7,이수,17809,17586,20200216,35395
20200213,7,남성,12288,11381,20200216,23669
20200213,7,숭실대입구,13102,12915,20200216,26017
20200213,7,상도,11540,10846,20200216,22386
20200213,7,장승배기,11123,10692,20200216,21815
20200213,7,신대방삼거리,17928,17250,20200216,35178
20200213,7,보라매,10461,10525,20200216,20986
20200213,7,신풍,11375,10811,20200216,22186
20200213,7,대림,7388,7191,20200216,14579
20200213,7,남구로,16614,17820,20200216,34434
20200213,7,가산디지털단지,48895,50072,20200216,98967
20200213,7,철산,24490,25055,20200216,49545
20200213,7,광명사거리,25318,24780,20200216,50098
20200213,7,온수,11211,10527,20200216,21738
20200213,7,까치울,7808,7392,20200216,15200
20200213,7,부천종합운동장,4843,4018,20200216,8861
20200213,7,춘의,10120,9975,20200216,20095
20200213,7,신중동,15517,15227,20200216,30744
20200213,7,부천시청,12987,12880,20200216,25867
20200213,7,상동,14034,14502,20200216,28536
20200213,7,삼산체육관,5143,4572,20200216,9715
20200213,7,굴포천,9546,10099,20200216,19645
20200213,7,부평구청,12951,10449,20200216,23400
20200214,7,장암,2666,827,20200217,3493
20200214,7,도봉산,9716,11103,20200217,20819
20200214,7,수락산,14055,13664,20200217,27719
20200214,7,마들,13251,12055,20200217,25306
20200214,7,노원,23116,25749,20200217,48865
20200214,7,중계,16451,14521,20200217,30972
20200214,7,하계,19929,18010,20200217,37939
20200214,7,공릉,13206,13061,20200217,26267
20200214,7,태릉입구,9001,8270,20200217,17271
20200214,7,먹골,11412,11013,20200217,22425
20200214,7,중화,12504,11869,20200217,24373
20200214,7,상봉,19452,18776,20200217,38228
20200214,7,면목,16858,15868,20200217,32726
20200214,7,사가정,17068,17117,20200217,34185
20200214,7,용마산,6616,6035,20200217,12651
20200214,7,중곡,10877,9971,20200217,20848
20200214,7,군자,16515,12862,20200217,29377
20200214,7,어린이대공원,12347,11988,20200217,24335
20200214,7,건대입구,14690,16500,20200217,31190
20200214,7,뚝섬유원지,8388,7915,20200217,16303
20200214,7,청담,22875,25850,20200217,48725
20200214,7,강남구청,17730,20491,20200217,38221
20200214,7,학동,25563,27987,20200217,53550
20200214,7,논현,23039,25876,20200217,48915
20200214,7,반포,6909,6487,20200217,13396
20200214,7,고속터미널,20185,16762,20200217,36947
20200214,7,내방,15841,16192,20200217,32033
20200214,7,이수,18633,18319,20200217,36952
20200214,7,남성,12548,11290,20200217,23838
20200214,7,숭실대입구,14038,13741,20200217,27779
20200214,7,상도,11907,11111,20200217,23018
20200214,7,장승배기,11671,11186,20200217,22857
20200214,7,신대방삼거리,18489,17263,20200217,35752
20200214,7,보라매,10972,10923,20200217,21895
20200214,7,신풍,11888,11080,20200217,22968
20200214,7,대림,7597,7755,20200217,15352
20200214,7,남구로,16871,18219,20200217,35090
20200214,7,가산디지털단지,49656,50152,20200217,99808
20200214,7,철산,25735,26732,20200217,52467
20200214,7,광명사거리,26863,26093,20200217,52956
20200214,7,천왕,11241,10087,20200217,21328
20200214,7,온수,11800,10782,20200217,22582
20200214,7,까치울,8102,7619,20200217,15721
20200214,7,부천종합운동장,5057,4082,20200217,9139
20200214,7,춘의,10454,10000,20200217,20454
20200214,7,신중동,16308,16355,20200217,32663
20200214,7,부천시청,13824,13794,20200217,27618
20200214,7,상동,15195,15712,20200217,30907
20200214,7,삼산체육관,5366,4666,20200217,10032
20200214,7,굴포천,9859,10469,20200217,20328
20200214,7,부평구청,13230,10463,20200217,23693
20200215,7,장암,1650,962,20200218,2612
20200215,7,도봉산,6619,9035,20200218,15654
20200215,7,수락산,10947,10603,20200218,21550
20200215,7,마들,8824,8072,20200218,16896
20200215,7,노원,16540,18357,20200218,34897
20200215,7,중계,10478,9322,20200218,19800
20200215,7,하계,13962,13134,20200218,27096
20200215,7,공릉,9207,8875,20200218,18082
20200215,7,태릉입구,6601,5887,20200218,12488
20200215,7,먹골,8677,8483,20200218,17160
20200215,7,중화,8474,7992,20200218,16466
20200215,7,상봉,14141,13547,20200218,27688
20200215,7,면목,12048,11479,20200218,23527
20200215,7,사가정,12822,12303,20200218,25125
20200215,7,용마산,4756,4658,20200218,9414
20200215,7,중곡,7340,6649,20200218,13989
20200215,7,군자,11132,8320,20200218,19452
20200215,7,어린이대공원,9251,8744,20200218,17995
20200215,7,건대입구,12379,13910,20200218,26289
20200215,7,뚝섬유원지,5904,5690,20200218,11594
20200215,7,청담,12100,13088,20200218,25188
20200215,7,강남구청,11216,12335,20200218,23551
20200215,7,학동,11769,12701,20200218,24470
20200215,7,논현,12168,13680,20200218,25848
20200215,7,반포,4769,4420,20200218,9189
20200215,7,고속터미널,17070,13278,20200218,30348
20200215,7,내방,8249,8186,20200218,16435
20200215,7,이수,13398,13102,20200218,26500
20200215,7,남성,8319,7532,20200218,15851
20200215,7,숭실대입구,8963,8682,20200218,17645
20200215,7,상도,7876,7248,20200218,15124
20200215,7,장승배기,7765,7445,20200218,15210
20200215,7,신대방삼거리,11816,10888,20200218,22704
20200215,7,보라매,6485,6119,20200218,12604
20200215,7,신풍,8180,7979,20200218,16159
20200215,7,대림,6108,6450,20200218,12558
20200215,7,남구로,8790,9374,20200218,18164
20200215,7,가산디지털단지,14992,13787,20200218,28779
20200215,7,철산,17438,17432,20200218,34870
20200215,7,광명사거리,19220,19047,20200218,38267
20200215,7,천왕,6569,5869,20200218,12438
20200215,7,온수,6094,6085,20200218,12179
20200215,7,까치울,5546,5272,20200218,10818
20200215,7,부천종합운동장,3345,2826,20200218,6171
20200215,7,춘의,5241,5057,20200218,10298
20200215,7,신중동,10285,10414,20200218,20699
20200215,7,부천시청,9635,9525,20200218,19160
20200215,7,상동,11524,11649,20200218,23173
20200215,7,삼산체육관,3399,3167,20200218,6566
20200215,7,굴포천,6843,7097,20200218,13940
20200215,7,부평구청,7806,6424,20200218,14230
20200216,7,장암,1055,610,20200219,1665
20200216,7,도봉산,4566,6381,20200219,10947
20200216,7,수락산,7686,7539,20200219,15225
20200216,7,마들,5444,5313,20200219,10757
20200216,7,노원,12076,12200,20200219,24276
20200216,7,중계,8208,7773,20200219,15981
20200216,7,하계,9911,9354,20200219,19265
20200216,7,공릉,6530,6659,20200219,13189
20200216,7,태릉입구,4914,4214,20200219,9128
20200216,7,먹골,5905,5799,20200219,11704
20200216,7,중화,6229,6145,20200219,12374
20200216,7,상봉,10078,9368,20200219,19446
20200216,7,면목,8064,7918,20200219,15982
20200216,7,사가정,8733,8457,20200219,17190
20200216,7,용마산,3132,3358,20200219,6490
20200216,7,중곡,5255,5036,20200219,10291
20200216,7,군자,7832,6207,20200219,14039
20200216,7,어린이대공원,6346,6280,20200219,12626
20200216,7,건대입구,9242,9687,20200219,18929
20200216,7,뚝섬유원지,3602,3620,20200219,7222
20200216,7,청담,6697,7138,20200219,13835
20200216,7,강남구청,5948,6409,20200219,12357
20200216,7,학동,6926,7285,20200219,14211
20200216,7,논현,6548,7039,20200219,13587
20200216,7,반포,3016,3061,20200219,6077
20200216,7,고속터미널,13109,9652,20200219,22761
20200216,7,내방,5112,5313,20200219,10425
20200216,7,이수,8997,8645,20200219,17642
20200216,7,남성,5660,5482,20200219,11142
20200216,7,숭실대입구,5897,6235,20200219,12132
20200216,7,상도,5590,5327,20200219,10917
20200216,7,장승배기,5587,5555,20200219,11142
20200216,7,신대방삼거리,8230,7985,20200219,16215
20200216,7,보라매,4034,3925,20200219,7959
20200216,7,신풍,6006,5779,20200219,11785
20200216,7,대림,5516,5091,20200219,10607
20200216,7,남구로,6887,6677,20200219,13564
20200216,7,가산디지털단지,9914,9222,20200219,19136
20200216,7,철산,11421,11532,20200219,22953
20200216,7,광명사거리,13541,13136,20200219,26677
20200216,7,천왕,4496,4423,20200219,8919
20200216,7,온수,4287,4447,20200219,8734
20200216,7,까치울,3646,3542,20200219,7188
20200216,7,부천종합운동장,2127,1863,20200219,3990
20200216,7,춘의,3379,3144,20200219,6523
20200216,7,신중동,6919,6626,20200219,13545
20200216,7,부천시청,6602,6590,20200219,13192
20200216,7,상동,7537,7250,20200219,14787
20200216,7,삼산체육관,2201,2107,20200219,4308
20200216,7,굴포천,4883,4893,20200219,9776
20200216,7,부평구청,5020,4339,20200219,9359
20200217,7,장암,2612,717,20200220,3329
20200217,7,도봉산,9239,10556,20200220,19795
20200217,7,수락산,12958,13211,20200220,26169
20200217,7,마들,12466,11869,20200220,24335
20200217,7,노원,21774,22990,20200220,44764
20200217,7,중계,15625,14620,20200220,30245
20200217,7,하계,18704,17669,20200220,36373
20200217,7,공릉,12270,12383,20200220,24653
20200217,7,태릉입구,8440,7757,20200220,16197
20200217,7,먹골,10945,10706,20200220,21651
20200217,7,중화,11870,11620,20200220,23490
20200217,7,상봉,17980,16968,20200220,34948
20200217,7,면목,16072,15731,20200220,31803
20200217,7,사가정,16315,16495,20200220,32810
20200217,7,용마산,6446,5964,20200220,12410
20200217,7,중곡,10557,9840,20200220,20397
20200217,7,군자,15340,12406,20200220,27746
20200217,7,어린이대공원,12190,11775,20200220,23965
20200217,7,건대입구,13960,14844,20200220,28804
20200217,7,뚝섬유원지,6882,6638,20200220,13520
20200217,7,청담,22300,25110,20200220,47410
20200217,7,강남구청,16897,18812,20200220,35709
20200217,7,학동,25975,27878,20200220,53853
20200217,7,논현,22094,24364,20200220,46458
20200217,7,반포,6516,6410,20200220,12926
20200217,7,고속터미널,17564,14953,20200220,32517
20200217,7,내방,15555,16005,20200220,31560
20200217,7,이수,17027,16761,20200220,33788
20200217,7,남성,12038,11365,20200220,23403
20200217,7,숭실대입구,13559,13549,20200220,27108
20200217,7,상도,11128,10723,20200220,21851
20200217,7,장승배기,10835,10653,20200220,21488
20200217,7,신대방삼거리,17448,16847,20200220,34295
20200217,7,보라매,10277,10200,20200220,20477
20200217,7,신풍,11388,10847,20200220,22235
20200217,7,대림,7969,7740,20200220,15709
20200217,7,남구로,17162,18344,20200220,35506
20200217,7,가산디지털단지,50184,50874,20200220,101058
20200217,7,철산,24211,24720,20200220,48931
20200217,7,광명사거리,25243,24542,20200220,49785
20200217,7,천왕,10659,9721,20200220,20380
20200217,7,온수,11222,10378,20200220,21600
20200217,7,까치울,7653,7378,20200220,15031
20200217,7,부천종합운동장,4894,4085,20200220,8979
20200217,7,춘의,10301,10229,20200220,20530
20200217,7,신중동,15659,15411,20200220,31070
20200217,7,부천시청,13182,13081,20200220,26263
20200217,7,상동,14249,14678,20200220,28927
20200217,7,삼산체육관,5282,4639,20200220,9921
20200217,7,굴포천,9485,10065,20200220,19550
20200217,7,부평구청,12955,10442,20200220,23397
20200218,7,장암,2526,757,20200221,3283
20200218,7,도봉산,9399,10834,20200221,20233
20200218,7,수락산,13174,13197,20200221,26371
20200218,7,마들,12321,11771,20200221,24092
20200218,7,노원,21660,22776,20200221,44436
20200218,7,중계,15385,13872,20200221,29257
20200218,7,하계,19351,18144,20200221,37495
20200218,7,공릉,12381,12540,20200221,24921
20200218,7,태릉입구,8217,7670,20200221,15887
20200218,7,먹골,10792,10572,20200221,21364
20200218,7,중화,11781,11620,20200221,23401
20200218,7,상봉,18214,17326,20200221,35540
20200218,7,면목,16157,15720,20200221,31877
20200218,7,사가정,16189,16332,20200221,32521
20200218,7,용마산,6247,5868,20200221,12115
20200218,7,중곡,10343,9649,20200221,19992
20200218,7,군자,15559,12177,20200221,27736
20200218,7,어린이대공원,11929,11588,20200221,23517
20200218,7,건대입구,13667,14605,20200221,28272
20200218,7,뚝섬유원지,7021,6793,20200221,13814
20200218,7,청담,22584,25180,20200221,47764
20200218,7,강남구청,17471,19398,20200221,36869
20200218,7,학동,25766,27968,20200221,53734
20200218,7,논현,22577,24734,20200221,47311
20200218,7,반포,6601,6329,20200221,12930
20200218,7,고속터미널,17032,14883,20200221,31915
20200218,7,내방,15445,15872,20200221,31317
20200218,7,이수,17529,17271,20200221,34800
20200218,7,남성,12142,11242,20200221,23384
20200218,7,숭실대입구,12892,12928,20200221,25820
20200218,7,상도,11118,10793,20200221,21911
20200218,7,장승배기,10914,10633,20200221,21547
20200218,7,신대방삼거리,17551,16960,20200221,34511
20200218,7,보라매,10301,10244,20200221,20545
20200218,7,신풍,11403,10862,20200221,22265
20200218,7,대림,7750,7571,20200221,15321
20200218,7,남구로,16948,17889,20200221,34837
20200218,7,가산디지털단지,49324,50215,20200221,99539
20200218,7,철산,23951,24672,20200221,48623
20200218,7,광명사거리,25103,24576,20200221,49679
20200218,7,천왕,10691,9820,20200221,20511
20200218,7,온수,11038,10270,20200221,21308
20200218,7,까치울,7726,7474,20200221,15200
20200218,7,부천종합운동장,4811,4027,20200221,8838
20200218,7,춘의,10336,9989,20200221,20325
20200218,7,신중동,15483,15267,20200221,30750
20200218,7,부천시청,12990,12987,20200221,25977
20200218,7,상동,14391,14716,20200221,29107
20200218,7,삼산체육관,5170,4598,20200221,9768
20200218,7,굴포천,9624,10256,20200221,19880
20200218,7,부평구청,12777,10532,20200221,23309
20200219,7,장암,2665,783,20200222,3448
20200219,7,도봉산,9392,10973,20200222,20365
20200219,7,수락산,13210,13379,20200222,26589
20200219,7,마들,12557,11923,20200222,24480
20200219,7,노원,21539,23042,20200222,44581
20200219,7,중계,15200,13711,20200222,28911
20200219,7,하계,19438,18286,20200222,37724
20200219,7,공릉,12679,12464,20200222,25143
20200219,7,태릉입구,8368,7882,20200222,16250
20200219,7,먹골,10670,10544,20200222,21214
20200219,7,중화,11853,11695,20200222,23548
20200219,7,상봉,18165,17287,20200222,35452
20200219,7,면목,16400,15870,20200222,32270
20200219,7,사가정,16683,16595,20200222,33278
20200219,7,용마산,6607,6084,20200222,12691
20200219,7,중곡,10693,10023,20200222,20716
20200219,7,군자,15809,12352,20200222,28161
20200219,7,어린이대공원,12192,12118,20200222,24310
20200219,7,건대입구,13533,14404,20200222,27937
20200219,7,뚝섬유원지,7430,7121,20200222,14551
20200219,7,청담,22388,25283,20200222,47671
20200219,7,강남구청,17530,19758,20200222,37288
20200219,7,학동,25957,28138,20200222,54095
20200219,7,논현,22317,24683,20200222,47000
20200219,7,반포,6583,6517,20200222,13100
20200219,7,고속터미널,17398,14900,20200222,32298
20200219,7,내방,15301,15918,20200222,31219
20200219,7,이수,17591,17268,20200222,34859
20200219,7,남성,12154,11337,20200222,23491
20200219,7,숭실대입구,13550,13304,20200222,26854
20200219,7,상도,11410,10989,20200222,22399
20200219,7,장승배기,11106,10772,20200222,21878
20200219,7,신대방삼거리,17778,17000,20200222,34778
20200219,7,보라매,10490,10410,20200222,20900
20200219,7,신풍,11425,10923,20200222,22348
20200219,7,대림,7520,7556,20200222,15076
20200219,7,남구로,16886,18048,20200222,34934
20200219,7,가산디지털단지,49656,50281,20200222,99937
20200219,7,철산,24244,24883,20200222,49127
20200219,7,광명사거리,25423,25035,20200222,50458
20200219,7,천왕,10803,9882,20200222,20685
20200219,7,온수,11188,10385,20200222,21573
20200219,7,까치울,7959,7623,20200222,15582
20200219,7,부천종합운동장,4769,4034,20200222,8803
20200219,7,춘의,10366,10244,20200222,20610
20200219,7,신중동,15754,15415,20200222,31169
20200219,7,부천시청,12937,13013,20200222,25950
20200219,7,상동,14312,14773,20200222,29085
20200219,7,삼산체육관,5208,4656,20200222,9864
20200219,7,굴포천,9462,9940,20200222,19402
20200219,7,부평구청,12833,10487,20200222,23320
20200220,7,장암,2699,814,20200223,3513
20200220,7,도봉산,9192,10723,20200223,19915
20200220,7,수락산,13183,13137,20200223,26320
20200220,7,마들,12318,11846,20200223,24164
20200220,7,노원,20795,22497,20200223,43292
20200220,7,중계,15060,13418,20200223,28478
20200220,7,하계,18895,17651,20200223,36546
20200220,7,공릉,12472,12653,20200223,25125
20200220,7,태릉입구,8438,7746,20200223,16184
20200220,7,먹골,10926,10534,20200223,21460
20200220,7,중화,11789,11504,20200223,23293
20200220,7,상봉,18078,17157,20200223,35235
20200220,7,면목,16101,15431,20200223,31532
20200220,7,사가정,16289,16346,20200223,32635
20200220,7,용마산,6449,6160,20200223,12609
20200220,7,중곡,10473,9783,20200223,20256
20200220,7,군자,15375,12043,20200223,27418
20200220,7,어린이대공원,12086,11925,20200223,24011
20200220,7,건대입구,13085,14120,20200223,27205
20200220,7,뚝섬유원지,7439,7248,20200223,14687
20200220,7,청담,21822,24681,20200223,46503
20200220,7,강남구청,17274,19438,20200223,36712
20200220,7,학동,25644,27858,20200223,53502
20200220,7,논현,22378,24573,20200223,46951
20200220,7,반포,6324,6155,20200223,12479
20200220,7,고속터미널,17068,14671,20200223,31739
20200220,7,내방,15242,15776,20200223,31018
20200220,7,이수,17377,16866,20200223,34243
20200220,7,남성,12055,11241,20200223,23296
20200220,7,숭실대입구,13313,13110,20200223,26423
20200220,7,상도,11283,10886,20200223,22169
20200220,7,장승배기,10779,10504,20200223,21283
20200220,7,신대방삼거리,17484,16833,20200223,34317
20200220,7,보라매,10201,10324,20200223,20525
20200220,7,신풍,11246,10652,20200223,21898
20200220,7,대림,7363,7246,20200223,14609
20200220,7,남구로,16657,17915,20200223,34572
20200220,7,가산디지털단지,48604,49937,20200223,98541
20200220,7,철산,23976,24771,20200223,48747
20200220,7,광명사거리,25174,24551,20200223,49725
20200220,7,천왕,10663,9761,20200223,20424
20200220,7,온수,11026,10147,20200223,21173
20200220,7,까치울,8036,7671,20200223,15707
20200220,7,부천종합운동장,4848,4021,20200223,8869
20200220,7,춘의,10213,10027,20200223,20240
20200220,7,신중동,15331,15209,20200223,30540
20200220,7,부천시청,13001,12978,20200223,25979
20200220,7,상동,14148,14532,20200223,28680
20200220,7,삼산체육관,5279,4643,20200223,9922
20200220,7,굴포천,9433,9874,20200223,19307
20200220,7,부평구청,12981,10346,20200223,23327
20200221,7,장암,2533,813,20200224,3346
20200221,7,도봉산,8919,10199,20200224,19118
20200221,7,수락산,12822,12772,20200224,25594
20200221,7,마들,12168,11461,20200224,23629
20200221,7,노원,20713,23023,20200224,43736
20200221,7,중계,14323,12546,20200224,26869
20200221,7,하계,18174,16931,20200224,35105
20200221,7,공릉,12673,12620,20200224,25293
20200221,7,태릉입구,8299,7528,20200224,15827
20200221,7,먹골,10612,10099,20200224,20711
20200221,7,중화,11770,11194,20200224,22964
20200221,7,상봉,20651,17527,20200224,38178
20200221,7,면목,15811,15010,20200224,30821
20200221,7,사가정,16266,16033,20200224,32299
20200221,7,용마산,6245,5757,20200224,12002
20200221,7,중곡,10098,9478,20200224,19576
20200221,7,군자,15447,11940,20200224,27387
20200221,7,어린이대공원,12429,12227,20200224,24656
20200221,7,건대입구,12827,14349,20200224,27176
20200221,7,뚝섬유원지,7061,6993,20200224,14054
20200221,7,청담,21618,24932,20200224,46550
20200221,7,강남구청,17024,19681,20200224,36705
20200221,7,학동,24608,27135,20200224,51743
20200221,7,논현,21927,24733,20200224,46660
20200221,7,반포,6306,6011,20200224,12317
20200221,7,고속터미널,17778,14640,20200224,32418
20200221,7,내방,14742,15206,20200224,29948
20200221,7,이수,17195,17054,20200224,34249
20200221,7,남성,11538,10535,20200224,22073
20200221,7,숭실대입구,12404,12226,20200224,24630
20200221,7,상도,11207,10459,20200224,21666
20200221,7,장승배기,10819,10302,20200224,21121
20200221,7,신대방삼거리,17100,16054,20200224,33154
20200221,7,보라매,10196,10093,20200224,20289
20200221,7,신풍,11083,10552,20200224,21635
20200221,7,대림,7143,7149,20200224,14292
20200221,7,남구로,16320,17600,20200224,33920
20200221,7,가산디지털단지,48107,48333,20200224,96440
20200221,7,철산,23914,25060,20200224,48974
20200221,7,광명사거리,24692,24191,20200224,48883
20200221,7,천왕,10468,9309,20200224,19777
20200221,7,온수,10693,10079,20200224,20772
20200221,7,까치울,7746,7251,20200224,14997
20200221,7,부천종합운동장,4592,3912,20200224,8504
20200221,7,춘의,9920,9730,20200224,19650
20200221,7,신중동,14991,14988,20200224,29979
20200221,7,부천시청,12780,12633,20200224,25413
20200221,7,상동,13778,14375,20200224,28153
20200221,7,삼산체육관,4930,4366,20200224,9296
20200221,7,굴포천,9201,9858,20200224,19059
20200221,7,부평구청,12514,10040,20200224,22554
20200222,7,장암,1218,672,20200225,1890
20200222,7,도봉산,5138,6898,20200225,12036
20200222,7,수락산,8541,8464,20200225,17005
20200222,7,마들,7305,6741,20200225,14046
20200222,7,노원,13662,14510,20200225,28172
20200222,7,중계,8367,7340,20200225,15707
20200222,7,하계,11099,10561,20200225,21660
20200222,7,공릉,7696,7626,20200225,15322
20200222,7,태릉입구,5465,4854,20200225,10319
20200222,7,먹골,7403,7264,20200225,14667
20200222,7,중화,7311,6847,20200225,14158
20200222,7,상봉,11876,11499,20200225,23375
20200222,7,면목,9993,9529,20200225,19522
20200222,7,사가정,10968,10728,20200225,21696
20200222,7,용마산,3786,3733,20200225,7519
20200222,7,중곡,6495,5925,20200225,12420
20200222,7,군자,9453,7136,20200225,16589
20200222,7,어린이대공원,7879,7527,20200225,15406
20200222,7,건대입구,9957,10716,20200225,20673
20200222,7,뚝섬유원지,4265,4237,20200225,8502
20200222,7,청담,10978,11712,20200225,22690
20200222,7,강남구청,9539,10564,20200225,20103
20200222,7,학동,10490,11102,20200225,21592
20200222,7,논현,10311,11458,20200225,21769
20200222,7,반포,4075,3733,20200225,7808
20200222,7,고속터미널,12644,9948,20200225,22592
20200222,7,내방,6694,6708,20200225,13402
20200222,7,이수,10825,10348,20200225,21173
20200222,7,남성,6766,6254,20200225,13020
20200222,7,숭실대입구,7108,6887,20200225,13995
20200222,7,상도,6426,6005,20200225,12431
20200222,7,장승배기,6348,6127,20200225,12475
20200222,7,신대방삼거리,9899,9184,20200225,19083
20200222,7,보라매,5416,5243,20200225,10659
20200222,7,신풍,6877,6713,20200225,13590
20200222,7,대림,5142,5385,20200225,10527
20200222,7,남구로,7349,7877,20200225,15226
20200222,7,가산디지털단지,12162,11166,20200225,23328
20200222,7,철산,13953,14250,20200225,28203
20200222,7,광명사거리,15797,15698,20200225,31495
20200222,7,천왕,5374,4935,20200225,10309
20200222,7,온수,5221,5188,20200225,10409
20200222,7,까치울,4450,4419,20200225,8869
20200222,7,부천종합운동장,2470,2178,20200225,4648
20200222,7,춘의,4489,4297,20200225,8786
20200222,7,신중동,8615,8504,20200225,17119
20200222,7,부천시청,7718,7581,20200225,15299
20200222,7,상동,9437,9628,20200225,19065
20200222,7,삼산체육관,2619,2477,20200225,5096
20200222,7,굴포천,5586,5727,20200225,11313
20200222,7,부평구청,6382,5378,20200225,11760
20200223,7,장암,1012,682,20200226,1694
20200223,7,도봉산,3963,5923,20200226,9886
20200223,7,수락산,6862,6900,20200226,13762
20200223,7,마들,4503,4172,20200226,8675
20200223,7,노원,9331,9397,20200226,18728
20200223,7,중계,5434,4849,20200226,10283
20200223,7,하계,7658,7179,20200226,14837
20200223,7,공릉,5553,5620,20200226,11173
20200223,7,태릉입구,4033,3502,20200226,7535
20200223,7,먹골,4590,4497,20200226,9087
20200223,7,중화,4957,4895,20200226,9852
20200223,7,상봉,7631,7155,20200226,14786
20200223,7,면목,6830,6656,20200226,13486
20200223,7,사가정,7512,7158,20200226,14670
20200223,7,용마산,2614,2890,20200226,5504
20200223,7,중곡,4167,3999,20200226,8166
20200223,7,군자,5997,4637,20200226,10634
20200223,7,어린이대공원,5408,5361,20200226,10769
20200223,7,건대입구,6348,6613,20200226,12961
20200223,7,뚝섬유원지,3612,3444,20200226,7056
20200223,7,청담,5788,6284,20200226,12072
20200223,7,강남구청,4913,5402,20200226,10315
20200223,7,학동,5353,5694,20200226,11047
20200223,7,논현,5527,5951,20200226,11478
20200223,7,반포,2121,2241,20200226,4362
20200223,7,고속터미널,9411,6622,20200226,16033
20200223,7,내방,3880,4068,20200226,7948
20200223,7,이수,6560,6465,20200226,13025
20200223,7,남성,4259,4205,20200226,8464
20200223,7,숭실대입구,4509,4651,20200226,9160
20200223,7,상도,4843,4394,20200226,9237
20200223,7,장승배기,4209,4091,20200226,8300
20200223,7,신대방삼거리,6394,6205,20200226,12599
20200223,7,보라매,3141,3122,20200226,6263
20200223,7,신풍,4489,4299,20200226,8788
20200223,7,대림,3846,3674,20200226,7520
20200223,7,남구로,5303,4990,20200226,10293
20200223,7,가산디지털단지,7485,7021,20200226,14506
20200223,7,철산,8327,8597,20200226,16924
20200223,7,광명사거리,10168,9726,20200226,19894
20200223,7,천왕,3405,3305,20200226,6710
20200223,7,온수,3218,3303,20200226,6521
20200223,7,까치울,2839,2717,20200226,5556
20200223,7,부천종합운동장,1623,1497,20200226,3120
20200223,7,춘의,2536,2424,20200226,4960
20200223,7,신중동,5050,5058,20200226,10108
20200223,7,부천시청,4529,4462,20200226,8991
20200223,7,상동,5341,5170,20200226,10511
20200223,7,삼산체육관,1674,1549,20200226,3223
20200223,7,굴포천,3484,3493,20200226,6977
20200223,7,부평구청,3683,3195,20200226,6878
20200224,7,장암,2474,717,20200227,3191
20200224,7,도봉산,8190,9521,20200227,17711
20200224,7,수락산,11250,11302,20200227,22552
20200224,7,마들,10783,10426,20200227,21209
20200224,7,노원,17587,18770,20200227,36357
20200224,7,중계,13003,11739,20200227,24742
20200224,7,하계,15643,14752,20200227,30395
20200224,7,공릉,10686,10709,20200227,21395
20200224,7,태릉입구,7201,6714,20200227,13915
20200224,7,먹골,9452,9154,20200227,18606
20200224,7,중화,10409,10065,20200227,20474
20200224,7,상봉,15823,14793,20200227,30616
20200224,7,면목,14327,13835,20200227,28162
20200224,7,사가정,14169,14361,20200227,28530
20200224,7,용마산,5578,5161,20200227,10739
20200224,7,중곡,8866,8419,20200227,17285
20200224,7,군자,13179,10485,20200227,23664
20200224,7,어린이대공원,10064,9659,20200227,19723
20200224,7,건대입구,10241,11093,20200227,21334
20200224,7,뚝섬유원지,6174,6120,20200227,12294
20200224,7,청담,19723,21893,20200227,41616
20200224,7,강남구청,15074,16684,20200227,31758
20200224,7,학동,23215,24805,20200227,48020
20200224,7,논현,19764,21437,20200227,41201
20200224,7,반포,5248,5213,20200227,10461
20200224,7,고속터미널,13151,10938,20200227,24089
20200224,7,내방,12826,13330,20200227,26156
20200224,7,이수,13910,13661,20200227,27571
20200224,7,남성,9977,9382,20200227,19359
20200224,7,숭실대입구,10302,10440,20200227,20742
20200224,7,상도,9418,9080,20200227,18498
20200224,7,장승배기,9392,9263,20200227,18655
20200224,7,신대방삼거리,15225,14662,20200227,29887
20200224,7,보라매,8543,8618,20200227,17161
20200224,7,신풍,9829,9356,20200227,19185
20200224,7,대림,6371,6227,20200227,12598
20200224,7,남구로,15521,16435,20200227,31956
20200224,7,가산디지털단지,45014,45928,20200227,90942
20200224,7,철산,19779,20396,20200227,40175
20200224,7,광명사거리,21621,21102,20200227,42723
20200224,7,천왕,9176,8568,20200227,17744
20200224,7,온수,9760,9080,20200227,18840
20200224,7,까치울,6503,6301,20200227,12804
20200224,7,부천종합운동장,4168,3567,20200227,7735
20200224,7,춘의,8991,8880,20200227,17871
20200224,7,신중동,12840,12690,20200227,25530
20200224,7,부천시청,10505,10360,20200227,20865
20200224,7,상동,11118,11450,20200227,22568
20200224,7,삼산체육관,4103,3600,20200227,7703
20200224,7,굴포천,7709,8295,20200227,16004
20200224,7,부평구청,10939,8735,20200227,19674
20200225,7,장암,2263,648,20200228,2911
20200225,7,도봉산,7485,8357,20200228,15842
20200225,7,수락산,10162,10609,20200228,20771
20200225,7,마들,10105,9495,20200228,19600
20200225,7,노원,15423,16350,20200228,31773
20200225,7,중계,11995,10693,20200228,22688
20200225,7,하계,14746,14003,20200228,28749
20200225,7,공릉,9734,9818,20200228,19552
20200225,7,태릉입구,6413,6002,20200228,12415
20200225,7,먹골,8909,8640,20200228,17549
20200225,7,중화,9741,9566,20200228,19307
20200225,7,상봉,14703,13819,20200228,28522
20200225,7,면목,13209,12797,20200228,26006
20200225,7,사가정,13358,13455,20200228,26813
20200225,7,용마산,5260,4816,20200228,10076
20200225,7,중곡,8289,7796,20200228,16085
20200225,7,군자,12229,9871,20200228,22100
20200225,7,어린이대공원,9215,8899,20200228,18114
20200225,7,건대입구,9548,10155,20200228,19703
20200225,7,뚝섬유원지,5507,5365,20200228,10872
20200225,7,청담,18427,20532,20200228,38959
20200225,7,강남구청,14533,16162,20200228,30695
20200225,7,학동,22511,23988,20200228,46499
20200225,7,논현,18611,20078,20200228,38689
20200225,7,반포,4684,4618,20200228,9302
20200225,7,고속터미널,11296,9918,20200228,21214
20200225,7,내방,12184,12567,20200228,24751
20200225,7,이수,12807,12780,20200228,25587
20200225,7,남성,9502,8624,20200228,18126
20200225,7,숭실대입구,9411,9548,20200228,18959
20200225,7,상도,8689,8405,20200228,17094
20200225,7,장승배기,8611,8381,20200228,16992
20200225,7,신대방삼거리,14307,13669,20200228,27976
20200225,7,보라매,8150,8127,20200228,16277
20200225,7,신풍,9148,8708,20200228,17856
20200225,7,대림,5769,5577,20200228,11346
20200225,7,남구로,14528,15222,20200228,29750
20200225,7,가산디지털단지,43835,44682,20200228,88517
20200225,7,철산,18690,19185,20200228,37875
20200225,7,광명사거리,19940,19441,20200228,39381
20200225,7,천왕,8516,7886,20200228,16402
20200225,7,온수,9084,8355,20200228,17439
20200225,7,까치울,6043,5707,20200228,11750
20200225,7,부천종합운동장,3681,3189,20200228,6870
20200225,7,춘의,8557,8508,20200228,17065
20200225,7,신중동,11748,11713,20200228,23461
20200225,7,부천시청,9704,9669,20200228,19373
20200225,7,상동,10276,10721,20200228,20997
20200225,7,삼산체육관,3877,3440,20200228,7317
20200225,7,굴포천,7228,7782,20200228,15010
20200225,7,부평구청,10247,8352,20200228,18599
20200226,7,장암,2212,620,20200229,2832
20200226,7,도봉산,7566,8860,20200229,16426
20200226,7,수락산,10353,10578,20200229,20931
20200226,7,마들,9541,9156,20200229,18697
20200226,7,노원,14749,15822,20200229,30571
20200226,7,중계,11420,10091,20200229,21511
20200226,7,하계,14283,13526,20200229,27809
20200226,7,공릉,9589,9580,20200229,19169
20200226,7,태릉입구,6373,6005,20200229,12378
20200226,7,먹골,8734,8546,20200229,17280
20200226,7,중화,9593,9376,20200229,18969
20200226,7,상봉,14729,13959,20200229,28688
20200226,7,면목,13287,12809,20200229,26096
20200226,7,사가정,13330,13342,20200229,26672
20200226,7,용마산,5239,4947,20200229,10186
20200226,7,중곡,8516,7900,20200229,16416
20200226,7,군자,12357,9946,20200229,22303
20200226,7,어린이대공원,9277,8870,20200229,18147
20200226,7,건대입구,9506,10158,20200229,19664
20200226,7,뚝섬유원지,5667,5682,20200229,11349
20200226,7,청담,17758,19834,20200229,37592
20200226,7,강남구청,14226,15961,20200229,30187
20200226,7,학동,21879,23475,20200229,45354
20200226,7,논현,18389,19962,20200229,38351
20200226,7,반포,4867,4742,20200229,9609
20200226,7,고속터미널,10995,9793,20200229,20788
20200226,7,내방,12178,12537,20200229,24715
20200226,7,이수,12824,12767,20200229,25591
20200226,7,남성,9238,8493,20200229,17731
20200226,7,숭실대입구,9314,9545,20200229,18859
20200226,7,상도,8682,8380,20200229,17062
20200226,7,장승배기,8621,8290,20200229,16911
20200226,7,신대방삼거리,14348,13801,20200229,28149
20200226,7,보라매,8024,8072,20200229,16096
20200226,7,신풍,9311,8911,20200229,18222
20200226,7,대림,5846,5724,20200229,11570
20200226,7,남구로,14507,15526,20200229,30033
20200226,7,가산디지털단지,42829,43679,20200229,86508
20200226,7,철산,18511,18764,20200229,37275
20200226,7,광명사거리,20524,20084,20200229,40608
20200226,7,천왕,8563,8050,20200229,16613
20200226,7,온수,9073,8388,20200229,17461
20200226,7,까치울,6204,5921,20200229,12125
20200226,7,부천종합운동장,3890,3284,20200229,7174
20200226,7,춘의,8762,8588,20200229,17350
20200226,7,신중동,11951,12040,20200229,23991
20200226,7,부천시청,9910,9949,20200229,19859
20200226,7,상동,10345,10774,20200229,21119
20200226,7,삼산체육관,3864,3432,20200229,7296
20200226,7,굴포천,7362,7847,20200229,15209
20200226,7,부평구청,10326,8424,20200229,18750
20200227,7,삼산체육관,3824,3318,20200301,7142
20200227,7,부평구청,10176,8302,20200301,18478
20200227,7,굴포천,7235,7857,20200301,15092
20200227,7,장암,2202,705,20200301,2907
20200227,7,도봉산,7451,8787,20200301,16238
20200227,7,수락산,10146,10329,20200301,20475
20200227,7,마들,9568,9084,20200301,18652
20200227,7,노원,14558,15396,20200301,29954
20200227,7,중계,11217,9934,20200301,21151
20200227,7,하계,13661,13058,20200301,26719
20200227,7,공릉,9425,9433,20200301,18858
20200227,7,태릉입구,6342,5734,20200301,12076
20200227,7,먹골,8807,8543,20200301,17350
20200227,7,중화,9435,9301,20200301,18736
20200227,7,상봉,14444,13592,20200301,28036
20200227,7,면목,13140,12725,20200301,25865
20200227,7,사가정,13206,13247,20200301,26453
20200227,7,용마산,5131,4877,20200301,10008
20200227,7,중곡,8092,7572,20200301,15664
20200227,7,군자,12091,9591,20200301,21682
20200227,7,어린이대공원,9085,8851,20200301,17936
20200227,7,건대입구,9022,9603,20200301,18625
20200227,7,뚝섬유원지,6144,6056,20200301,12200
20200227,7,청담,17092,19023,20200301,36115
20200227,7,강남구청,13731,15436,20200301,29167
20200227,7,학동,20803,22325,20200301,43128
20200227,7,논현,17508,19272,20200301,36780
20200227,7,반포,4636,4573,20200301,9209
20200227,7,고속터미널,10607,9484,20200301,20091
20200227,7,내방,11827,12136,20200301,23963
20200227,7,이수,12605,12480,20200301,25085
20200227,7,남성,9158,8442,20200301,17600
20200227,7,숭실대입구,9065,9030,20200301,18095
20200227,7,상도,8409,8110,20200301,16519
20200227,7,장승배기,8328,8158,20200301,16486
20200227,7,신대방삼거리,13919,13205,20200301,27124
20200227,7,보라매,7806,7770,20200301,15576
20200227,7,신풍,8952,8670,20200301,17622
20200227,7,대림,5418,5367,20200301,10785
20200227,7,남구로,13932,14944,20200301,28876
20200227,7,가산디지털단지,40087,41412,20200301,81499
20200227,7,철산,16577,16707,20200301,33284
20200227,7,광명사거리,19417,19059,20200301,38476
20200227,7,천왕,8212,7652,20200301,15864
20200227,7,온수,9597,8304,20200301,17901
20200227,7,까치울,6128,5732,20200301,11860
20200227,7,부천종합운동장,3971,3423,20200301,7394
20200227,7,춘의,8424,8342,20200301,16766
20200227,7,신중동,11884,11847,20200301,23731
20200227,7,부천시청,9772,9786,20200301,19558
20200227,7,상동,10084,10488,20200301,20572
20200228,7,장암,2051,630,20200302,2681
20200228,7,도봉산,6974,7996,20200302,14970
20200228,7,수락산,9738,9996,20200302,19734
20200228,7,마들,9299,8828,20200302,18127
20200228,7,노원,14568,15497,20200302,30065
20200228,7,중계,10765,9405,20200302,20170
20200228,7,하계,13290,12423,20200302,25713
20200228,7,공릉,9058,9049,20200302,18107
20200228,7,태릉입구,6086,5552,20200302,11638
20200228,7,먹골,8496,8218,20200302,16714
20200228,7,중화,9313,9032,20200302,18345
20200228,7,상봉,14119,13372,20200302,27491
20200228,7,면목,12845,12390,20200302,25235
20200228,7,사가정,12913,13011,20200302,25924
20200228,7,용마산,5037,4619,20200302,9656
20200228,7,중곡,7799,7266,20200302,15065
20200228,7,군자,11839,9271,20200302,21110
20200228,7,어린이대공원,8790,8383,20200302,17173
20200228,7,건대입구,9062,9727,20200302,18789
20200228,7,뚝섬유원지,5009,5047,20200302,10056
20200228,7,청담,16026,18174,20200302,34200
20200228,7,강남구청,13204,14954,20200302,28158
20200228,7,학동,19917,21581,20200302,41498
20200228,7,논현,17034,18872,20200302,35906
20200228,7,반포,3999,3929,20200302,7928
20200228,7,고속터미널,11024,9562,20200302,20586
20200228,7,내방,11634,11819,20200302,23453
20200228,7,이수,12304,12592,20200302,24896
20200228,7,남성,8877,8134,20200302,17011
20200228,7,숭실대입구,9037,8848,20200302,17885
20200228,7,상도,8249,7734,20200302,15983
20200228,7,장승배기,8160,7960,20200302,16120
20200228,7,신대방삼거리,13341,12709,20200302,26050
20200228,7,보라매,7467,7391,20200302,14858
20200228,7,신풍,8714,8352,20200302,17066
20200228,7,대림,5304,5418,20200302,10722
20200228,7,남구로,13364,14614,20200302,27978
20200228,7,가산디지털단지,38778,38785,20200302,77563
20200228,7,철산,16615,17238,20200302,33853
20200228,7,광명사거리,18998,18722,20200302,37720
20200228,7,천왕,8039,7301,20200302,15340
20200228,7,온수,8756,7970,20200302,16726
20200228,7,까치울,5893,5546,20200302,11439
20200228,7,부천종합운동장,3643,3060,20200302,6703
20200228,7,춘의,8262,8133,20200302,16395
20200228,7,신중동,11645,11698,20200302,23343
20200228,7,부천시청,9505,9570,20200302,19075
20200228,7,상동,9917,10508,20200302,20425
20200228,7,삼산체육관,3584,3165,20200302,6749
20200228,7,굴포천,6973,7516,20200302,14489
20200228,7,부평구청,9674,7826,20200302,17500
20200229,7,부평구청,4518,3879,20200303,8397
20200229,7,굴포천,4177,4411,20200303,8588
20200229,7,삼산체육관,1822,1652,20200303,3474
20200229,7,상동,6084,6214,20200303,12298
20200229,7,부천시청,5880,5915,20200303,11795
20200229,7,신중동,6379,6555,20200303,12934
20200229,7,춘의,3571,3390,20200303,6961
20200229,7,부천종합운동장,2101,1899,20200303,4000
20200229,7,까치울,3306,3295,20200303,6601
20200229,7,온수,3974,3976,20200303,7950
20200229,7,천왕,4102,3700,20200303,7802
20200229,7,광명사거리,11934,11840,20200303,23774
20200229,7,철산,9021,9290,20200303,18311
20200229,7,가산디지털단지,9061,8573,20200303,17634
20200229,7,남구로,5864,6298,20200303,12162
20200229,7,대림,3829,3850,20200303,7679
20200229,7,신풍,5143,4921,20200303,10064
20200229,7,보라매,3868,3677,20200303,7545
20200229,7,신대방삼거리,7595,7132,20200303,14727
20200229,7,장승배기,4860,4546,20200303,9406
20200229,7,장암,997,562,20200303,1559
20200229,7,도봉산,4178,5720,20200303,9898
20200229,7,수락산,6547,6525,20200303,13072
20200229,7,마들,5485,5165,20200303,10650
20200229,7,노원,9286,9945,20200303,19231
20200229,7,중계,5998,5151,20200303,11149
20200229,7,하계,7618,6970,20200303,14588
20200229,7,공릉,5546,5507,20200303,11053
20200229,7,태릉입구,3923,3538,20200303,7461
20200229,7,먹골,5343,5213,20200303,10556
20200229,7,중화,5696,5475,20200303,11171
20200229,7,상봉,9342,9116,20200303,18458
20200229,7,면목,8171,7788,20200303,15959
20200229,7,사가정,8542,8377,20200303,16919
20200229,7,용마산,3022,2827,20200303,5849
20200229,7,중곡,4572,4306,20200303,8878
20200229,7,군자,6885,5266,20200303,12151
20200229,7,어린이대공원,5194,4946,20200303,10140
20200229,7,건대입구,6396,6653,20200303,13049
20200229,7,뚝섬유원지,4064,3903,20200303,7967
20200229,7,청담,7734,8182,20200303,15916
20200229,7,강남구청,6380,7118,20200303,13498
20200229,7,학동,6994,7342,20200303,14336
20200229,7,논현,7679,8373,20200303,16052
20200229,7,반포,2773,2744,20200303,5517
20200229,7,고속터미널,6911,5953,20200303,12864
20200229,7,내방,4798,4864,20200303,9662
20200229,7,이수,7639,7405,20200303,15044
20200229,7,남성,5056,4599,20200303,9655
20200229,7,숭실대입구,4729,4771,20200303,9500
20200229,7,상도,4563,4339,20200303,8902
20200301,7,장암,784,570,20200304,1354
20200301,7,도봉산,3200,4604,20200304,7804
20200301,7,수락산,5332,5331,20200304,10663
20200301,7,마들,3229,3090,20200304,6319
20200301,7,노원,6011,6065,20200304,12076
20200301,7,중계,3958,3532,20200304,7490
20200301,7,하계,5154,4671,20200304,9825
20200301,7,공릉,3806,3905,20200304,7711
20200301,7,태릉입구,2800,2434,20200304,5234
20200301,7,먹골,3498,3388,20200304,6886
20200301,7,중화,3916,3564,20200304,7480
20200301,7,상봉,6367,5908,20200304,12275
20200301,7,면목,5394,5155,20200304,10549
20200301,7,사가정,5590,5492,20200304,11082
20200301,7,용마산,1934,2142,20200304,4076
20200301,7,중곡,3062,2927,20200304,5989
20200301,7,군자,4561,3532,20200304,8093
20200301,7,어린이대공원,3604,3606,20200304,7210
20200301,7,건대입구,4567,4628,20200304,9195
20200301,7,뚝섬유원지,2594,2584,20200304,5178
20200301,7,청담,3994,4332,20200304,8326
20200301,7,강남구청,3498,3735,20200304,7233
20200301,7,학동,3738,3962,20200304,7700
20200301,7,논현,3985,4205,20200304,8190
20200301,7,반포,1749,1790,20200304,3539
20200301,7,고속터미널,5647,4217,20200304,9864
20200301,7,내방,2881,2999,20200304,5880
20200301,7,이수,4691,4451,20200304,9142
20200301,7,남성,3123,3165,20200304,6288
20200301,7,숭실대입구,3107,3282,20200304,6389
20200301,7,상도,2945,2881,20200304,5826
20200301,7,장승배기,3091,2995,20200304,6086
20200301,7,신대방삼거리,4888,4758,20200304,9646
20200301,7,보라매,2226,2211,20200304,4437
20200301,7,신풍,3263,3055,20200304,6318
20200301,7,대림,2709,2474,20200304,5183
20200301,7,남구로,3989,3827,20200304,7816
20200301,7,가산디지털단지,5524,5341,20200304,10865
20200301,7,철산,5721,5876,20200304,11597
20200301,7,광명사거리,7707,7391,20200304,15098
20200301,7,천왕,2526,2342,20200304,4868
20200301,7,온수,2489,2507,20200304,4996
20200301,7,까치울,2227,2132,20200304,4359
20200301,7,부천종합운동장,1325,1192,20200304,2517
20200301,7,춘의,2060,1934,20200304,3994
20200301,7,신중동,4020,3924,20200304,7944
20200301,7,부천시청,3791,3779,20200304,7570
20200301,7,상동,3911,3841,20200304,7752
20200301,7,삼산체육관,1171,1057,20200304,2228
20200301,7,굴포천,2815,2791,20200304,5606
20200301,7,부평구청,2899,2511,20200304,5410
20200302,7,남성,8849,8235,20200305,17084
20200302,7,장암,2083,625,20200305,2708
20200302,7,도봉산,7307,8260,20200305,15567
20200302,7,수락산,10177,10346,20200305,20523
20200302,7,마들,9281,8941,20200305,18222
20200302,7,노원,14042,15025,20200305,29067
20200302,7,중계,10950,9652,20200305,20602
20200302,7,하계,13503,12698,20200305,26201
20200302,7,공릉,8978,8943,20200305,17921
20200302,7,태릉입구,5961,5601,20200305,11562
20200302,7,먹골,8439,8138,20200305,16577
20200302,7,중화,9097,8966,20200305,18063
20200302,7,상봉,13878,13047,20200305,26925
20200302,7,면목,12704,12374,20200305,25078
20200302,7,사가정,12709,12984,20200305,25693
20200302,7,용마산,4912,4602,20200305,9514
20200302,7,중곡,7775,7381,20200305,15156
20200302,7,군자,11447,9184,20200305,20631
20200302,7,어린이대공원,8772,8670,20200305,17442
20200302,7,건대입구,8951,9320,20200305,18271
20200302,7,뚝섬유원지,5492,5524,20200305,11016
20200302,7,청담,16200,17986,20200305,34186
20200302,7,강남구청,12485,14047,20200305,26532
20200302,7,학동,20206,21588,20200305,41794
20200302,7,논현,16788,18108,20200305,34896
20200302,7,반포,4347,4474,20200305,8821
20200302,7,고속터미널,10605,9095,20200305,19700
20200302,7,내방,11672,12007,20200305,23679
20200302,7,이수,12205,11982,20200305,24187
20200302,7,숭실대입구,8922,9072,20200305,17994
20200302,7,상도,8113,7873,20200305,15986
20200302,7,장승배기,8123,7975,20200305,16098
20200302,7,신대방삼거리,13354,13005,20200305,26359
20200302,7,보라매,7576,7630,20200305,15206
20200302,7,신풍,8625,8378,20200305,17003
20200302,7,대림,5371,5237,20200305,10608
20200302,7,남구로,13881,14614,20200305,28495
20200302,7,가산디지털단지,38438,39278,20200305,77716
20200302,7,철산,17014,17460,20200305,34474
20200302,7,광명사거리,19131,18939,20200305,38070
20200302,7,천왕,7988,7397,20200305,15385
20200302,7,온수,8781,8097,20200305,16878
20200302,7,까치울,5926,5654,20200305,11580
20200302,7,부천종합운동장,3802,3198,20200305,7000
20200302,7,춘의,8162,8229,20200305,16391
20200302,7,신중동,11238,11108,20200305,22346
20200302,7,부천시청,9709,9533,20200305,19242
20200302,7,상동,9733,10146,20200305,19879
20200302,7,삼산체육관,3623,3216,20200305,6839
20200302,7,굴포천,7110,7549,20200305,14659
20200302,7,부평구청,9583,7883,20200305,17466
20200303,7,장암,2054,706,20200306,2760
20200303,7,도봉산,7256,8555,20200306,15811
20200303,7,수락산,10033,10255,20200306,20288
20200303,7,마들,9358,8867,20200306,18225
20200303,7,노원,14523,15535,20200306,30058
20200303,7,중계,10950,9823,20200306,20773
20200303,7,하계,13798,13142,20200306,26940
20200303,7,공릉,8884,8961,20200306,17845
20200303,7,태릉입구,6146,5725,20200306,11871
20200303,7,먹골,8304,8174,20200306,16478
20200303,7,중화,9273,8988,20200306,18261
20200303,7,상봉,13888,12988,20200306,26876
20200303,7,면목,12640,12298,20200306,24938
20200303,7,사가정,12749,12843,20200306,25592
20200303,7,용마산,4969,4758,20200306,9727
20200303,7,중곡,7894,7501,20200306,15395
20200303,7,군자,11535,9302,20200306,20837
20200303,7,어린이대공원,8663,8501,20200306,17164
20200303,7,건대입구,8962,9217,20200306,18179
20200303,7,뚝섬유원지,5461,5605,20200306,11066
20200303,7,청담,16359,18293,20200306,34652
20200303,7,강남구청,13138,14648,20200306,27786
20200303,7,학동,20237,21624,20200306,41861
20200303,7,논현,16834,18334,20200306,35168
20200303,7,반포,4276,4306,20200306,8582
20200303,7,고속터미널,10150,9118,20200306,19268
20200303,7,내방,11681,11862,20200306,23543
20200303,7,이수,12504,12208,20200306,24712
20200303,7,남성,8973,8381,20200306,17354
20200303,7,숭실대입구,8898,8850,20200306,17748
20200303,7,상도,8022,7756,20200306,15778
20200303,7,장승배기,8129,7847,20200306,15976
20200303,7,신대방삼거리,13315,12837,20200306,26152
20200303,7,보라매,7668,7632,20200306,15300
20200303,7,신풍,8604,8278,20200306,16882
20200303,7,대림,5196,5147,20200306,10343
20200303,7,남구로,13703,14643,20200306,28346
20200303,7,가산디지털단지,38401,38903,20200306,77304
20200303,7,철산,17155,17556,20200306,34711
20200303,7,광명사거리,19190,18920,20200306,38110
20200303,7,천왕,8010,7412,20200306,15422
20200303,7,온수,8758,8102,20200306,16860
20200303,7,까치울,5946,5678,20200306,11624
20200303,7,부천종합운동장,3836,3269,20200306,7105
20200303,7,춘의,8393,8182,20200306,16575
20200303,7,신중동,11671,11608,20200306,23279
20200303,7,부천시청,9637,9633,20200306,19270
20200303,7,상동,10104,10510,20200306,20614
20200303,7,삼산체육관,3619,3296,20200306,6915
20200303,7,굴포천,7369,7832,20200306,15201
20200303,7,부평구청,9909,8045,20200306,17954
20200304,7,장암,2068,648,20200307,2716
20200304,7,도봉산,6946,8203,20200307,15149
20200304,7,수락산,9928,10068,20200307,19996
20200304,7,마들,9369,8935,20200307,18304
20200304,7,노원,14576,15305,20200307,29881
20200304,7,중계,10944,9748,20200307,20692
20200304,7,하계,13506,12906,20200307,26412
20200304,7,공릉,8743,8868,20200307,17611
20200304,7,태릉입구,6161,5741,20200307,11902
20200304,7,먹골,8368,8216,20200307,16584
20200304,7,중화,9022,8889,20200307,17911
20200304,7,상봉,13940,13050,20200307,26990
20200304,7,면목,12574,12220,20200307,24794
20200304,7,사가정,12681,12823,20200307,25504
20200304,7,용마산,4987,4692,20200307,9679
20200304,7,중곡,7916,7279,20200307,15195
20200304,7,군자,11582,9211,20200307,20793
20200304,7,어린이대공원,8581,8505,20200307,17086
20200304,7,건대입구,9142,9423,20200307,18565
20200304,7,뚝섬유원지,5190,5228,20200307,10418
20200304,7,청담,16167,17938,20200307,34105
20200304,7,강남구청,12993,14586,20200307,27579
20200304,7,학동,20259,21579,20200307,41838
20200304,7,논현,16708,18161,20200307,34869
20200304,7,반포,4303,4369,20200307,8672
20200304,7,고속터미널,10085,9090,20200307,19175
20200304,7,내방,11742,11994,20200307,23736
20200304,7,이수,12479,12262,20200307,24741
20200304,7,남성,8919,8287,20200307,17206
20200304,7,숭실대입구,8857,8887,20200307,17744
20200304,7,상도,7885,7703,20200307,15588
20200304,7,장승배기,8108,7875,20200307,15983
20200304,7,신대방삼거리,13379,13035,20200307,26414
20200304,7,보라매,7659,7582,20200307,15241
20200304,7,신풍,8746,8281,20200307,17027
20200304,7,대림,5206,5086,20200307,10292
20200304,7,남구로,13519,14437,20200307,27956
20200304,7,가산디지털단지,38428,38811,20200307,77239
20200304,7,철산,17210,17708,20200307,34918
20200304,7,광명사거리,19207,18922,20200307,38129
20200304,7,천왕,8051,7350,20200307,15401
20200304,7,온수,8695,8056,20200307,16751
20200304,7,까치울,6032,5735,20200307,11767
20200304,7,부천종합운동장,3714,3167,20200307,6881
20200304,7,춘의,8186,8097,20200307,16283
20200304,7,신중동,11658,11544,20200307,23202
20200304,7,부천시청,9674,9612,20200307,19286
20200304,7,상동,10120,10538,20200307,20658
20200304,7,삼산체육관,3647,3221,20200307,6868
20200304,7,굴포천,7222,7772,20200307,14994
20200304,7,부평구청,9702,7995,20200307,17697
20200305,7,장암,1999,737,20200308,2736
20200305,7,도봉산,7304,8324,20200308,15628
20200305,7,수락산,10047,10159,20200308,20206
20200305,7,마들,9340,9050,20200308,18390
20200305,7,노원,14649,15723,20200308,30372
20200305,7,중계,11053,9867,20200308,20920
20200305,7,하계,13428,12655,20200308,26083
20200305,7,공릉,8966,8945,20200308,17911
20200305,7,태릉입구,6111,5563,20200308,11674
20200305,7,먹골,8272,8074,20200308,16346
20200305,7,중화,8946,8591,20200308,17537
20200305,7,상봉,13947,12960,20200308,26907
20200305,7,면목,12796,12518,20200308,25314
20200305,7,사가정,12613,12820,20200308,25433
20200305,7,용마산,4846,4619,20200308,9465
20200305,7,중곡,7893,7334,20200308,15227
20200305,7,군자,11773,9269,20200308,21042
20200305,7,어린이대공원,8722,8505,20200308,17227
20200305,7,건대입구,9370,9622,20200308,18992
20200305,7,뚝섬유원지,5443,5443,20200308,10886
20200305,7,청담,16105,17850,20200308,33955
20200305,7,강남구청,12991,14644,20200308,27635
20200305,7,학동,19991,21625,20200308,41616
20200305,7,논현,16833,18531,20200308,35364
20200305,7,반포,4322,4316,20200308,8638
20200305,7,고속터미널,10424,9308,20200308,19732
20200305,7,내방,11541,11963,20200308,23504
20200305,7,이수,12362,12225,20200308,24587
20200305,7,남성,8900,8296,20200308,17196
20200305,7,숭실대입구,8856,8781,20200308,17637
20200305,7,상도,8160,7678,20200308,15838
20200305,7,장승배기,8142,7920,20200308,16062
20200305,7,신대방삼거리,13405,12802,20200308,26207
20200305,7,보라매,7585,7546,20200308,15131
20200305,7,신풍,8551,8221,20200308,16772
20200305,7,대림,5132,5102,20200308,10234
20200305,7,남구로,13392,14396,20200308,27788
20200305,7,가산디지털단지,38008,38871,20200308,76879
20200305,7,철산,17079,17466,20200308,34545
20200305,7,광명사거리,19223,18983,20200308,38206
20200305,7,천왕,8019,7279,20200308,15298
20200305,7,온수,8702,7947,20200308,16649
20200305,7,까치울,5982,5639,20200308,11621
20200305,7,부천종합운동장,3786,3233,20200308,7019
20200305,7,춘의,8159,8097,20200308,16256
20200305,7,신중동,11499,11510,20200308,23009
20200305,7,부천시청,9838,9707,20200308,19545
20200305,7,상동,10077,10480,20200308,20557
20200305,7,삼산체육관,3662,3256,20200308,6918
20200305,7,굴포천,7171,7683,20200308,14854
20200305,7,부평구청,9714,7877,20200308,17591
20200306,7,장암,2035,742,20200309,2777
20200306,7,도봉산,7431,8514,20200309,15945
20200306,7,수락산,10395,10338,20200309,20733
20200306,7,마들,9781,9223,20200309,19004
20200306,7,노원,15611,16872,20200309,32483
20200306,7,중계,11321,9793,20200309,21114
20200306,7,하계,13946,13006,20200309,26952
20200306,7,공릉,9348,9531,20200309,18879
20200306,7,태릉입구,6360,5846,20200309,12206
20200306,7,먹골,8623,8406,20200309,17029
20200306,7,중화,9305,8879,20200309,18184
20200306,7,상봉,14341,13640,20200309,27981
20200306,7,면목,13189,12521,20200309,25710
20200306,7,사가정,13234,13465,20200309,26699
20200306,7,용마산,5100,4612,20200309,9712
20200306,7,중곡,8091,7360,20200309,15451
20200306,7,군자,12266,9520,20200309,21786
20200306,7,어린이대공원,9087,8741,20200309,17828
20200306,7,건대입구,9753,10293,20200309,20046
20200306,7,뚝섬유원지,5918,5912,20200309,11830
20200306,7,청담,16258,18395,20200309,34653
20200306,7,강남구청,13190,15068,20200309,28258
20200306,7,학동,19960,21654,20200309,41614
20200306,7,논현,17194,19173,20200309,36367
20200306,7,반포,4487,4457,20200309,8944
20200306,7,고속터미널,11423,9965,20200309,21388
20200306,7,내방,11704,12040,20200309,23744
20200306,7,이수,12906,13133,20200309,26039
20200306,7,남성,9129,8256,20200309,17385
20200306,7,숭실대입구,9236,8996,20200309,18232
20200306,7,상도,8299,7862,20200309,16161
20200306,7,장승배기,8468,8101,20200309,16569
20200306,7,신대방삼거리,13733,12916,20200309,26649
20200306,7,보라매,7506,7407,20200309,14913
20200306,7,신풍,8848,8501,20200309,17349
20200306,7,대림,5285,5273,20200309,10558
20200306,7,남구로,13512,14463,20200309,27975
20200306,7,가산디지털단지,37670,37799,20200309,75469
20200306,7,철산,17745,18365,20200309,36110
20200306,7,광명사거리,19810,19543,20200309,39353
20200306,7,천왕,8171,7473,20200309,15644
20200306,7,온수,8828,8070,20200309,16898
20200306,7,까치울,6144,5814,20200309,11958
20200306,7,부천종합운동장,3883,3366,20200309,7249
20200306,7,춘의,8287,8138,20200309,16425
20200306,7,신중동,12062,12184,20200309,24246
20200306,7,부천시청,10191,10236,20200309,20427
20200306,7,상동,10562,11009,20200309,21571
20200306,7,삼산체육관,3792,3265,20200309,7057
20200306,7,굴포천,7341,7895,20200309,15236
20200306,7,부평구청,10033,8002,20200309,18035
20200307,7,장암,1112,654,20200310,1766
20200307,7,도봉산,4526,6425,20200310,10951
20200307,7,수락산,7208,7239,20200310,14447
20200307,7,마들,5888,5584,20200310,11472
20200307,7,노원,10228,11080,20200310,21308
20200307,7,중계,6381,5499,20200310,11880
20200307,7,하계,8155,7623,20200310,15778
20200307,7,공릉,5978,5981,20200310,11959
20200307,7,태릉입구,4185,3740,20200310,7925
20200307,7,먹골,5566,5396,20200310,10962
20200307,7,중화,5712,5315,20200310,11027
20200307,7,상봉,9886,9282,20200310,19168
20200307,7,면목,8282,7840,20200310,16122
20200307,7,사가정,8697,8750,20200310,17447
20200307,7,용마산,3159,3030,20200310,6189
20200307,7,중곡,4866,4473,20200310,9339
20200307,7,군자,7637,5672,20200310,13309
20200307,7,어린이대공원,5669,5454,20200310,11123
20200307,7,건대입구,7235,7447,20200310,14682
20200307,7,뚝섬유원지,4614,4489,20200310,9103
20200307,7,청담,7877,8226,20200310,16103
20200307,7,강남구청,6555,7388,20200310,13943
20200307,7,학동,6757,7256,20200310,14013
20200307,7,논현,8028,8826,20200310,16854
20200307,7,반포,3048,2823,20200310,5871
20200307,7,고속터미널,7261,6042,20200310,13303
20200307,7,내방,5337,5353,20200310,10690
20200307,7,이수,8212,8003,20200310,16215
20200307,7,남성,5509,5106,20200310,10615
20200307,7,숭실대입구,5312,5162,20200310,10474
20200307,7,상도,5073,4710,20200310,9783
20200307,7,장승배기,5007,4733,20200310,9740
20200307,7,신대방삼거리,8108,7441,20200310,15549
20200307,7,보라매,3968,3769,20200310,7737
20200307,7,신풍,5380,5102,20200310,10482
20200307,7,대림,3787,4001,20200310,7788
20200307,7,남구로,5835,6185,20200310,12020
20200307,7,가산디지털단지,9584,8958,20200310,18542
20200307,7,철산,9920,10259,20200310,20179
20200307,7,광명사거리,12562,12528,20200310,25090
20200307,7,천왕,4151,3879,20200310,8030
20200307,7,온수,4134,4102,20200310,8236
20200307,7,까치울,3665,3530,20200310,7195
20200307,7,부천종합운동장,2220,1954,20200310,4174
20200307,7,춘의,3627,3524,20200310,7151
20200307,7,신중동,6872,6933,20200310,13805
20200307,7,부천시청,6368,6359,20200310,12727
20200307,7,상동,6817,7089,20200310,13906
20200307,7,삼산체육관,2100,1955,20200310,4055
20200307,7,굴포천,4481,4696,20200310,9177
20200307,7,부평구청,4953,4164,20200310,9117
20200308,7,신중동,4327,4241,20200311,8568
20200308,7,장암,1024,691,20200311,1715
20200308,7,도봉산,4141,6269,20200311,10410
20200308,7,수락산,6376,6373,20200311,12749
20200308,7,마들,3699,3391,20200311,7090
20200308,7,노원,7258,7461,20200311,14719
20200308,7,중계,4413,3970,20200311,8383
20200308,7,하계,5954,5489,20200311,11443
20200308,7,공릉,4306,4458,20200311,8764
20200308,7,태릉입구,3164,2816,20200311,5980
20200308,7,먹골,3764,3656,20200311,7420
20200308,7,중화,4186,3992,20200311,8178
20200308,7,상봉,6582,6140,20200311,12722
20200308,7,면목,5656,5447,20200311,11103
20200308,7,사가정,6271,6050,20200311,12321
20200308,7,용마산,2234,2430,20200311,4664
20200308,7,중곡,3409,3167,20200311,6576
20200308,7,군자,5106,4040,20200311,9146
20200308,7,어린이대공원,4130,4247,20200311,8377
20200308,7,건대입구,5339,5365,20200311,10704
20200308,7,뚝섬유원지,6126,6148,20200311,12274
20200308,7,청담,4252,4591,20200311,8843
20200308,7,강남구청,3479,3919,20200311,7398
20200308,7,학동,3854,4082,20200311,7936
20200308,7,논현,4489,4787,20200311,9276
20200308,7,반포,1773,1904,20200311,3677
20200308,7,고속터미널,6755,4784,20200311,11539
20200308,7,내방,3192,3270,20200311,6462
20200308,7,이수,5288,5075,20200311,10363
20200308,7,남성,3575,3563,20200311,7138
20200308,7,숭실대입구,3657,3777,20200311,7434
20200308,7,상도,3270,3277,20200311,6547
20200308,7,장승배기,3348,3313,20200311,6661
20200308,7,신대방삼거리,5471,5179,20200311,10650
20200308,7,보라매,2680,2637,20200311,5317
20200308,7,신풍,3579,3345,20200311,6924
20200308,7,대림,3111,2870,20200311,5981
20200308,7,남구로,4194,4049,20200311,8243
20200308,7,가산디지털단지,6473,6151,20200311,12624
20200308,7,철산,6462,6531,20200311,12993
20200308,7,광명사거리,8299,8079,20200311,16378
20200308,7,천왕,2657,2502,20200311,5159
20200308,7,온수,2660,2687,20200311,5347
20200308,7,까치울,2496,2482,20200311,4978
20200308,7,부천종합운동장,1510,1367,20200311,2877
20200308,7,춘의,2158,2095,20200311,4253
20200308,7,부천시청,4040,3973,20200311,8013
20200308,7,상동,4439,4178,20200311,8617
20200308,7,삼산체육관,1379,1234,20200311,2613
20200308,7,굴포천,2987,3047,20200311,6034
20200308,7,부평구청,3165,2720,20200311,5885
20200309,7,장암,2169,706,20200312,2875
20200309,7,도봉산,7745,8873,20200312,16618
20200309,7,수락산,10454,10567,20200312,21021
20200309,7,마들,9830,9477,20200312,19307
20200309,7,노원,15599,16689,20200312,32288
20200309,7,중계,11988,10801,20200312,22789
20200309,7,하계,14363,13227,20200312,27590
20200309,7,공릉,9420,9671,20200312,19091
20200309,7,태릉입구,6464,5926,20200312,12390
20200309,7,먹골,8689,8520,20200312,17209
20200309,7,중화,9368,9152,20200312,18520
20200309,7,상봉,14615,13724,20200312,28339
20200309,7,면목,13193,12887,20200312,26080
20200309,7,사가정,13335,13526,20200312,26861
20200309,7,용마산,5130,4881,20200312,10011
20200309,7,중곡,8228,7667,20200312,15895
20200309,7,군자,12231,9770,20200312,22001
20200309,7,어린이대공원,8855,8806,20200312,17661
20200309,7,건대입구,9541,10253,20200312,19794
20200309,7,뚝섬유원지,7272,7260,20200312,14532
20200309,7,청담,16650,18580,20200312,35230
20200309,7,강남구청,13302,14672,20200312,27974
20200309,7,학동,21357,22808,20200312,44165
20200309,7,논현,18066,19504,20200312,37570
20200309,7,반포,4656,4687,20200312,9343
20200309,7,고속터미널,11492,9749,20200312,21241
20200309,7,내방,12076,12405,20200312,24481
20200309,7,이수,13026,12887,20200312,25913
20200309,7,남성,9357,8698,20200312,18055
20200309,7,숭실대입구,9378,9472,20200312,18850
20200309,7,상도,8397,8166,20200312,16563
20200309,7,장승배기,8422,8259,20200312,16681
20200309,7,신대방삼거리,13895,13390,20200312,27285
20200309,7,보라매,8138,8035,20200312,16173
20200309,7,신풍,8980,8633,20200312,17613
20200309,7,대림,5629,5571,20200312,11200
20200309,7,남구로,14398,15077,20200312,29475
20200309,7,가산디지털단지,39371,40122,20200312,79493
20200309,7,철산,17970,18486,20200312,36456
20200309,7,광명사거리,19841,19549,20200312,39390
20200309,7,천왕,8403,7789,20200312,16192
20200309,7,온수,8986,8444,20200312,17430
20200309,7,까치울,6172,5802,20200312,11974
20200309,7,부천종합운동장,3856,3218,20200312,7074
20200309,7,춘의,8388,8399,20200312,16787
20200309,7,신중동,11883,11805,20200312,23688
20200309,7,부천시청,9875,9778,20200312,19653
20200309,7,상동,10173,10592,20200312,20765
20200309,7,삼산체육관,3965,3419,20200312,7384
20200309,7,굴포천,7474,7873,20200312,15347
20200309,7,부평구청,10175,8239,20200312,18414
20200310,7,굴포천,7113,7554,20200313,14667
20200310,7,장암,1953,641,20200313,2594
20200310,7,도봉산,7128,8122,20200313,15250
20200310,7,수락산,9834,10095,20200313,19929
20200310,7,마들,9491,9146,20200313,18637
20200310,7,노원,14299,15061,20200313,29360
20200310,7,중계,11038,10033,20200313,21071
20200310,7,하계,13989,13377,20200313,27366
20200310,7,공릉,9048,9032,20200313,18080
20200310,7,태릉입구,6209,5674,20200313,11883
20200310,7,먹골,8521,8264,20200313,16785
20200310,7,중화,9248,9079,20200313,18327
20200310,7,상봉,13863,13015,20200313,26878
20200310,7,면목,12710,12482,20200313,25192
20200310,7,사가정,12596,12781,20200313,25377
20200310,7,용마산,4928,4575,20200313,9503
20200310,7,중곡,7998,7410,20200313,15408
20200310,7,군자,11868,9460,20200313,21328
20200310,7,어린이대공원,8755,8466,20200313,17221
20200310,7,건대입구,9334,9723,20200313,19057
20200310,7,뚝섬유원지,5253,5134,20200313,10387
20200310,7,청담,16344,18211,20200313,34555
20200310,7,강남구청,13288,14866,20200313,28154
20200310,7,학동,20907,22401,20200313,43308
20200310,7,논현,17349,18805,20200313,36154
20200310,7,반포,4538,4503,20200313,9041
20200310,7,고속터미널,10850,9500,20200313,20350
20200310,7,내방,11935,12175,20200313,24110
20200310,7,이수,12550,12346,20200313,24896
20200310,7,남성,9067,8438,20200313,17505
20200310,7,숭실대입구,9005,9132,20200313,18137
20200310,7,상도,8020,7738,20200313,15758
20200310,7,장승배기,8063,7809,20200313,15872
20200310,7,신대방삼거리,13405,12695,20200313,26100
20200310,7,보라매,7629,7588,20200313,15217
20200310,7,신풍,8691,8365,20200313,17056
20200310,7,대림,5236,5011,20200313,10247
20200310,7,남구로,13791,14436,20200313,28227
20200310,7,가산디지털단지,38893,39451,20200313,78344
20200310,7,철산,17130,17459,20200313,34589
20200310,7,광명사거리,18659,18269,20200313,36928
20200310,7,천왕,7880,7348,20200313,15228
20200310,7,온수,8624,8090,20200313,16714
20200310,7,까치울,5748,5658,20200313,11406
20200310,7,부천종합운동장,3563,3054,20200313,6617
20200310,7,춘의,8134,8062,20200313,16196
20200310,7,신중동,11396,11237,20200313,22633
20200310,7,부천시청,9523,9354,20200313,18877
20200310,7,상동,10046,10539,20200313,20585
20200310,7,삼산체육관,3739,3349,20200313,7088
20200310,7,부평구청,9810,8054,20200313,17864
20200311,7,장암,2006,742,20200314,2748
20200311,7,도봉산,7714,8903,20200314,16617
20200311,7,수락산,10373,10502,20200314,20875
20200311,7,마들,9784,9454,20200314,19238
20200311,7,노원,14946,15994,20200314,30940
20200311,7,중계,11663,10253,20200314,21916
20200311,7,하계,14102,13354,20200314,27456
20200311,7,공릉,9483,9728,20200314,19211
20200311,7,태릉입구,6496,5897,20200314,12393
20200311,7,먹골,8605,8387,20200314,16992
20200311,7,중화,9353,8966,20200314,18319
20200311,7,상봉,14498,13491,20200314,27989
20200311,7,면목,12986,12786,20200314,25772
20200311,7,사가정,13260,13511,20200314,26771
20200311,7,용마산,5125,4771,20200314,9896
20200311,7,중곡,8108,7695,20200314,15803
20200311,7,군자,12188,9792,20200314,21980
20200311,7,어린이대공원,9162,9035,20200314,18197
20200311,7,건대입구,9537,9879,20200314,19416
20200311,7,뚝섬유원지,6345,6361,20200314,12706
20200311,7,청담,16557,18490,20200314,35047
20200311,7,강남구청,13651,15385,20200314,29036
20200311,7,학동,21071,22836,20200314,43907
20200311,7,논현,17666,19336,20200314,37002
20200311,7,반포,4546,4604,20200314,9150
20200311,7,고속터미널,10706,9529,20200314,20235
20200311,7,내방,11910,12227,20200314,24137
20200311,7,이수,12898,12703,20200314,25601
20200311,7,남성,9145,8527,20200314,17672
20200311,7,숭실대입구,9384,9380,20200314,18764
20200311,7,상도,8229,8005,20200314,16234
20200311,7,장승배기,8092,7841,20200314,15933
20200311,7,신대방삼거리,13559,12994,20200314,26553
20200311,7,보라매,7816,7739,20200314,15555
20200311,7,신풍,8680,8345,20200314,17025
20200311,7,대림,5298,5098,20200314,10396
20200311,7,남구로,13449,14299,20200314,27748
20200311,7,가산디지털단지,38025,38549,20200314,76574
20200311,7,철산,17633,18037,20200314,35670
20200311,7,광명사거리,19230,18911,20200314,38141
20200311,7,천왕,8026,7517,20200314,15543
20200311,7,온수,8704,8206,20200314,16910
20200311,7,까치울,6031,5695,20200314,11726
20200311,7,부천종합운동장,3818,3233,20200314,7051
20200311,7,춘의,8341,8197,20200314,16538
20200311,7,신중동,11693,11698,20200314,23391
20200311,7,부천시청,9629,9695,20200314,19324
20200311,7,상동,10128,10627,20200314,20755
20200311,7,삼산체육관,3785,3311,20200314,7096
20200311,7,굴포천,7214,7571,20200314,14785
20200311,7,부평구청,9980,8115,20200314,18095
20200312,7,장암,1983,711,20200315,2694
20200312,7,도봉산,7550,8781,20200315,16331
20200312,7,수락산,10192,10342,20200315,20534
20200312,7,마들,9678,9275,20200315,18953
20200312,7,노원,14828,15812,20200315,30640
20200312,7,중계,11259,10035,20200315,21294
20200312,7,하계,13894,13064,20200315,26958
20200312,7,공릉,9421,9490,20200315,18911
20200312,7,태릉입구,6593,5976,20200315,12569
20200312,7,먹골,8547,8321,20200315,16868
20200312,7,중화,9154,8885,20200315,18039
20200312,7,상봉,13926,13195,20200315,27121
20200312,7,면목,12875,12447,20200315,25322
20200312,7,사가정,13026,13191,20200315,26217
20200312,7,용마산,5005,4734,20200315,9739
20200312,7,중곡,8072,7501,20200315,15573
20200312,7,군자,12185,9557,20200315,21742
20200312,7,어린이대공원,8964,8726,20200315,17690
20200312,7,건대입구,9340,9919,20200315,19259
20200312,7,뚝섬유원지,6943,6932,20200315,13875
20200312,7,청담,16275,18268,20200315,34543
20200312,7,강남구청,13383,14972,20200315,28355
20200312,7,학동,20917,22731,20200315,43648
20200312,7,논현,17550,19051,20200315,36601
20200312,7,반포,4561,4453,20200315,9014
20200312,7,고속터미널,10724,9590,20200315,20314
20200312,7,내방,11753,12062,20200315,23815
20200312,7,이수,12674,12341,20200315,25015
20200312,7,남성,9112,8516,20200315,17628
20200312,7,숭실대입구,9097,9091,20200315,18188
20200312,7,상도,8202,7911,20200315,16113
20200312,7,장승배기,8077,7857,20200315,15934
20200312,7,신대방삼거리,13403,12736,20200315,26139
20200312,7,보라매,7722,7651,20200315,15373
20200312,7,신풍,8566,8311,20200315,16877
20200312,7,대림,5036,4961,20200315,9997
20200312,7,남구로,13181,13880,20200315,27061
20200312,7,가산디지털단지,37443,38161,20200315,75604
20200312,7,철산,17329,17715,20200315,35044
20200312,7,광명사거리,18878,18645,20200315,37523
20200312,7,천왕,8025,7405,20200315,15430
20200312,7,온수,8673,8142,20200315,16815
20200312,7,까치울,5934,5655,20200315,11589
20200312,7,부천종합운동장,3773,3194,20200315,6967
20200312,7,춘의,8243,8111,20200315,16354
20200312,7,신중동,11598,11377,20200315,22975
20200312,7,부천시청,9487,9481,20200315,18968
20200312,7,상동,9862,10314,20200315,20176
20200312,7,삼산체육관,3691,3254,20200315,6945
20200312,7,굴포천,7067,7556,20200315,14623
20200312,7,부평구청,9921,7925,20200315,17846
20200313,7,장암,1939,719,20200316,2658
20200313,7,도봉산,7570,8560,20200316,16130
20200313,7,수락산,10435,10356,20200316,20791
20200313,7,마들,9977,9358,20200316,19335
20200313,7,노원,16046,16983,20200316,33029
20200313,7,중계,11621,9834,20200316,21455
20200313,7,하계,14047,12992,20200316,27039
20200313,7,공릉,9667,9813,20200316,19480
20200313,7,태릉입구,6546,5940,20200316,12486
20200313,7,먹골,8855,8379,20200316,17234
20200313,7,중화,9431,9001,20200316,18432
20200313,7,상봉,14339,13639,20200316,27978
20200313,7,면목,13201,12715,20200316,25916
20200313,7,사가정,13343,13474,20200316,26817
20200313,7,용마산,5110,4678,20200316,9788
20200313,7,중곡,8240,7627,20200316,15867
20200313,7,군자,12447,9756,20200316,22203
20200313,7,어린이대공원,9282,8992,20200316,18274
20200313,7,건대입구,10149,10843,20200316,20992
20200313,7,뚝섬유원지,6279,6251,20200316,12530
20200313,7,청담,16070,18344,20200316,34414
20200313,7,강남구청,13361,15218,20200316,28579
20200313,7,학동,20507,22469,20200316,42976
20200313,7,논현,17689,19699,20200316,37388
20200313,7,반포,4689,4525,20200316,9214
20200313,7,고속터미널,11504,10160,20200316,21664
20200313,7,내방,11927,12073,20200316,24000
20200313,7,이수,13320,13258,20200316,26578
20200313,7,남성,9147,8351,20200316,17498
20200313,7,숭실대입구,9454,9368,20200316,18822
20200313,7,상도,8513,8054,20200316,16567
20200313,7,장승배기,8215,7971,20200316,16186
20200313,7,신대방삼거리,13810,12867,20200316,26677
20200313,7,보라매,7876,7728,20200316,15604
20200313,7,신풍,8738,8402,20200316,17140
20200313,7,대림,5203,5215,20200316,10418
20200313,7,남구로,12920,13834,20200316,26754
20200313,7,가산디지털단지,37336,37364,20200316,74700
20200313,7,철산,17943,18596,20200316,36539
20200313,7,광명사거리,19478,19137,20200316,38615
20200313,7,천왕,8163,7350,20200316,15513
20200313,7,온수,8701,8063,20200316,16764
20200313,7,까치울,5977,5678,20200316,11655
20200313,7,부천종합운동장,3843,3231,20200316,7074
20200313,7,춘의,8163,8040,20200316,16203
20200313,7,신중동,11896,12031,20200316,23927
20200313,7,부천시청,9983,10088,20200316,20071
20200313,7,상동,10337,10862,20200316,21199
20200313,7,삼산체육관,3782,3178,20200316,6960
20200313,7,굴포천,7134,7684,20200316,14818
20200313,7,부평구청,9985,8036,20200316,18021
20200314,7,장암,1216,689,20200317,1905
20200314,7,도봉산,4723,6723,20200317,11446
20200314,7,수락산,7560,7496,20200317,15056
20200314,7,마들,6063,5637,20200317,11700
20200314,7,노원,10577,11288,20200317,21865
20200314,7,중계,6441,5770,20200317,12211
20200314,7,하계,8227,7741,20200317,15968
20200314,7,공릉,6443,6430,20200317,12873
20200314,7,태릉입구,4510,4024,20200317,8534
20200314,7,먹골,5786,5673,20200317,11459
20200314,7,중화,5998,5782,20200317,11780
20200314,7,상봉,10037,9453,20200317,19490
20200314,7,면목,8578,8311,20200317,16889
20200314,7,사가정,9139,8971,20200317,18110
20200314,7,용마산,3288,3183,20200317,6471
20200314,7,중곡,5139,4722,20200317,9861
20200314,7,군자,7819,5949,20200317,13768
20200314,7,어린이대공원,5973,5614,20200317,11587
20200314,7,건대입구,8027,8483,20200317,16510
20200314,7,뚝섬유원지,5303,5411,20200317,10714
20200314,7,청담,7916,8437,20200317,16353
20200314,7,강남구청,6972,7744,20200317,14716
20200314,7,학동,7083,7530,20200317,14613
20200314,7,논현,8615,9487,20200317,18102
20200314,7,반포,3126,2902,20200317,6028
20200314,7,고속터미널,7865,6540,20200317,14405
20200314,7,내방,5487,5502,20200317,10989
20200314,7,이수,8690,8396,20200317,17086
20200314,7,남성,5656,5241,20200317,10897
20200314,7,숭실대입구,5375,5144,20200317,10519
20200314,7,상도,5223,4774,20200317,9997
20200314,7,장승배기,5125,4854,20200317,9979
20200314,7,신대방삼거리,8201,7566,20200317,15767
20200314,7,보라매,4012,3816,20200317,7828
20200314,7,신풍,5392,5169,20200317,10561
20200314,7,대림,3851,3989,20200317,7840
20200314,7,남구로,5764,6010,20200317,11774
20200314,7,가산디지털단지,9322,8758,20200317,18080
20200314,7,철산,10313,10655,20200317,20968
20200314,7,광명사거리,12525,12402,20200317,24927
20200314,7,천왕,4257,3945,20200317,8202
20200314,7,온수,4153,4063,20200317,8216
20200314,7,까치울,3762,3652,20200317,7414
20200314,7,부천종합운동장,2218,1964,20200317,4182
20200314,7,춘의,3755,3582,20200317,7337
20200314,7,신중동,6868,6868,20200317,13736
20200314,7,부천시청,6294,6319,20200317,12613
20200314,7,상동,7003,7077,20200317,14080
20200314,7,삼산체육관,1995,1791,20200317,3786
20200314,7,굴포천,4453,4712,20200317,9165
20200314,7,부평구청,4943,4291,20200317,9234
20200315,7,장암,908,743,20200318,1651
20200315,7,도봉산,3584,5559,20200318,9143
20200315,7,수락산,6145,6156,20200318,12301
20200315,7,마들,3587,3446,20200318,7033
20200315,7,노원,6926,6988,20200318,13914
20200315,7,중계,4516,4059,20200318,8575
20200315,7,하계,6069,5602,20200318,11671
20200315,7,공릉,4319,4556,20200318,8875
20200315,7,태릉입구,3205,2747,20200318,5952
20200315,7,먹골,3662,3526,20200318,7188
20200315,7,중화,4093,3912,20200318,8005
20200315,7,상봉,6825,6363,20200318,13188
20200315,7,면목,5736,5579,20200318,11315
20200315,7,사가정,6271,6043,20200318,12314
20200315,7,용마산,2194,2464,20200318,4658
20200315,7,중곡,3386,3247,20200318,6633
20200315,7,군자,5149,4081,20200318,9230
20200315,7,어린이대공원,4158,4097,20200318,8255
20200315,7,건대입구,5898,5826,20200318,11724
20200315,7,뚝섬유원지,3741,3576,20200318,7317
20200315,7,청담,4284,4686,20200318,8970
20200315,7,강남구청,3676,3959,20200318,7635
20200315,7,학동,3793,4059,20200318,7852
20200315,7,논현,4435,4885,20200318,9320
20200315,7,반포,2044,2042,20200318,4086
20200315,7,고속터미널,6807,4726,20200318,11533
20200315,7,내방,3151,3181,20200318,6332
20200315,7,이수,5598,5424,20200318,11022
20200315,7,남성,3503,3529,20200318,7032
20200315,7,숭실대입구,3568,3862,20200318,7430
20200315,7,상도,3232,3273,20200318,6505
20200315,7,장승배기,3209,3132,20200318,6341
20200315,7,신대방삼거리,5238,5146,20200318,10384
20200315,7,보라매,2590,2589,20200318,5179
20200315,7,신풍,3507,3249,20200318,6756
20200315,7,대림,3026,2800,20200318,5826
20200315,7,남구로,3905,3728,20200318,7633
20200315,7,가산디지털단지,6046,5804,20200318,11850
20200315,7,철산,6615,6671,20200318,13286
20200315,7,광명사거리,8088,7827,20200318,15915
20200315,7,천왕,2635,2561,20200318,5196
20200315,7,온수,2638,2585,20200318,5223
20200315,7,까치울,2446,2387,20200318,4833
20200315,7,부천종합운동장,1418,1329,20200318,2747
20200315,7,춘의,2139,2012,20200318,4151
20200315,7,신중동,4258,4245,20200318,8503
20200315,7,부천시청,4178,4079,20200318,8257
20200315,7,상동,4371,4215,20200318,8586
20200315,7,삼산체육관,1376,1253,20200318,2629
20200315,7,굴포천,3046,2986,20200318,6032
20200315,7,부평구청,3210,2710,20200318,5920
20200316,7,장암,2099,700,20200319,2799
20200316,7,도봉산,7593,8757,20200319,16350
20200316,7,수락산,10267,10351,20200319,20618
20200316,7,마들,9747,9382,20200319,19129
20200316,7,노원,15900,16773,20200319,32673
20200316,7,중계,11459,10229,20200319,21688
20200316,7,하계,13966,13260,20200319,27226
20200316,7,공릉,9560,9757,20200319,19317
20200316,7,태릉입구,6500,5968,20200319,12468
20200316,7,먹골,8597,8460,20200319,17057
20200316,7,중화,9402,9202,20200319,18604
20200316,7,상봉,14248,13466,20200319,27714
20200316,7,면목,13076,12865,20200319,25941
20200316,7,사가정,13132,13406,20200319,26538
20200316,7,용마산,5142,4795,20200319,9937
20200316,7,중곡,8022,7714,20200319,15736
20200316,7,군자,12194,9748,20200319,21942
20200316,7,어린이대공원,9384,9328,20200319,18712
20200316,7,건대입구,9407,9935,20200319,19342
20200316,7,뚝섬유원지,5965,6042,20200319,12007
20200316,7,청담,16864,18778,20200319,35642
20200316,7,강남구청,13243,14918,20200319,28161
20200316,7,학동,21091,22492,20200319,43583
20200316,7,논현,17876,19400,20200319,37276
20200316,7,반포,4609,4583,20200319,9192
20200316,7,고속터미널,11548,9849,20200319,21397
20200316,7,내방,11964,12335,20200319,24299
20200316,7,이수,12822,12673,20200319,25495
20200316,7,남성,9128,8608,20200319,17736
20200316,7,숭실대입구,9357,9642,20200319,18999
20200316,7,상도,8392,8197,20200319,16589
20200316,7,장승배기,8257,8113,20200319,16370
20200316,7,신대방삼거리,13660,13203,20200319,26863
20200316,7,보라매,7862,7746,20200319,15608
20200316,7,신풍,8840,8504,20200319,17344
20200316,7,대림,5565,5415,20200319,10980
20200316,7,남구로,13567,14347,20200319,27914
20200316,7,가산디지털단지,39316,39417,20200319,78733
20200316,7,철산,17594,18141,20200319,35735
20200316,7,광명사거리,19402,19270,20200319,38672
20200316,7,천왕,8135,7559,20200319,15694
20200316,7,온수,8769,8171,20200319,16940
20200316,7,까치울,5969,5692,20200319,11661
20200316,7,부천종합운동장,3836,3203,20200319,7039
20200316,7,춘의,8220,8147,20200319,16367
20200316,7,신중동,11639,11704,20200319,23343
20200316,7,부천시청,9206,9006,20200319,18212
20200316,7,상동,10023,10213,20200319,20236
20200316,7,삼산체육관,3733,3336,20200319,7069
20200316,7,굴포천,7104,7420,20200319,14524
20200316,7,부평구청,9812,7987,20200319,17799
20200317,7,장암,2097,717,20200320,2814
20200317,7,도봉산,7455,8576,20200320,16031
20200317,7,수락산,10205,10245,20200320,20450
20200317,7,마들,9791,9388,20200320,19179
20200317,7,노원,15628,16686,20200320,32314
20200317,7,중계,11441,10214,20200320,21655
20200317,7,하계,14319,13599,20200320,27918
20200317,7,공릉,9549,9653,20200320,19202
20200317,7,태릉입구,6522,5958,20200320,12480
20200317,7,먹골,8617,8344,20200320,16961
20200317,7,중화,9428,9140,20200320,18568
20200317,7,상봉,14228,13332,20200320,27560
20200317,7,면목,13027,12781,20200320,25808
20200317,7,사가정,12959,13115,20200320,26074
20200317,7,용마산,5113,4792,20200320,9905
20200317,7,중곡,8070,7600,20200320,15670
20200317,7,군자,12151,9706,20200320,21857
20200317,7,어린이대공원,9189,9081,20200320,18270
20200317,7,건대입구,9411,10022,20200320,19433
20200317,7,뚝섬유원지,5994,6047,20200320,12041
20200317,7,청담,16945,18878,20200320,35823
20200317,7,강남구청,13588,15165,20200320,28753
20200317,7,학동,21415,22930,20200320,44345
20200317,7,논현,17951,19424,20200320,37375
20200317,7,반포,4609,4533,20200320,9142
20200317,7,고속터미널,11022,9798,20200320,20820
20200317,7,내방,11789,12233,20200320,24022
20200317,7,이수,12986,12557,20200320,25543
20200317,7,남성,9310,8619,20200320,17929
20200317,7,숭실대입구,9420,9551,20200320,18971
20200317,7,상도,8295,7962,20200320,16257
20200317,7,장승배기,8184,8014,20200320,16198
20200317,7,신대방삼거리,13583,13073,20200320,26656
20200317,7,보라매,7734,7746,20200320,15480
20200317,7,신풍,8835,8435,20200320,17270
20200317,7,대림,5380,5353,20200320,10733
20200317,7,남구로,13411,14112,20200320,27523
20200317,7,가산디지털단지,38864,39429,20200320,78293
20200317,7,철산,17727,18034,20200320,35761
20200317,7,광명사거리,19298,19066,20200320,38364
20200317,7,천왕,8045,7442,20200320,15487
20200317,7,온수,8795,8119,20200320,16914
20200317,7,까치울,6027,5670,20200320,11697
20200317,7,부천종합운동장,3679,3166,20200320,6845
20200317,7,춘의,8396,8179,20200320,16575
20200317,7,신중동,11514,11612,20200320,23126
20200317,7,부천시청,9740,9690,20200320,19430
20200317,7,상동,10049,10310,20200320,20359
20200317,7,삼산체육관,3748,3266,20200320,7014
20200317,7,굴포천,6947,7563,20200320,14510
20200317,7,부평구청,9849,7970,20200320,17819
20200318,7,장암,2172,794,20200321,2966
20200318,7,도봉산,7784,9377,20200321,17161
20200318,7,수락산,10711,10812,20200321,21523
20200318,7,마들,9955,9534,20200321,19489
20200318,7,노원,16043,16980,20200321,33023
20200318,7,중계,11622,10432,20200321,22054
20200318,7,하계,14513,13723,20200321,28236
20200318,7,공릉,9725,9828,20200321,19553
20200318,7,태릉입구,6688,6118,20200321,12806
20200318,7,먹골,8737,8493,20200321,17230
20200318,7,중화,9658,9332,20200321,18990
20200318,7,상봉,14607,13686,20200321,28293
20200318,7,면목,13403,13125,20200321,26528
20200318,7,사가정,13413,13368,20200321,26781
20200318,7,용마산,5223,4909,20200321,10132
20200318,7,중곡,8301,7751,20200321,16052
20200318,7,군자,12523,9969,20200321,22492
20200318,7,어린이대공원,9566,9484,20200321,19050
20200318,7,건대입구,9800,10393,20200321,20193
20200318,7,뚝섬유원지,8530,8638,20200321,17168
20200318,7,청담,17112,19006,20200321,36118
20200318,7,강남구청,13765,15392,20200321,29157
20200318,7,학동,21423,23205,20200321,44628
20200318,7,논현,17925,19623,20200321,37548
20200318,7,반포,4847,4722,20200321,9569
20200318,7,고속터미널,11196,9931,20200321,21127
20200318,7,내방,12179,12542,20200321,24721
20200318,7,이수,13187,12783,20200321,25970
20200318,7,남성,9397,8758,20200321,18155
20200318,7,숭실대입구,9741,9776,20200321,19517
20200318,7,상도,8573,8267,20200321,16840
20200318,7,장승배기,8342,8105,20200321,16447
20200318,7,신대방삼거리,13859,13390,20200321,27249
20200318,7,보라매,7996,8014,20200321,16010
20200318,7,신풍,8983,8539,20200321,17522
20200318,7,대림,5542,5499,20200321,11041
20200318,7,남구로,13618,14365,20200321,27983
20200318,7,가산디지털단지,38902,39567,20200321,78469
20200318,7,철산,18260,18882,20200321,37142
20200318,7,광명사거리,19810,19484,20200321,39294
20200318,7,천왕,8240,7605,20200321,15845
20200318,7,온수,8885,8245,20200321,17130
20200318,7,까치울,6236,5928,20200321,12164
20200318,7,부천종합운동장,3872,3407,20200321,7279
20200318,7,춘의,8463,8312,20200321,16775
20200318,7,신중동,12014,11963,20200321,23977
20200318,7,부천시청,9860,9862,20200321,19722
20200318,7,상동,10142,10409,20200321,20551
20200318,7,삼산체육관,3776,3399,20200321,7175
20200318,7,굴포천,7261,7641,20200321,14902
20200318,7,부평구청,9914,8088,20200321,18002
20200319,7,장암,1935,639,20200322,2574
20200319,7,도봉산,7312,8202,20200322,15514
20200319,7,수락산,9704,9993,20200322,19697
20200319,7,마들,9580,9224,20200322,18804
20200319,7,노원,15323,15888,20200322,31211
20200319,7,중계,11157,9898,20200322,21055
20200319,7,하계,13619,12991,20200322,26610
20200319,7,공릉,9214,9344,20200322,18558
20200319,7,태릉입구,6409,5850,20200322,12259
20200319,7,먹골,8472,8273,20200322,16745
20200319,7,중화,9128,8829,20200322,17957
20200319,7,상봉,13779,12902,20200322,26681
20200319,7,면목,12750,12497,20200322,25247
20200319,7,사가정,12755,12883,20200322,25638
20200319,7,용마산,5026,4715,20200322,9741
20200319,7,중곡,7986,7440,20200322,15426
20200319,7,군자,11997,9495,20200322,21492
20200319,7,어린이대공원,8977,8981,20200322,17958
20200319,7,건대입구,9617,9878,20200322,19495
20200319,7,뚝섬유원지,5408,5419,20200322,10827
20200319,7,청담,16572,18543,20200322,35115
20200319,7,강남구청,13585,15121,20200322,28706
20200319,7,학동,21003,22712,20200322,43715
20200319,7,논현,17214,19098,20200322,36312
20200319,7,반포,4478,4500,20200322,8978
20200319,7,고속터미널,10861,9486,20200322,20347
20200319,7,내방,11554,11900,20200322,23454
20200319,7,이수,12620,12285,20200322,24905
20200319,7,남성,8952,8344,20200322,17296
20200319,7,숭실대입구,9192,9223,20200322,18415
20200319,7,상도,8161,7833,20200322,15994
20200319,7,장승배기,7930,7744,20200322,15674
20200319,7,신대방삼거리,13384,12877,20200322,26261
20200319,7,보라매,7690,7636,20200322,15326
20200319,7,신풍,8764,8323,20200322,17087
20200319,7,대림,5392,5325,20200322,10717
20200319,7,남구로,13294,14086,20200322,27380
20200319,7,가산디지털단지,38483,38988,20200322,77471
20200319,7,철산,17400,17812,20200322,35212
20200319,7,광명사거리,19151,18938,20200322,38089
20200319,7,천왕,8069,7448,20200322,15517
20200319,7,온수,8577,7852,20200322,16429
20200319,7,까치울,5950,5543,20200322,11493
20200319,7,부천종합운동장,3619,3082,20200322,6701
20200319,7,춘의,8182,8127,20200322,16309
20200319,7,신중동,11398,11338,20200322,22736
20200319,7,부천시청,9662,9563,20200322,19225
20200319,7,상동,9874,10303,20200322,20177
20200319,7,삼산체육관,3703,3306,20200322,7009
20200319,7,굴포천,7063,7496,20200322,14559
20200319,7,부평구청,9692,8073,20200322,17765
20200320,7,장암,2100,796,20200323,2896
20200320,7,도봉산,7857,8979,20200323,16836
20200320,7,수락산,11057,10815,20200323,21872
20200320,7,마들,10439,9752,20200323,20191
20200320,7,노원,17065,18702,20200323,35767
20200320,7,중계,11897,10212,20200323,22109
20200320,7,하계,14873,13759,20200323,28632
20200320,7,공릉,10332,10368,20200323,20700
20200320,7,태릉입구,6976,6313,20200323,13289
20200320,7,먹골,9151,8847,20200323,17998
20200320,7,중화,10032,9572,20200323,19604
20200320,7,상봉,15147,14570,20200323,29717
20200320,7,면목,13788,13311,20200323,27099
20200320,7,사가정,14175,14132,20200323,28307
20200320,7,용마산,5370,4880,20200323,10250
20200320,7,중곡,8535,7849,20200323,16384
20200320,7,군자,12949,10122,20200323,23071
20200320,7,어린이대공원,10025,9642,20200323,19667
20200320,7,건대입구,10583,11570,20200323,22153
20200320,7,뚝섬유원지,7889,7865,20200323,15754
20200320,7,청담,17175,19269,20200323,36444
20200320,7,강남구청,14022,15821,20200323,29843
20200320,7,학동,20964,23021,20200323,43985
20200320,7,논현,18436,20536,20200323,38972
20200320,7,반포,4993,4789,20200323,9782
20200320,7,고속터미널,12314,10708,20200323,23022
20200320,7,내방,12140,12346,20200323,24486
20200320,7,이수,13730,13632,20200323,27362
20200320,7,남성,9582,8797,20200323,18379
20200320,7,숭실대입구,10074,9888,20200323,19962
20200320,7,상도,8761,8334,20200323,17095
20200320,7,장승배기,8566,8202,20200323,16768
20200320,7,신대방삼거리,14349,13384,20200323,27733
20200320,7,보라매,8061,7969,20200323,16030
20200320,7,신풍,9139,8645,20200323,17784
20200320,7,대림,5614,5675,20200323,11289
20200320,7,남구로,13496,14282,20200323,27778
20200320,7,가산디지털단지,38462,38761,20200323,77223
20200320,7,철산,18708,19301,20200323,38009
20200320,7,광명사거리,20474,20140,20200323,40614
20200320,7,천왕,8476,7691,20200323,16167
20200320,7,온수,9067,8209,20200323,17276
20200320,7,까치울,6294,5968,20200323,12262
20200320,7,부천종합운동장,3912,3342,20200323,7254
20200320,7,춘의,8419,8271,20200323,16690
20200320,7,신중동,12261,12607,20200323,24868
20200320,7,부천시청,10358,10434,20200323,20792
20200320,7,상동,10849,11123,20200323,21972
20200320,7,삼산체육관,3885,3414,20200323,7299
20200320,7,굴포천,7611,8069,20200323,15680
20200320,7,부평구청,10225,8200,20200323,18425
20200321,7,장암,1116,697,20200324,1813
20200321,7,도봉산,5121,7269,20200324,12390
20200321,7,수락산,7652,7549,20200324,15201
20200321,7,마들,6320,5879,20200324,12199
20200321,7,노원,11162,12063,20200324,23225
20200321,7,중계,6819,6076,20200324,12895
20200321,7,하계,8726,8098,20200324,16824
20200321,7,공릉,6517,6420,20200324,12937
20200321,7,태릉입구,4728,4129,20200324,8857
20200321,7,먹골,5898,5628,20200324,11526
20200321,7,중화,6241,5948,20200324,12189
20200321,7,상봉,10431,9916,20200324,20347
20200321,7,면목,8912,8393,20200324,17305
20200321,7,사가정,9625,9360,20200324,18985
20200321,7,용마산,3459,3518,20200324,6977
20200321,7,중곡,5411,4911,20200324,10322
20200321,7,군자,8236,6085,20200324,14321
20200321,7,어린이대공원,6342,6099,20200324,12441
20200321,7,건대입구,8529,8705,20200324,17234
20200321,7,뚝섬유원지,8689,9030,20200324,17719
20200321,7,청담,8071,8560,20200324,16631
20200321,7,강남구청,6993,7604,20200324,14597
20200321,7,학동,6966,7448,20200324,14414
20200321,7,논현,8897,9873,20200324,18770
20200321,7,반포,3374,3117,20200324,6491
20200321,7,고속터미널,8281,7097,20200324,15378
20200321,7,내방,5687,5608,20200324,11295
20200321,7,이수,8495,8225,20200324,16720
20200321,7,남성,5919,5397,20200324,11316
20200321,7,숭실대입구,5693,5498,20200324,11191
20200321,7,상도,5473,4955,20200324,10428
20200321,7,장승배기,5251,4881,20200324,10132
20200321,7,신대방삼거리,8454,7690,20200324,16144
20200321,7,보라매,4123,4025,20200324,8148
20200321,7,신풍,5751,5511,20200324,11262
20200321,7,대림,4252,4394,20200324,8646
20200321,7,남구로,6049,6315,20200324,12364
20200321,7,가산디지털단지,10154,9427,20200324,19581
20200321,7,철산,11211,11361,20200324,22572
20200321,7,광명사거리,13214,13237,20200324,26451
20200321,7,천왕,4472,4171,20200324,8643
20200321,7,온수,4401,4514,20200324,8915
20200321,7,까치울,3973,3794,20200324,7767
20200321,7,부천종합운동장,2419,2248,20200324,4667
20200321,7,춘의,3786,3600,20200324,7386
20200321,7,신중동,7144,7257,20200324,14401
20200321,7,부천시청,6544,6471,20200324,13015
20200321,7,상동,6883,7111,20200324,13994
20200321,7,삼산체육관,2159,1991,20200324,4150
20200321,7,굴포천,4565,4911,20200324,9476
20200321,7,부평구청,5175,4384,20200324,9559
20200322,7,장암,1181,868,20200325,2049
20200322,7,도봉산,4634,7113,20200325,11747
20200322,7,수락산,6539,6566,20200325,13105
20200322,7,마들,3861,3551,20200325,7412
20200322,7,노원,7722,7758,20200325,15480
20200322,7,중계,4790,4335,20200325,9125
20200322,7,하계,6466,5963,20200325,12429
20200322,7,공릉,4667,4810,20200325,9477
20200322,7,태릉입구,3520,3142,20200325,6662
20200322,7,먹골,3890,3815,20200325,7705
20200322,7,중화,4436,4224,20200325,8660
20200322,7,상봉,6860,6509,20200325,13369
20200322,7,면목,6171,6040,20200325,12211
20200322,7,사가정,6704,6457,20200325,13161
20200322,7,용마산,2429,2848,20200325,5277
20200322,7,중곡,3709,3491,20200325,7200
20200322,7,군자,5481,4198,20200325,9679
20200322,7,어린이대공원,4872,4921,20200325,9793
20200322,7,건대입구,6007,6304,20200325,12311
20200322,7,뚝섬유원지,9677,10162,20200325,19839
20200322,7,청담,4703,4979,20200325,9682
20200322,7,강남구청,3769,4155,20200325,7924
20200322,7,학동,3840,3960,20200325,7800
20200322,7,논현,4838,5087,20200325,9925
20200322,7,반포,1911,2020,20200325,3931
20200322,7,고속터미널,7331,5202,20200325,12533
20200322,7,내방,3410,3552,20200325,6962
20200322,7,이수,5614,5345,20200325,10959
20200322,7,남성,3721,3686,20200325,7407
20200322,7,숭실대입구,3768,4043,20200325,7811
20200322,7,상도,3523,3495,20200325,7018
20200322,7,장승배기,3508,3444,20200325,6952
20200322,7,신대방삼거리,5552,5485,20200325,11037
20200322,7,보라매,2708,2770,20200325,5478
20200322,7,신풍,3836,3501,20200325,7337
20200322,7,대림,3406,3106,20200325,6512
20200322,7,남구로,4497,4280,20200325,8777
20200322,7,가산디지털단지,6674,6529,20200325,13203
20200322,7,철산,7047,7154,20200325,14201
20200322,7,광명사거리,8973,8688,20200325,17661
20200322,7,천왕,2863,2724,20200325,5587
20200322,7,온수,2740,2838,20200325,5578
20200322,7,까치울,2789,2748,20200325,5537
20200322,7,부천종합운동장,1869,1813,20200325,3682
20200322,7,춘의,2334,2114,20200325,4448
20200322,7,신중동,4700,4560,20200325,9260
20200322,7,부천시청,4285,4295,20200325,8580
20200322,7,상동,4595,4234,20200325,8829
20200322,7,삼산체육관,1565,1382,20200325,2947
20200322,7,굴포천,3067,3032,20200325,6099
20200322,7,부평구청,3432,2919,20200325,6351
20200323,7,장암,2199,726,20200326,2925
20200323,7,도봉산,7830,9080,20200326,16910
20200323,7,수락산,10681,10711,20200326,21392
20200323,7,마들,9876,9417,20200326,19293
20200323,7,노원,16251,17308,20200326,33559
20200323,7,중계,11797,10633,20200326,22430
20200323,7,하계,14269,13435,20200326,27704
20200323,7,공릉,9537,9672,20200326,19209
20200323,7,태릉입구,6553,6165,20200326,12718
20200323,7,먹골,8727,8508,20200326,17235
20200323,7,중화,9527,9219,20200326,18746
20200323,7,상봉,14422,13641,20200326,28063
20200323,7,면목,13562,13184,20200326,26746
20200323,7,사가정,13315,13525,20200326,26840
20200323,7,용마산,5211,4959,20200326,10170
20200323,7,중곡,8379,7898,20200326,16277
20200323,7,군자,12385,9806,20200326,22191
20200323,7,어린이대공원,9419,9326,20200326,18745
20200323,7,건대입구,9477,10261,20200326,19738
20200323,7,뚝섬유원지,8894,9058,20200326,17952
20200323,7,청담,17272,19035,20200326,36307
20200323,7,강남구청,13295,14965,20200326,28260
20200323,7,학동,21619,23055,20200326,44674
20200323,7,논현,18086,19623,20200326,37709
20200323,7,반포,4700,4613,20200326,9313
20200323,7,고속터미널,11712,9870,20200326,21582
20200323,7,내방,12063,12290,20200326,24353
20200323,7,이수,12766,12322,20200326,25088
20200323,7,남성,9383,8833,20200326,18216
20200323,7,숭실대입구,9557,9866,20200326,19423
20200323,7,상도,8528,8324,20200326,16852
20200323,7,장승배기,8524,8275,20200326,16799
20200323,7,신대방삼거리,13940,13390,20200326,27330
20200323,7,보라매,8040,8074,20200326,16114
20200323,7,신풍,9176,8632,20200326,17808
20200323,7,대림,5926,5767,20200326,11693
20200323,7,남구로,14060,14832,20200326,28892
20200323,7,가산디지털단지,40533,41304,20200326,81837
20200323,7,철산,18415,18805,20200326,37220
20200323,7,광명사거리,20268,19777,20200326,40045
20200323,7,천왕,8383,7787,20200326,16170
20200323,7,온수,9006,8343,20200326,17349
20200323,7,까치울,6243,5868,20200326,12111
20200323,7,부천종합운동장,4113,3532,20200326,7645
20200323,7,춘의,8333,8317,20200326,16650
20200323,7,신중동,11884,11840,20200326,23724
20200323,7,부천시청,10123,9937,20200326,20060
20200323,7,상동,10161,10407,20200326,20568
20200323,7,삼산체육관,3953,3493,20200326,7446
20200323,7,굴포천,7311,7778,20200326,15089
20200323,7,부평구청,10000,8176,20200326,18176
20200324,7,장암,2183,778,20200327,2961
20200324,7,도봉산,7909,9216,20200327,17125
20200324,7,수락산,10672,10739,20200327,21411
20200324,7,마들,10029,9601,20200327,19630
20200324,7,노원,16196,17098,20200327,33294
20200324,7,중계,11744,10637,20200327,22381
20200324,7,하계,14905,14274,20200327,29179
20200324,7,공릉,9682,9943,20200327,19625
20200324,7,태릉입구,6673,6161,20200327,12834
20200324,7,먹골,8738,8453,20200327,17191
20200324,7,중화,9579,9377,20200327,18956
20200324,7,상봉,14676,13798,20200327,28474
20200324,7,면목,13201,12985,20200327,26186
20200324,7,사가정,13500,13449,20200327,26949
20200324,7,용마산,5240,5000,20200327,10240
20200324,7,중곡,8319,7721,20200327,16040
20200324,7,군자,12419,9746,20200327,22165
20200324,7,어린이대공원,9445,9315,20200327,18760
20200324,7,건대입구,9697,10481,20200327,20178
20200324,7,뚝섬유원지,9919,10110,20200327,20029
20200324,7,청담,17126,19002,20200327,36128
20200324,7,강남구청,13912,15532,20200327,29444
20200324,7,학동,21467,23279,20200327,44746
20200324,7,논현,18101,19650,20200327,37751
20200324,7,반포,4767,4767,20200327,9534
20200324,7,고속터미널,11186,9836,20200327,21022
20200324,7,내방,12173,12514,20200327,24687
20200324,7,이수,12966,12786,20200327,25752
20200324,7,남성,9401,8778,20200327,18179
20200324,7,숭실대입구,9666,9796,20200327,19462
20200324,7,상도,8533,8207,20200327,16740
20200324,7,장승배기,8366,8236,20200327,16602
20200324,7,신대방삼거리,14029,13443,20200327,27472
20200324,7,보라매,7877,7924,20200327,15801
20200324,7,신풍,9079,8644,20200327,17723
20200324,7,대림,5610,5511,20200327,11121
20200324,7,남구로,13822,14512,20200327,28334
20200324,7,가산디지털단지,40415,40976,20200327,81391
20200324,7,철산,18461,18718,20200327,37179
20200324,7,광명사거리,19929,19628,20200327,39557
20200324,7,천왕,8362,7825,20200327,16187
20200324,7,온수,8965,8329,20200327,17294
20200324,7,까치울,6318,6007,20200327,12325
20200324,7,부천종합운동장,4114,3687,20200327,7801
20200324,7,춘의,8387,8271,20200327,16658
20200324,7,신중동,12004,12060,20200327,24064
20200324,7,부천시청,9952,9924,20200327,19876
20200324,7,상동,10413,10700,20200327,21113
20200324,7,삼산체육관,3895,3414,20200327,7309
20200324,7,굴포천,7401,7860,20200327,15261
20200324,7,부평구청,10007,8108,20200327,18115
20200325,7,장암,2166,789,20200328,2955
20200325,7,도봉산,7969,9385,20200328,17354
20200325,7,수락산,10913,10887,20200328,21800
20200325,7,마들,10073,9602,20200328,19675
20200325,7,노원,16016,17255,20200328,33271
20200325,7,중계,11891,10559,20200328,22450
20200325,7,하계,14713,13993,20200328,28706
20200325,7,공릉,9940,10089,20200328,20029
20200325,7,태릉입구,6593,6314,20200328,12907
20200325,7,먹골,8792,8514,20200328,17306
20200325,7,중화,9658,9458,20200328,19116
20200325,7,상봉,14888,13883,20200328,28771
20200325,7,면목,13780,13420,20200328,27200
20200325,7,사가정,13627,13579,20200328,27206
20200325,7,용마산,5397,5096,20200328,10493
20200325,7,중곡,8516,7989,20200328,16505
20200325,7,군자,12619,9993,20200328,22612
20200325,7,어린이대공원,9798,9490,20200328,19288
20200325,7,건대입구,10164,10844,20200328,21008
20200325,7,뚝섬유원지,10348,10685,20200328,21033
20200325,7,청담,17446,19259,20200328,36705
20200325,7,강남구청,14112,15804,20200328,29916
20200325,7,학동,21544,23308,20200328,44852
20200325,7,논현,18228,19644,20200328,37872
20200325,7,반포,5004,4994,20200328,9998
20200325,7,고속터미널,11049,9852,20200328,20901
20200325,7,내방,12206,12444,20200328,24650
20200325,7,이수,13179,12936,20200328,26115
20200325,7,남성,9605,8882,20200328,18487
20200325,7,숭실대입구,9765,9774,20200328,19539
20200325,7,상도,8670,8377,20200328,17047
20200325,7,장승배기,8553,8361,20200328,16914
20200325,7,신대방삼거리,14150,13439,20200328,27589
20200325,7,보라매,7990,8112,20200328,16102
20200325,7,신풍,9276,8803,20200328,18079
20200325,7,대림,5725,5672,20200328,11397
20200325,7,남구로,13973,14764,20200328,28737
20200325,7,가산디지털단지,40183,40793,20200328,80976
20200325,7,철산,18672,19074,20200328,37746
20200325,7,광명사거리,20112,19884,20200328,39996
20200325,7,천왕,8559,7891,20200328,16450
20200325,7,온수,9016,8361,20200328,17377
20200325,7,까치울,6493,6119,20200328,12612
20200325,7,부천종합운동장,4349,3843,20200328,8192
20200325,7,춘의,8540,8331,20200328,16871
20200325,7,신중동,12215,12238,20200328,24453
20200325,7,부천시청,10128,10056,20200328,20184
20200325,7,상동,10356,10751,20200328,21107
20200325,7,삼산체육관,3898,3428,20200328,7326
20200325,7,굴포천,7419,7809,20200328,15228
20200325,7,부평구청,10226,8160,20200328,18386
20200326,7,장암,2114,811,20200329,2925
20200326,7,도봉산,7741,8822,20200329,16563
20200326,7,수락산,10447,10460,20200329,20907
20200326,7,마들,9885,9500,20200329,19385
20200326,7,노원,15757,16569,20200329,32326
20200326,7,중계,11487,10390,20200329,21877
20200326,7,하계,14210,13482,20200329,27692
20200326,7,공릉,9727,9706,20200329,19433
20200326,7,태릉입구,6591,5943,20200329,12534
20200326,7,먹골,8801,8672,20200329,17473
20200326,7,중화,9473,9086,20200329,18559
20200326,7,상봉,14334,13528,20200329,27862
20200326,7,면목,13288,12978,20200329,26266
20200326,7,사가정,13278,13185,20200329,26463
20200326,7,용마산,5152,4937,20200329,10089
20200326,7,중곡,8181,7647,20200329,15828
20200326,7,군자,12372,9877,20200329,22249
20200326,7,어린이대공원,9512,9189,20200329,18701
20200326,7,건대입구,9548,10110,20200329,19658
20200326,7,뚝섬유원지,6335,6319,20200329,12654
20200326,7,청담,16871,18947,20200329,35818
20200326,7,강남구청,13771,15595,20200329,29366
20200326,7,학동,21273,23175,20200329,44448
20200326,7,논현,17984,19598,20200329,37582
20200326,7,반포,4690,4591,20200329,9281
20200326,7,고속터미널,10971,9968,20200329,20939
20200326,7,내방,11780,12243,20200329,24023
20200326,7,이수,12935,12646,20200329,25581
20200326,7,남성,9317,8714,20200329,18031
20200326,7,숭실대입구,9528,9493,20200329,19021
20200326,7,상도,8581,8224,20200329,16805
20200326,7,장승배기,8497,8187,20200329,16684
20200326,7,신대방삼거리,13945,13398,20200329,27343
20200326,7,보라매,7900,7751,20200329,15651
20200326,7,신풍,9158,8729,20200329,17887
20200326,7,대림,5572,5533,20200329,11105
20200326,7,남구로,13702,14768,20200329,28470
20200326,7,가산디지털단지,39727,40374,20200329,80101
20200326,7,철산,18264,18674,20200329,36938
20200326,7,광명사거리,20050,19667,20200329,39717
20200326,7,천왕,8405,7689,20200329,16094
20200326,7,온수,9026,8278,20200329,17304
20200326,7,까치울,6204,5948,20200329,12152
20200326,7,부천종합운동장,4215,3728,20200329,7943
20200326,7,춘의,8342,8206,20200329,16548
20200326,7,신중동,11785,11810,20200329,23595
20200326,7,부천시청,9879,9756,20200329,19635
20200326,7,상동,10267,10527,20200329,20794
20200326,7,삼산체육관,3907,3434,20200329,7341
20200326,7,굴포천,7397,7690,20200329,15087
20200326,7,부평구청,9975,8116,20200329,18091
20200327,7,장암,2074,777,20200330,2851
20200327,7,도봉산,7735,8936,20200330,16671
20200327,7,수락산,10712,10505,20200330,21217
20200327,7,마들,10193,9548,20200330,19741
20200327,7,노원,16820,18427,20200330,35247
20200327,7,중계,11847,10323,20200330,22170
20200327,7,하계,14687,13557,20200330,28244
20200327,7,공릉,10155,10178,20200330,20333
20200327,7,태릉입구,6860,6271,20200330,13131
20200327,7,먹골,9082,8658,20200330,17740
20200327,7,중화,9734,9395,20200330,19129
20200327,7,상봉,15055,14468,20200330,29523
20200327,7,면목,13873,13043,20200330,26916
20200327,7,사가정,13553,13808,20200330,27361
20200327,7,용마산,5239,4781,20200330,10020
20200327,7,중곡,8410,7772,20200330,16182
20200327,7,군자,12899,10036,20200330,22935
20200327,7,어린이대공원,9646,9383,20200330,19029
20200327,7,건대입구,10526,11231,20200330,21757
20200327,7,뚝섬유원지,8474,8491,20200330,16965
20200327,7,청담,17066,19097,20200330,36163
20200327,7,강남구청,13942,15810,20200330,29752
20200327,7,학동,21381,23267,20200330,44648
20200327,7,논현,18313,20489,20200330,38802
20200327,7,반포,5045,4837,20200330,9882
20200327,7,고속터미널,12391,10944,20200330,23335
20200327,7,내방,12198,12447,20200330,24645
20200327,7,이수,13823,13595,20200330,27418
20200327,7,남성,9530,8687,20200330,18217
20200327,7,숭실대입구,9966,9870,20200330,19836
20200327,7,상도,8906,8325,20200330,17231
20200327,7,장승배기,8767,8217,20200330,16984
20200327,7,신대방삼거리,14397,13587,20200330,27984
20200327,7,보라매,8098,7858,20200330,15956
20200327,7,신풍,9318,8813,20200330,18131
20200327,7,대림,5826,5727,20200330,11553
20200327,7,남구로,13647,14485,20200330,28132
20200327,7,가산디지털단지,39771,39976,20200330,79747
20200327,7,철산,18856,19515,20200330,38371
20200327,7,광명사거리,20522,20096,20200330,40618
20200327,7,천왕,8505,7687,20200330,16192
20200327,7,온수,9052,8353,20200330,17405
20200327,7,까치울,6432,6052,20200330,12484
20200327,7,부천종합운동장,4041,3633,20200330,7674
20200327,7,춘의,8311,8058,20200330,16369
20200327,7,신중동,12449,12577,20200330,25026
20200327,7,부천시청,10301,10228,20200330,20529
20200327,7,상동,10663,11064,20200330,21727
20200327,7,삼산체육관,3949,3468,20200330,7417
20200327,7,굴포천,7516,8115,20200330,15631
20200327,7,부평구청,10186,8116,20200330,18302
20200328,7,장암,1238,841,20200331,2079
20200328,7,도봉산,5349,7506,20200331,12855
20200328,7,수락산,7984,8010,20200331,15994
20200328,7,마들,6471,5972,20200331,12443
20200328,7,노원,11687,12399,20200331,24086
20200328,7,중계,7028,6300,20200331,13328
20200328,7,하계,9007,8328,20200331,17335
20200328,7,공릉,6639,6644,20200331,13283
20200328,7,태릉입구,4714,4204,20200331,8918
20200328,7,먹골,6071,5766,20200331,11837
20200328,7,중화,6277,5978,20200331,12255
20200328,7,상봉,10674,10066,20200331,20740
20200328,7,면목,9101,8591,20200331,17692
20200328,7,사가정,9649,9414,20200331,19063
20200328,7,용마산,3504,3496,20200331,7000
20200328,7,중곡,5455,4913,20200331,10368
20200328,7,군자,8466,6291,20200331,14757
20200328,7,어린이대공원,6655,6556,20200331,13211
20200328,7,건대입구,8245,9000,20200331,17245
20200328,7,뚝섬유원지,9797,10283,20200331,20080
20200328,7,청담,8040,8572,20200331,16612
20200328,7,강남구청,6883,7531,20200331,14414
20200328,7,학동,7291,7603,20200331,14894
20200328,7,논현,8751,9818,20200331,18569
20200328,7,반포,3298,3183,20200331,6481
20200328,7,고속터미널,8410,7131,20200331,15541
20200328,7,내방,5562,5605,20200331,11167
20200328,7,이수,8633,8556,20200331,17189
20200328,7,남성,5873,5428,20200331,11301
20200328,7,숭실대입구,5798,5636,20200331,11434
20200328,7,상도,5455,4969,20200331,10424
20200328,7,장승배기,5435,5156,20200331,10591
20200328,7,신대방삼거리,8567,7885,20200331,16452
20200328,7,보라매,4261,4147,20200331,8408
20200328,7,신풍,5871,5581,20200331,11452
20200328,7,대림,4344,4480,20200331,8824
20200328,7,남구로,6231,6499,20200331,12730
20200328,7,가산디지털단지,10896,10064,20200331,20960
20200328,7,철산,11474,11805,20200331,23279
20200328,7,광명사거리,13345,13196,20200331,26541
20200328,7,천왕,4622,4296,20200331,8918
20200328,7,온수,4384,4257,20200331,8641
20200328,7,까치울,4012,3868,20200331,7880
20200328,7,부천종합운동장,2706,2559,20200331,5265
20200328,7,춘의,3787,3647,20200331,7434
20200328,7,신중동,7271,7158,20200331,14429
20200328,7,부천시청,6644,6545,20200331,13189
20200328,7,상동,7141,7092,20200331,14233
20200328,7,삼산체육관,2272,2061,20200331,4333
20200328,7,굴포천,4660,4945,20200331,9605
20200328,7,부평구청,5214,4597,20200331,9811
20200329,7,장암,1323,827,20200401,2150
20200329,7,도봉산,4622,6862,20200401,11484
20200329,7,수락산,6573,6658,20200401,13231
20200329,7,마들,3992,3595,20200401,7587
20200329,7,노원,7715,7959,20200401,15674
20200329,7,중계,4956,4409,20200401,9365
20200329,7,하계,6470,6101,20200401,12571
20200329,7,공릉,4866,4952,20200401,9818
20200329,7,태릉입구,3478,3188,20200401,6666
20200329,7,먹골,3970,3782,20200401,7752
20200329,7,중화,4392,4248,20200401,8640
20200329,7,상봉,7269,6923,20200401,14192
20200329,7,면목,6290,6109,20200401,12399
20200329,7,사가정,6911,6591,20200401,13502
20200329,7,용마산,2439,2790,20200401,5229
20200329,7,중곡,3793,3520,20200401,7313
20200329,7,군자,5589,4315,20200401,9904
20200329,7,어린이대공원,5101,5058,20200401,10159
20200329,7,건대입구,6369,6674,20200401,13043
20200329,7,뚝섬유원지,9956,10562,20200401,20518
20200329,7,청담,4277,4688,20200401,8965
20200329,7,강남구청,3858,4288,20200401,8146
20200329,7,학동,3898,4235,20200401,8133
20200329,7,논현,4706,5039,20200401,9745
20200329,7,반포,2128,2292,20200401,4420
20200329,7,고속터미널,7351,5155,20200401,12506
20200329,7,내방,3304,3576,20200401,6880
20200329,7,이수,5720,5421,20200401,11141
20200329,7,남성,3906,3780,20200401,7686
20200329,7,숭실대입구,3747,3998,20200401,7745
20200329,7,상도,3508,3562,20200401,7070
20200329,7,장승배기,3593,3601,20200401,7194
20200329,7,신대방삼거리,5585,5441,20200401,11026
20200329,7,보라매,2837,2887,20200401,5724
20200329,7,신풍,3787,3599,20200401,7386
20200329,7,대림,3626,3452,20200401,7078
20200329,7,남구로,4533,4263,20200401,8796
20200329,7,가산디지털단지,7096,6713,20200401,13809
20200329,7,철산,7401,7454,20200401,14855
20200329,7,광명사거리,9149,8799,20200401,17948
20200329,7,천왕,3052,2851,20200401,5903
20200329,7,온수,2780,2788,20200401,5568
20200329,7,까치울,2904,2707,20200401,5611
20200329,7,부천종합운동장,2098,2139,20200401,4237
20200329,7,춘의,2288,2200,20200401,4488
20200329,7,신중동,4590,4554,20200401,9144
20200329,7,부천시청,4444,4348,20200401,8792
20200329,7,상동,4792,4658,20200401,9450
20200329,7,삼산체육관,1538,1414,20200401,2952
20200329,7,굴포천,3260,3241,20200401,6501
20200329,7,부평구청,3538,2896,20200401,6434
20200330,7,장암,2219,777,20200402,2996
20200330,7,도봉산,7772,9106,20200402,16878
20200330,7,수락산,10764,10786,20200402,21550
20200330,7,마들,10001,9600,20200402,19601
20200330,7,노원,16200,17143,20200402,33343
20200330,7,중계,11948,10865,20200402,22813
20200330,7,하계,14256,13504,20200402,27760
20200330,7,공릉,9736,9911,20200402,19647
20200330,7,태릉입구,6577,6209,20200402,12786
20200330,7,먹골,8801,8476,20200402,17277
20200330,7,중화,9687,9422,20200402,19109
20200330,7,상봉,14525,13785,20200402,28310
20200330,7,면목,13541,13268,20200402,26809
20200330,7,사가정,13540,13681,20200402,27221
20200330,7,용마산,5248,5058,20200402,10306
20200330,7,중곡,8371,7875,20200402,16246
20200330,7,군자,12553,9937,20200402,22490
20200330,7,어린이대공원,9398,9607,20200402,19005
20200330,7,건대입구,9646,10253,20200402,19899
20200330,7,뚝섬유원지,9283,9550,20200402,18833
20200330,7,청담,17350,19205,20200402,36555
20200330,7,강남구청,13376,15190,20200402,28566
20200330,7,학동,21330,23037,20200402,44367
20200330,7,논현,18245,19689,20200402,37934
20200330,7,반포,4684,4668,20200402,9352
20200330,7,고속터미널,11957,10183,20200402,22140
20200330,7,내방,12110,12316,20200402,24426
20200330,7,이수,12960,12810,20200402,25770
20200330,7,남성,9422,8785,20200402,18207
20200330,7,숭실대입구,9605,9828,20200402,19433
20200330,7,상도,8544,8378,20200402,16922
20200330,7,장승배기,8543,8411,20200402,16954
20200330,7,신대방삼거리,14117,13636,20200402,27753
20200330,7,보라매,8087,8013,20200402,16100
20200330,7,신풍,9347,8765,20200402,18112
20200330,7,대림,5980,5799,20200402,11779
20200330,7,남구로,14118,14899,20200402,29017
20200330,7,가산디지털단지,41058,41789,20200402,82847
20200330,7,철산,18606,18891,20200402,37497
20200330,7,광명사거리,20372,20047,20200402,40419
20200330,7,천왕,8502,7963,20200402,16465
20200330,7,온수,9116,8471,20200402,17587
20200330,7,까치울,6354,5962,20200402,12316
20200330,7,부천종합운동장,4115,3638,20200402,7753
20200330,7,춘의,8358,8281,20200402,16639
20200330,7,신중동,12158,12133,20200402,24291
20200330,7,부천시청,9992,9706,20200402,19698
20200330,7,상동,10211,10536,20200402,20747
20200330,7,삼산체육관,3978,3493,20200402,7471
20200330,7,굴포천,7361,7784,20200402,15145
20200330,7,부평구청,10227,8278,20200402,18505
20200331,7,장암,2183,816,20200403,2999
20200331,7,도봉산,7887,9321,20200403,17208
20200331,7,수락산,10825,10966,20200403,21791
20200331,7,마들,10075,9545,20200403,19620
20200331,7,노원,16132,17242,20200403,33374
20200331,7,중계,12093,10807,20200403,22900
20200331,7,하계,14847,14061,20200403,28908
20200331,7,공릉,9847,9865,20200403,19712
20200331,7,태릉입구,6832,6210,20200403,13042
20200331,7,먹골,8857,8580,20200403,17437
20200331,7,중화,9700,9471,20200403,19171
20200331,7,상봉,14689,13669,20200403,28358
20200331,7,면목,13557,13253,20200403,26810
20200331,7,사가정,13631,13606,20200403,27237
20200331,7,용마산,5326,5070,20200403,10396
20200331,7,중곡,8398,7840,20200403,16238
20200331,7,군자,12708,10014,20200403,22722
20200331,7,어린이대공원,9656,9623,20200403,19279
20200331,7,건대입구,9774,10286,20200403,20060
20200331,7,뚝섬유원지,9354,9654,20200403,19008
20200331,7,청담,17438,19417,20200403,36855
20200331,7,강남구청,14146,15824,20200403,29970
20200331,7,학동,21505,23460,20200403,44965
20200331,7,논현,18429,19914,20200403,38343
20200331,7,반포,4730,4706,20200403,9436
20200331,7,고속터미널,11476,10085,20200403,21561
20200331,7,내방,12287,12566,20200403,24853
20200331,7,이수,13206,13032,20200403,26238
20200331,7,남성,9638,8925,20200403,18563
20200331,7,숭실대입구,9816,10017,20200403,19833
20200331,7,상도,8650,8414,20200403,17064
20200331,7,장승배기,8545,8231,20200403,16776
20200331,7,신대방삼거리,14019,13420,20200403,27439
20200331,7,보라매,8086,8079,20200403,16165
20200331,7,신풍,9232,8741,20200403,17973
20200331,7,대림,5821,5780,20200403,11601
20200331,7,남구로,13965,14811,20200403,28776
20200331,7,가산디지털단지,40731,41877,20200403,82608
20200331,7,철산,18550,18998,20200403,37548
20200331,7,광명사거리,20384,19908,20200403,40292
20200331,7,천왕,8480,7786,20200403,16266
20200331,7,온수,9146,8431,20200403,17577
20200331,7,까치울,6447,6050,20200403,12497
20200331,7,부천종합운동장,4146,3581,20200403,7727
20200331,7,춘의,8448,8357,20200403,16805
20200331,7,신중동,12146,12052,20200403,24198
20200331,7,부천시청,9950,9861,20200403,19811
20200331,7,상동,10338,10758,20200403,21096
20200331,7,삼산체육관,3975,3481,20200403,7456
20200331,7,굴포천,7533,7826,20200403,15359
20200331,7,부평구청,10277,8258,20200403,18535
20200401,7,장암,2157,747,20200404,2904
20200401,7,도봉산,7938,9363,20200404,17301
20200401,7,수락산,10571,10535,20200404,21106
20200401,7,마들,10159,9640,20200404,19799
20200401,7,노원,15964,17084,20200404,33048
20200401,7,중계,11908,10588,20200404,22496
20200401,7,하계,14824,14023,20200404,28847
20200401,7,공릉,9731,9746,20200404,19477
20200401,7,태릉입구,6892,6408,20200404,13300
20200401,7,먹골,8875,8625,20200404,17500
20200401,7,중화,9820,9509,20200404,19329
20200401,7,상봉,14889,13888,20200404,28777
20200401,7,면목,13736,13531,20200404,27267
20200401,7,사가정,13677,13548,20200404,27225
20200401,7,용마산,5329,4998,20200404,10327
20200401,7,중곡,8397,7830,20200404,16227
20200401,7,군자,12624,9842,20200404,22466
20200401,7,어린이대공원,9999,9876,20200404,19875
20200401,7,건대입구,10003,10927,20200404,20930
20200401,7,뚝섬유원지,9314,9577,20200404,18891
20200401,7,청담,17365,19465,20200404,36830
20200401,7,강남구청,14023,15710,20200404,29733
20200401,7,학동,21680,23279,20200404,44959
20200401,7,논현,18057,19670,20200404,37727
20200401,7,반포,4807,4819,20200404,9626
20200401,7,고속터미널,10929,9817,20200404,20746
20200401,7,내방,12278,12539,20200404,24817
20200401,7,이수,13700,13250,20200404,26950
20200401,7,남성,9576,8804,20200404,18380
20200401,7,숭실대입구,9942,9899,20200404,19841
20200401,7,상도,8698,8343,20200404,17041
20200401,7,장승배기,8554,8267,20200404,16821
20200401,7,신대방삼거리,14254,13687,20200404,27941
20200401,7,보라매,8190,8110,20200404,16300
20200401,7,신풍,9309,8899,20200404,18208
20200401,7,대림,5878,5784,20200404,11662
20200401,7,남구로,13971,14860,20200404,28831
20200401,7,가산디지털단지,40822,41379,20200404,82201
20200401,7,철산,18697,19176,20200404,37873
20200401,7,광명사거리,20506,20064,20200404,40570
20200401,7,천왕,8638,7925,20200404,16563
20200401,7,온수,9181,8547,20200404,17728
20200401,7,까치울,6421,6128,20200404,12549
20200401,7,부천종합운동장,4070,3540,20200404,7610
20200401,7,춘의,8517,8276,20200404,16793
20200401,7,신중동,12143,12142,20200404,24285
20200401,7,부천시청,10003,9872,20200404,19875
20200401,7,상동,10539,10827,20200404,21366
20200401,7,삼산체육관,3903,3498,20200404,7401
20200401,7,굴포천,7504,7905,20200404,15409
20200401,7,부평구청,10087,8157,20200404,18244
20200402,7,장암,2129,769,20200405,2898
20200402,7,도봉산,8004,9346,20200405,17350
20200402,7,수락산,10791,10745,20200405,21536
20200402,7,마들,10213,9650,20200405,19863
20200402,7,노원,15965,17177,20200405,33142
20200402,7,중계,11863,10681,20200405,22544
20200402,7,하계,15133,14190,20200405,29323
20200402,7,공릉,9795,9782,20200405,19577
20200402,7,태릉입구,6863,6385,20200405,13248
20200402,7,먹골,8951,8591,20200405,17542
20200402,7,중화,9642,9194,20200405,18836
20200402,7,상봉,14781,13745,20200405,28526
20200402,7,면목,13542,13095,20200405,26637
20200402,7,사가정,13577,13650,20200405,27227
20200402,7,용마산,5356,5039,20200405,10395
20200402,7,중곡,8433,7831,20200405,16264
20200402,7,군자,12495,9964,20200405,22459
20200402,7,어린이대공원,9672,9596,20200405,19268
20200402,7,건대입구,10116,11045,20200405,21161
20200402,7,뚝섬유원지,8806,9032,20200405,17838
20200402,7,청담,17360,19454,20200405,36814
20200402,7,강남구청,14088,15683,20200405,29771
20200402,7,학동,21292,23153,20200405,44445
20200402,7,논현,17795,19596,20200405,37391
20200402,7,반포,4780,4696,20200405,9476
20200402,7,고속터미널,11167,10090,20200405,21257
20200402,7,내방,12139,12489,20200405,24628
20200402,7,이수,13328,13085,20200405,26413
20200402,7,남성,9512,8745,20200405,18257
20200402,7,숭실대입구,9901,9976,20200405,19877
20200402,7,상도,8746,8396,20200405,17142
20200402,7,장승배기,8420,8165,20200405,16585
20200402,7,신대방삼거리,14250,13461,20200405,27711
20200402,7,보라매,8079,8140,20200405,16219
20200402,7,신풍,9367,8916,20200405,18283
20200402,7,대림,5683,5634,20200405,11317
20200402,7,남구로,13907,14780,20200405,28687
20200402,7,가산디지털단지,40599,41367,20200405,81966
20200402,7,철산,18653,19096,20200405,37749
20200402,7,광명사거리,20258,19688,20200405,39946
20200402,7,천왕,8555,8022,20200405,16577
20200402,7,온수,9129,8465,20200405,17594
20200402,7,까치울,6358,6000,20200405,12358
20200402,7,부천종합운동장,3932,3400,20200405,7332
20200402,7,춘의,8413,8331,20200405,16744
20200402,7,신중동,12190,12129,20200405,24319
20200402,7,부천시청,10125,9876,20200405,20001
20200402,7,상동,10471,10744,20200405,21215
20200402,7,삼산체육관,3962,3475,20200405,7437
20200402,7,굴포천,7405,7737,20200405,15142
20200402,7,부평구청,10087,8102,20200405,18189
20200403,7,장암,2143,795,20200406,2938
20200403,7,도봉산,7925,9186,20200406,17111
20200403,7,수락산,10886,10664,20200406,21550
20200403,7,마들,10506,9794,20200406,20300
20200403,7,노원,17081,18712,20200406,35793
20200403,7,중계,12212,10563,20200406,22775
20200403,7,하계,15015,14094,20200406,29109
20200403,7,공릉,10330,10300,20200406,20630
20200403,7,태릉입구,7059,6456,20200406,13515
20200403,7,먹골,9168,8670,20200406,17838
20200403,7,중화,9899,9472,20200406,19371
20200403,7,상봉,15435,14512,20200406,29947
20200403,7,면목,14057,13204,20200406,27261
20200403,7,사가정,14001,14131,20200406,28132
20200403,7,용마산,5487,5067,20200406,10554
20200403,7,중곡,8576,7924,20200406,16500
20200403,7,군자,12959,10029,20200406,22988
20200403,7,어린이대공원,10166,10173,20200406,20339
20200403,7,건대입구,10808,11758,20200406,22566
20200403,7,뚝섬유원지,9318,9364,20200406,18682
20200403,7,청담,17532,19559,20200406,37091
20200403,7,강남구청,14054,16130,20200406,30184
20200403,7,학동,21177,22969,20200406,44146
20200403,7,논현,18454,20565,20200406,39019
20200403,7,반포,5128,4802,20200406,9930
20200403,7,고속터미널,12836,11302,20200406,24138
20200403,7,내방,12219,12711,20200406,24930
20200403,7,이수,13844,13739,20200406,27583
20200403,7,남성,9762,8774,20200406,18536
20200403,7,숭실대입구,10365,10112,20200406,20477
20200403,7,상도,9060,8412,20200406,17472
20200403,7,장승배기,8886,8436,20200406,17322
20200403,7,신대방삼거리,14568,13625,20200406,28193
20200403,7,보라매,8431,8330,20200406,16761
20200403,7,신풍,9695,9086,20200406,18781
20200403,7,대림,5944,5938,20200406,11882
20200403,7,남구로,13849,14766,20200406,28615
20200403,7,가산디지털단지,40372,40668,20200406,81040
20200403,7,철산,19437,20183,20200406,39620
20200403,7,광명사거리,20836,20362,20200406,41198
20200403,7,천왕,8796,7968,20200406,16764
20200403,7,온수,9235,8432,20200406,17667
20200403,7,까치울,6596,6219,20200406,12815
20200403,7,부천종합운동장,3990,3406,20200406,7396
20200403,7,춘의,8584,8299,20200406,16883
20200403,7,신중동,12677,12808,20200406,25485
20200403,7,부천시청,10405,10423,20200406,20828
20200403,7,상동,11097,11415,20200406,22512
20200403,7,삼산체육관,4083,3519,20200406,7602
20200403,7,굴포천,7637,8047,20200406,15684
20200403,7,부평구청,10187,8234,20200406,18421
20200404,7,장암,1237,881,20200407,2118
20200404,7,도봉산,5255,7424,20200407,12679
20200404,7,수락산,8080,8087,20200407,16167
20200404,7,마들,6483,6018,20200407,12501
20200404,7,노원,11630,12354,20200407,23984
20200404,7,중계,7178,6284,20200407,13462
20200404,7,하계,9116,8576,20200407,17692
20200404,7,공릉,6795,6604,20200407,13399
20200404,7,태릉입구,4958,4334,20200407,9292
20200404,7,먹골,6035,5760,20200407,11795
20200404,7,중화,6384,6133,20200407,12517
20200404,7,상봉,10664,10105,20200407,20769
20200404,7,면목,9216,8720,20200407,17936
20200404,7,사가정,9712,9401,20200407,19113
20200404,7,용마산,3577,3552,20200407,7129
20200404,7,중곡,5396,4908,20200407,10304
20200404,7,군자,8592,6392,20200407,14984
20200404,7,어린이대공원,7350,7374,20200407,14724
20200404,7,건대입구,8854,9261,20200407,18115
20200404,7,뚝섬유원지,9509,9988,20200407,19497
20200404,7,청담,7825,8266,20200407,16091
20200404,7,강남구청,7068,7795,20200407,14863
20200404,7,학동,6862,7104,20200407,13966
20200404,7,논현,8657,9675,20200407,18332
20200404,7,반포,3465,3274,20200407,6739
20200404,7,고속터미널,8783,7279,20200407,16062
20200404,7,내방,5579,5515,20200407,11094
20200404,7,이수,8953,8516,20200407,17469
20200404,7,남성,5998,5520,20200407,11518
20200404,7,숭실대입구,5781,5723,20200407,11504
20200404,7,상도,5584,5154,20200407,10738
20200404,7,장승배기,5349,5021,20200407,10370
20200404,7,신대방삼거리,8786,8132,20200407,16918
20200404,7,보라매,4384,4308,20200407,8692
20200404,7,신풍,5963,5666,20200407,11629
20200404,7,대림,4660,4862,20200407,9522
20200404,7,남구로,6323,6675,20200407,12998
20200404,7,가산디지털단지,11207,10154,20200407,21361
20200404,7,철산,11649,11820,20200407,23469
20200404,7,광명사거리,13590,13576,20200407,27166
20200404,7,천왕,4677,4406,20200407,9083
20200404,7,온수,4411,4451,20200407,8862
20200404,7,까치울,4020,4036,20200407,8056
20200404,7,부천종합운동장,2550,2332,20200407,4882
20200404,7,춘의,3950,3801,20200407,7751
20200404,7,신중동,7455,7440,20200407,14895
20200404,7,부천시청,6977,6697,20200407,13674
20200404,7,상동,7227,7415,20200407,14642
20200404,7,삼산체육관,2309,2168,20200407,4477
20200404,7,굴포천,4688,4940,20200407,9628
20200404,7,부평구청,5337,4527,20200407,9864
20200405,7,남성,4035,4073,20200408,8108
20200405,7,장암,1107,897,20200408,2004
20200405,7,도봉산,4384,6545,20200408,10929
20200405,7,수락산,6550,6582,20200408,13132
20200405,7,마들,4106,3740,20200408,7846
20200405,7,노원,7891,8019,20200408,15910
20200405,7,중계,4992,4594,20200408,9586
20200405,7,하계,6692,6161,20200408,12853
20200405,7,공릉,4726,4800,20200408,9526
20200405,7,태릉입구,3448,3158,20200408,6606
20200405,7,먹골,4004,3965,20200408,7969
20200405,7,중화,4397,4209,20200408,8606
20200405,7,상봉,7385,7043,20200408,14428
20200405,7,면목,6174,6087,20200408,12261
20200405,7,사가정,6844,6476,20200408,13320
20200405,7,용마산,2578,2851,20200408,5429
20200405,7,중곡,3771,3607,20200408,7378
20200405,7,군자,5770,4433,20200408,10203
20200405,7,어린이대공원,5293,5612,20200408,10905
20200405,7,건대입구,6151,6401,20200408,12552
20200405,7,뚝섬유원지,6919,7108,20200408,14027
20200405,7,청담,4387,4770,20200408,9157
20200405,7,강남구청,3780,4204,20200408,7984
20200405,7,학동,3708,3968,20200408,7676
20200405,7,논현,4781,4982,20200408,9763
20200405,7,반포,2188,2258,20200408,4446
20200405,7,고속터미널,8053,5383,20200408,13436
20200405,7,내방,3361,3561,20200408,6922
20200405,7,이수,5925,5728,20200408,11653
20200405,7,숭실대입구,3884,4117,20200408,8001
20200405,7,상도,3511,3555,20200408,7066
20200405,7,장승배기,3563,3462,20200408,7025
20200405,7,신대방삼거리,5839,5668,20200408,11507
20200405,7,보라매,3295,3295,20200408,6590
20200405,7,신풍,3891,3641,20200408,7532
20200405,7,대림,3861,3629,20200408,7490
20200405,7,남구로,4522,4382,20200408,8904
20200405,7,가산디지털단지,7475,6988,20200408,14463
20200405,7,철산,7573,7670,20200408,15243
20200405,7,광명사거리,9284,8957,20200408,18241
20200405,7,천왕,3079,3005,20200408,6084
20200405,7,온수,2791,2814,20200408,5605
20200405,7,까치울,2926,2887,20200408,5813
20200405,7,부천종합운동장,1753,1669,20200408,3422
20200405,7,춘의,2453,2349,20200408,4802
20200405,7,신중동,4834,4764,20200408,9598
20200405,7,부천시청,4516,4351,20200408,8867
20200405,7,상동,4911,4706,20200408,9617
20200405,7,삼산체육관,1594,1479,20200408,3073
20200405,7,굴포천,3333,3294,20200408,6627
20200405,7,부평구청,3616,2969,20200408,6585
20200406,7,장암,2197,758,20200409,2955
20200406,7,도봉산,7990,9194,20200409,17184
20200406,7,수락산,11018,10910,20200409,21928
20200406,7,마들,10364,9886,20200409,20250
20200406,7,노원,16441,17443,20200409,33884
20200406,7,중계,12377,11021,20200409,23398
20200406,7,하계,14997,14206,20200409,29203
20200406,7,공릉,10094,10228,20200409,20322
20200406,7,태릉입구,6851,6505,20200409,13356
20200406,7,먹골,8995,8769,20200409,17764
20200406,7,중화,9796,9525,20200409,19321
20200406,7,상봉,14984,13930,20200409,28914
20200406,7,면목,13835,13518,20200409,27353
20200406,7,사가정,13860,13908,20200409,27768
20200406,7,용마산,5338,5069,20200409,10407
20200406,7,중곡,8463,7993,20200409,16456
20200406,7,군자,12741,10142,20200409,22883
20200406,7,어린이대공원,9954,9833,20200409,19787
20200406,7,건대입구,9771,10428,20200409,20199
20200406,7,뚝섬유원지,7505,7665,20200409,15170
20200406,7,청담,17790,19752,20200409,37542
20200406,7,강남구청,13823,15536,20200409,29359
20200406,7,학동,21980,23548,20200409,45528
20200406,7,논현,18764,20356,20200409,39120
20200406,7,반포,4889,4827,20200409,9716
20200406,7,고속터미널,12522,10595,20200409,23117
20200406,7,내방,12234,12698,20200409,24932
20200406,7,이수,13437,13119,20200409,26556
20200406,7,남성,9717,9171,20200409,18888
20200406,7,숭실대입구,9842,10068,20200409,19910
20200406,7,상도,8776,8634,20200409,17410
20200406,7,장승배기,8799,8631,20200409,17430
20200406,7,신대방삼거리,14490,13956,20200409,28446
20200406,7,보라매,8607,8624,20200409,17231
20200406,7,신풍,9581,9176,20200409,18757
20200406,7,대림,6287,6185,20200409,12472
20200406,7,남구로,14729,15330,20200409,30059
20200406,7,가산디지털단지,42532,43107,20200409,85639
20200406,7,철산,19268,19755,20200409,39023
20200406,7,광명사거리,20804,20311,20200409,41115
20200406,7,천왕,8846,8179,20200409,17025
20200406,7,온수,9303,8881,20200409,18184
20200406,7,까치울,6528,6220,20200409,12748
20200406,7,부천종합운동장,4014,3432,20200409,7446
20200406,7,춘의,8632,8523,20200409,17155
20200406,7,신중동,12658,12408,20200409,25066
20200406,7,부천시청,10370,10063,20200409,20433
20200406,7,상동,10625,10952,20200409,21577
20200406,7,삼산체육관,4105,3588,20200409,7693
20200406,7,굴포천,7625,8135,20200409,15760
20200406,7,부평구청,10510,8504,20200409,19014
20200407,7,장암,2201,713,20200410,2914
20200407,7,도봉산,8025,9344,20200410,17369
20200407,7,수락산,10994,10958,20200410,21952
20200407,7,마들,10407,9864,20200410,20271
20200407,7,노원,16195,17440,20200410,33635
20200407,7,중계,12377,11078,20200410,23455
20200407,7,하계,15294,14553,20200410,29847
20200407,7,공릉,10005,10047,20200410,20052
20200407,7,태릉입구,6993,6471,20200410,13464
20200407,7,먹골,8952,8765,20200410,17717
20200407,7,중화,9928,9566,20200410,19494
20200407,7,상봉,15011,14093,20200410,29104
20200407,7,면목,13810,13477,20200410,27287
20200407,7,사가정,13840,13947,20200410,27787
20200407,7,용마산,5361,5102,20200410,10463
20200407,7,중곡,8636,8036,20200410,16672
20200407,7,군자,13053,10382,20200410,23435
20200407,7,어린이대공원,9826,9627,20200410,19453
20200407,7,건대입구,9971,10606,20200410,20577
20200407,7,뚝섬유원지,7686,7740,20200410,15426
20200407,7,청담,18016,19939,20200410,37955
20200407,7,강남구청,14396,16050,20200410,30446
20200407,7,학동,22188,23958,20200410,46146
20200407,7,논현,18823,20421,20200410,39244
20200407,7,반포,4979,4929,20200410,9908
20200407,7,고속터미널,11835,10381,20200410,22216
20200407,7,내방,12679,12968,20200410,25647
20200407,7,이수,13819,13606,20200410,27425
20200407,7,남성,9859,9063,20200410,18922
20200407,7,숭실대입구,10079,10216,20200410,20295
20200407,7,상도,8954,8735,20200410,17689
20200407,7,장승배기,8736,8412,20200410,17148
20200407,7,신대방삼거리,14531,13876,20200410,28407
20200407,7,보라매,8459,8422,20200410,16881
20200407,7,신풍,9578,9179,20200410,18757
20200407,7,대림,6213,6073,20200410,12286
20200407,7,남구로,14507,15304,20200410,29811
20200407,7,가산디지털단지,42348,43243,20200410,85591
20200407,7,철산,19457,19858,20200410,39315
20200407,7,광명사거리,20713,20257,20200410,40970
20200407,7,천왕,8889,8272,20200410,17161
20200407,7,온수,9260,8797,20200410,18057
20200407,7,까치울,6651,6249,20200410,12900
20200407,7,부천종합운동장,4024,3584,20200410,7608
20200407,7,춘의,8635,8478,20200410,17113
20200407,7,신중동,12502,12510,20200410,25012
20200407,7,부천시청,10408,10190,20200410,20598
20200407,7,상동,10842,11280,20200410,22122
20200407,7,삼산체육관,4127,3697,20200410,7824
20200407,7,굴포천,7670,8039,20200410,15709
20200407,7,부평구청,10488,8420,20200410,18908
20200408,7,장암,2123,747,20200411,2870
20200408,7,도봉산,8061,9490,20200411,17551
20200408,7,수락산,11167,11030,20200411,22197
20200408,7,마들,10511,9999,20200411,20510
20200408,7,노원,16356,17506,20200411,33862
20200408,7,중계,12361,11005,20200411,23366
20200408,7,하계,15745,14998,20200411,30743
20200408,7,공릉,10129,10268,20200411,20397
20200408,7,태릉입구,6986,6488,20200411,13474
20200408,7,먹골,9114,8774,20200411,17888
20200408,7,중화,9938,9603,20200411,19541
20200408,7,상봉,15041,14094,20200411,29135
20200408,7,면목,13913,13627,20200411,27540
20200408,7,사가정,13815,13990,20200411,27805
20200408,7,용마산,5513,5128,20200411,10641
20200408,7,중곡,8525,7989,20200411,16514
20200408,7,군자,13044,10318,20200411,23362
20200408,7,어린이대공원,9771,9685,20200411,19456
20200408,7,건대입구,10183,10893,20200411,21076
20200408,7,뚝섬유원지,7549,7608,20200411,15157
20200408,7,청담,17758,20054,20200411,37812
20200408,7,강남구청,14618,16216,20200411,30834
20200408,7,학동,22253,23913,20200411,46166
20200408,7,논현,18789,20377,20200411,39166
20200408,7,반포,5004,4930,20200411,9934
20200408,7,고속터미널,11449,10368,20200411,21817
20200408,7,내방,12610,12825,20200411,25435
20200408,7,이수,13801,13398,20200411,27199
20200408,7,남성,9938,9185,20200411,19123
20200408,7,숭실대입구,10108,10395,20200411,20503
20200408,7,상도,9115,8709,20200411,17824
20200408,7,장승배기,8886,8696,20200411,17582
20200408,7,신대방삼거리,14685,14000,20200411,28685
20200408,7,보라매,8406,8451,20200411,16857
20200408,7,신풍,9668,9167,20200411,18835
20200408,7,대림,6128,5963,20200411,12091
20200408,7,남구로,14344,15234,20200411,29578
20200408,7,가산디지털단지,42737,43109,20200411,85846
20200408,7,철산,19560,20064,20200411,39624
20200408,7,광명사거리,20776,20349,20200411,41125
20200408,7,천왕,8904,8200,20200411,17104
20200408,7,온수,9319,8724,20200411,18043
20200408,7,까치울,6631,6332,20200411,12963
20200408,7,부천종합운동장,4023,3478,20200411,7501
20200408,7,춘의,8726,8537,20200411,17263
20200408,7,신중동,12754,12589,20200411,25343
20200408,7,부천시청,10436,10259,20200411,20695
20200408,7,상동,10969,11430,20200411,22399
20200408,7,삼산체육관,3978,3640,20200411,7618
20200408,7,굴포천,7679,8047,20200411,15726
20200408,7,부평구청,10537,8492,20200411,19029
20200409,7,남성,9763,9114,20200412,18877
20200409,7,장암,2201,773,20200412,2974
20200409,7,도봉산,8074,9483,20200412,17557
20200409,7,수락산,10958,11006,20200412,21964
20200409,7,마들,10518,10002,20200412,20520
20200409,7,노원,16420,17439,20200412,33859
20200409,7,중계,12287,11159,20200412,23446
20200409,7,하계,15382,14601,20200412,29983
20200409,7,공릉,10125,10049,20200412,20174
20200409,7,태릉입구,6934,6504,20200412,13438
20200409,7,먹골,9096,8772,20200412,17868
20200409,7,중화,9763,9397,20200412,19160
20200409,7,상봉,15145,14199,20200412,29344
20200409,7,면목,13859,13425,20200412,27284
20200409,7,사가정,13925,13970,20200412,27895
20200409,7,용마산,5449,5146,20200412,10595
20200409,7,중곡,8482,7937,20200412,16419
20200409,7,군자,13092,10300,20200412,23392
20200409,7,어린이대공원,9605,9494,20200412,19099
20200409,7,건대입구,10336,10888,20200412,21224
20200409,7,뚝섬유원지,7498,7516,20200412,15014
20200409,7,청담,17616,19802,20200412,37418
20200409,7,강남구청,14183,16102,20200412,30285
20200409,7,학동,22124,23760,20200412,45884
20200409,7,논현,18607,20177,20200412,38784
20200409,7,반포,4984,4925,20200412,9909
20200409,7,고속터미널,11541,10384,20200412,21925
20200409,7,내방,12528,12945,20200412,25473
20200409,7,이수,13728,13382,20200412,27110
20200409,7,숭실대입구,10217,10105,20200412,20322
20200409,7,상도,8967,8595,20200412,17562
20200409,7,장승배기,8763,8412,20200412,17175
20200409,7,신대방삼거리,14479,13916,20200412,28395
20200409,7,보라매,8461,8466,20200412,16927
20200409,7,신풍,9533,9158,20200412,18691
20200409,7,대림,6046,6078,20200412,12124
20200409,7,남구로,14404,15214,20200412,29618
20200409,7,가산디지털단지,42295,43157,20200412,85452
20200409,7,철산,19486,19831,20200412,39317
20200409,7,광명사거리,20759,20608,20200412,41367
20200409,7,천왕,8863,8152,20200412,17015
20200409,7,온수,9150,8647,20200412,17797
20200409,7,까치울,6584,6288,20200412,12872
20200409,7,부천종합운동장,3938,3471,20200412,7409
20200409,7,춘의,8591,8545,20200412,17136
20200409,7,신중동,12539,12436,20200412,24975
20200409,7,부천시청,10603,10379,20200412,20982
20200409,7,상동,10807,11138,20200412,21945
20200409,7,삼산체육관,4042,3568,20200412,7610
20200409,7,굴포천,7668,8051,20200412,15719
20200409,7,부평구청,10347,8392,20200412,18739
20200410,7,장암,2092,813,20200413,2905
20200410,7,도봉산,8261,9391,20200413,17652
20200410,7,수락산,11176,10988,20200413,22164
20200410,7,마들,10871,10034,20200413,20905
20200410,7,노원,17605,19259,20200413,36864
20200410,7,중계,12543,10883,20200413,23426
20200410,7,하계,15701,14532,20200413,30233
20200410,7,공릉,10642,10618,20200413,21260
20200410,7,태릉입구,7238,6726,20200413,13964
20200410,7,먹골,9284,8827,20200413,18111
20200410,7,중화,10323,9768,20200413,20091
20200410,7,상봉,15616,14863,20200413,30479
20200410,7,면목,14141,13606,20200413,27747
20200410,7,사가정,14350,14203,20200413,28553
20200410,7,용마산,5549,5018,20200413,10567
20200410,7,중곡,8763,7980,20200413,16743
20200410,7,군자,13490,10406,20200413,23896
20200410,7,어린이대공원,10263,9854,20200413,20117
20200410,7,건대입구,10761,11708,20200413,22469
20200410,7,뚝섬유원지,8042,8063,20200413,16105
20200410,7,청담,17770,20137,20200413,37907
20200410,7,강남구청,14531,16466,20200413,30997
20200410,7,학동,21862,23606,20200413,45468
20200410,7,논현,18753,21012,20200413,39765
20200410,7,반포,5322,5095,20200413,10417
20200410,7,고속터미널,13170,11657,20200413,24827
20200410,7,내방,12641,12919,20200413,25560
20200410,7,이수,14470,14348,20200413,28818
20200410,7,남성,10126,9067,20200413,19193
20200410,7,숭실대입구,10610,10532,20200413,21142
20200410,7,상도,9346,8871,20200413,18217
20200410,7,장승배기,9062,8567,20200413,17629
20200410,7,신대방삼거리,14968,14165,20200413,29133
20200410,7,보라매,8719,8569,20200413,17288
20200410,7,신풍,10004,9347,20200413,19351
20200410,7,대림,6171,6167,20200413,12338
20200410,7,남구로,14451,15189,20200413,29640
20200410,7,가산디지털단지,42002,42477,20200413,84479
20200410,7,철산,20203,21085,20200413,41288
20200410,7,광명사거리,21528,21231,20200413,42759
20200410,7,천왕,9177,8209,20200413,17386
20200410,7,온수,9443,8829,20200413,18272
20200410,7,까치울,6732,6339,20200413,13071
20200410,7,부천종합운동장,4183,3543,20200413,7726
20200410,7,춘의,8680,8442,20200413,17122
20200410,7,신중동,12882,12966,20200413,25848
20200410,7,부천시청,11026,10856,20200413,21882
20200410,7,상동,11474,11921,20200413,23395
20200410,7,삼산체육관,4157,3567,20200413,7724
20200410,7,굴포천,7856,8283,20200413,16139
20200410,7,부평구청,10692,8495,20200413,19187
20200411,7,장암,1382,915,20200414,2297
20200411,7,도봉산,5491,7826,20200414,13317
20200411,7,수락산,8743,8577,20200414,17320
20200411,7,마들,6683,6286,20200414,12969
20200411,7,노원,12358,13146,20200414,25504
20200411,7,중계,7391,6630,20200414,14021
20200411,7,하계,9945,9335,20200414,19280
20200411,7,공릉,7246,7171,20200414,14417
20200411,7,태릉입구,4998,4501,20200414,9499
20200411,7,먹골,6509,6263,20200414,12772
20200411,7,중화,6675,6324,20200414,12999
20200411,7,상봉,11084,10329,20200414,21413
20200411,7,면목,9727,9242,20200414,18969
20200411,7,사가정,10180,9841,20200414,20021
20200411,7,용마산,3597,3744,20200414,7341
20200411,7,중곡,5432,5133,20200414,10565
20200411,7,군자,8678,6462,20200414,15140
20200411,7,어린이대공원,7012,6789,20200414,13801
20200411,7,건대입구,8557,8979,20200414,17536
20200411,7,뚝섬유원지,7397,7735,20200414,15132
20200411,7,청담,8205,8444,20200414,16649
20200411,7,강남구청,7325,8033,20200414,15358
20200411,7,학동,7381,7852,20200414,15233
20200411,7,논현,9330,10314,20200414,19644
20200411,7,반포,3599,3325,20200414,6924
20200411,7,고속터미널,9291,7917,20200414,17208
20200411,7,내방,5988,5913,20200414,11901
20200411,7,이수,9569,9065,20200414,18634
20200411,7,남성,6271,5853,20200414,12124
20200411,7,숭실대입구,6356,6075,20200414,12431
20200411,7,상도,5571,5169,20200414,10740
20200411,7,장승배기,5764,5354,20200414,11118
20200411,7,신대방삼거리,9088,8440,20200414,17528
20200411,7,보라매,4593,4478,20200414,9071
20200411,7,신풍,6272,6018,20200414,12290
20200411,7,대림,5094,5247,20200414,10341
20200411,7,남구로,6560,6880,20200414,13440
20200411,7,가산디지털단지,11853,10881,20200414,22734
20200411,7,철산,12267,12503,20200414,24770
20200411,7,광명사거리,14178,14253,20200414,28431
20200411,7,천왕,4974,4691,20200414,9665
20200411,7,온수,4605,4474,20200414,9079
20200411,7,까치울,4293,4163,20200414,8456
20200411,7,부천종합운동장,2537,2327,20200414,4864
20200411,7,춘의,4128,3842,20200414,7970
20200411,7,신중동,7741,7694,20200414,15435
20200411,7,부천시청,7495,7353,20200414,14848
20200411,7,상동,7805,7992,20200414,15797
20200411,7,삼산체육관,2478,2317,20200414,4795
20200411,7,굴포천,4986,5256,20200414,10242
20200411,7,부평구청,5678,4778,20200414,10456
20200412,7,장암,1214,945,20200415,2159
20200412,7,도봉산,4455,6664,20200415,11119
20200412,7,수락산,7060,7147,20200415,14207
20200412,7,마들,4076,3793,20200415,7869
20200412,7,노원,8216,8233,20200415,16449
20200412,7,중계,5161,4722,20200415,9883
20200412,7,하계,7028,6578,20200415,13606
20200412,7,공릉,4870,4936,20200415,9806
20200412,7,태릉입구,3496,3173,20200415,6669
20200412,7,먹골,4132,4016,20200415,8148
20200412,7,중화,4598,4387,20200415,8985
20200412,7,상봉,7442,6728,20200415,14170
20200412,7,면목,6302,6277,20200415,12579
20200412,7,사가정,7161,6739,20200415,13900
20200412,7,용마산,2534,2800,20200415,5334
20200412,7,중곡,3930,3775,20200415,7705
20200412,7,군자,5869,4538,20200415,10407
20200412,7,어린이대공원,5059,4998,20200415,10057
20200412,7,건대입구,5862,6174,20200415,12036
20200412,7,뚝섬유원지,5342,5479,20200415,10821
20200412,7,청담,4630,4841,20200415,9471
20200412,7,강남구청,4149,4560,20200415,8709
20200412,7,학동,4294,4572,20200415,8866
20200412,7,논현,5078,5427,20200415,10505
20200412,7,반포,2067,2148,20200415,4215
20200412,7,고속터미널,8365,5688,20200415,14053
20200412,7,내방,3584,3718,20200415,7302
20200412,7,이수,6034,5718,20200415,11752
20200412,7,남성,4101,4096,20200415,8197
20200412,7,숭실대입구,4102,4461,20200415,8563
20200412,7,상도,3664,3622,20200415,7286
20200412,7,장승배기,3742,3710,20200415,7452
20200412,7,신대방삼거리,5946,5812,20200415,11758
20200412,7,보라매,3037,3071,20200415,6108
20200412,7,신풍,4147,3854,20200415,8001
20200412,7,대림,4157,3982,20200415,8139
20200412,7,남구로,4917,4718,20200415,9635
20200412,7,가산디지털단지,7984,7459,20200415,15443
20200412,7,철산,8082,7978,20200415,16060
20200412,7,광명사거리,9657,9338,20200415,18995
20200412,7,천왕,3227,3069,20200415,6296
20200412,7,온수,2975,2952,20200415,5927
20200412,7,까치울,3038,2988,20200415,6026
20200412,7,부천종합운동장,1735,1665,20200415,3400
20200412,7,춘의,2489,2378,20200415,4867
20200412,7,신중동,5006,4918,20200415,9924
20200412,7,부천시청,4547,4393,20200415,8940
20200412,7,상동,5080,4809,20200415,9889
20200412,7,삼산체육관,1675,1568,20200415,3243
20200412,7,굴포천,3328,3194,20200415,6522
20200412,7,부평구청,3623,3132,20200415,6755
20200413,7,장암,2262,792,20200416,3054
20200413,7,도봉산,8181,9493,20200416,17674
20200413,7,수락산,11223,11059,20200416,22282
20200413,7,마들,10730,10134,20200416,20864
20200413,7,노원,16789,18083,20200416,34872
20200413,7,중계,12619,11356,20200416,23975
20200413,7,하계,15568,14880,20200416,30448
20200413,7,공릉,10137,10184,20200416,20321
20200413,7,태릉입구,7022,6651,20200416,13673
20200413,7,먹골,9197,8776,20200416,17973
20200413,7,중화,10035,9773,20200416,19808
20200413,7,상봉,15131,14251,20200416,29382
20200413,7,면목,13832,13634,20200416,27466
20200413,7,사가정,14203,14279,20200416,28482
20200413,7,용마산,5420,5136,20200416,10556
20200413,7,중곡,8685,8139,20200416,16824
20200413,7,군자,12951,10398,20200416,23349
20200413,7,어린이대공원,9770,9626,20200416,19396
20200413,7,건대입구,10243,10704,20200416,20947
20200413,7,뚝섬유원지,7552,7661,20200416,15213
20200413,7,청담,17828,19889,20200416,37717
20200413,7,강남구청,13849,15477,20200416,29326
20200413,7,학동,21824,23700,20200416,45524
20200413,7,논현,19014,20446,20200416,39460
20200413,7,반포,5088,5013,20200416,10101
20200413,7,고속터미널,12915,10811,20200416,23726
20200413,7,내방,12668,13075,20200416,25743
20200413,7,이수,13823,13365,20200416,27188
20200413,7,남성,10004,9422,20200416,19426
20200413,7,숭실대입구,10530,10656,20200416,21186
20200413,7,상도,9120,8884,20200416,18004
20200413,7,장승배기,8906,8655,20200416,17561
20200413,7,신대방삼거리,14817,14425,20200416,29242
20200413,7,보라매,8750,8703,20200416,17453
20200413,7,신풍,9837,9353,20200416,19190
20200413,7,대림,6673,6456,20200416,13129
20200413,7,남구로,14923,15728,20200416,30651
20200413,7,가산디지털단지,43735,44368,20200416,88103
20200413,7,철산,19512,20052,20200416,39564
20200413,7,광명사거리,21226,20704,20200416,41930
20200413,7,천왕,9149,8477,20200416,17626
20200413,7,온수,9470,8835,20200416,18305
20200413,7,까치울,6685,6347,20200416,13032
20200413,7,부천종합운동장,4043,3465,20200416,7508
20200413,7,춘의,8739,8602,20200416,17341
20200413,7,신중동,12883,12785,20200416,25668
20200413,7,부천시청,10586,10350,20200416,20936
20200413,7,상동,10888,11246,20200416,22134
20200413,7,삼산체육관,4125,3562,20200416,7687
20200413,7,굴포천,7763,8205,20200416,15968
20200413,7,부평구청,10687,8576,20200416,19263
20200414,7,장암,2292,827,20200417,3119
20200414,7,도봉산,9197,10532,20200417,19729
20200414,7,수락산,11630,11247,20200417,22877
20200414,7,마들,10847,9954,20200417,20801
20200414,7,노원,17423,19027,20200417,36450
20200414,7,중계,12990,11190,20200417,24180
20200414,7,하계,15938,14604,20200417,30542
20200414,7,공릉,10599,10576,20200417,21175
20200414,7,태릉입구,7312,6803,20200417,14115
20200414,7,먹골,9465,9049,20200417,18514
20200414,7,중화,10575,10025,20200417,20600
20200414,7,상봉,15815,14898,20200417,30713
20200414,7,면목,14277,13372,20200417,27649
20200414,7,사가정,14589,14603,20200417,29192
20200414,7,용마산,5545,5014,20200417,10559
20200414,7,중곡,8846,7992,20200417,16838
20200414,7,군자,13595,10540,20200417,24135
20200414,7,어린이대공원,9940,9904,20200417,19844
20200414,7,건대입구,10688,11510,20200417,22198
20200414,7,뚝섬유원지,8047,8100,20200417,16147
20200414,7,청담,17956,20480,20200417,38436
20200414,7,강남구청,14551,16558,20200417,31109
20200414,7,학동,21908,24212,20200417,46120
20200414,7,논현,19140,21829,20200417,40969
20200414,7,반포,5341,5129,20200417,10470
20200414,7,고속터미널,12767,11443,20200417,24210
20200414,7,내방,12982,13502,20200417,26484
20200414,7,이수,14685,14621,20200417,29306
20200414,7,남성,10332,9328,20200417,19660
20200414,7,숭실대입구,10976,10686,20200417,21662
20200414,7,상도,9474,8908,20200417,18382
20200414,7,장승배기,9271,8818,20200417,18089
20200414,7,신대방삼거리,15145,14309,20200417,29454
20200414,7,보라매,8863,8770,20200417,17633
20200414,7,신풍,10214,9587,20200417,19801
20200414,7,대림,6663,6551,20200417,13214
20200414,7,남구로,14660,15926,20200417,30586
20200414,7,가산디지털단지,44139,47075,20200417,91214
20200414,7,철산,20542,21118,20200417,41660
20200414,7,광명사거리,21953,21112,20200417,43065
20200414,7,천왕,9405,8427,20200417,17832
20200414,7,온수,11644,9686,20200417,21330
20200414,7,까치울,7082,6537,20200417,13619
20200414,7,부천종합운동장,4362,3600,20200417,7962
20200414,7,춘의,9094,8576,20200417,17670
20200414,7,신중동,13558,13491,20200417,27049
20200414,7,부천시청,11322,11053,20200417,22375
20200414,7,상동,11651,12060,20200417,23711
20200414,7,삼산체육관,4321,3750,20200417,8071
20200414,7,굴포천,8138,8455,20200417,16593
20200414,7,부평구청,11190,8909,20200417,20099
20200415,7,장암,1229,789,20200418,2018
20200415,7,도봉산,5159,7120,20200418,12279
20200415,7,수락산,7324,7361,20200418,14685
20200415,7,마들,5725,5511,20200418,11236
20200415,7,노원,10334,11010,20200418,21344
20200415,7,중계,6684,6024,20200418,12708
20200415,7,하계,8579,8218,20200418,16797
20200415,7,공릉,6395,6379,20200418,12774
20200415,7,태릉입구,4570,4160,20200418,8730
20200415,7,먹골,5505,5365,20200418,10870
20200415,7,중화,6205,5875,20200418,12080
20200415,7,상봉,9643,9265,20200418,18908
20200415,7,면목,8671,8514,20200418,17185
20200415,7,사가정,9047,8752,20200418,17799
20200415,7,용마산,3407,3486,20200418,6893
20200415,7,중곡,4923,4743,20200418,9666
20200415,7,군자,7895,6164,20200418,14059
20200415,7,어린이대공원,6209,6118,20200418,12327
20200415,7,건대입구,7368,7589,20200418,14957
20200415,7,뚝섬유원지,7673,7891,20200418,15564
20200415,7,청담,7119,7535,20200418,14654
20200415,7,강남구청,6016,6672,20200418,12688
20200415,7,학동,6192,6446,20200418,12638
20200415,7,논현,7722,8139,20200418,15861
20200415,7,반포,2997,2927,20200418,5924
20200415,7,고속터미널,6930,5722,20200418,12652
20200415,7,내방,5266,5429,20200418,10695
20200415,7,이수,8202,7715,20200418,15917
20200415,7,남성,5478,5336,20200418,10814
20200415,7,숭실대입구,5468,5574,20200418,11042
20200415,7,상도,4972,4808,20200418,9780
20200415,7,장승배기,5198,4980,20200418,10178
20200415,7,신대방삼거리,7855,7587,20200418,15442
20200415,7,보라매,4061,4000,20200418,8061
20200415,7,신풍,5589,5338,20200418,10927
20200415,7,대림,4843,4754,20200418,9597
20200415,7,남구로,6345,6364,20200418,12709
20200415,7,가산디지털단지,11715,11210,20200418,22925
20200415,7,철산,10496,10661,20200418,21157
20200415,7,광명사거리,13031,12884,20200418,25915
20200415,7,천왕,4460,4367,20200418,8827
20200415,7,온수,4323,4287,20200418,8610
20200415,7,까치울,3942,3888,20200418,7830
20200415,7,부천종합운동장,2396,2176,20200418,4572
20200415,7,춘의,4489,4366,20200418,8855
20200415,7,신중동,6565,6605,20200418,13170
20200415,7,부천시청,6177,6071,20200418,12248
20200415,7,상동,6532,6535,20200418,13067
20200415,7,삼산체육관,2152,2101,20200418,4253
20200415,7,굴포천,4455,4500,20200418,8955
20200415,7,부평구청,4869,4247,20200418,9116
20200416,7,장암,2204,835,20200419,3039
20200416,7,도봉산,8192,9681,20200419,17873
20200416,7,수락산,11459,11332,20200419,22791
20200416,7,마들,10694,10114,20200419,20808
20200416,7,노원,17056,18272,20200419,35328
20200416,7,중계,12737,11188,20200419,23925
20200416,7,하계,15738,14800,20200419,30538
20200416,7,공릉,10584,10644,20200419,21228
20200416,7,태릉입구,7046,6736,20200419,13782
20200416,7,먹골,9305,8954,20200419,18259
20200416,7,중화,9989,9635,20200419,19624
20200416,7,상봉,15355,14137,20200419,29492
20200416,7,면목,14105,13781,20200419,27886
20200416,7,사가정,14137,14154,20200419,28291
20200416,7,용마산,5514,5160,20200419,10674
20200416,7,중곡,8624,8016,20200419,16640
20200416,7,군자,13120,10457,20200419,23577
20200416,7,어린이대공원,10041,9799,20200419,19840
20200416,7,건대입구,10235,10906,20200419,21141
20200416,7,뚝섬유원지,8190,8196,20200419,16386
20200416,7,청담,18163,20286,20200419,38449
20200416,7,강남구청,14563,16372,20200419,30935
20200416,7,학동,22223,24176,20200419,46399
20200416,7,논현,18975,20973,20200419,39948
20200416,7,반포,5168,5079,20200419,10247
20200416,7,고속터미널,12233,10876,20200419,23109
20200416,7,내방,12897,13285,20200419,26182
20200416,7,이수,14027,13817,20200419,27844
20200416,7,남성,9996,9331,20200419,19327
20200416,7,숭실대입구,10630,10821,20200419,21451
20200416,7,상도,9245,8937,20200419,18182
20200416,7,장승배기,8767,8539,20200419,17306
20200416,7,신대방삼거리,14933,14237,20200419,29170
20200416,7,보라매,8545,8596,20200419,17141
20200416,7,신풍,10041,9421,20200419,19462
20200416,7,대림,6478,6303,20200419,12781
20200416,7,남구로,14634,15700,20200419,30334
20200416,7,가산디지털단지,43270,44168,20200419,87438
20200416,7,철산,19740,20180,20200419,39920
20200416,7,광명사거리,21545,21129,20200419,42674
20200416,7,천왕,9197,8503,20200419,17700
20200416,7,온수,9578,8882,20200419,18460
20200416,7,까치울,6836,6455,20200419,13291
20200416,7,부천종합운동장,4118,3524,20200419,7642
20200416,7,춘의,8748,8643,20200419,17391
20200416,7,신중동,12930,12821,20200419,25751
20200416,7,부천시청,10839,10636,20200419,21475
20200416,7,상동,11230,11655,20200419,22885
20200416,7,삼산체육관,4241,3667,20200419,7908
20200416,7,굴포천,7791,8155,20200419,15946
20200416,7,부평구청,10764,8626,20200419,19390
20200417,7,장암,2115,736,20200420,2851
20200417,7,도봉산,7710,8598,20200420,16308
20200417,7,수락산,10846,10495,20200420,21341
20200417,7,마들,10732,9892,20200420,20624
20200417,7,노원,17426,18805,20200420,36231
20200417,7,중계,12469,10802,20200420,23271
20200417,7,하계,15476,14317,20200420,29793
20200417,7,공릉,10442,10337,20200420,20779
20200417,7,태릉입구,7078,6540,20200420,13618
20200417,7,먹골,9277,8883,20200420,18160
20200417,7,중화,10003,9500,20200420,19503
20200417,7,상봉,15304,14488,20200420,29792
20200417,7,면목,13973,13364,20200420,27337
20200417,7,사가정,13971,13971,20200420,27942
20200417,7,용마산,5504,4860,20200420,10364
20200417,7,중곡,8678,7912,20200420,16590
20200417,7,군자,13233,10335,20200420,23568
20200417,7,어린이대공원,9667,9343,20200420,19010
20200417,7,건대입구,10443,11451,20200420,21894
20200417,7,뚝섬유원지,6129,5943,20200420,12072
20200417,7,청담,17756,20008,20200420,37764
20200417,7,강남구청,14473,16196,20200420,30669
20200417,7,학동,21895,23977,20200420,45872
20200417,7,논현,18973,21208,20200420,40181
20200417,7,반포,5350,5069,20200420,10419
20200417,7,고속터미널,13841,11844,20200420,25685
20200417,7,내방,12745,13087,20200420,25832
20200417,7,이수,14263,14363,20200420,28626
20200417,7,남성,9876,8876,20200420,18752
20200417,7,숭실대입구,10696,10461,20200420,21157
20200417,7,상도,9255,8755,20200420,18010
20200417,7,장승배기,9005,8442,20200420,17447
20200417,7,신대방삼거리,15013,14117,20200420,29130
20200417,7,보라매,8572,8337,20200420,16909
20200417,7,신풍,9796,9265,20200420,19061
20200417,7,대림,6295,6233,20200420,12528
20200417,7,남구로,14575,15313,20200420,29888
20200417,7,가산디지털단지,43246,43797,20200420,87043
20200417,7,철산,19799,20657,20200420,40456
20200417,7,광명사거리,21417,21065,20200420,42482
20200417,7,천왕,9011,8145,20200420,17156
20200417,7,온수,9522,8777,20200420,18299
20200417,7,까치울,6626,6206,20200420,12832
20200417,7,부천종합운동장,3876,3284,20200420,7160
20200417,7,춘의,8588,8276,20200420,16864
20200417,7,신중동,12767,13190,20200420,25957
20200417,7,부천시청,10750,10521,20200420,21271
20200417,7,상동,11370,11984,20200420,23354
20200417,7,삼산체육관,4095,3478,20200420,7573
20200417,7,굴포천,7889,8266,20200420,16155
20200417,7,부평구청,10651,8361,20200420,19012
20200418,7,장암,1478,1070,20200421,2548
20200418,7,도봉산,6221,8815,20200421,15036
20200418,7,수락산,9182,9068,20200421,18250
20200418,7,마들,7209,6709,20200421,13918
20200418,7,노원,12912,13954,20200421,26866
20200418,7,중계,8117,6905,20200421,15022
20200418,7,하계,10168,9123,20200421,19291
20200418,7,공릉,7456,7434,20200421,14890
20200418,7,태릉입구,5360,4734,20200421,10094
20200418,7,먹골,6667,6270,20200421,12937
20200418,7,중화,7018,6611,20200421,13629
20200418,7,상봉,11644,11145,20200421,22789
20200418,7,면목,9750,9352,20200421,19102
20200418,7,사가정,10675,10333,20200421,21008
20200418,7,용마산,3847,3763,20200421,7610
20200418,7,중곡,6028,5406,20200421,11434
20200418,7,군자,9079,6756,20200421,15835
20200418,7,어린이대공원,7608,7482,20200421,15090
20200418,7,건대입구,9536,10085,20200421,19621
20200418,7,뚝섬유원지,9947,10348,20200421,20295
20200418,7,청담,8934,9435,20200421,18369
20200418,7,강남구청,8116,8901,20200421,17017
20200418,7,학동,8070,8697,20200421,16767
20200418,7,논현,9681,10574,20200421,20255
20200418,7,반포,3849,3583,20200421,7432
20200418,7,고속터미널,10261,8692,20200421,18953
20200418,7,내방,6357,6248,20200421,12605
20200418,7,이수,10120,9714,20200421,19834
20200418,7,남성,6641,6035,20200421,12676
20200418,7,숭실대입구,6636,6438,20200421,13074
20200418,7,상도,6187,5625,20200421,11812
20200418,7,장승배기,5941,5579,20200421,11520
20200418,7,신대방삼거리,9466,8669,20200421,18135
20200418,7,보라매,4749,4612,20200421,9361
20200418,7,신풍,6520,6280,20200421,12800
20200418,7,대림,5407,5697,20200421,11104
20200418,7,남구로,7071,7287,20200421,14358
20200418,7,가산디지털단지,12698,11813,20200421,24511
20200418,7,철산,13306,13652,20200421,26958
20200418,7,광명사거리,15304,15241,20200421,30545
20200418,7,천왕,5356,4934,20200421,10290
20200418,7,온수,5037,4935,20200421,9972
20200418,7,까치울,4766,4578,20200421,9344
20200418,7,부천종합운동장,2790,2475,20200421,5265
20200418,7,춘의,4173,3957,20200421,8130
20200418,7,신중동,8395,8343,20200421,16738
20200418,7,부천시청,7522,7285,20200421,14807
20200418,7,상동,8462,8651,20200421,17113
20200418,7,삼산체육관,2691,2435,20200421,5126
20200418,7,굴포천,5405,5419,20200421,10824
20200418,7,부평구청,5921,5105,20200421,11026
20200419,7,장암,1201,839,20200422,2040
20200419,7,도봉산,4406,6530,20200422,10936
20200419,7,수락산,6741,6866,20200422,13607
20200419,7,마들,4116,3946,20200422,8062
20200419,7,노원,8509,8279,20200422,16788
20200419,7,중계,5178,4868,20200422,10046
20200419,7,하계,6705,6302,20200422,13007
20200419,7,공릉,4773,4825,20200422,9598
20200419,7,태릉입구,3542,3185,20200422,6727
20200419,7,먹골,4199,4095,20200422,8294
20200419,7,중화,4637,4441,20200422,9078
20200419,7,상봉,7668,7204,20200422,14872
20200419,7,면목,6426,6231,20200422,12657
20200419,7,사가정,7093,6861,20200422,13954
20200419,7,용마산,2576,2760,20200422,5336
20200419,7,중곡,3805,3781,20200422,7586
20200419,7,군자,5659,4464,20200422,10123
20200419,7,어린이대공원,4726,4764,20200422,9490
20200419,7,건대입구,6186,6341,20200422,12527
20200419,7,뚝섬유원지,3420,3357,20200422,6777
20200419,7,청담,4575,5026,20200422,9601
20200419,7,강남구청,4034,4527,20200422,8561
20200419,7,학동,3968,4295,20200422,8263
20200419,7,논현,4751,5224,20200422,9975
20200419,7,반포,2236,2285,20200422,4521
20200419,7,고속터미널,8781,5904,20200422,14685
20200419,7,내방,3689,3898,20200422,7587
20200419,7,이수,6117,6015,20200422,12132
20200419,7,남성,4134,4082,20200422,8216
20200419,7,숭실대입구,4061,4216,20200422,8277
20200419,7,상도,3672,3652,20200422,7324
20200419,7,장승배기,3846,3730,20200422,7576
20200419,7,신대방삼거리,6030,5792,20200422,11822
20200419,7,보라매,3074,3050,20200422,6124
20200419,7,신풍,4323,4116,20200422,8439
20200419,7,대림,4427,4123,20200422,8550
20200419,7,남구로,5137,4934,20200422,10071
20200419,7,가산디지털단지,8129,7654,20200422,15783
20200419,7,철산,7885,7882,20200422,15767
20200419,7,광명사거리,9984,9615,20200422,19599
20200419,7,천왕,3173,3077,20200422,6250
20200419,7,온수,2978,2983,20200422,5961
20200419,7,까치울,3064,2962,20200422,6026
20200419,7,부천종합운동장,1612,1534,20200422,3146
20200419,7,춘의,2588,2408,20200422,4996
20200419,7,신중동,5062,5058,20200422,10120
20200419,7,부천시청,4819,4731,20200422,9550
20200419,7,상동,5252,4959,20200422,10211
20200419,7,삼산체육관,1599,1460,20200422,3059
20200419,7,굴포천,3510,3528,20200422,7038
20200419,7,부평구청,3835,3169,20200422,7004
20200420,7,장암,2283,750,20200423,3033
20200420,7,도봉산,8078,9196,20200423,17274
20200420,7,수락산,11227,11150,20200423,22377
20200420,7,마들,10675,10154,20200423,20829
20200420,7,노원,17547,18673,20200423,36220
20200420,7,중계,12866,11655,20200423,24521
20200420,7,하계,15468,14499,20200423,29967
20200420,7,공릉,10283,10456,20200423,20739
20200420,7,태릉입구,7072,6586,20200423,13658
20200420,7,먹골,9385,9102,20200423,18487
20200420,7,중화,10237,9878,20200423,20115
20200420,7,상봉,15459,14395,20200423,29854
20200420,7,면목,14304,14000,20200423,28304
20200420,7,사가정,14390,14599,20200423,28989
20200420,7,용마산,5534,5170,20200423,10704
20200420,7,중곡,8759,8292,20200423,17051
20200420,7,군자,13297,10674,20200423,23971
20200420,7,어린이대공원,9631,9519,20200423,19150
20200420,7,건대입구,10238,10807,20200423,21045
20200420,7,뚝섬유원지,6302,6281,20200423,12583
20200420,7,청담,18332,20429,20200423,38761
20200420,7,강남구청,13968,15618,20200423,29586
20200420,7,학동,22451,24204,20200423,46655
20200420,7,논현,19187,20966,20200423,40153
20200420,7,반포,5113,5083,20200423,10196
20200420,7,고속터미널,13124,11047,20200423,24171
20200420,7,내방,12985,13345,20200423,26330
20200420,7,이수,13942,13823,20200423,27765
20200420,7,남성,10055,9469,20200423,19524
20200420,7,숭실대입구,10504,10692,20200423,21196
20200420,7,상도,9277,8907,20200423,18184
20200420,7,장승배기,9221,9018,20200423,18239
20200420,7,신대방삼거리,15197,14697,20200423,29894
20200420,7,보라매,8729,8815,20200423,17544
20200420,7,신풍,10191,9666,20200423,19857
20200420,7,대림,6911,6519,20200423,13430
20200420,7,남구로,15303,16212,20200423,31515
20200420,7,가산디지털단지,44784,45225,20200423,90009
20200420,7,철산,20074,20459,20200423,40533
20200420,7,광명사거리,21598,21264,20200423,42862
20200420,7,천왕,9274,8545,20200423,17819
20200420,7,온수,9553,8848,20200423,18401
20200420,7,까치울,6581,6297,20200423,12878
20200420,7,부천종합운동장,4113,3389,20200423,7502
20200420,7,춘의,8875,8790,20200423,17665
20200420,7,신중동,12922,12878,20200423,25800
20200420,7,부천시청,10713,10527,20200423,21240
20200420,7,상동,11274,11574,20200423,22848
20200420,7,삼산체육관,4275,3811,20200423,8086
20200420,7,굴포천,7814,8198,20200423,16012
20200420,7,부평구청,10887,8630,20200423,19517
20200421,7,장암,2256,830,20200424,3086
20200421,7,도봉산,8225,9738,20200424,17963
20200421,7,수락산,11598,11580,20200424,23178
20200421,7,마들,10899,10461,20200424,21360
20200421,7,노원,17740,18541,20200424,36281
20200421,7,중계,13205,11793,20200424,24998
20200421,7,하계,15766,15133,20200424,30899
20200421,7,공릉,10574,10618,20200424,21192
20200421,7,태릉입구,7399,6739,20200424,14138
20200421,7,먹골,9584,9330,20200424,18914
20200421,7,중화,10148,9952,20200424,20100
20200421,7,상봉,15637,14634,20200424,30271
20200421,7,면목,14289,14115,20200424,28404
20200421,7,사가정,14585,14684,20200424,29269
20200421,7,용마산,5613,5363,20200424,10976
20200421,7,중곡,9053,8444,20200424,17497
20200421,7,군자,13456,10871,20200424,24327
20200421,7,어린이대공원,9772,9608,20200424,19380
20200421,7,건대입구,10841,11227,20200424,22068
20200421,7,뚝섬유원지,6675,6512,20200424,13187
20200421,7,청담,18635,20923,20200424,39558
20200421,7,강남구청,14779,16636,20200424,31415
20200421,7,학동,23002,24816,20200424,47818
20200421,7,논현,19244,21422,20200424,40666
20200421,7,반포,5231,5232,20200424,10463
20200421,7,고속터미널,12681,11192,20200424,23873
20200421,7,내방,13384,13758,20200424,27142
20200421,7,이수,14499,14419,20200424,28918
20200421,7,남성,10368,9624,20200424,19992
20200421,7,숭실대입구,10991,10948,20200424,21939
20200421,7,상도,9279,9033,20200424,18312
20200421,7,장승배기,9230,9052,20200424,18282
20200421,7,신대방삼거리,15146,14567,20200424,29713
20200421,7,보라매,9034,8940,20200424,17974
20200421,7,신풍,10063,9776,20200424,19839
20200421,7,대림,6810,6666,20200424,13476
20200421,7,남구로,15267,16116,20200424,31383
20200421,7,가산디지털단지,45301,45451,20200424,90752
20200421,7,철산,20445,21061,20200424,41506
20200421,7,광명사거리,21845,21557,20200424,43402
20200421,7,천왕,9361,8642,20200424,18003
20200421,7,온수,9863,9247,20200424,19110
20200421,7,까치울,6818,6459,20200424,13277
20200421,7,부천종합운동장,4059,3546,20200424,7605
20200421,7,춘의,8920,8757,20200424,17677
20200421,7,신중동,13134,13057,20200424,26191
20200421,7,부천시청,11044,10907,20200424,21951
20200421,7,상동,11605,11914,20200424,23519
20200421,7,삼산체육관,4343,3866,20200424,8209
20200421,7,굴포천,8006,8509,20200424,16515
20200421,7,부평구청,10959,8790,20200424,19749
20200422,7,장암,2148,731,20200425,2879
20200422,7,도봉산,8097,9418,20200425,17515
20200422,7,수락산,11249,11321,20200425,22570
20200422,7,마들,10772,10239,20200425,21011
20200422,7,노원,17551,18365,20200425,35916
20200422,7,중계,13007,11631,20200425,24638
20200422,7,하계,15940,15140,20200425,31080
20200422,7,공릉,10404,10561,20200425,20965
20200422,7,태릉입구,7155,6519,20200425,13674
20200422,7,먹골,9318,9221,20200425,18539
20200422,7,중화,10207,10040,20200425,20247
20200422,7,상봉,15590,14383,20200425,29973
20200422,7,면목,14213,13852,20200425,28065
20200422,7,사가정,14332,14389,20200425,28721
20200422,7,용마산,5568,5235,20200425,10803
20200422,7,중곡,8956,8327,20200425,17283
20200422,7,군자,13409,10764,20200425,24173
20200422,7,어린이대공원,9665,9557,20200425,19222
20200422,7,건대입구,10859,11164,20200425,22023
20200422,7,뚝섬유원지,6246,6194,20200425,12440
20200422,7,청담,18513,20877,20200425,39390
20200422,7,강남구청,14694,16524,20200425,31218
20200422,7,학동,22840,24693,20200425,47533
20200422,7,논현,19121,21089,20200425,40210
20200422,7,반포,5740,5740,20200425,11480
20200422,7,고속터미널,12660,11227,20200425,23887
20200422,7,내방,13352,13721,20200425,27073
20200422,7,이수,14416,14137,20200425,28553
20200422,7,남성,10287,9549,20200425,19836
20200422,7,숭실대입구,10855,10819,20200425,21674
20200422,7,상도,9260,8975,20200425,18235
20200422,7,장승배기,9222,8946,20200425,18168
20200422,7,신대방삼거리,15288,14562,20200425,29850
20200422,7,보라매,8888,8869,20200425,17757
20200422,7,신풍,10191,9615,20200425,19806
20200422,7,대림,6707,6410,20200425,13117
20200422,7,남구로,14972,15985,20200425,30957
20200422,7,가산디지털단지,44748,44827,20200425,89575
20200422,7,철산,20322,20876,20200425,41198
20200422,7,광명사거리,21374,21161,20200425,42535
20200422,7,천왕,9432,8693,20200425,18125
20200422,7,온수,9616,8982,20200425,18598
20200422,7,까치울,6760,6334,20200425,13094
20200422,7,부천종합운동장,4089,3407,20200425,7496
20200422,7,춘의,8961,8758,20200425,17719
20200422,7,신중동,13111,13081,20200425,26192
20200422,7,부천시청,10895,10879,20200425,21774
20200422,7,상동,11754,12084,20200425,23838
20200422,7,삼산체육관,4251,3789,20200425,8040
20200422,7,굴포천,8024,8486,20200425,16510
20200422,7,부평구청,10900,8860,20200425,19760
20200423,7,장암,2251,808,20200426,3059
20200423,7,도봉산,8310,9707,20200426,18017
20200423,7,수락산,11638,11584,20200426,23222
20200423,7,마들,10941,10371,20200426,21312
20200423,7,노원,17779,18820,20200426,36599
20200423,7,중계,13055,11645,20200426,24700
20200423,7,하계,16113,15149,20200426,31262
20200423,7,공릉,10741,10690,20200426,21431
20200423,7,태릉입구,7408,6780,20200426,14188
20200423,7,먹골,9562,9246,20200426,18808
20200423,7,중화,10264,9999,20200426,20263
20200423,7,상봉,15977,15016,20200426,30993
20200423,7,면목,14462,14092,20200426,28554
20200423,7,사가정,14942,14822,20200426,29764
20200423,7,용마산,5671,5311,20200426,10982
20200423,7,중곡,8917,8202,20200426,17119
20200423,7,군자,13592,10786,20200426,24378
20200423,7,어린이대공원,9942,9617,20200426,19559
20200423,7,건대입구,11110,11356,20200426,22466
20200423,7,뚝섬유원지,6977,6866,20200426,13843
20200423,7,청담,18620,21123,20200426,39743
20200423,7,강남구청,14978,16952,20200426,31930
20200423,7,학동,22707,24802,20200426,47509
20200423,7,논현,19459,21612,20200426,41071
20200423,7,반포,5523,5440,20200426,10963
20200423,7,고속터미널,13116,11671,20200426,24787
20200423,7,내방,13434,13853,20200426,27287
20200423,7,이수,14707,14301,20200426,29008
20200423,7,남성,10569,9680,20200426,20249
20200423,7,숭실대입구,11035,11036,20200426,22071
20200423,7,상도,9329,8931,20200426,18260
20200423,7,장승배기,9333,9091,20200426,18424
20200423,7,신대방삼거리,15289,14546,20200426,29835
20200423,7,보라매,9043,8965,20200426,18008
20200423,7,신풍,10286,9717,20200426,20003
20200423,7,대림,6825,6653,20200426,13478
20200423,7,남구로,15170,16218,20200426,31388
20200423,7,가산디지털단지,44833,45216,20200426,90049
20200423,7,철산,20785,21423,20200426,42208
20200423,7,광명사거리,22012,21509,20200426,43521
20200423,7,천왕,9442,8688,20200426,18130
20200423,7,온수,9713,9146,20200426,18859
20200423,7,까치울,6939,6580,20200426,13519
20200423,7,부천종합운동장,4158,3599,20200426,7757
20200423,7,춘의,8975,8657,20200426,17632
20200423,7,신중동,13334,13232,20200426,26566
20200423,7,부천시청,11228,10971,20200426,22199
20200423,7,상동,11613,11996,20200426,23609
20200423,7,삼산체육관,4278,3810,20200426,8088
20200423,7,굴포천,8080,8456,20200426,16536
20200423,7,부평구청,10945,8888,20200426,19833
20200424,7,장암,2342,881,20200427,3223
20200424,7,도봉산,8430,9754,20200427,18184
20200424,7,수락산,12007,11735,20200427,23742
20200424,7,마들,11486,10777,20200427,22263
20200424,7,노원,18591,20431,20200427,39022
20200424,7,중계,13396,11591,20200427,24987
20200424,7,하계,16397,15108,20200427,31505
20200424,7,공릉,11277,11086,20200427,22363
20200424,7,태릉입구,7762,7074,20200427,14836
20200424,7,먹골,9981,9512,20200427,19493
20200424,7,중화,10640,10138,20200427,20778
20200424,7,상봉,16505,15556,20200427,32061
20200424,7,면목,15159,14279,20200427,29438
20200424,7,사가정,15505,15241,20200427,30746
20200424,7,용마산,5816,5421,20200427,11237
20200424,7,중곡,9327,8476,20200427,17803
20200424,7,군자,14338,10921,20200427,25259
20200424,7,어린이대공원,10421,10068,20200427,20489
20200424,7,건대입구,11651,12526,20200427,24177
20200424,7,뚝섬유원지,7270,7253,20200427,14523
20200424,7,청담,18917,21538,20200427,40455
20200424,7,강남구청,15323,17344,20200427,32667
20200424,7,학동,22763,24828,20200427,47591
20200424,7,논현,20170,22935,20200427,43105
20200424,7,반포,5871,5545,20200427,11416
20200424,7,고속터미널,15126,12984,20200427,28110
20200424,7,내방,13699,14123,20200427,27822
20200424,7,이수,15460,15389,20200427,30849
20200424,7,남성,10729,9663,20200427,20392
20200424,7,숭실대입구,11691,11401,20200427,23092
20200424,7,상도,9875,9179,20200427,19054
20200424,7,장승배기,9578,9153,20200427,18731
20200424,7,신대방삼거리,15868,14921,20200427,30789
20200424,7,보라매,9499,9265,20200427,18764
20200424,7,신풍,10624,10006,20200427,20630
20200424,7,대림,6871,6893,20200427,13764
20200424,7,남구로,15130,16090,20200427,31220
20200424,7,가산디지털단지,45124,45168,20200427,90292
20200424,7,철산,21612,22310,20200427,43922
20200424,7,광명사거리,22615,22236,20200427,44851
20200424,7,천왕,9696,8659,20200427,18355
20200424,7,온수,9880,9101,20200427,18981
20200424,7,까치울,7160,6791,20200427,13951
20200424,7,부천종합운동장,4264,3639,20200427,7903
20200424,7,춘의,9081,8664,20200427,17745
20200424,7,신중동,13840,14030,20200427,27870
20200424,7,부천시청,11683,11502,20200427,23185
20200424,7,상동,12228,12754,20200427,24982
20200424,7,삼산체육관,4392,3808,20200427,8200
20200424,7,굴포천,8501,9025,20200427,17526
20200424,7,부평구청,11276,8910,20200427,20186
20200425,7,장암,1438,1087,20200428,2525
20200425,7,도봉산,6120,8634,20200428,14754
20200425,7,수락산,9317,9136,20200428,18453
20200425,7,마들,7489,6985,20200428,14474
20200425,7,노원,13651,14433,20200428,28084
20200425,7,중계,8274,7222,20200428,15496
20200425,7,하계,10643,9856,20200428,20499
20200425,7,공릉,7675,7699,20200428,15374
20200425,7,태릉입구,5430,4901,20200428,10331
20200425,7,먹골,7192,6826,20200428,14018
20200425,7,중화,7153,6713,20200428,13866
20200425,7,상봉,12040,11372,20200428,23412
20200425,7,면목,10339,9857,20200428,20196
20200425,7,사가정,11170,10784,20200428,21954
20200425,7,용마산,3973,4108,20200428,8081
20200425,7,중곡,6072,5483,20200428,11555
20200425,7,군자,9577,7093,20200428,16670
20200425,7,어린이대공원,7487,7265,20200428,14752
20200425,7,건대입구,9740,10377,20200428,20117
20200425,7,뚝섬유원지,7775,7649,20200428,15424
20200425,7,청담,9484,9906,20200428,19390
20200425,7,강남구청,8466,9435,20200428,17901
20200425,7,학동,8586,9201,20200428,17787
20200425,7,논현,10235,11302,20200428,21537
20200425,7,반포,4009,3731,20200428,7740
20200425,7,고속터미널,11433,9306,20200428,20739
20200425,7,내방,6745,6697,20200428,13442
20200425,7,이수,10409,9936,20200428,20345
20200425,7,남성,6984,6371,20200428,13355
20200425,7,숭실대입구,6872,6551,20200428,13423
20200425,7,상도,6376,5696,20200428,12072
20200425,7,장승배기,6343,6002,20200428,12345
20200425,7,신대방삼거리,10072,9144,20200428,19216
20200425,7,보라매,5381,5135,20200428,10516
20200425,7,신풍,6884,6487,20200428,13371
20200425,7,대림,5714,6060,20200428,11774
20200425,7,남구로,7460,7833,20200428,15293
20200425,7,가산디지털단지,13149,12195,20200428,25344
20200425,7,철산,14112,14447,20200428,28559
20200425,7,광명사거리,15930,15797,20200428,31727
20200425,7,천왕,5464,5010,20200428,10474
20200425,7,온수,5189,5081,20200428,10270
20200425,7,까치울,4863,4828,20200428,9691
20200425,7,부천종합운동장,2832,2497,20200428,5329
20200425,7,춘의,4351,4225,20200428,8576
20200425,7,신중동,8672,8695,20200428,17367
20200425,7,부천시청,7917,7725,20200428,15642
20200425,7,상동,9035,9220,20200428,18255
20200425,7,삼산체육관,2749,2462,20200428,5211
20200425,7,굴포천,5768,5945,20200428,11713
20200425,7,부평구청,6224,5203,20200428,11427
20200426,7,장암,1308,1088,20200429,2396
20200426,7,도봉산,5396,8269,20200429,13665
20200426,7,수락산,8059,8119,20200429,16178
20200426,7,마들,4660,4300,20200429,8960
20200426,7,노원,9301,9476,20200429,18777
20200426,7,중계,5782,5149,20200429,10931
20200426,7,하계,7714,7315,20200429,15029
20200426,7,공릉,5636,5767,20200429,11403
20200426,7,태릉입구,4117,3755,20200429,7872
20200426,7,먹골,4845,4706,20200429,9551
20200426,7,중화,5296,5135,20200429,10431
20200426,7,상봉,8375,7632,20200429,16007
20200426,7,면목,7318,7179,20200429,14497
20200426,7,사가정,8264,8004,20200429,16268
20200426,7,용마산,2915,3315,20200429,6230
20200426,7,중곡,4361,4276,20200429,8637
20200426,7,군자,6720,5122,20200429,11842
20200426,7,어린이대공원,5534,5602,20200429,11136
20200426,7,건대입구,6988,7089,20200429,14077
20200426,7,뚝섬유원지,7927,7939,20200429,15866
20200426,7,청담,5203,5543,20200429,10746
20200426,7,강남구청,4497,5062,20200429,9559
20200426,7,학동,4574,4904,20200429,9478
20200426,7,논현,5780,6166,20200429,11946
20200426,7,반포,2555,2557,20200429,5112
20200426,7,고속터미널,9558,6740,20200429,16298
20200426,7,내방,4120,4295,20200429,8415
20200426,7,이수,7097,6639,20200429,13736
20200426,7,남성,4708,4633,20200429,9341
20200426,7,숭실대입구,4658,4993,20200429,9651
20200426,7,상도,4284,4399,20200429,8683
20200426,7,장승배기,4337,4288,20200429,8625
20200426,7,신대방삼거리,6980,6778,20200429,13758
20200426,7,보라매,3494,3543,20200429,7037
20200426,7,신풍,5162,4704,20200429,9866
20200426,7,대림,5342,4953,20200429,10295
20200426,7,남구로,5783,5654,20200429,11437
20200426,7,가산디지털단지,9498,8775,20200429,18273
20200426,7,철산,9330,9488,20200429,18818
20200426,7,광명사거리,11500,11229,20200429,22729
20200426,7,천왕,3842,3678,20200429,7520
20200426,7,온수,3497,3522,20200429,7019
20200426,7,까치울,3526,3503,20200429,7029
20200426,7,부천종합운동장,2124,1950,20200429,4074
20200426,7,춘의,2933,2732,20200429,5665
20200426,7,신중동,5822,5784,20200429,11606
20200426,7,부천시청,5277,5025,20200429,10302
20200426,7,상동,5975,5752,20200429,11727
20200426,7,삼산체육관,2026,1967,20200429,3993
20200426,7,굴포천,3866,3907,20200429,7773
20200426,7,부평구청,4169,3711,20200429,7880
20200427,7,장암,2372,821,20200430,3193
20200427,7,도봉산,8455,9770,20200430,18225
20200427,7,수락산,11874,11867,20200430,23741
20200427,7,마들,11041,10445,20200430,21486
20200427,7,노원,18213,19379,20200430,37592
20200427,7,중계,13409,12136,20200430,25545
20200427,7,하계,16123,15224,20200430,31347
20200427,7,공릉,10786,10930,20200430,21716
20200427,7,태릉입구,7496,6778,20200430,14274
20200427,7,먹골,9606,9308,20200430,18914
20200427,7,중화,10508,10079,20200430,20587
20200427,7,상봉,15943,15089,20200430,31032
20200427,7,면목,14695,14442,20200430,29137
20200427,7,사가정,15074,15100,20200430,30174
20200427,7,용마산,5750,5425,20200430,11175
20200427,7,중곡,9038,8488,20200430,17526
20200427,7,군자,13707,10807,20200430,24514
20200427,7,어린이대공원,9829,9801,20200430,19630
20200427,7,건대입구,10830,11483,20200430,22313
20200427,7,뚝섬유원지,7617,7508,20200430,15125
20200427,7,청담,19048,21282,20200430,40330
20200427,7,강남구청,14726,16474,20200430,31200
20200427,7,학동,22962,24993,20200430,47955
20200427,7,논현,19979,21787,20200430,41766
20200427,7,반포,5521,5477,20200430,10998
20200427,7,고속터미널,14162,12030,20200430,26192
20200427,7,내방,13535,14027,20200430,27562
20200427,7,이수,14468,14330,20200430,28798
20200427,7,남성,10512,9794,20200430,20306
20200427,7,숭실대입구,11173,11251,20200430,22424
20200427,7,상도,9590,9368,20200430,18958
20200427,7,장승배기,9499,9361,20200430,18860
20200427,7,신대방삼거리,15817,15142,20200430,30959
20200427,7,보라매,9417,9320,20200430,18737
20200427,7,신풍,10481,10026,20200430,20507
20200427,7,대림,7165,6966,20200430,14131
20200427,7,남구로,15759,16797,20200430,32556
20200427,7,가산디지털단지,45728,46596,20200430,92324
20200427,7,철산,20987,21451,20200430,42438
20200427,7,광명사거리,22578,21968,20200430,44546
20200427,7,천왕,9744,8940,20200430,18684
20200427,7,온수,9982,9183,20200430,19165
20200427,7,까치울,6980,6648,20200430,13628
20200427,7,부천종합운동장,4295,3672,20200430,7967
20200427,7,춘의,9255,9027,20200430,18282
20200427,7,신중동,13526,13534,20200430,27060
20200427,7,부천시청,11301,11046,20200430,22347
20200427,7,상동,11810,12166,20200430,23976
20200427,7,삼산체육관,4467,3919,20200430,8386
20200427,7,굴포천,8308,8691,20200430,16999
20200427,7,부평구청,11315,9018,20200430,20333
20200428,7,장암,2360,883,20200501,3243
20200428,7,도봉산,8613,10074,20200501,18687
20200428,7,수락산,12118,12161,20200501,24279
20200428,7,마들,11376,10578,20200501,21954
20200428,7,노원,18460,19506,20200501,37966
20200428,7,중계,13676,12141,20200501,25817
20200428,7,하계,16673,15634,20200501,32307
20200428,7,공릉,10836,10780,20200501,21616
20200428,7,태릉입구,7502,7110,20200501,14612
20200428,7,먹골,9887,9475,20200501,19362
20200428,7,중화,10629,10368,20200501,20997
20200428,7,상봉,16356,15148,20200501,31504
20200428,7,면목,14805,14281,20200501,29086
20200428,7,사가정,15106,15106,20200501,30212
20200428,7,용마산,5816,5501,20200501,11317
20200428,7,중곡,9308,8654,20200501,17962
20200428,7,군자,14103,11068,20200501,25171
20200428,7,어린이대공원,10196,10122,20200501,20318
20200428,7,건대입구,11212,11796,20200501,23008
20200428,7,뚝섬유원지,8198,8161,20200501,16359
20200428,7,청담,19216,21697,20200501,40913
20200428,7,강남구청,15580,17422,20200501,33002
20200428,7,학동,23200,25454,20200501,48654
20200428,7,논현,20095,22263,20200501,42358
20200428,7,반포,5604,5465,20200501,11069
20200428,7,고속터미널,14041,12425,20200501,26466
20200428,7,내방,13781,14167,20200501,27948
20200428,7,이수,15178,15063,20200501,30241
20200428,7,남성,10968,10073,20200501,21041
20200428,7,숭실대입구,11490,11465,20200501,22955
20200428,7,상도,9919,9514,20200501,19433
20200428,7,장승배기,9603,9218,20200501,18821
20200428,7,신대방삼거리,15876,14996,20200501,30872
20200428,7,보라매,9587,9660,20200501,19247
20200428,7,신풍,10610,10050,20200501,20660
20200428,7,대림,7147,7005,20200501,14152
20200428,7,남구로,15573,16664,20200501,32237
20200428,7,가산디지털단지,46112,47165,20200501,93277
20200428,7,철산,21615,22097,20200501,43712
20200428,7,광명사거리,22586,22152,20200501,44738
20200428,7,천왕,9919,9118,20200501,19037
20200428,7,온수,10100,9259,20200501,19359
20200428,7,까치울,7312,6889,20200501,14201
20200428,7,부천종합운동장,4390,3861,20200501,8251
20200428,7,춘의,9180,8889,20200501,18069
20200428,7,신중동,13632,13704,20200501,27336
20200428,7,부천시청,11665,11475,20200501,23140
20200428,7,상동,12096,12574,20200501,24670
20200428,7,삼산체육관,4624,4014,20200501,8638
20200428,7,굴포천,8609,8928,20200501,17537
20200428,7,부평구청,11660,9271,20200501,20931
20200429,7,장암,2429,930,20200502,3359
20200429,7,도봉산,8845,9947,20200502,18792
20200429,7,수락산,12720,12179,20200502,24899
20200429,7,마들,11659,10690,20200502,22349
20200429,7,노원,19008,20542,20200502,39550
20200429,7,중계,14155,12248,20200502,26403
20200429,7,하계,17814,16392,20200502,34206
20200429,7,공릉,11278,11256,20200502,22534
20200429,7,태릉입구,7836,7227,20200502,15063
20200429,7,먹골,10190,9566,20200502,19756
20200429,7,중화,10881,10414,20200502,21295
20200429,7,상봉,16964,15844,20200502,32808
20200429,7,면목,15376,14486,20200502,29862
20200429,7,사가정,15700,15484,20200502,31184
20200429,7,용마산,5980,5495,20200502,11475
20200429,7,중곡,9508,8542,20200502,18050
20200429,7,군자,14506,11336,20200502,25842
20200429,7,어린이대공원,10711,10295,20200502,21006
20200429,7,건대입구,11822,12735,20200502,24557
20200429,7,뚝섬유원지,9047,9084,20200502,18131
20200429,7,청담,19344,22130,20200502,41474
20200429,7,강남구청,15500,17886,20200502,33386
20200429,7,학동,23237,25807,20200502,49044
20200429,7,논현,20251,23134,20200502,43385
20200429,7,반포,6047,5743,20200502,11790
20200429,7,고속터미널,15244,14361,20200502,29605
20200429,7,내방,13942,14321,20200502,28263
20200429,7,이수,15561,15545,20200502,31106
20200429,7,남성,11328,10016,20200502,21344
20200429,7,숭실대입구,11969,11620,20200502,23589
20200429,7,상도,10168,9350,20200502,19518
20200429,7,장승배기,10023,9479,20200502,19502
20200429,7,신대방삼거리,16451,15055,20200502,31506
20200429,7,보라매,9758,9499,20200502,19257
20200429,7,신풍,11051,10227,20200502,21278
20200429,7,대림,7492,7435,20200502,14927
20200429,7,남구로,15664,16719,20200502,32383
20200429,7,가산디지털단지,46474,46602,20200502,93076
20200429,7,철산,22746,23492,20200502,46238
20200429,7,광명사거리,23872,23294,20200502,47166
20200429,7,천왕,10321,9155,20200502,19476
20200429,7,온수,10314,9444,20200502,19758
20200429,7,까치울,7523,6953,20200502,14476
20200429,7,부천종합운동장,4456,3746,20200502,8202
20200429,7,춘의,9204,8903,20200502,18107
20200429,7,신중동,14387,14390,20200502,28777
20200429,7,부천시청,12023,11728,20200502,23751
20200429,7,상동,13261,13849,20200502,27110
20200429,7,삼산체육관,4564,4051,20200502,8615
20200429,7,굴포천,8722,9011,20200502,17733
20200429,7,부평구청,11786,9307,20200502,21093
20200430,7,장암,1472,1053,20200503,2525
20200430,7,도봉산,6164,9004,20200503,15168
20200430,7,수락산,8806,8468,20200503,17274
20200430,7,마들,6555,5958,20200503,12513
20200430,7,노원,11768,12275,20200503,24043
20200430,7,중계,7540,6388,20200503,13928
20200430,7,하계,9756,8921,20200503,18677
20200430,7,공릉,7016,6819,20200503,13835
20200430,7,태릉입구,5182,4568,20200503,9750
20200430,7,먹골,6024,5656,20200503,11680
20200430,7,중화,6456,6015,20200503,12471
20200430,7,상봉,10730,10070,20200503,20800
20200430,7,면목,9583,8787,20200503,18370
20200430,7,사가정,10015,9293,20200503,19308
20200430,7,용마산,3689,3812,20200503,7501
20200430,7,중곡,5489,4926,20200503,10415
20200430,7,군자,8533,6111,20200503,14644
20200430,7,어린이대공원,7034,6672,20200503,13706
20200430,7,건대입구,8337,8777,20200503,17114
20200430,7,뚝섬유원지,11071,11354,20200503,22425
20200430,7,청담,7373,8049,20200503,15422
20200430,7,강남구청,6392,7127,20200503,13519
20200430,7,학동,6050,6343,20200503,12393
20200430,7,논현,7889,8498,20200503,16387
20200430,7,반포,3345,3199,20200503,6544
20200430,7,고속터미널,9914,9635,20200503,19549
20200430,7,내방,5540,5400,20200503,10940
20200430,7,이수,8619,8086,20200503,16705
20200430,7,남성,6290,5663,20200503,11953
20200430,7,숭실대입구,6529,6194,20200503,12723
20200430,7,상도,5610,4834,20200503,10444
20200430,7,장승배기,5620,5141,20200503,10761
20200430,7,신대방삼거리,8963,7800,20200503,16763
20200430,7,보라매,4681,4346,20200503,9027
20200430,7,신풍,6124,5813,20200503,11937
20200430,7,대림,5635,5716,20200503,11351
20200430,7,남구로,7023,7162,20200503,14185
20200430,7,가산디지털단지,12460,11385,20200503,23845
20200430,7,철산,11974,12131,20200503,24105
20200430,7,광명사거리,14585,14194,20200503,28779
20200430,7,천왕,4943,4532,20200503,9475
20200430,7,온수,4661,4428,20200503,9089
20200430,7,까치울,4551,4523,20200503,9074
20200430,7,부천종합운동장,2602,2469,20200503,5071
20200430,7,춘의,4285,4047,20200503,8332
20200430,7,신중동,7342,7252,20200503,14594
20200430,7,부천시청,7072,6681,20200503,13753
20200430,7,상동,7730,7786,20200503,15516
20200430,7,삼산체육관,2616,2286,20200503,4902
20200430,7,굴포천,4990,5027,20200503,10017
20200430,7,부평구청,5413,4684,20200503,10097
20200501,7,부평구청,6030,5097,20200504,11127
20200501,7,굴포천,5435,5389,20200504,10824
20200501,7,삼산체육관,2724,2447,20200504,5171
20200501,7,상동,8476,8655,20200504,17131
20200501,7,부천시청,7681,7496,20200504,15177
20200501,7,신중동,8427,8205,20200504,16632
20200501,7,춘의,4435,4207,20200504,8642
20200501,7,부천종합운동장,2686,2394,20200504,5080
20200501,7,까치울,4895,4695,20200504,9590
20200501,7,온수,5265,5066,20200504,10331
20200501,7,천왕,5562,5239,20200504,10801
20200501,7,광명사거리,15787,15505,20200504,31292
20200501,7,철산,13210,13474,20200504,26684
20200501,7,가산디지털단지,14406,13670,20200504,28076
20200501,7,남구로,7846,7820,20200504,15666
20200501,7,대림,6590,6507,20200504,13097
20200501,7,신풍,6563,6150,20200504,12713
20200501,7,보라매,5283,5118,20200504,10401
20200501,7,신대방삼거리,9553,8781,20200504,18334
20200501,7,장승배기,6445,5930,20200504,12375
20200501,7,상도,6184,5630,20200504,11814
20200501,7,숭실대입구,7740,7542,20200504,15282
20200501,7,남성,7070,6483,20200504,13553
20200501,7,이수,9924,9624,20200504,19548
20200501,7,내방,6830,6882,20200504,13712
20200501,7,고속터미널,11772,9289,20200504,21061
20200501,7,반포,4088,3876,20200504,7964
20200501,7,논현,9627,10871,20200504,20498
20200501,7,학동,7855,8511,20200504,16366
20200501,7,강남구청,7403,8282,20200504,15685
20200501,7,청담,9111,10019,20200504,19130
20200501,7,뚝섬유원지,10222,10334,20200504,20556
20200501,7,건대입구,8744,9198,20200504,17942
20200501,7,어린이대공원,7860,7689,20200504,15549
20200501,7,군자,9219,6927,20200504,16146
20200501,7,중곡,6263,5630,20200504,11893
20200501,7,용마산,3927,3953,20200504,7880
20200501,7,사가정,10827,10435,20200504,21262
20200501,7,면목,10284,9792,20200504,20076
20200501,7,상봉,11315,10853,20200504,22168
20200501,7,중화,7282,6873,20200504,14155
20200501,7,먹골,6701,6324,20200504,13025
20200501,7,태릉입구,5511,5003,20200504,10514
20200501,7,공릉,7764,7631,20200504,15395
20200501,7,하계,11013,10016,20200504,21029
20200501,7,중계,8590,7305,20200504,15895
20200501,7,노원,14051,14784,20200504,28835
20200501,7,마들,7722,7092,20200504,14814
20200501,7,수락산,8925,8665,20200504,17590
20200501,7,도봉산,6018,8082,20200504,14100
20200501,7,장암,1322,890,20200504,2212
20200502,7,장암,1465,963,20200505,2428
20200502,7,도봉산,5743,7996,20200505,13739
20200502,7,수락산,8593,8376,20200505,16969
20200502,7,마들,6918,6376,20200505,13294
20200502,7,노원,12765,13742,20200505,26507
20200502,7,중계,7850,6891,20200505,14741
20200502,7,하계,10089,9525,20200505,19614
20200502,7,공릉,6956,6957,20200505,13913
20200502,7,태릉입구,5112,4461,20200505,9573
20200502,7,먹골,6512,6186,20200505,12698
20200502,7,중화,6614,6305,20200505,12919
20200502,7,상봉,10903,10349,20200505,21252
20200502,7,면목,9421,9030,20200505,18451
20200502,7,사가정,10264,9986,20200505,20250
20200502,7,용마산,3640,3602,20200505,7242
20200502,7,중곡,5549,5145,20200505,10694
20200502,7,군자,8573,6416,20200505,14989
20200502,7,어린이대공원,6958,6697,20200505,13655
20200502,7,건대입구,8890,9504,20200505,18394
20200502,7,뚝섬유원지,10150,9963,20200505,20113
20200502,7,청담,8742,9188,20200505,17930
20200502,7,강남구청,7457,8365,20200505,15822
20200502,7,학동,7456,7865,20200505,15321
20200502,7,논현,9148,10121,20200505,19269
20200502,7,반포,3795,3567,20200505,7362
20200502,7,고속터미널,13130,9436,20200505,22566
20200502,7,내방,5991,5951,20200505,11942
20200502,7,이수,9220,8899,20200505,18119
20200502,7,남성,6449,5900,20200505,12349
20200502,7,숭실대입구,6212,6201,20200505,12413
20200502,7,상도,5634,5204,20200505,10838
20200502,7,장승배기,5836,5663,20200505,11499
20200502,7,신대방삼거리,8872,8256,20200505,17128
20200502,7,보라매,4675,4508,20200505,9183
20200502,7,신풍,6322,6078,20200505,12400
20200502,7,대림,6132,6380,20200505,12512
20200502,7,남구로,7039,7105,20200505,14144
20200502,7,가산디지털단지,12223,11324,20200505,23547
20200502,7,철산,12549,12754,20200505,25303
20200502,7,광명사거리,14871,14710,20200505,29581
20200502,7,천왕,5019,4666,20200505,9685
20200502,7,온수,4707,4676,20200505,9383
20200502,7,까치울,4479,4368,20200505,8847
20200502,7,부천종합운동장,2471,2294,20200505,4765
20200502,7,춘의,3843,3601,20200505,7444
20200502,7,신중동,7964,8003,20200505,15967
20200502,7,부천시청,7256,7115,20200505,14371
20200502,7,상동,8544,8516,20200505,17060
20200502,7,삼산체육관,2524,2398,20200505,4922
20200502,7,굴포천,5257,5337,20200505,10594
20200502,7,부평구청,5696,4837,20200505,10533
20200503,7,부평구청,4384,3764,20200506,8148
20200503,7,굴포천,4057,4021,20200506,8078
20200503,7,삼산체육관,2071,1835,20200506,3906
20200503,7,상동,6209,6116,20200506,12325
20200503,7,부천시청,5485,5417,20200506,10902
20200503,7,신중동,5969,5885,20200506,11854
20200503,7,춘의,2942,2885,20200506,5827
20200503,7,부천종합운동장,1954,1833,20200506,3787
20200503,7,까치울,3602,3562,20200506,7164
20200503,7,온수,3512,3593,20200506,7105
20200503,7,천왕,3726,3631,20200506,7357
20200503,7,광명사거리,11792,11485,20200506,23277
20200503,7,철산,9607,9714,20200506,19321
20200503,7,가산디지털단지,10066,9587,20200506,19653
20200503,7,남구로,6002,5832,20200506,11834
20200503,7,대림,5853,5524,20200506,11377
20200503,7,신풍,5158,4963,20200506,10121
20200503,7,보라매,3606,3643,20200506,7249
20200503,7,신대방삼거리,6925,7023,20200506,13948
20200503,7,장승배기,4700,4760,20200506,9460
20200503,7,상도,4245,4163,20200506,8408
20200503,7,숭실대입구,4764,5028,20200506,9792
20200503,7,남성,4866,4908,20200506,9774
20200503,7,이수,6974,6913,20200506,13887
20200503,7,내방,4097,4277,20200506,8374
20200503,7,고속터미널,13223,7105,20200506,20328
20200503,7,반포,2716,2674,20200506,5390
20200503,7,논현,5500,5854,20200506,11354
20200503,7,학동,4509,4959,20200506,9468
20200503,7,강남구청,4421,5018,20200506,9439
20200503,7,청담,5051,5245,20200506,10296
20200503,7,뚝섬유원지,8517,8352,20200506,16869
20200503,7,건대입구,7221,7630,20200506,14851
20200503,7,어린이대공원,5824,6081,20200506,11905
20200503,7,군자,6537,5229,20200506,11766
20200503,7,중곡,4545,4338,20200506,8883
20200503,7,용마산,2816,3060,20200506,5876
20200503,7,사가정,8243,7868,20200506,16111
20200503,7,면목,7231,7095,20200506,14326
20200503,7,상봉,8583,8462,20200506,17045
20200503,7,중화,5171,4928,20200506,10099
20200503,7,먹골,4850,4692,20200506,9542
20200503,7,태릉입구,4117,3729,20200506,7846
20200503,7,공릉,5553,5818,20200506,11371
20200503,7,하계,8086,7727,20200506,15813
20200503,7,중계,6022,5544,20200506,11566
20200503,7,노원,9600,9841,20200506,19441
20200503,7,마들,4728,4495,20200506,9223
20200503,7,수락산,7656,7662,20200506,15318
20200503,7,도봉산,4946,7220,20200506,12166
20200503,7,장암,1219,912,20200506,2131
20200504,7,부평구청,9272,7406,20200507,16678
20200504,7,굴포천,7393,7682,20200507,15075
20200504,7,삼산체육관,3791,3338,20200507,7129
20200504,7,상동,10880,11237,20200507,22117
20200504,7,부천시청,10188,9876,20200507,20064
20200504,7,신중동,12308,12373,20200507,24681
20200504,7,춘의,7124,6904,20200507,14028
20200504,7,부천종합운동장,3809,3214,20200507,7023
20200504,7,까치울,6335,5998,20200507,12333
20200504,7,온수,8343,7661,20200507,16004
20200504,7,천왕,8319,7667,20200507,15986
20200504,7,광명사거리,20757,20318,20200507,41075
20200504,7,철산,19207,19774,20200507,38981
20200504,7,가산디지털단지,30298,30135,20200507,60433
20200504,7,남구로,12138,12736,20200507,24874
20200504,7,대림,7261,7204,20200507,14465
20200504,7,신풍,9424,8853,20200507,18277
20200504,7,보라매,8054,7982,20200507,16036
20200504,7,신대방삼거리,13809,13117,20200507,26926
20200504,7,장승배기,8687,8262,20200507,16949
20200504,7,상도,8757,8265,20200507,17022
20200504,7,숭실대입구,9989,10064,20200507,20053
20200504,7,남성,9425,8791,20200507,18216
20200504,7,이수,13618,13358,20200507,26976
20200504,7,내방,11610,11808,20200507,23418
20200504,7,고속터미널,15442,12113,20200507,27555
20200504,7,반포,5345,5140,20200507,10485
20200504,7,논현,15837,17798,20200507,33635
20200504,7,학동,15954,17331,20200507,33285
20200504,7,강남구청,11415,13028,20200507,24443
20200504,7,청담,14600,16317,20200507,30917
20200504,7,뚝섬유원지,9393,9582,20200507,18975
20200504,7,건대입구,11397,12185,20200507,23582
20200504,7,어린이대공원,9843,10161,20200507,20004
20200504,7,군자,12378,9634,20200507,22012
20200504,7,중곡,8246,7627,20200507,15873
20200504,7,용마산,5151,4947,20200507,10098
20200504,7,사가정,13987,13951,20200507,27938
20200504,7,면목,13597,13056,20200507,26653
20200504,7,상봉,14824,14090,20200507,28914
20200504,7,중화,9812,9224,20200507,19036
20200504,7,먹골,8910,8504,20200507,17414
20200504,7,태릉입구,7080,6615,20200507,13695
20200504,7,공릉,10079,10084,20200507,20163
20200504,7,하계,15194,14056,20200507,29250
20200504,7,중계,12335,10677,20200507,23012
20200504,7,노원,18852,20506,20200507,39358
20200504,7,마들,10130,9387,20200507,19517
20200504,7,수락산,11463,10998,20200507,22461
20200504,7,도봉산,7451,8966,20200507,16417
20200504,7,장암,1972,820,20200507,2792
20200505,7,장암,1288,889,20200508,2177
20200505,7,도봉산,5127,7200,20200508,12327
20200505,7,수락산,7714,7694,20200508,15408
20200505,7,마들,5790,5471,20200508,11261
20200505,7,노원,11227,11620,20200508,22847
20200505,7,중계,6652,6063,20200508,12715
20200505,7,하계,8805,8330,20200508,17135
20200505,7,공릉,6216,6431,20200508,12647
20200505,7,태릉입구,4439,3895,20200508,8334
20200505,7,먹골,5218,5101,20200508,10319
20200505,7,중화,5790,5612,20200508,11402
20200505,7,상봉,9621,9161,20200508,18782
20200505,7,면목,8565,8330,20200508,16895
20200505,7,사가정,8964,8754,20200508,17718
20200505,7,용마산,3311,3463,20200508,6774
20200505,7,중곡,4884,4586,20200508,9470
20200505,7,군자,7627,5925,20200508,13552
20200505,7,어린이대공원,8300,9109,20200508,17409
20200505,7,건대입구,8245,8655,20200508,16900
20200505,7,뚝섬유원지,9067,8606,20200508,17673
20200505,7,청담,6350,6739,20200508,13089
20200505,7,강남구청,5413,6019,20200508,11432
20200505,7,학동,5197,5565,20200508,10762
20200505,7,논현,6308,6670,20200508,12978
20200505,7,반포,3060,3040,20200508,6100
20200505,7,고속터미널,9847,6960,20200508,16807
20200505,7,내방,4919,5024,20200508,9943
20200505,7,이수,7695,7465,20200508,15160
20200505,7,남성,5486,5325,20200508,10811
20200505,7,숭실대입구,5617,5807,20200508,11424
20200505,7,상도,4782,4765,20200508,9547
20200505,7,장승배기,5075,4940,20200508,10015
20200505,7,신대방삼거리,7670,7535,20200508,15205
20200505,7,보라매,4139,4157,20200508,8296
20200505,7,신풍,5397,5226,20200508,10623
20200505,7,대림,5248,5054,20200508,10302
20200505,7,남구로,6317,6397,20200508,12714
20200505,7,가산디지털단지,11230,10608,20200508,21838
20200505,7,철산,10659,10794,20200508,21453
20200505,7,광명사거리,12898,12651,20200508,25549
20200505,7,천왕,4332,4263,20200508,8595
20200505,7,온수,4019,4095,20200508,8114
20200505,7,까치울,3913,3976,20200508,7889
20200505,7,부천종합운동장,2227,1983,20200508,4210
20200505,7,춘의,3690,3473,20200508,7163
20200505,7,신중동,6441,6363,20200508,12804
20200505,7,부천시청,6332,6115,20200508,12447
20200505,7,상동,6960,6978,20200508,13938
20200505,7,삼산체육관,2221,2003,20200508,4224
20200505,7,굴포천,4332,4475,20200508,8807
20200505,7,부평구청,4760,4181,20200508,8941
20200506,7,부평구청,11936,9504,20200509,21440
20200506,7,굴포천,8663,9013,20200509,17676
20200506,7,삼산체육관,4731,4126,20200509,8857
20200506,7,상동,12801,13231,20200509,26032
20200506,7,부천시청,12052,11860,20200509,23912
20200506,7,신중동,14532,14535,20200509,29067
20200506,7,춘의,9322,9104,20200509,18426
20200506,7,부천종합운동장,4418,3760,20200509,8178
20200506,7,까치울,7446,7185,20200509,14631
20200506,7,온수,10396,9700,20200509,20096
20200506,7,천왕,10192,9500,20200509,19692
20200506,7,광명사거리,23739,23319,20200509,47058
20200506,7,철산,22341,22895,20200509,45236
20200506,7,가산디지털단지,47470,47807,20200509,95277
20200506,7,남구로,16246,17244,20200509,33490
20200506,7,대림,7726,7546,20200509,15272
20200506,7,신풍,10974,10440,20200509,21414
20200506,7,보라매,10055,10039,20200509,20094
20200506,7,신대방삼거리,16507,15872,20200509,32379
20200506,7,장승배기,10240,9815,20200509,20055
20200506,7,상도,9976,9605,20200509,19581
20200506,7,숭실대입구,11698,11994,20200509,23692
20200506,7,남성,11392,10486,20200509,21878
20200506,7,이수,15595,15326,20200509,30921
20200506,7,내방,14547,14945,20200509,29492
20200506,7,고속터미널,14656,12354,20200509,27010
20200506,7,반포,6018,5806,20200509,11824
20200506,7,논현,20819,22743,20200509,43562
20200506,7,학동,24246,26281,20200509,50527
20200506,7,강남구청,16190,17907,20200509,34097
20200506,7,청담,20354,22672,20200509,43026
20200506,7,뚝섬유원지,9982,9982,20200509,19964
20200506,7,건대입구,11811,12546,20200509,24357
20200506,7,어린이대공원,11210,11133,20200509,22343
20200506,7,군자,14273,11380,20200509,25653
20200506,7,중곡,9537,8975,20200509,18512
20200506,7,용마산,6053,5841,20200509,11894
20200506,7,사가정,15610,15725,20200509,31335
20200506,7,면목,15428,14916,20200509,30344
20200506,7,상봉,16776,15683,20200509,32459
20200506,7,중화,11098,10600,20200509,21698
20200506,7,먹골,10260,9864,20200509,20124
20200506,7,태릉입구,7808,7378,20200509,15186
20200506,7,공릉,11257,11340,20200509,22597
20200506,7,장암,2519,860,20200509,3379
20200506,7,도봉산,8901,10584,20200509,19485
20200506,7,수락산,12564,12441,20200509,25005
20200506,7,마들,11789,11131,20200509,22920
20200506,7,노원,19391,20904,20200509,40295
20200506,7,중계,14398,12825,20200509,27223
20200506,7,하계,17790,16989,20200509,34779
20200507,7,장암,2436,888,20200510,3324
20200507,7,도봉산,9059,10525,20200510,19584
20200507,7,수락산,12772,12512,20200510,25284
20200507,7,마들,11896,11063,20200510,22959
20200507,7,노원,19538,21198,20200510,40736
20200507,7,중계,14532,12868,20200510,27400
20200507,7,하계,17855,16785,20200510,34640
20200507,7,공릉,11431,11362,20200510,22793
20200507,7,태릉입구,8143,7724,20200510,15867
20200507,7,먹골,10290,9879,20200510,20169
20200507,7,중화,10984,10411,20200510,21395
20200507,7,상봉,17041,16060,20200510,33101
20200507,7,면목,15323,14822,20200510,30145
20200507,7,사가정,15736,15584,20200510,31320
20200507,7,용마산,6123,5807,20200510,11930
20200507,7,중곡,9684,8926,20200510,18610
20200507,7,군자,14528,11444,20200510,25972
20200507,7,어린이대공원,11462,11202,20200510,22664
20200507,7,건대입구,12346,13254,20200510,25600
20200507,7,뚝섬유원지,10048,9840,20200510,19888
20200507,7,청담,20307,22900,20200510,43207
20200507,7,강남구청,15999,17930,20200510,33929
20200507,7,학동,24086,26332,20200510,50418
20200507,7,논현,20985,22960,20200510,43945
20200507,7,반포,6066,5863,20200510,11929
20200507,7,고속터미널,14987,13178,20200510,28165
20200507,7,내방,14557,15186,20200510,29743
20200507,7,이수,15800,15528,20200510,31328
20200507,7,남성,11434,10447,20200510,21881
20200507,7,숭실대입구,11979,11745,20200510,23724
20200507,7,부평구청,11922,9520,20200510,21442
20200507,7,굴포천,8837,9219,20200510,18056
20200507,7,삼산체육관,4842,4273,20200510,9115
20200507,7,상동,12834,13126,20200510,25960
20200507,7,부천시청,12263,11962,20200510,24225
20200507,7,신중동,14468,14544,20200510,29012
20200507,7,춘의,9374,9053,20200510,18427
20200507,7,부천종합운동장,4462,3836,20200510,8298
20200507,7,까치울,7643,7243,20200510,14886
20200507,7,온수,10515,9722,20200510,20237
20200507,7,천왕,10112,9401,20200510,19513
20200507,7,광명사거리,23976,23264,20200510,47240
20200507,7,철산,22663,23324,20200510,45987
20200507,7,가산디지털단지,47077,47944,20200510,95021
20200507,7,남구로,16210,17254,20200510,33464
20200507,7,대림,7541,7419,20200510,14960
20200507,7,신풍,11086,10418,20200510,21504
20200507,7,보라매,10087,10228,20200510,20315
20200507,7,신대방삼거리,16563,15535,20200510,32098
20200507,7,장승배기,10062,9715,20200510,19777
20200507,7,상도,10373,9780,20200510,20153
20200508,7,장암,2452,906,20200511,3358
20200508,7,도봉산,9237,10661,20200511,19898
20200508,7,수락산,13165,13255,20200511,26420
20200508,7,마들,12145,11424,20200511,23569
20200508,7,노원,20241,22099,20200511,42340
20200508,7,중계,14610,13083,20200511,27693
20200508,7,하계,17976,17380,20200511,35356
20200508,7,공릉,11943,12008,20200511,23951
20200508,7,태릉입구,8289,7933,20200511,16222
20200508,7,먹골,10642,10403,20200511,21045
20200508,7,중화,11128,10986,20200511,22114
20200508,7,상봉,17079,16522,20200511,33601
20200508,7,면목,15859,15512,20200511,31371
20200508,7,사가정,16126,16534,20200511,32660
20200508,7,용마산,6126,5836,20200511,11962
20200508,7,중곡,9797,9256,20200511,19053
20200508,7,군자,14736,11699,20200511,26435
20200508,7,어린이대공원,11620,10921,20200511,22541
20200508,7,건대입구,12971,13897,20200511,26868
20200508,7,뚝섬유원지,8341,8338,20200511,16679
20200508,7,청담,20817,22988,20200511,43805
20200508,7,강남구청,16301,18243,20200511,34544
20200508,7,학동,25149,26264,20200511,51413
20200508,7,논현,21119,23021,20200511,44140
20200508,7,반포,6519,6129,20200511,12648
20200508,7,고속터미널,15947,13963,20200511,29910
20200508,7,내방,14877,15353,20200511,30230
20200508,7,이수,16046,15756,20200511,31802
20200508,7,남성,11658,10605,20200511,22263
20200508,7,숭실대입구,12433,12231,20200511,24664
20200508,7,상도,10660,9977,20200511,20637
20200508,7,장승배기,10391,9935,20200511,20326
20200508,7,신대방삼거리,16909,15944,20200511,32853
20200508,7,보라매,10473,10286,20200511,20759
20200508,7,신풍,11227,10943,20200511,22170
20200508,7,대림,7896,7964,20200511,15860
20200508,7,남구로,16915,17659,20200511,34574
20200508,7,가산디지털단지,49228,47567,20200511,96795
20200508,7,철산,22975,24588,20200511,47563
20200508,7,광명사거리,24397,24503,20200511,48900
20200508,7,천왕,10414,9568,20200511,19982
20200508,7,온수,10569,9915,20200511,20484
20200508,7,까치울,7702,7589,20200511,15291
20200508,7,부천종합운동장,4565,3914,20200511,8479
20200508,7,춘의,9445,9226,20200511,18671
20200508,7,신중동,14755,15313,20200511,30068
20200508,7,부천시청,12668,12624,20200511,25292
20200508,7,상동,13171,14055,20200511,27226
20200508,7,삼산체육관,4762,4298,20200511,9060
20200508,7,굴포천,8896,9637,20200511,18533
20200508,7,부평구청,12029,9793,20200511,21822
20200509,7,장암,1062,676,20200512,1738
20200509,7,도봉산,4841,5838,20200512,10679
20200509,7,수락산,8150,7837,20200512,15987
20200509,7,마들,7068,6514,20200512,13582
20200509,7,노원,13284,14297,20200512,27581
20200509,7,중계,7885,6911,20200512,14796
20200509,7,하계,10402,9734,20200512,20136
20200509,7,공릉,7152,7176,20200512,14328
20200509,7,태릉입구,5165,4620,20200512,9785
20200509,7,먹골,7207,6869,20200512,14076
20200509,7,중화,6810,6498,20200512,13308
20200509,7,상봉,10857,10513,20200512,21370
20200509,7,면목,9713,9352,20200512,19065
20200509,7,사가정,10353,10027,20200512,20380
20200509,7,용마산,3591,3345,20200512,6936
20200509,7,중곡,5720,5279,20200512,10999
20200509,7,군자,8851,6752,20200512,15603
20200509,7,어린이대공원,6536,6437,20200512,12973
20200509,7,건대입구,9147,10058,20200512,19205
20200509,7,뚝섬유원지,4103,4057,20200512,8160
20200509,7,청담,9723,10184,20200512,19907
20200509,7,강남구청,8497,9261,20200512,17758
20200509,7,학동,10125,10607,20200512,20732
20200509,7,논현,10108,11101,20200512,21209
20200509,7,반포,4067,3644,20200512,7711
20200509,7,고속터미널,12786,9986,20200512,22772
20200509,7,내방,6758,6538,20200512,13296
20200509,7,이수,10057,9671,20200512,19728
20200509,7,남성,6682,6091,20200512,12773
20200509,7,숭실대입구,6672,6477,20200512,13149
20200509,7,상도,6107,5766,20200512,11873
20200509,7,장승배기,6314,5984,20200512,12298
20200509,7,신대방삼거리,9560,8841,20200512,18401
20200509,7,보라매,5559,5238,20200512,10797
20200509,7,신풍,6536,6315,20200512,12851
20200509,7,대림,5842,6178,20200512,12020
20200509,7,남구로,7262,7427,20200512,14689
20200509,7,가산디지털단지,12508,11333,20200512,23841
20200509,7,철산,13329,13570,20200512,26899
20200509,7,광명사거리,14830,14836,20200512,29666
20200509,7,천왕,5042,4617,20200512,9659
20200509,7,온수,4922,4772,20200512,9694
20200509,7,까치울,4355,4375,20200512,8730
20200509,7,부천종합운동장,2391,2032,20200512,4423
20200509,7,춘의,4174,3891,20200512,8065
20200509,7,신중동,8372,8244,20200512,16616
20200509,7,부천시청,7562,7426,20200512,14988
20200509,7,상동,9187,9220,20200512,18407
20200509,7,삼산체육관,2670,2445,20200512,5115
20200509,7,굴포천,5416,5629,20200512,11045
20200509,7,부평구청,5930,5094,20200512,11024
20200510,7,장암,1377,905,20200513,2282
20200510,7,도봉산,5131,7388,20200513,12519
20200510,7,수락산,7607,7518,20200513,15125
20200510,7,마들,5018,4698,20200513,9716
20200510,7,노원,10163,10386,20200513,20549
20200510,7,중계,6270,5595,20200513,11865
20200510,7,하계,8351,7783,20200513,16134
20200510,7,공릉,5937,6064,20200513,12001
20200510,7,태릉입구,4539,4168,20200513,8707
20200510,7,먹골,5128,5150,20200513,10278
20200510,7,중화,5524,5358,20200513,10882
20200510,7,상봉,8441,8158,20200513,16599
20200510,7,면목,7581,7368,20200513,14949
20200510,7,사가정,8314,8079,20200513,16393
20200510,7,용마산,2956,3106,20200513,6062
20200510,7,중곡,4633,4406,20200513,9039
20200510,7,군자,6972,5446,20200513,12418
20200510,7,어린이대공원,5751,6052,20200513,11803
20200510,7,건대입구,6805,7380,20200513,14185
20200510,7,뚝섬유원지,6675,6719,20200513,13394
20200510,7,청담,6231,6612,20200513,12843
20200510,7,강남구청,5052,5628,20200513,10680
20200510,7,학동,5154,5629,20200513,10783
20200510,7,논현,5739,6203,20200513,11942
20200510,7,반포,2586,2608,20200513,5194
20200510,7,고속터미널,12499,7751,20200513,20250
20200510,7,내방,4577,4812,20200513,9389
20200510,7,이수,7391,7171,20200513,14562
20200510,7,남성,5127,5049,20200513,10176
20200510,7,숭실대입구,5101,5539,20200513,10640
20200510,7,상도,4529,4570,20200513,9099
20200510,7,장승배기,4839,4802,20200513,9641
20200510,7,신대방삼거리,7260,7400,20200513,14660
20200510,7,보라매,3770,3749,20200513,7519
20200510,7,신풍,5198,4953,20200513,10151
20200510,7,대림,6114,5646,20200513,11760
20200510,7,남구로,6234,6069,20200513,12303
20200510,7,가산디지털단지,10075,9447,20200513,19522
20200510,7,철산,10186,10229,20200513,20415
20200510,7,광명사거리,12147,11835,20200513,23982
20200510,7,천왕,4075,3897,20200513,7972
20200510,7,온수,3751,3724,20200513,7475
20200510,7,까치울,3776,3810,20200513,7586
20200510,7,부천종합운동장,2033,1783,20200513,3816
20200510,7,춘의,3047,2951,20200513,5998
20200510,7,신중동,6134,6048,20200513,12182
20200510,7,부천시청,5547,5214,20200513,10761
20200510,7,상동,6276,5987,20200513,12263
20200510,7,삼산체육관,2003,1797,20200513,3800
20200510,7,굴포천,4189,3993,20200513,8182
20200510,7,부평구청,4614,3801,20200513,8415
20200511,7,부평구청,11639,9258,20200514,20897
20200511,7,굴포천,8524,8897,20200514,17421
20200511,7,삼산체육관,4658,4070,20200514,8728
20200511,7,상동,12135,12491,20200514,24626
20200511,7,부천시청,11371,11060,20200514,22431
20200511,7,신중동,14016,14071,20200514,28087
20200511,7,춘의,9250,9061,20200514,18311
20200511,7,부천종합운동장,4366,3842,20200514,8208
20200511,7,까치울,7370,7175,20200514,14545
20200511,7,온수,10366,9779,20200514,20145
20200511,7,천왕,10216,9504,20200514,19720
20200511,7,광명사거리,23519,22840,20200514,46359
20200511,7,철산,22124,22854,20200514,44978
20200511,7,가산디지털단지,47396,47425,20200514,94821
20200511,7,남구로,16567,17217,20200514,33784
20200511,7,대림,7590,7368,20200514,14958
20200511,7,신풍,10757,10201,20200514,20958
20200511,7,보라매,10076,10111,20200514,20187
20200511,7,신대방삼거리,16218,15593,20200514,31811
20200511,7,장승배기,9891,9674,20200514,19565
20200511,7,상도,10069,9807,20200514,19876
20200511,7,숭실대입구,11993,12089,20200514,24082
20200511,7,남성,11171,10256,20200514,21427
20200511,7,이수,15295,14995,20200514,30290
20200511,7,내방,14359,14875,20200514,29234
20200511,7,고속터미널,15595,12828,20200514,28423
20200511,7,반포,5887,5668,20200514,11555
20200511,7,논현,20414,22274,20200514,42688
20200511,7,학동,23680,25498,20200514,49178
20200511,7,강남구청,15532,17083,20200514,32615
20200511,7,청담,19867,22264,20200514,42131
20200511,7,뚝섬유원지,8237,8270,20200514,16507
20200511,7,건대입구,11437,12491,20200514,23928
20200511,7,어린이대공원,10859,10919,20200514,21778
20200511,7,군자,14007,11221,20200514,25228
20200511,7,중곡,9349,8718,20200514,18067
20200511,7,용마산,5930,5592,20200514,11522
20200511,7,사가정,15630,15697,20200514,31327
20200511,7,면목,15277,14778,20200514,30055
20200511,7,상봉,16501,15687,20200514,32188
20200511,7,중화,10865,10594,20200514,21459
20200511,7,먹골,10086,9710,20200514,19796
20200511,7,태릉입구,7989,7523,20200514,15512
20200511,7,공릉,11220,11425,20200514,22645
20200511,7,하계,17098,16172,20200514,33270
20200511,7,중계,14059,12740,20200514,26799
20200511,7,노원,19269,20625,20200514,39894
20200511,7,마들,11501,10959,20200514,22460
20200511,7,수락산,12354,12323,20200514,24677
20200511,7,도봉산,9372,10708,20200514,20080
20200511,7,장암,2482,887,20200514,3369
20200512,7,장암,2523,962,20200515,3485
20200512,7,도봉산,9172,10751,20200515,19923
20200512,7,수락산,12333,12362,20200515,24695
20200512,7,마들,11440,10756,20200515,22196
20200512,7,노원,18692,20084,20200515,38776
20200512,7,중계,13904,12608,20200515,26512
20200512,7,하계,16945,16023,20200515,32968
20200512,7,공릉,11112,11133,20200515,22245
20200512,7,태릉입구,8095,7516,20200515,15611
20200512,7,먹골,9929,9621,20200515,19550
20200512,7,중화,10859,10650,20200515,21509
20200512,7,상봉,16540,15550,20200515,32090
20200512,7,면목,14820,14497,20200515,29317
20200512,7,사가정,15365,15641,20200515,31006
20200512,7,용마산,5869,5672,20200515,11541
20200512,7,중곡,9461,8898,20200515,18359
20200512,7,군자,14067,11071,20200515,25138
20200512,7,어린이대공원,10904,10817,20200515,21721
20200512,7,건대입구,11497,12035,20200515,23532
20200512,7,뚝섬유원지,7996,8028,20200515,16024
20200512,7,청담,19698,22064,20200515,41762
20200512,7,강남구청,15861,17572,20200515,33433
20200512,7,학동,23960,25525,20200515,49485
20200512,7,논현,20419,22147,20200515,42566
20200512,7,반포,5797,5644,20200515,11441
20200512,7,고속터미널,14435,12736,20200515,27171
20200512,7,내방,14571,14959,20200515,29530
20200512,7,이수,15294,14989,20200515,30283
20200512,7,남성,11193,10350,20200515,21543
20200512,7,숭실대입구,11755,11950,20200515,23705
20200512,7,상도,10018,9613,20200515,19631
20200512,7,장승배기,9973,9626,20200515,19599
20200512,7,신대방삼거리,15928,15306,20200515,31234
20200512,7,보라매,10029,10063,20200515,20092
20200512,7,신풍,10741,10155,20200515,20896
20200512,7,대림,7408,7242,20200515,14650
20200512,7,남구로,15982,16836,20200515,32818
20200512,7,가산디지털단지,46437,46917,20200515,93354
20200512,7,철산,21867,22496,20200515,44363
20200512,7,광명사거리,23234,22689,20200515,45923
20200512,7,천왕,10039,9225,20200515,19264
20200512,7,온수,10272,9640,20200515,19912
20200512,7,까치울,7267,7032,20200515,14299
20200512,7,부천종합운동장,4401,3802,20200515,8203
20200512,7,춘의,9075,8909,20200515,17984
20200512,7,신중동,14127,14144,20200515,28271
20200512,7,부천시청,11235,11024,20200515,22259
20200512,7,상동,12027,12449,20200515,24476
20200512,7,삼산체육관,4557,4018,20200515,8575
20200512,7,굴포천,8395,8921,20200515,17316
20200512,7,부평구청,11406,9328,20200515,20734
20200513,7,마들,11520,10930,20200516,22450
20200513,7,수락산,12367,12375,20200516,24742
20200513,7,도봉산,9352,10883,20200516,20235
20200513,7,장암,2494,952,20200516,3446
20200513,7,춘의,9394,9115,20200516,18509
20200513,7,신중동,14039,14197,20200516,28236
20200513,7,부천시청,11400,11034,20200516,22434
20200513,7,상동,12468,12683,20200516,25151
20200513,7,삼산체육관,4508,3998,20200516,8506
20200513,7,굴포천,8377,8937,20200516,17314
20200513,7,온수,10447,9660,20200516,20107
20200513,7,천왕,10094,9503,20200516,19597
20200513,7,광명사거리,23465,22908,20200516,46373
20200513,7,철산,21984,22781,20200516,44765
20200513,7,가산디지털단지,46874,47031,20200516,93905
20200513,7,남구로,15977,17004,20200516,32981
20200513,7,대림,7248,7201,20200516,14449
20200513,7,신풍,10899,10276,20200516,21175
20200513,7,부평구청,11351,9258,20200516,20609
20200513,7,부천종합운동장,4436,3757,20200516,8193
20200513,7,까치울,7437,7236,20200516,14673
20200513,7,보라매,10184,10118,20200516,20302
20200513,7,신대방삼거리,16221,15401,20200516,31622
20200513,7,장승배기,9871,9573,20200516,19444
20200513,7,상도,10169,9746,20200516,19915
20200513,7,숭실대입구,11832,11937,20200516,23769
20200513,7,남성,11121,10346,20200516,21467
20200513,7,이수,15558,15019,20200516,30577
20200513,7,내방,14309,15016,20200516,29325
20200513,7,고속터미널,14251,12550,20200516,26801
20200513,7,반포,5952,5840,20200516,11792
20200513,7,논현,20140,21966,20200516,42106
20200513,7,학동,23671,25525,20200516,49196
20200513,7,강남구청,15891,17872,20200516,33763
20200513,7,청담,20033,22434,20200516,42467
20200513,7,뚝섬유원지,9291,9362,20200516,18653
20200513,7,건대입구,11721,12402,20200516,24123
20200513,7,어린이대공원,11216,11048,20200516,22264
20200513,7,군자,14309,11326,20200516,25635
20200513,7,중곡,9710,8982,20200516,18692
20200513,7,용마산,5989,5659,20200516,11648
20200513,7,사가정,15611,15637,20200516,31248
20200513,7,면목,15334,14789,20200516,30123
20200513,7,상봉,16779,15755,20200516,32534
20200513,7,중화,10972,10750,20200516,21722
20200513,7,먹골,10222,9762,20200516,19984
20200513,7,태릉입구,8027,7611,20200516,15638
20200513,7,공릉,11170,11373,20200516,22543
20200513,7,하계,17542,16648,20200516,34190
20200513,7,중계,14112,12713,20200516,26825
20200513,7,노원,18721,20190,20200516,38911
20200514,7,남구로,15769,16878,20200517,32647
20200514,7,부평구청,11521,9194,20200517,20715
20200514,7,굴포천,8331,8674,20200517,17005
20200514,7,삼산체육관,4542,3957,20200517,8499
20200514,7,상동,12063,12435,20200517,24498
20200514,7,부천시청,11193,10938,20200517,22131
20200514,7,신중동,13909,14043,20200517,27952
20200514,7,춘의,9122,9007,20200517,18129
20200514,7,부천종합운동장,4404,3781,20200517,8185
20200514,7,까치울,7363,7108,20200517,14471
20200514,7,온수,10401,9507,20200517,19908
20200514,7,천왕,9997,9343,20200517,19340
20200514,7,광명사거리,23136,22811,20200517,45947
20200514,7,철산,21684,22371,20200517,44055
20200514,7,가산디지털단지,46240,47216,20200517,93456
20200514,7,대림,7106,6963,20200517,14069
20200514,7,신풍,10680,10132,20200517,20812
20200514,7,보라매,9886,10107,20200517,19993
20200514,7,신대방삼거리,15922,15249,20200517,31171
20200514,7,장승배기,9695,9467,20200517,19162
20200514,7,상도,10125,9622,20200517,19747
20200514,7,숭실대입구,11755,11770,20200517,23525
20200514,7,남성,11211,10296,20200517,21507
20200514,7,이수,15292,15137,20200517,30429
20200514,7,내방,14521,14806,20200517,29327
20200514,7,고속터미널,14411,12446,20200517,26857
20200514,7,반포,5833,5583,20200517,11416
20200514,7,논현,20165,21859,20200517,42024
20200514,7,학동,23294,25248,20200517,48542
20200514,7,강남구청,15793,17722,20200517,33515
20200514,7,청담,19474,21950,20200517,41424
20200514,7,뚝섬유원지,9057,8971,20200517,18028
20200514,7,건대입구,11471,12253,20200517,23724
20200514,7,어린이대공원,10932,10616,20200517,21548
20200514,7,군자,13945,11255,20200517,25200
20200514,7,중곡,9372,8714,20200517,18086
20200514,7,용마산,6025,5761,20200517,11786
20200514,7,사가정,15346,15408,20200517,30754
20200514,7,면목,15045,14435,20200517,29480
20200514,7,상봉,16658,15509,20200517,32167
20200514,7,중화,10847,10591,20200517,21438
20200514,7,먹골,10096,9639,20200517,19735
20200514,7,태릉입구,8216,7747,20200517,15963
20200514,7,공릉,11216,11294,20200517,22510
20200514,7,하계,17185,16033,20200517,33218
20200514,7,중계,13927,12452,20200517,26379
20200514,7,노원,18505,19775,20200517,38280
20200514,7,마들,11551,10805,20200517,22356
20200514,7,수락산,12441,12284,20200517,24725
20200514,7,도봉산,9079,10673,20200517,19752
20200514,7,장암,2659,1147,20200517,3806
20200515,7,부평구청,10970,8723,20200518,19693
20200515,7,굴포천,8314,8852,20200518,17166
20200515,7,삼산체육관,4358,3846,20200518,8204
20200515,7,상동,12296,12863,20200518,25159
20200515,7,부천시청,11175,10973,20200518,22148
20200515,7,신중동,13705,13951,20200518,27656
20200515,7,춘의,8862,8676,20200518,17538
20200515,7,부천종합운동장,4050,3431,20200518,7481
20200515,7,까치울,6941,6639,20200518,13580
20200515,7,온수,10092,9333,20200518,19425
20200515,7,천왕,9796,8926,20200518,18722
20200515,7,광명사거리,22518,22179,20200518,44697
20200515,7,철산,21522,22499,20200518,44021
20200515,7,가산디지털단지,45789,45774,20200518,91563
20200515,7,남구로,15486,16473,20200518,31959
20200515,7,신풍,10490,9832,20200518,20322
20200515,7,보라매,9730,9403,20200518,19133
20200515,7,신대방삼거리,15940,14870,20200518,30810
20200515,7,장승배기,9768,9336,20200518,19104
20200515,7,상도,9921,9364,20200518,19285
20200515,7,숭실대입구,11704,11426,20200518,23130
20200515,7,남성,10924,9948,20200518,20872
20200515,7,이수,15396,15393,20200518,30789
20200515,7,내방,14104,14665,20200518,28769
20200515,7,고속터미널,16048,13401,20200518,29449
20200515,7,반포,6003,5597,20200518,11600
20200515,7,논현,19806,22176,20200518,41982
20200515,7,학동,23398,25038,20200518,48436
20200515,7,강남구청,15613,17553,20200518,33166
20200515,7,청담,19214,21486,20200518,40700
20200515,7,뚝섬유원지,6274,6077,20200518,12351
20200515,7,건대입구,11895,12886,20200518,24781
20200515,7,어린이대공원,11054,10813,20200518,21867
20200515,7,군자,14160,11374,20200518,25534
20200515,7,중곡,9304,8554,20200518,17858
20200515,7,용마산,5790,5285,20200518,11075
20200515,7,사가정,14819,14859,20200518,29678
20200515,7,면목,14826,14246,20200518,29072
20200515,7,상봉,16272,15596,20200518,31868
20200515,7,중화,10657,10409,20200518,21066
20200515,7,먹골,9984,9686,20200518,19670
20200515,7,태릉입구,7877,7342,20200518,15219
20200515,7,공릉,11040,11013,20200518,22053
20200515,7,하계,16516,15287,20200518,31803
20200515,7,중계,13477,11845,20200518,25322
20200515,7,노원,19055,20525,20200518,39580
20200515,7,마들,11377,10711,20200518,22088
20200515,7,수락산,11881,11554,20200518,23435
20200515,7,도봉산,8349,9299,20200518,17648
20200515,7,장암,2311,853,20200518,3164
20200515,7,대림,6988,7129,20200518,14117
20200516,7,부평구청,6378,5273,20200519,11651
20200516,7,굴포천,5688,5890,20200519,11578
20200516,7,삼산체육관,2719,2459,20200519,5178
20200516,7,상동,9464,9642,20200519,19106
20200516,7,부천시청,7663,7294,20200519,14957
20200516,7,신중동,8750,8930,20200519,17680
20200516,7,춘의,4535,4289,20200519,8824
20200516,7,부천종합운동장,2752,2484,20200519,5236
20200516,7,까치울,4919,4846,20200519,9765
20200516,7,온수,5457,5449,20200519,10906
20200516,7,천왕,5840,5330,20200519,11170
20200516,7,광명사거리,16161,16082,20200519,32243
20200516,7,철산,13973,14084,20200519,28057
20200516,7,가산디지털단지,13748,12795,20200519,26543
20200516,7,남구로,7542,7887,20200519,15429
20200516,7,대림,6221,6583,20200519,12804
20200516,7,신풍,7229,6968,20200519,14197
20200516,7,보라매,5694,5471,20200519,11165
20200516,7,신대방삼거리,10471,9661,20200519,20132
20200516,7,장승배기,6790,6324,20200519,13114
20200516,7,상도,6640,6155,20200519,12795
20200516,7,숭실대입구,7392,7188,20200519,14580
20200516,7,남성,7329,6745,20200519,14074
20200516,7,이수,10784,10450,20200519,21234
20200516,7,내방,7110,7160,20200519,14270
20200516,7,고속터미널,12000,10104,20200519,22104
20200516,7,반포,4309,3969,20200519,8278
20200516,7,논현,10675,11370,20200519,22045
20200516,7,학동,10262,10892,20200519,21154
20200516,7,청담,10570,11203,20200519,21773
20200516,7,뚝섬유원지,7019,6809,20200519,13828
20200516,7,건대입구,9560,10039,20200519,19599
20200516,7,어린이대공원,7422,7008,20200519,14430
20200516,7,군자,9636,7135,20200519,16771
20200516,7,중곡,6083,5640,20200519,11723
20200516,7,용마산,3795,3663,20200519,7458
20200516,7,사가정,11152,10911,20200519,22063
20200516,7,면목,10425,9940,20200519,20365
20200516,7,상봉,12330,11653,20200519,23983
20200516,7,중화,7721,7371,20200519,15092
20200516,7,먹골,7620,7315,20200519,14935
20200516,7,태릉입구,5978,5401,20200519,11379
20200516,7,공릉,8091,8008,20200519,16099
20200516,7,하계,11570,10683,20200519,22253
20200516,7,중계,8576,7472,20200519,16048
20200516,7,노원,13865,14866,20200519,28731
20200516,7,마들,7655,7034,20200519,14689
20200516,7,수락산,8884,8560,20200519,17444
20200516,7,도봉산,5917,7869,20200519,13786
20200516,7,장암,1336,925,20200519,2261
20200516,7,강남구청,8999,9878,20200519,18877
20200517,7,부평구청,4469,3739,20200520,8208
20200517,7,굴포천,3983,4006,20200520,7989
20200517,7,삼산체육관,1964,1768,20200520,3732
20200517,7,상동,6090,5883,20200520,11973
20200517,7,부천시청,5104,4972,20200520,10076
20200517,7,신중동,6165,6061,20200520,12226
20200517,7,춘의,3048,2876,20200520,5924
20200517,7,부천종합운동장,2154,1966,20200520,4120
20200517,7,까치울,3739,3714,20200520,7453
20200517,7,온수,3697,3710,20200520,7407
20200517,7,천왕,4089,3889,20200520,7978
20200517,7,광명사거리,12018,11808,20200520,23826
20200517,7,철산,9535,9726,20200520,19261
20200517,7,가산디지털단지,10011,9461,20200520,19472
20200517,7,남구로,6284,6129,20200520,12413
20200517,7,대림,6023,5608,20200520,11631
20200517,7,신풍,5358,4999,20200520,10357
20200517,7,보라매,3965,3890,20200520,7855
20200517,7,신대방삼거리,7552,7450,20200520,15002
20200517,7,장승배기,4696,4492,20200520,9188
20200517,7,상도,4575,4497,20200520,9072
20200517,7,숭실대입구,5197,5428,20200520,10625
20200517,7,남성,5076,4995,20200520,10071
20200517,7,이수,7540,7204,20200520,14744
20200517,7,내방,4511,4670,20200520,9181
20200517,7,고속터미널,10334,7165,20200520,17499
20200517,7,반포,2854,2942,20200520,5796
20200517,7,논현,5892,6130,20200520,12022
20200517,7,학동,5130,5564,20200520,10694
20200517,7,강남구청,4978,5372,20200520,10350
20200517,7,청담,5620,6168,20200520,11788
20200517,7,뚝섬유원지,7916,7540,20200520,15456
20200517,7,건대입구,7078,7311,20200520,14389
20200517,7,어린이대공원,5898,6101,20200520,11999
20200517,7,군자,6962,5510,20200520,12472
20200517,7,중곡,4895,4521,20200520,9416
20200517,7,용마산,3060,3354,20200520,6414
20200517,7,사가정,8576,8323,20200520,16899
20200517,7,면목,7699,7463,20200520,15162
20200517,7,상봉,9164,8530,20200520,17694
20200517,7,중화,5645,5348,20200520,10993
20200517,7,먹골,5198,5139,20200520,10337
20200517,7,태릉입구,4774,4477,20200520,9251
20200517,7,공릉,5920,5962,20200520,11882
20200517,7,하계,8516,8165,20200520,16681
20200517,7,중계,6125,5544,20200520,11669
20200517,7,노원,9966,10068,20200520,20034
20200517,7,마들,5240,4885,20200520,10125
20200517,7,수락산,8301,8467,20200520,16768
20200517,7,도봉산,5841,8293,20200520,14134
20200517,7,장암,1580,1130,20200520,2710
20200518,7,대림,7443,7214,20200521,14657
20200518,7,신풍,10367,10002,20200521,20369
20200518,7,보라매,9745,9787,20200521,19532
20200518,7,신대방삼거리,15675,15098,20200521,30773
20200518,7,장승배기,9614,9540,20200521,19154
20200518,7,상도,9685,9392,20200521,19077
20200518,7,숭실대입구,11282,11623,20200521,22905
20200518,7,남성,10727,10274,20200521,21001
20200518,7,이수,14701,14613,20200521,29314
20200518,7,내방,14238,14666,20200521,28904
20200518,7,고속터미널,14756,12205,20200521,26961
20200518,7,반포,5737,5549,20200521,11286
20200518,7,논현,19385,21554,20200521,40939
20200518,7,학동,23211,24565,20200521,47776
20200518,7,강남구청,14635,16575,20200521,31210
20200518,7,청담,19271,21574,20200521,40845
20200518,7,뚝섬유원지,6486,6443,20200521,12929
20200518,7,건대입구,11035,11768,20200521,22803
20200518,7,어린이대공원,10684,10529,20200521,21213
20200518,7,군자,13413,10875,20200521,24288
20200518,7,중곡,8968,8575,20200521,17543
20200518,7,용마산,5755,5549,20200521,11304
20200518,7,사가정,14739,14842,20200521,29581
20200518,7,면목,14736,14718,20200521,29454
20200518,7,상봉,15973,14602,20200521,30575
20200518,7,중화,10666,10426,20200521,21092
20200518,7,먹골,9651,9356,20200521,19007
20200518,7,태릉입구,7727,7212,20200521,14939
20200518,7,공릉,10728,10917,20200521,21645
20200518,7,하계,16421,15654,20200521,32075
20200518,7,중계,13426,12279,20200521,25705
20200518,7,노원,18477,19215,20200521,37692
20200518,7,마들,11078,10804,20200521,21882
20200518,7,수락산,11809,11732,20200521,23541
20200518,7,도봉산,8582,9611,20200521,18193
20200518,7,장암,2330,788,20200521,3118
20200518,7,남구로,16064,17102,20200521,33166
20200518,7,가산디지털단지,47188,46611,20200521,93799
20200518,7,철산,20949,21700,20200521,42649
20200518,7,광명사거리,22238,22035,20200521,44273
20200518,7,천왕,9800,9298,20200521,19098
20200518,7,온수,10145,9281,20200521,19426
20200518,7,까치울,6734,6530,20200521,13264
20200518,7,부천종합운동장,4100,3547,20200521,7647
20200518,7,춘의,8915,8805,20200521,17720
20200518,7,신중동,13305,13361,20200521,26666
20200518,7,부천시청,10877,10616,20200521,21493
20200518,7,상동,11626,11868,20200521,23494
20200518,7,삼산체육관,4367,3922,20200521,8289
20200518,7,굴포천,8081,8582,20200521,16663
20200518,7,부평구청,10951,8693,20200521,19644
20200519,7,부평구청,11109,9010,20200522,20119
20200519,7,굴포천,8243,8681,20200522,16924
20200519,7,삼산체육관,4356,3803,20200522,8159
20200519,7,상동,11873,12241,20200522,24114
20200519,7,부천시청,11158,10775,20200522,21933
20200519,7,신중동,13499,13595,20200522,27094
20200519,7,춘의,9095,8894,20200522,17989
20200519,7,부천종합운동장,4117,3603,20200522,7720
20200519,7,까치울,6991,6874,20200522,13865
20200519,7,온수,10147,9385,20200522,19532
20200519,7,천왕,9739,9217,20200522,18956
20200519,7,광명사거리,22755,22144,20200522,44899
20200519,7,철산,21278,21458,20200522,42736
20200519,7,가산디지털단지,46519,47188,20200522,93707
20200519,7,남구로,15801,16713,20200522,32514
20200519,7,대림,7400,7251,20200522,14651
20200519,7,신풍,10579,10040,20200522,20619
20200519,7,보라매,9843,9835,20200522,19678
20200519,7,신대방삼거리,15764,15082,20200522,30846
20200519,7,장승배기,9669,9335,20200522,19004
20200519,7,상도,9818,9296,20200522,19114
20200519,7,숭실대입구,11488,11502,20200522,22990
20200519,7,남성,11051,10301,20200522,21352
20200519,7,이수,15225,14892,20200522,30117
20200519,7,내방,14244,14599,20200522,28843
20200519,7,고속터미널,13988,12359,20200522,26347
20200519,7,반포,5753,5537,20200522,11290
20200519,7,논현,19855,21771,20200522,41626
20200519,7,학동,23501,25084,20200522,48585
20200519,7,강남구청,15455,17144,20200522,32599
20200519,7,청담,19652,21904,20200522,41556
20200519,7,뚝섬유원지,6916,6878,20200522,13794
20200519,7,건대입구,11119,11658,20200522,22777
20200519,7,어린이대공원,10532,10494,20200522,21026
20200519,7,군자,13823,10971,20200522,24794
20200519,7,중곡,9263,8667,20200522,17930
20200519,7,용마산,5806,5508,20200522,11314
20200519,7,사가정,14865,14883,20200522,29748
20200519,7,면목,14697,14242,20200522,28939
20200519,7,상봉,15973,15069,20200522,31042
20200519,7,중화,10629,10507,20200522,21136
20200519,7,먹골,9810,9541,20200522,19351
20200519,7,태릉입구,7946,7466,20200522,15412
20200519,7,공릉,10916,10876,20200522,21792
20200519,7,하계,16679,15646,20200522,32325
20200519,7,중계,13514,12120,20200522,25634
20200519,7,노원,18280,19436,20200522,37716
20200519,7,마들,11186,10349,20200522,21535
20200519,7,수락산,11819,11694,20200522,23513
20200519,7,도봉산,8505,9623,20200522,18128
20200519,7,장암,2215,744,20200522,2959
20200520,7,부평구청,11643,9222,20200523,20865
20200520,7,굴포천,8663,8973,20200523,17636
20200520,7,삼산체육관,4738,4254,20200523,8992
20200520,7,상동,12239,12731,20200523,24970
20200520,7,부천시청,11651,11337,20200523,22988
20200520,7,신중동,14330,14179,20200523,28509
20200520,7,춘의,9367,9088,20200523,18455
20200520,7,부천종합운동장,4401,3771,20200523,8172
20200520,7,까치울,7343,7232,20200523,14575
20200520,7,온수,10738,9945,20200523,20683
20200520,7,천왕,10309,9586,20200523,19895
20200520,7,광명사거리,23706,23223,20200523,46929
20200520,7,철산,22188,22850,20200523,45038
20200520,7,가산디지털단지,47007,47442,20200523,94449
20200520,7,남구로,16216,17240,20200523,33456
20200520,7,대림,7507,7375,20200523,14882
20200520,7,신풍,11097,10611,20200523,21708
20200520,7,보라매,10350,10569,20200523,20919
20200520,7,신대방삼거리,16636,15744,20200523,32380
20200520,7,장승배기,10277,9902,20200523,20179
20200520,7,상도,10259,9847,20200523,20106
20200520,7,숭실대입구,12089,12189,20200523,24278
20200520,7,남성,11396,10559,20200523,21955
20200520,7,이수,15649,15386,20200523,31035
20200520,7,내방,14660,14997,20200523,29657
20200520,7,고속터미널,14250,12564,20200523,26814
20200520,7,반포,6149,5883,20200523,12032
20200520,7,논현,20750,22589,20200523,43339
20200520,7,학동,23669,25548,20200523,49217
20200520,7,강남구청,15851,17940,20200523,33791
20200520,7,청담,20111,22510,20200523,42621
20200520,7,뚝섬유원지,9022,8996,20200523,18018
20200520,7,건대입구,11678,12525,20200523,24203
20200520,7,어린이대공원,11383,11282,20200523,22665
20200520,7,군자,14492,11418,20200523,25910
20200520,7,중곡,9894,9103,20200523,18997
20200520,7,용마산,6110,5938,20200523,12048
20200520,7,사가정,16010,15724,20200523,31734
20200520,7,면목,15631,15187,20200523,30818
20200520,7,상봉,16994,16043,20200523,33037
20200520,7,중화,11380,11001,20200523,22381
20200520,7,먹골,10186,9822,20200523,20008
20200520,7,태릉입구,8489,8107,20200523,16596
20200520,7,공릉,11726,11651,20200523,23377
20200520,7,하계,18122,16977,20200523,35099
20200520,7,중계,14375,12895,20200523,27270
20200520,7,노원,19347,20811,20200523,40158
20200520,7,마들,11855,11226,20200523,23081
20200520,7,수락산,12701,12686,20200523,25387
20200520,7,도봉산,9279,10986,20200523,20265
20200520,7,장암,2484,870,20200523,3354
20200521,7,장암,2530,982,20200524,3512
20200521,7,도봉산,9296,10739,20200524,20035
20200521,7,수락산,12650,12665,20200524,25315
20200521,7,마들,11932,11114,20200524,23046
20200521,7,노원,19202,20498,20200524,39700
20200521,7,중계,14212,12696,20200524,26908
20200521,7,하계,17651,16557,20200524,34208
20200521,7,공릉,11743,11642,20200524,23385
20200521,7,태릉입구,8757,8166,20200524,16923
20200521,7,먹골,10325,9963,20200524,20288
20200521,7,중화,11277,10817,20200524,22094
20200521,7,상봉,16941,15985,20200524,32926
20200521,7,면목,15339,14960,20200524,30299
20200521,7,사가정,15694,15674,20200524,31368
20200521,7,용마산,6084,5884,20200524,11968
20200521,7,중곡,9767,8882,20200524,18649
20200521,7,군자,14496,11396,20200524,25892
20200521,7,어린이대공원,11239,11027,20200524,22266
20200521,7,건대입구,11647,12223,20200524,23870
20200521,7,뚝섬유원지,9425,9277,20200524,18702
20200521,7,청담,19783,22296,20200524,42079
20200521,7,강남구청,15632,17799,20200524,33431
20200521,7,학동,23457,25589,20200524,49046
20200521,7,논현,20373,22425,20200524,42798
20200521,7,반포,6086,5858,20200524,11944
20200521,7,고속터미널,14505,12669,20200524,27174
20200521,7,내방,14382,15003,20200524,29385
20200521,7,이수,15720,15320,20200524,31040
20200521,7,남성,11364,10447,20200524,21811
20200521,7,숭실대입구,11956,11989,20200524,23945
20200521,7,상도,10390,9786,20200524,20176
20200521,7,장승배기,10124,9713,20200524,19837
20200521,7,부평구청,11518,9270,20200524,20788
20200521,7,굴포천,8476,8806,20200524,17282
20200521,7,삼산체육관,4647,4075,20200524,8722
20200521,7,상동,12070,12492,20200524,24562
20200521,7,부천시청,11522,11257,20200524,22779
20200521,7,신중동,13935,13903,20200524,27838
20200521,7,춘의,9167,9012,20200524,18179
20200521,7,부천종합운동장,4477,3817,20200524,8294
20200521,7,까치울,7561,7291,20200524,14852
20200521,7,온수,10427,9813,20200524,20240
20200521,7,천왕,10142,9494,20200524,19636
20200521,7,광명사거리,23358,23005,20200524,46363
20200521,7,철산,21962,22559,20200524,44521
20200521,7,가산디지털단지,46904,47786,20200524,94690
20200521,7,남구로,15956,17045,20200524,33001
20200521,7,대림,7300,7170,20200524,14470
20200521,7,신풍,10926,10293,20200524,21219
20200521,7,보라매,10256,10233,20200524,20489
20200521,7,신대방삼거리,16204,15418,20200524,31622
20200522,7,내방,14427,14774,20200525,29201
20200522,7,고속터미널,16511,14261,20200525,30772
20200522,7,이수,16340,16301,20200525,32641
20200522,7,남성,11416,10279,20200525,21695
20200522,7,숭실대입구,12320,11967,20200525,24287
20200522,7,상도,10634,9805,20200525,20439
20200522,7,장승배기,10174,9740,20200525,19914
20200522,7,신대방삼거리,16670,15506,20200525,32176
20200522,7,보라매,10442,10409,20200525,20851
20200522,7,신풍,11147,10602,20200525,21749
20200522,7,대림,7583,7771,20200525,15354
20200522,7,남구로,15941,17041,20200525,32982
20200522,7,가산디지털단지,46918,47037,20200525,93955
20200522,7,철산,22430,23555,20200525,45985
20200522,7,광명사거리,23983,23314,20200525,47297
20200522,7,천왕,10254,9543,20200525,19797
20200522,7,온수,10660,9962,20200525,20622
20200522,7,까치울,7553,7188,20200525,14741
20200522,7,부천종합운동장,4506,3881,20200525,8387
20200522,7,춘의,9376,8987,20200525,18363
20200522,7,신중동,14200,14298,20200525,28498
20200522,7,부천시청,11809,11537,20200525,23346
20200522,7,상동,12490,12707,20200525,25197
20200522,7,삼산체육관,4555,4043,20200525,8598
20200522,7,굴포천,8533,9117,20200525,17650
20200522,7,부평구청,11539,9157,20200525,20696
20200522,7,장암,2430,949,20200525,3379
20200522,7,도봉산,9270,10480,20200525,19750
20200522,7,수락산,12846,12645,20200525,25491
20200522,7,마들,11854,10952,20200525,22806
20200522,7,노원,19973,21834,20200525,41807
20200522,7,중계,14490,12686,20200525,27176
20200522,7,하계,17860,16495,20200525,34355
20200522,7,공릉,11975,11998,20200525,23973
20200522,7,태릉입구,8707,8250,20200525,16957
20200522,7,먹골,10471,9982,20200525,20453
20200522,7,중화,11432,10779,20200525,22211
20200522,7,상봉,17404,16444,20200525,33848
20200522,7,면목,15644,14919,20200525,30563
20200522,7,사가정,16047,16008,20200525,32055
20200522,7,용마산,6223,5722,20200525,11945
20200522,7,중곡,9684,8930,20200525,18614
20200522,7,군자,14842,11632,20200525,26474
20200522,7,어린이대공원,11531,11082,20200525,22613
20200522,7,건대입구,11862,13010,20200525,24872
20200522,7,뚝섬유원지,8640,8581,20200525,17221
20200522,7,청담,19963,22610,20200525,42573
20200522,7,강남구청,15719,17969,20200525,33688
20200522,7,학동,23574,25575,20200525,49149
20200522,7,논현,20765,23384,20200525,44149
20200522,7,반포,6445,5919,20200525,12364
20200523,7,장암,1623,1111,20200526,2734
20200523,7,도봉산,7280,9823,20200526,17103
20200523,7,수락산,10278,10187,20200526,20465
20200523,7,마들,8242,7628,20200526,15870
20200523,7,노원,14973,16149,20200526,31122
20200523,7,중계,9490,8256,20200526,17746
20200523,7,하계,12740,11858,20200526,24598
20200523,7,공릉,8983,8717,20200526,17700
20200523,7,태릉입구,7167,6513,20200526,13680
20200523,7,먹골,7967,7653,20200526,15620
20200523,7,중화,8060,7615,20200526,15675
20200523,7,상봉,13196,12594,20200526,25790
20200523,7,면목,11250,10692,20200526,21942
20200523,7,사가정,12083,11650,20200526,23733
20200523,7,용마산,4310,4424,20200526,8734
20200523,7,중곡,6595,5994,20200526,12589
20200523,7,군자,10387,7800,20200526,18187
20200523,7,어린이대공원,8431,8435,20200526,16866
20200523,7,건대입구,10136,10681,20200526,20817
20200523,7,뚝섬유원지,12353,12099,20200526,24452
20200523,7,청담,10857,11557,20200526,22414
20200523,7,강남구청,9369,10502,20200526,19871
20200523,7,학동,10551,11195,20200526,21746
20200523,7,논현,11476,12433,20200526,23909
20200523,7,반포,4731,4315,20200526,9046
20200523,7,고속터미널,12987,11042,20200526,24029
20200523,7,내방,7634,7474,20200526,15108
20200523,7,이수,11793,11487,20200526,23280
20200523,7,남성,7722,7094,20200526,14816
20200523,7,숭실대입구,8134,8086,20200526,16220
20200523,7,상도,7131,6599,20200526,13730
20200523,7,장승배기,7220,6689,20200526,13909
20200523,7,신대방삼거리,11269,10315,20200526,21584
20200523,7,보라매,6398,6147,20200526,12545
20200523,7,신풍,7776,7369,20200526,15145
20200523,7,대림,6448,6870,20200526,13318
20200523,7,남구로,7948,8468,20200526,16416
20200523,7,가산디지털단지,15278,14293,20200526,29571
20200523,7,철산,15112,15482,20200526,30594
20200523,7,광명사거리,16907,17022,20200526,33929
20200523,7,천왕,6205,5761,20200526,11966
20200523,7,온수,5692,5575,20200526,11267
20200523,7,까치울,5331,5284,20200526,10615
20200523,7,부천종합운동장,2958,2715,20200526,5673
20200523,7,춘의,4667,4470,20200526,9137
20200523,7,신중동,9107,9002,20200526,18109
20200523,7,부천시청,7598,7419,20200526,15017
20200523,7,상동,8973,9093,20200526,18066
20200523,7,삼산체육관,3097,2881,20200526,5978
20200523,7,굴포천,5804,5903,20200526,11707
20200523,7,부평구청,6400,5458,20200526,11858
20200524,7,부평구청,4198,3584,20200527,7782
20200524,7,굴포천,3785,3713,20200527,7498
20200524,7,삼산체육관,1920,1717,20200527,3637
20200524,7,상동,5274,5101,20200527,10375
20200524,7,부천시청,4660,4627,20200527,9287
20200524,7,신중동,5560,5415,20200527,10975
20200524,7,춘의,3038,2796,20200527,5834
20200524,7,부천종합운동장,1854,1576,20200527,3430
20200524,7,까치울,3361,3414,20200527,6775
20200524,7,온수,3740,3755,20200527,7495
20200524,7,천왕,3958,3728,20200527,7686
20200524,7,광명사거리,11628,11440,20200527,23068
20200524,7,철산,9560,9594,20200527,19154
20200524,7,가산디지털단지,10365,9588,20200527,19953
20200524,7,남구로,6101,5863,20200527,11964
20200524,7,대림,5927,5467,20200527,11394
20200524,7,신풍,5195,4855,20200527,10050
20200524,7,보라매,4022,3894,20200527,7916
20200524,7,신대방삼거리,7135,6970,20200527,14105
20200524,7,장승배기,4567,4496,20200527,9063
20200524,7,상도,4529,4441,20200527,8970
20200524,7,숭실대입구,5121,5323,20200527,10444
20200524,7,남성,5034,4945,20200527,9979
20200524,7,이수,7490,7206,20200527,14696
20200524,7,내방,4439,4616,20200527,9055
20200524,7,고속터미널,10213,6973,20200527,17186
20200524,7,반포,2600,2616,20200527,5216
20200524,7,논현,6045,6285,20200527,12330
20200524,7,학동,5327,5641,20200527,10968
20200524,7,강남구청,4850,5391,20200527,10241
20200524,7,청담,5579,5927,20200527,11506
20200524,7,뚝섬유원지,6861,6483,20200527,13344
20200524,7,건대입구,6577,6741,20200527,13318
20200524,7,어린이대공원,7449,7457,20200527,14906
20200524,7,군자,6809,5373,20200527,12182
20200524,7,중곡,4508,4245,20200527,8753
20200524,7,용마산,3053,3146,20200527,6199
20200524,7,사가정,8094,7763,20200527,15857
20200524,7,면목,7396,7173,20200527,14569
20200524,7,상봉,8215,7531,20200527,15746
20200524,7,중화,5489,5318,20200527,10807
20200524,7,먹골,5011,4871,20200527,9882
20200524,7,태릉입구,5019,4559,20200527,9578
20200524,7,공릉,5856,5961,20200527,11817
20200524,7,하계,8349,7862,20200527,16211
20200524,7,중계,5974,5389,20200527,11363
20200524,7,노원,9700,10048,20200527,19748
20200524,7,마들,4762,4531,20200527,9293
20200524,7,수락산,7052,6916,20200527,13968
20200524,7,도봉산,4884,6592,20200527,11476
20200524,7,장암,1097,743,20200527,1840
20200525,7,까치울,7337,7036,20200528,14373
20200525,7,부평구청,11527,9160,20200528,20687
20200525,7,굴포천,8333,8828,20200528,17161
20200525,7,삼산체육관,4588,4075,20200528,8663
20200525,7,상동,11987,12200,20200528,24187
20200525,7,부천시청,11419,11004,20200528,22423
20200525,7,신중동,13852,13865,20200528,27717
20200525,7,춘의,9257,9121,20200528,18378
20200525,7,부천종합운동장,4402,3790,20200528,8192
20200525,7,온수,10519,9815,20200528,20334
20200525,7,천왕,10419,9777,20200528,20196
20200525,7,광명사거리,23421,22941,20200528,46362
20200525,7,철산,21950,22446,20200528,44396
20200525,7,가산디지털단지,47362,47954,20200528,95316
20200525,7,남구로,16236,17004,20200528,33240
20200525,7,대림,7756,7444,20200528,15200
20200525,7,신풍,11031,10487,20200528,21518
20200525,7,보라매,10308,10550,20200528,20858
20200525,7,신대방삼거리,16391,15836,20200528,32227
20200525,7,장승배기,10194,9896,20200528,20090
20200525,7,상도,10210,9953,20200528,20163
20200525,7,숭실대입구,11804,11991,20200528,23795
20200525,7,남성,11190,10381,20200528,21571
20200525,7,이수,15464,15184,20200528,30648
20200525,7,내방,14437,14880,20200528,29317
20200525,7,고속터미널,15175,12843,20200528,28018
20200525,7,반포,5913,5767,20200528,11680
20200525,7,논현,20611,22582,20200528,43193
20200525,7,학동,23924,25679,20200528,49603
20200525,7,강남구청,15314,17181,20200528,32495
20200525,7,청담,20024,22387,20200528,42411
20200525,7,뚝섬유원지,8689,8650,20200528,17339
20200525,7,건대입구,11355,11996,20200528,23351
20200525,7,어린이대공원,11112,10878,20200528,21990
20200525,7,군자,14064,11289,20200528,25353
20200525,7,중곡,9538,8927,20200528,18465
20200525,7,용마산,5980,5730,20200528,11710
20200525,7,사가정,15759,15673,20200528,31432
20200525,7,면목,15406,14915,20200528,30321
20200525,7,상봉,16828,15875,20200528,32703
20200525,7,중화,11096,10737,20200528,21833
20200525,7,먹골,10145,9712,20200528,19857
20200525,7,태릉입구,8584,8093,20200528,16677
20200525,7,공릉,11587,11666,20200528,23253
20200525,7,하계,17144,16065,20200528,33209
20200525,7,중계,14336,12950,20200528,27286
20200525,7,노원,19347,20649,20200528,39996
20200525,7,마들,11753,11171,20200528,22924
20200525,7,수락산,12513,12496,20200528,25009
20200525,7,도봉산,9258,10544,20200528,19802
20200525,7,장암,2544,863,20200528,3407
20200526,7,부평구청,11502,9192,20200529,20694
20200526,7,굴포천,8463,8860,20200529,17323
20200526,7,삼산체육관,4505,4061,20200529,8566
20200526,7,상동,11716,11999,20200529,23715
20200526,7,부천시청,11333,10994,20200529,22327
20200526,7,신중동,13754,13738,20200529,27492
20200526,7,춘의,9250,9025,20200529,18275
20200526,7,부천종합운동장,4452,3777,20200529,8229
20200526,7,까치울,7202,7075,20200529,14277
20200526,7,온수,10590,9786,20200529,20376
20200526,7,천왕,10234,9531,20200529,19765
20200526,7,광명사거리,23314,22934,20200529,46248
20200526,7,철산,21999,22527,20200529,44526
20200526,7,가산디지털단지,47396,47851,20200529,95247
20200526,7,남구로,15975,17179,20200529,33154
20200526,7,대림,7472,7448,20200529,14920
20200526,7,신풍,10871,10453,20200529,21324
20200526,7,보라매,10323,10366,20200529,20689
20200526,7,신대방삼거리,16232,15634,20200529,31866
20200526,7,장승배기,10005,9816,20200529,19821
20200526,7,상도,10373,9937,20200529,20310
20200526,7,숭실대입구,12281,12313,20200529,24594
20200526,7,남성,11232,10425,20200529,21657
20200526,7,이수,15408,15174,20200529,30582
20200526,7,내방,14440,14839,20200529,29279
20200526,7,고속터미널,14373,12634,20200529,27007
20200526,7,반포,5994,5811,20200529,11805
20200526,7,논현,20362,22297,20200529,42659
20200526,7,학동,24198,26138,20200529,50336
20200526,7,강남구청,15831,17738,20200529,33569
20200526,7,청담,20206,22719,20200529,42925
20200526,7,뚝섬유원지,7487,7488,20200529,14975
20200526,7,건대입구,11443,11932,20200529,23375
20200526,7,어린이대공원,11158,11091,20200529,22249
20200526,7,군자,14384,11397,20200529,25781
20200526,7,중곡,9776,9034,20200529,18810
20200526,7,용마산,6094,5917,20200529,12011
20200526,7,사가정,15511,15400,20200529,30911
20200526,7,면목,15373,14862,20200529,30235
20200526,7,상봉,16889,15631,20200529,32520
20200526,7,중화,10899,10733,20200529,21632
20200526,7,먹골,10171,9933,20200529,20104
20200526,7,태릉입구,8320,7898,20200529,16218
20200526,7,공릉,11450,11487,20200529,22937
20200526,7,하계,17464,16564,20200529,34028
20200526,7,중계,14354,13106,20200529,27460
20200526,7,노원,19157,20110,20200529,39267
20200526,7,마들,11645,11097,20200529,22742
20200526,7,수락산,12436,12548,20200529,24984
20200526,7,도봉산,9188,10583,20200529,19771
20200526,7,장암,2414,903,20200529,3317
20200527,7,부평구청,11543,9154,20200530,20697
20200527,7,굴포천,8462,8877,20200530,17339
20200527,7,삼산체육관,4563,4077,20200530,8640
20200527,7,상동,11844,12125,20200530,23969
20200527,7,부천시청,11261,10927,20200530,22188
20200527,7,신중동,13670,13869,20200530,27539
20200527,7,춘의,9332,8997,20200530,18329
20200527,7,부천종합운동장,4583,3819,20200530,8402
20200527,7,까치울,7503,7243,20200530,14746
20200527,7,온수,10957,10309,20200530,21266
20200527,7,천왕,10461,9711,20200530,20172
20200527,7,광명사거리,23652,23256,20200530,46908
20200527,7,철산,22355,22898,20200530,45253
20200527,7,가산디지털단지,47232,47873,20200530,95105
20200527,7,남구로,16091,17125,20200530,33216
20200527,7,대림,7575,7484,20200530,15059
20200527,7,신풍,11112,10634,20200530,21746
20200527,7,보라매,10439,10557,20200530,20996
20200527,7,신대방삼거리,16694,15845,20200530,32539
20200527,7,장승배기,10268,9953,20200530,20221
20200527,7,상도,10306,9916,20200530,20222
20200527,7,숭실대입구,12397,12390,20200530,24787
20200527,7,남성,11477,10536,20200530,22013
20200527,7,이수,15542,15664,20200530,31206
20200527,7,내방,14499,15049,20200530,29548
20200527,7,고속터미널,14267,12567,20200530,26834
20200527,7,반포,6244,6033,20200530,12277
20200527,7,논현,20660,22593,20200530,43253
20200527,7,학동,24170,25907,20200530,50077
20200527,7,강남구청,16024,17951,20200530,33975
20200527,7,청담,20349,22914,20200530,43263
20200527,7,뚝섬유원지,9836,9721,20200530,19557
20200527,7,건대입구,11541,12173,20200530,23714
20200527,7,어린이대공원,11392,11292,20200530,22684
20200527,7,군자,14683,11343,20200530,26026
20200527,7,중곡,10062,9248,20200530,19310
20200527,7,용마산,6229,5969,20200530,12198
20200527,7,사가정,15923,16052,20200530,31975
20200527,7,면목,15703,15225,20200530,30928
20200527,7,상봉,17102,16096,20200530,33198
20200527,7,중화,11303,10983,20200530,22286
20200527,7,먹골,10230,9840,20200530,20070
20200527,7,태릉입구,8719,8316,20200530,17035
20200527,7,공릉,11896,11900,20200530,23796
20200527,7,하계,18376,17248,20200530,35624
20200527,7,중계,14829,13353,20200530,28182
20200527,7,노원,19312,20663,20200530,39975
20200527,7,마들,11867,11247,20200530,23114
20200527,7,수락산,12800,12739,20200530,25539
20200527,7,도봉산,9375,10761,20200530,20136
20200527,7,장암,2413,826,20200530,3239
20200528,7,춘의,8895,8739,20200531,17634
20200528,7,부평구청,11121,8836,20200531,19957
20200528,7,굴포천,8015,8320,20200531,16335
20200528,7,삼산체육관,4473,3928,20200531,8401
20200528,7,상동,11178,11542,20200531,22720
20200528,7,부천시청,10788,10536,20200531,21324
20200528,7,신중동,12752,12514,20200531,25266
20200528,7,부천종합운동장,4159,3555,20200531,7714
20200528,7,까치울,7166,6858,20200531,14024
20200528,7,온수,10614,9999,20200531,20613
20200528,7,천왕,10138,9374,20200531,19512
20200528,7,광명사거리,23183,22731,20200531,45914
20200528,7,철산,21826,22394,20200531,44220
20200528,7,가산디지털단지,46353,47550,20200531,93903
20200528,7,남구로,15647,16671,20200531,32318
20200528,7,대림,7291,7209,20200531,14500
20200528,7,신풍,10857,10169,20200531,21026
20200528,7,보라매,10312,10509,20200531,20821
20200528,7,신대방삼거리,16353,15472,20200531,31825
20200528,7,장승배기,9986,9726,20200531,19712
20200528,7,상도,10244,9666,20200531,19910
20200528,7,숭실대입구,12224,12175,20200531,24399
20200528,7,남성,11426,10404,20200531,21830
20200528,7,이수,15452,14942,20200531,30394
20200528,7,내방,14415,14951,20200531,29366
20200528,7,고속터미널,14560,12881,20200531,27441
20200528,7,반포,6067,5885,20200531,11952
20200528,7,논현,20455,22434,20200531,42889
20200528,7,학동,23393,25478,20200531,48871
20200528,7,강남구청,15841,17826,20200531,33667
20200528,7,청담,20023,22694,20200531,42717
20200528,7,뚝섬유원지,9686,9606,20200531,19292
20200528,7,건대입구,11342,11978,20200531,23320
20200528,7,어린이대공원,11090,11002,20200531,22092
20200528,7,군자,14383,11367,20200531,25750
20200528,7,중곡,9694,8932,20200531,18626
20200528,7,용마산,6119,5857,20200531,11976
20200528,7,사가정,15587,15595,20200531,31182
20200528,7,면목,15440,14867,20200531,30307
20200528,7,상봉,16699,15839,20200531,32538
20200528,7,중화,11024,10727,20200531,21751
20200528,7,먹골,10126,9649,20200531,19775
20200528,7,태릉입구,8370,8161,20200531,16531
20200528,7,공릉,11906,11973,20200531,23879
20200528,7,하계,17810,16760,20200531,34570
20200528,7,중계,14608,13174,20200531,27782
20200528,7,노원,19007,20326,20200531,39333
20200528,7,마들,11867,11167,20200531,23034
20200528,7,수락산,12693,12469,20200531,25162
20200528,7,도봉산,9266,10719,20200531,19985
20200528,7,장암,2424,860,20200531,3284
20200529,7,장암,2484,970,20200601,3454
20200529,7,도봉산,9145,10687,20200601,19832
20200529,7,수락산,12897,12564,20200601,25461
20200529,7,마들,12141,11329,20200601,23470
20200529,7,노원,19758,22035,20200601,41793
20200529,7,중계,14851,12919,20200601,27770
20200529,7,하계,17715,16317,20200601,34032
20200529,7,공릉,12188,12040,20200601,24228
20200529,7,태릉입구,8747,8239,20200601,16986
20200529,7,먹골,10366,10004,20200601,20370
20200529,7,중화,11305,10719,20200601,22024
20200529,7,상봉,17099,16153,20200601,33252
20200529,7,면목,15637,14869,20200601,30506
20200529,7,사가정,16164,15979,20200601,32143
20200529,7,용마산,6115,5598,20200601,11713
20200529,7,중곡,9851,9046,20200601,18897
20200529,7,군자,14742,11249,20200601,25991
20200529,7,어린이대공원,11399,11090,20200601,22489
20200529,7,건대입구,11715,12657,20200601,24372
20200529,7,뚝섬유원지,10633,10855,20200601,21488
20200529,7,청담,19978,22658,20200601,42636
20200529,7,강남구청,16053,18276,20200601,34329
20200529,7,학동,23716,25910,20200601,49626
20200529,7,논현,20664,23083,20200601,43747
20200529,7,반포,6272,6054,20200601,12326
20200529,7,고속터미널,16239,13943,20200601,30182
20200529,7,내방,14483,14944,20200601,29427
20200529,7,이수,16033,15948,20200601,31981
20200529,7,남성,11571,10336,20200601,21907
20200529,7,숭실대입구,12595,12019,20200601,24614
20200529,7,상도,10638,9874,20200601,20512
20200529,7,장승배기,10179,9696,20200601,19875
20200529,7,신대방삼거리,16469,15432,20200601,31901
20200529,7,보라매,10319,10133,20200601,20452
20200529,7,신풍,10878,10260,20200601,21138
20200529,7,대림,7309,7462,20200601,14771
20200529,7,남구로,15545,16704,20200601,32249
20200529,7,가산디지털단지,46556,46764,20200601,93320
20200529,7,철산,22154,23385,20200601,45539
20200529,7,광명사거리,23780,23154,20200601,46934
20200529,7,천왕,10197,9405,20200601,19602
20200529,7,온수,10623,9744,20200601,20367
20200529,7,까치울,7109,6781,20200601,13890
20200529,7,부천종합운동장,4226,3552,20200601,7778
20200529,7,춘의,8746,8471,20200601,17217
20200529,7,신중동,12952,12711,20200601,25663
20200529,7,부천시청,10883,10446,20200601,21329
20200529,7,상동,11378,11702,20200601,23080
20200529,7,삼산체육관,4309,3845,20200601,8154
20200529,7,굴포천,7925,8236,20200601,16161
20200529,7,부평구청,10973,8645,20200601,19618
20200530,7,장암,1701,1175,20200602,2876
20200530,7,도봉산,6954,9578,20200602,16532
20200530,7,수락산,9993,9765,20200602,19758
20200530,7,마들,8738,8040,20200602,16778
20200530,7,노원,14754,15711,20200602,30465
20200530,7,중계,8970,7901,20200602,16871
20200530,7,하계,12587,11676,20200602,24263
20200530,7,공릉,8291,8439,20200602,16730
20200530,7,태릉입구,6654,6277,20200602,12931
20200530,7,먹골,8011,7792,20200602,15803
20200530,7,중화,7867,7313,20200602,15180
20200530,7,상봉,12391,11892,20200602,24283
20200530,7,면목,10833,10479,20200602,21312
20200530,7,사가정,11599,11183,20200602,22782
20200530,7,용마산,4168,4144,20200602,8312
20200530,7,중곡,6725,6243,20200602,12968
20200530,7,군자,9952,7555,20200602,17507
20200530,7,어린이대공원,8052,7685,20200602,15737
20200530,7,건대입구,9959,10422,20200602,20381
20200530,7,뚝섬유원지,11973,12291,20200602,24264
20200530,7,청담,10625,11238,20200602,21863
20200530,7,강남구청,9076,10112,20200602,19188
20200530,7,학동,9837,10534,20200602,20371
20200530,7,논현,10690,11821,20200602,22511
20200530,7,반포,4475,4167,20200602,8642
20200530,7,고속터미널,12236,10277,20200602,22513
20200530,7,내방,7378,7290,20200602,14668
20200530,7,이수,11320,10807,20200602,22127
20200530,7,남성,7425,6808,20200602,14233
20200530,7,숭실대입구,8042,7913,20200602,15955
20200530,7,상도,6830,6265,20200602,13095
20200530,7,장승배기,6678,6284,20200602,12962
20200530,7,신대방삼거리,10820,9853,20200602,20673
20200530,7,보라매,5734,5508,20200602,11242
20200530,7,신풍,7124,6776,20200602,13900
20200530,7,대림,6381,6769,20200602,13150
20200530,7,남구로,7788,8152,20200602,15940
20200530,7,가산디지털단지,14539,13612,20200602,28151
20200530,7,철산,14215,14753,20200602,28968
20200530,7,광명사거리,16099,16124,20200602,32223
20200530,7,천왕,5541,5270,20200602,10811
20200530,7,온수,5389,5198,20200602,10587
20200530,7,까치울,4662,4450,20200602,9112
20200530,7,부천종합운동장,2563,2231,20200602,4794
20200530,7,춘의,4286,4037,20200602,8323
20200530,7,신중동,7791,7633,20200602,15424
20200530,7,부천시청,6740,6431,20200602,13171
20200530,7,상동,7454,7572,20200602,15026
20200530,7,삼산체육관,2598,2322,20200602,4920
20200530,7,굴포천,4943,5068,20200602,10011
20200530,7,부평구청,5807,4986,20200602,10793
20200531,7,부평구청,4060,3458,20200603,7518
20200531,7,굴포천,3641,3609,20200603,7250
20200531,7,삼산체육관,1782,1592,20200603,3374
20200531,7,상동,5214,5001,20200603,10215
20200531,7,부천시청,4614,4511,20200603,9125
20200531,7,신중동,4977,4945,20200603,9922
20200531,7,춘의,2836,2692,20200603,5528
20200531,7,부천종합운동장,1825,1683,20200603,3508
20200531,7,까치울,3287,3325,20200603,6612
20200531,7,온수,3603,3632,20200603,7235
20200531,7,천왕,4119,3934,20200603,8053
20200531,7,광명사거리,11551,11390,20200603,22941
20200531,7,철산,9285,9210,20200603,18495
20200531,7,가산디지털단지,10063,9355,20200603,19418
20200531,7,남구로,6136,5953,20200603,12089
20200531,7,대림,5950,5413,20200603,11363
20200531,7,신풍,5043,4763,20200603,9806
20200531,7,보라매,3742,3735,20200603,7477
20200531,7,신대방삼거리,7227,6959,20200603,14186
20200531,7,장승배기,4626,4589,20200603,9215
20200531,7,상도,4549,4537,20200603,9086
20200531,7,숭실대입구,5140,5358,20200603,10498
20200531,7,남성,4994,5040,20200603,10034
20200531,7,이수,7497,7222,20200603,14719
20200531,7,내방,4308,4493,20200603,8801
20200531,7,고속터미널,10598,7308,20200603,17906
20200531,7,반포,2780,2839,20200603,5619
20200531,7,논현,5823,6193,20200603,12016
20200531,7,학동,5472,5880,20200603,11352
20200531,7,강남구청,5018,5549,20200603,10567
20200531,7,청담,5873,6328,20200603,12201
20200531,7,뚝섬유원지,8588,8348,20200603,16936
20200531,7,건대입구,7024,7218,20200603,14242
20200531,7,어린이대공원,6939,6978,20200603,13917
20200531,7,군자,6888,5251,20200603,12139
20200531,7,중곡,4579,4326,20200603,8905
20200531,7,용마산,2953,3201,20200603,6154
20200531,7,사가정,8327,8207,20200603,16534
20200531,7,면목,7642,7313,20200603,14955
20200531,7,상봉,8788,8263,20200603,17051
20200531,7,중화,5613,5350,20200603,10963
20200531,7,먹골,5188,4996,20200603,10184
20200531,7,태릉입구,5012,4580,20200603,9592
20200531,7,공릉,6056,6248,20200603,12304
20200531,7,하계,8224,7897,20200603,16121
20200531,7,중계,6223,5632,20200603,11855
20200531,7,노원,9628,9931,20200603,19559
20200531,7,마들,4986,4548,20200603,9534
20200531,7,수락산,7996,8082,20200603,16078
20200531,7,도봉산,5690,8276,20200603,13966
20200531,7,장암,1521,1115,20200603,2636
20200101,8,모란,2542,2103,20200104,4645
20200101,8,수진,3261,3118,20200104,6379
20200101,8,신흥,3062,3257,20200104,6319
20200101,8,단대오거리,4779,5044,20200104,9823
20200101,8,남한산성입구,5961,5950,20200104,11911
20200101,8,산성,3041,3023,20200104,6064
20200101,8,복정,4130,3672,20200104,7802
20200101,8,장지,10784,10821,20200104,21605
20200101,8,문정,4346,4645,20200104,8991
20200101,8,가락시장,3156,3551,20200104,6707
20200101,8,송파,4221,4117,20200104,8338
20200101,8,석촌,3771,4422,20200104,8193
20200101,8,잠실,12712,13225,20200104,25937
20200101,8,몽촌토성,3566,3439,20200104,7005
20200101,8,강동구청,4406,4486,20200104,8892
20200101,8,천호,9229,10239,20200104,19468
20200101,8,암사,8493,8171,20200104,16664
20200102,8,송파,10637,10161,20200105,20798
20200102,8,암사,20546,17954,20200105,38500
20200102,8,천호,18937,21912,20200105,40849
20200102,8,강동구청,11800,12125,20200105,23925
20200102,8,몽촌토성,6054,6467,20200105,12521
20200102,8,잠실,17458,19917,20200105,37375
20200102,8,석촌,8758,9960,20200105,18718
20200102,8,가락시장,8292,9874,20200105,18166
20200102,8,문정,22705,23677,20200105,46382
20200102,8,장지,19646,18552,20200105,38198
20200102,8,복정,11516,9735,20200105,21251
20200102,8,산성,5708,5694,20200105,11402
20200102,8,남한산성입구,14674,13146,20200105,27820
20200102,8,단대오거리,11228,10837,20200105,22065
20200102,8,신흥,5178,5544,20200105,10722
20200102,8,수진,5927,5564,20200105,11491
20200102,8,모란,4832,3583,20200105,8415
20200103,8,암사,21652,18751,20200106,40403
20200103,8,천호,20473,24046,20200106,44519
20200103,8,강동구청,12501,12691,20200106,25192
20200103,8,몽촌토성,6358,6769,20200106,13127
20200103,8,잠실,18719,21398,20200106,40117
20200103,8,석촌,9309,10577,20200106,19886
20200103,8,송파,11434,10728,20200106,22162
20200103,8,가락시장,9503,11038,20200106,20541
20200103,8,문정,23687,24335,20200106,48022
20200103,8,장지,20841,19713,20200106,40554
20200103,8,복정,12466,10359,20200106,22825
20200103,8,산성,6082,5853,20200106,11935
20200103,8,남한산성입구,15425,13446,20200106,28871
20200103,8,단대오거리,12061,11175,20200106,23236
20200103,8,신흥,5438,5842,20200106,11280
20200103,8,수진,6543,6074,20200106,12617
20200103,8,모란,5171,4087,20200106,9258
20200104,8,암사,14258,12855,20200107,27113
20200104,8,천호,16089,18619,20200107,34708
20200104,8,강동구청,7383,7403,20200107,14786
20200104,8,몽촌토성,4285,4492,20200107,8777
20200104,8,잠실,16162,18111,20200107,34273
20200104,8,석촌,6322,7631,20200107,13953
20200104,8,송파,7287,6850,20200107,14137
20200104,8,가락시장,6926,7538,20200107,14464
20200104,8,문정,10337,10066,20200107,20403
20200104,8,장지,15460,14451,20200107,29911
20200104,8,복정,7783,6497,20200107,14280
20200104,8,산성,5108,4903,20200107,10011
20200104,8,남한산성입구,10607,9148,20200107,19755
20200104,8,단대오거리,9023,8073,20200107,17096
20200104,8,신흥,4637,5052,20200107,9689
20200104,8,수진,5243,4892,20200107,10135
20200104,8,모란,6471,5224,20200107,11695
20200105,8,암사,10252,9666,20200108,19918
20200105,8,천호,11883,13316,20200108,25199
20200105,8,강동구청,5532,5671,20200108,11203
20200105,8,몽촌토성,3520,3508,20200108,7028
20200105,8,잠실,12197,13278,20200108,25475
20200105,8,석촌,4583,5695,20200108,10278
20200105,8,송파,5214,5168,20200108,10382
20200105,8,가락시장,4094,5197,20200108,9291
20200105,8,문정,6163,6382,20200108,12545
20200105,8,장지,12047,11822,20200108,23869
20200105,8,복정,6544,5937,20200108,12481
20200105,8,산성,3492,3672,20200108,7164
20200105,8,남한산성입구,7693,7130,20200108,14823
20200105,8,단대오거리,6037,5750,20200108,11787
20200105,8,신흥,3502,3658,20200108,7160
20200105,8,수진,4225,3866,20200108,8091
20200105,8,모란,2887,2274,20200108,5161
20200106,8,암사,21332,18924,20200109,40256
20200106,8,천호,19121,21403,20200109,40524
20200106,8,강동구청,12533,13141,20200109,25674
20200106,8,몽촌토성,6221,6460,20200109,12681
20200106,8,잠실,17104,19032,20200109,36136
20200106,8,석촌,9019,10285,20200109,19304
20200106,8,송파,10797,10430,20200109,21227
20200106,8,가락시장,8998,10260,20200109,19258
20200106,8,문정,24409,25309,20200109,49718
20200106,8,장지,19985,18891,20200109,38876
20200106,8,복정,12136,10119,20200109,22255
20200106,8,산성,5878,5799,20200109,11677
20200106,8,남한산성입구,14943,13625,20200109,28568
20200106,8,단대오거리,11356,11164,20200109,22520
20200106,8,신흥,5236,5556,20200109,10792
20200106,8,수진,6067,5809,20200109,11876
20200106,8,모란,4901,3632,20200109,8533
20200107,8,암사,20776,18691,20200110,39467
20200107,8,천호,18646,20955,20200110,39601
20200107,8,강동구청,12383,12871,20200110,25254
20200107,8,몽촌토성,6211,6441,20200110,12652
20200107,8,잠실,17114,19148,20200110,36262
20200107,8,석촌,9068,10205,20200110,19273
20200107,8,송파,10810,10534,20200110,21344
20200107,8,가락시장,8905,9780,20200110,18685
20200107,8,문정,24003,24961,20200110,48964
20200107,8,장지,19782,18867,20200110,38649
20200107,8,복정,11813,9965,20200110,21778
20200107,8,산성,5587,5480,20200110,11067
20200107,8,남한산성입구,14364,13205,20200110,27569
20200107,8,단대오거리,11234,10807,20200110,22041
20200107,8,신흥,4917,5308,20200110,10225
20200107,8,수진,5923,5534,20200110,11457
20200107,8,모란,4646,3447,20200110,8093
20200108,8,암사,21595,19066,20200111,40661
20200108,8,천호,19532,22363,20200111,41895
20200108,8,강동구청,12730,13095,20200111,25825
20200108,8,몽촌토성,6304,6808,20200111,13112
20200108,8,잠실,17803,20160,20200111,37963
20200108,8,석촌,9139,10442,20200111,19581
20200108,8,송파,11329,10870,20200111,22199
20200108,8,가락시장,9394,10351,20200111,19745
20200108,8,문정,24422,25493,20200111,49915
20200108,8,장지,21008,19875,20200111,40883
20200108,8,복정,12112,10445,20200111,22557
20200108,8,산성,5934,5861,20200111,11795
20200108,8,남한산성입구,15200,13743,20200111,28943
20200108,8,단대오거리,11835,11359,20200111,23194
20200108,8,신흥,5349,5702,20200111,11051
20200108,8,수진,6777,6479,20200111,13256
20200108,8,모란,4930,3574,20200111,8504
20200109,8,암사,22078,19381,20200112,41459
20200109,8,천호,19918,22487,20200112,42405
20200109,8,강동구청,12843,13240,20200112,26083
20200109,8,몽촌토성,6575,7025,20200112,13600
20200109,8,잠실,18350,20954,20200112,39304
20200109,8,석촌,9540,10935,20200112,20475
20200109,8,송파,11116,10553,20200112,21669
20200109,8,가락시장,9632,10833,20200112,20465
20200109,8,문정,24478,25639,20200112,50117
20200109,8,장지,20583,19515,20200112,40098
20200109,8,복정,12602,10534,20200112,23136
20200109,8,산성,6051,5965,20200112,12016
20200109,8,남한산성입구,15490,13971,20200112,29461
20200109,8,단대오거리,12249,11715,20200112,23964
20200109,8,신흥,5481,5968,20200112,11449
20200109,8,수진,6649,6249,20200112,12898
20200109,8,모란,7101,5283,20200112,12384
20200110,8,암사,22276,19312,20200113,41588
20200110,8,천호,20840,24524,20200113,45364
20200110,8,강동구청,13150,13285,20200113,26435
20200110,8,몽촌토성,6431,6980,20200113,13411
20200110,8,잠실,18664,21623,20200113,40287
20200110,8,석촌,9687,10988,20200113,20675
20200110,8,송파,11290,10704,20200113,21994
20200110,8,가락시장,10093,11602,20200113,21695
20200110,8,문정,24721,25178,20200113,49899
20200110,8,장지,21437,20060,20200113,41497
20200110,8,복정,12907,10611,20200113,23518
20200110,8,산성,6256,5931,20200113,12187
20200110,8,남한산성입구,15954,13907,20200113,29861
20200110,8,단대오거리,12404,11581,20200113,23985
20200110,8,신흥,5603,5982,20200113,11585
20200110,8,수진,6796,6235,20200113,13031
20200110,8,모란,5318,4183,20200113,9501
20200111,8,암사,15004,13335,20200114,28339
20200111,8,천호,16727,19810,20200114,36537
20200111,8,강동구청,7653,7662,20200114,15315
20200111,8,몽촌토성,4584,4846,20200114,9430
20200111,8,잠실,16812,19103,20200114,35915
20200111,8,석촌,6831,8073,20200114,14904
20200111,8,송파,7920,7625,20200114,15545
20200111,8,가락시장,7254,7838,20200114,15092
20200111,8,문정,10916,10799,20200114,21715
20200111,8,장지,15838,14867,20200114,30705
20200111,8,복정,8533,6979,20200114,15512
20200111,8,산성,5077,4903,20200114,9980
20200111,8,남한산성입구,11050,9448,20200114,20498
20200111,8,단대오거리,8981,8234,20200114,17215
20200111,8,신흥,4852,5276,20200114,10128
20200111,8,수진,5764,5521,20200114,11285
20200111,8,모란,4461,3607,20200114,8068
20200112,8,암사,10581,10009,20200115,20590
20200112,8,천호,12003,13541,20200115,25544
20200112,8,강동구청,5636,5732,20200115,11368
20200112,8,몽촌토성,3543,3337,20200115,6880
20200112,8,잠실,12930,14050,20200115,26980
20200112,8,석촌,4889,5893,20200115,10782
20200112,8,송파,5457,5535,20200115,10992
20200112,8,가락시장,4009,5233,20200115,9242
20200112,8,문정,6312,6563,20200115,12875
20200112,8,장지,12445,11991,20200115,24436
20200112,8,복정,6754,6055,20200115,12809
20200112,8,산성,3670,3719,20200115,7389
20200112,8,남한산성입구,8140,7485,20200115,15625
20200112,8,단대오거리,6341,6153,20200115,12494
20200112,8,신흥,3593,3824,20200115,7417
20200112,8,수진,4765,4414,20200115,9179
20200112,8,모란,3043,2405,20200115,5448
20200113,8,암사,21499,19072,20200116,40571
20200113,8,천호,19602,22016,20200116,41618
20200113,8,강동구청,12629,13110,20200116,25739
20200113,8,몽촌토성,6233,6545,20200116,12778
20200113,8,잠실,17320,19744,20200116,37064
20200113,8,석촌,9227,10617,20200116,19844
20200113,8,송파,10855,10427,20200116,21282
20200113,8,가락시장,9545,10508,20200116,20053
20200113,8,문정,24403,25220,20200116,49623
20200113,8,장지,19962,19293,20200116,39255
20200113,8,복정,11987,10118,20200116,22105
20200113,8,산성,5784,5629,20200116,11413
20200113,8,남한산성입구,14983,13821,20200116,28804
20200113,8,단대오거리,11654,11174,20200116,22828
20200113,8,신흥,5348,5712,20200116,11060
20200113,8,수진,6302,5781,20200116,12083
20200113,8,모란,5104,3775,20200116,8879
20200114,8,모란,7129,5323,20200117,12452
20200114,8,수진,6301,5843,20200117,12144
20200114,8,신흥,5356,5785,20200117,11141
20200114,8,단대오거리,12154,11727,20200117,23881
20200114,8,남한산성입구,15573,13986,20200117,29559
20200114,8,산성,5834,5741,20200117,11575
20200114,8,복정,12171,10341,20200117,22512
20200114,8,장지,20464,19316,20200117,39780
20200114,8,문정,24569,25442,20200117,50011
20200114,8,가락시장,9801,10925,20200117,20726
20200114,8,송파,10947,10524,20200117,21471
20200114,8,석촌,9297,10529,20200117,19826
20200114,8,잠실,17181,19624,20200117,36805
20200114,8,몽촌토성,6404,6725,20200117,13129
20200114,8,강동구청,12792,13401,20200117,26193
20200114,8,천호,19650,22343,20200117,41993
20200114,8,암사,21721,19287,20200117,41008
20200115,8,암사,21989,19390,20200118,41379
20200115,8,천호,19962,22342,20200118,42304
20200115,8,강동구청,12810,13256,20200118,26066
20200115,8,몽촌토성,6449,6784,20200118,13233
20200115,8,잠실,17385,20035,20200118,37420
20200115,8,석촌,9441,10958,20200118,20399
20200115,8,송파,11042,10582,20200118,21624
20200115,8,가락시장,10020,11209,20200118,21229
20200115,8,문정,24674,25584,20200118,50258
20200115,8,장지,20958,20032,20200118,40990
20200115,8,복정,12431,10289,20200118,22720
20200115,8,산성,5888,5738,20200118,11626
20200115,8,남한산성입구,15328,14000,20200118,29328
20200115,8,단대오거리,11886,11357,20200118,23243
20200115,8,신흥,5382,5829,20200118,11211
20200115,8,수진,6759,6388,20200118,13147
20200115,8,모란,5124,3728,20200118,8852
20200116,8,모란,5114,3853,20200119,8967
20200116,8,수진,6228,5803,20200119,12031
20200116,8,신흥,5385,5883,20200119,11268
20200116,8,단대오거리,11749,11317,20200119,23066
20200116,8,남한산성입구,15435,13943,20200119,29378
20200116,8,산성,5994,5761,20200119,11755
20200116,8,복정,12065,10251,20200119,22316
20200116,8,장지,20415,19390,20200119,39805
20200116,8,문정,24706,25504,20200119,50210
20200116,8,가락시장,10170,11565,20200119,21735
20200116,8,송파,11056,10500,20200119,21556
20200116,8,석촌,9325,10769,20200119,20094
20200116,8,잠실,17946,20263,20200119,38209
20200116,8,몽촌토성,6464,7020,20200119,13484
20200116,8,강동구청,12833,13190,20200119,26023
20200116,8,천호,20026,22545,20200119,42571
20200116,8,암사,22040,19415,20200119,41455
20200117,8,암사,22430,19459,20200120,41889
20200117,8,천호,20823,24149,20200120,44972
20200117,8,강동구청,13197,13460,20200120,26657
20200117,8,몽촌토성,6453,6963,20200120,13416
20200117,8,잠실,18302,21365,20200120,39667
20200117,8,석촌,9452,11070,20200120,20522
20200117,8,송파,11592,10841,20200120,22433
20200117,8,가락시장,10621,12196,20200120,22817
20200117,8,문정,24795,25549,20200120,50344
20200117,8,장지,21448,20045,20200120,41493
20200117,8,복정,12902,10635,20200120,23537
20200117,8,산성,6129,5772,20200120,11901
20200117,8,남한산성입구,15720,13843,20200120,29563
20200117,8,단대오거리,12269,11485,20200120,23754
20200117,8,신흥,5517,6006,20200120,11523
20200117,8,수진,6490,5974,20200120,12464
20200117,8,모란,5203,4017,20200120,9220
20200118,8,암사,14904,13491,20200121,28395
20200118,8,천호,16410,19199,20200121,35609
20200118,8,강동구청,7884,7824,20200121,15708
20200118,8,몽촌토성,4517,4689,20200121,9206
20200118,8,잠실,16313,18629,20200121,34942
20200118,8,석촌,6929,8288,20200121,15217
20200118,8,송파,7606,7286,20200121,14892
20200118,8,가락시장,7723,8404,20200121,16127
20200118,8,문정,10518,10169,20200121,20687
20200118,8,장지,15715,14821,20200121,30536
20200118,8,복정,8054,6698,20200121,14752
20200118,8,산성,5130,4951,20200121,10081
20200118,8,남한산성입구,11180,9677,20200121,20857
20200118,8,단대오거리,9263,8160,20200121,17423
20200118,8,신흥,4804,5112,20200121,9916
20200118,8,수진,5433,5028,20200121,10461
20200118,8,모란,4258,3612,20200121,7870
20200119,8,암사,10767,9811,20200122,20578
20200119,8,천호,12300,13775,20200122,26075
20200119,8,강동구청,5765,5922,20200122,11687
20200119,8,몽촌토성,3417,3390,20200122,6807
20200119,8,잠실,12693,13810,20200122,26503
20200119,8,석촌,5003,5827,20200122,10830
20200119,8,송파,5391,5382,20200122,10773
20200119,8,가락시장,4529,5603,20200122,10132
20200119,8,문정,6277,6337,20200122,12614
20200119,8,장지,12643,12461,20200122,25104
20200119,8,복정,6901,6118,20200122,13019
20200119,8,산성,3725,3767,20200122,7492
20200119,8,남한산성입구,7899,7441,20200122,15340
20200119,8,단대오거리,6676,6279,20200122,12955
20200119,8,신흥,3850,4021,20200122,7871
20200119,8,수진,4630,4349,20200122,8979
20200119,8,모란,5794,4493,20200122,10287
20200120,8,모란,5006,3665,20200123,8671
20200120,8,수진,6302,5804,20200123,12106
20200120,8,신흥,5303,5759,20200123,11062
20200120,8,단대오거리,11849,11297,20200123,23146
20200120,8,남한산성입구,15269,13888,20200123,29157
20200120,8,산성,5783,5729,20200123,11512
20200120,8,복정,11974,9936,20200123,21910
20200120,8,장지,20534,19482,20200123,40016
20200120,8,문정,24361,25592,20200123,49953
20200120,8,가락시장,10231,11654,20200123,21885
20200120,8,송파,10860,10454,20200123,21314
20200120,8,석촌,9238,10639,20200123,19877
20200120,8,잠실,17486,19992,20200123,37478
20200120,8,몽촌토성,6308,6637,20200123,12945
20200120,8,강동구청,12794,13159,20200123,25953
20200120,8,천호,19788,22153,20200123,41941
20200120,8,암사,21856,19170,20200123,41026
20200121,8,암사,21786,19189,20200124,40975
20200121,8,천호,19971,22548,20200124,42519
20200121,8,강동구청,12811,13209,20200124,26020
20200121,8,몽촌토성,6369,6818,20200124,13187
20200121,8,잠실,17094,20034,20200124,37128
20200121,8,석촌,9205,10637,20200124,19842
20200121,8,송파,10971,10504,20200124,21475
20200121,8,가락시장,10306,11562,20200124,21868
20200121,8,문정,24471,25504,20200124,49975
20200121,8,장지,20636,19364,20200124,40000
20200121,8,복정,12303,10290,20200124,22593
20200121,8,산성,6047,5862,20200124,11909
20200121,8,남한산성입구,15087,13625,20200124,28712
20200121,8,단대오거리,12032,11598,20200124,23630
20200121,8,신흥,5260,5627,20200124,10887
20200121,8,수진,6238,5811,20200124,12049
20200121,8,모란,4934,3702,20200124,8636
20200122,8,암사,22076,19318,20200125,41394
20200122,8,천호,19789,22764,20200125,42553
20200122,8,강동구청,12715,13045,20200125,25760
20200122,8,몽촌토성,6321,6587,20200125,12908
20200122,8,잠실,17267,19956,20200125,37223
20200122,8,석촌,9227,10536,20200125,19763
20200122,8,송파,11112,10206,20200125,21318
20200122,8,가락시장,10650,12237,20200125,22887
20200122,8,문정,24772,25762,20200125,50534
20200122,8,장지,20914,19545,20200125,40459
20200122,8,복정,12377,9966,20200125,22343
20200122,8,산성,6028,5727,20200125,11755
20200122,8,남한산성입구,15097,13444,20200125,28541
20200122,8,단대오거리,11870,11449,20200125,23319
20200122,8,신흥,5343,5764,20200125,11107
20200122,8,수진,6624,6274,20200125,12898
20200122,8,모란,5064,3721,20200125,8785
20200123,8,암사,20958,17977,20200126,38935
20200123,8,천호,19359,22312,20200126,41671
20200123,8,강동구청,11801,11797,20200126,23598
20200123,8,몽촌토성,5661,5884,20200126,11545
20200123,8,잠실,17529,19910,20200126,37439
20200123,8,석촌,8708,9778,20200126,18486
20200123,8,송파,10213,9473,20200126,19686
20200123,8,가락시장,9909,11439,20200126,21348
20200123,8,문정,20621,20617,20200126,41238
20200123,8,장지,19312,17920,20200126,37232
20200123,8,복정,10987,8916,20200126,19903
20200123,8,산성,5581,5139,20200126,10720
20200123,8,남한산성입구,14595,12469,20200126,27064
20200123,8,단대오거리,11593,10477,20200126,22070
20200123,8,신흥,5275,5743,20200126,11018
20200123,8,수진,6186,5457,20200126,11643
20200123,8,모란,4825,3745,20200126,8570
20200124,8,모란,3481,2851,20200127,6332
20200124,8,수진,2998,2477,20200127,5475
20200124,8,신흥,2880,2941,20200127,5821
20200124,8,단대오거리,5190,4987,20200127,10177
20200124,8,남한산성입구,5931,5223,20200127,11154
20200124,8,산성,2839,2641,20200127,5480
20200124,8,복정,4004,3202,20200127,7206
20200124,8,장지,8275,7570,20200127,15845
20200124,8,문정,4262,3450,20200127,7712
20200124,8,가락시장,4005,4318,20200127,8323
20200124,8,송파,3841,3481,20200127,7322
20200124,8,석촌,3352,3654,20200127,7006
20200124,8,잠실,8805,9508,20200127,18313
20200124,8,몽촌토성,2258,2054,20200127,4312
20200124,8,강동구청,3866,3821,20200127,7687
20200124,8,천호,8455,9733,20200127,18188
20200124,8,암사,8364,7317,20200127,15681
20200125,8,암사,6421,6214,20200128,12635
20200125,8,천호,6034,7166,20200128,13200
20200125,8,강동구청,3109,3149,20200128,6258
20200125,8,몽촌토성,1618,1804,20200128,3422
20200125,8,잠실,7146,8021,20200128,15167
20200125,8,석촌,2381,3107,20200128,5488
20200125,8,송파,2895,2935,20200128,5830
20200125,8,가락시장,1922,2165,20200128,4087
20200125,8,문정,2747,2651,20200128,5398
20200125,8,장지,4975,4811,20200128,9786
20200125,8,복정,3110,2603,20200128,5713
20200125,8,산성,2368,2253,20200128,4621
20200125,8,남한산성입구,5112,4762,20200128,9874
20200125,8,단대오거리,4275,4094,20200128,8369
20200125,8,신흥,2230,2453,20200128,4683
20200125,8,수진,2258,1995,20200128,4253
20200125,8,모란,1965,1645,20200128,3610
20200126,8,암사,8434,7825,20200129,16259
20200126,8,천호,8734,10697,20200129,19431
20200126,8,강동구청,4179,4357,20200129,8536
20200126,8,몽촌토성,2636,2854,20200129,5490
20200126,8,잠실,10912,12117,20200129,23029
20200126,8,석촌,3490,4558,20200129,8048
20200126,8,송파,4068,3971,20200129,8039
20200126,8,가락시장,2725,3306,20200129,6031
20200126,8,문정,3941,4321,20200129,8262
20200126,8,장지,9859,9527,20200129,19386
20200126,8,복정,4987,4452,20200129,9439
20200126,8,산성,3171,3162,20200129,6333
20200126,8,남한산성입구,6714,5969,20200129,12683
20200126,8,단대오거리,5532,5144,20200129,10676
20200126,8,신흥,3038,3353,20200129,6391
20200126,8,수진,3512,3378,20200129,6890
20200126,8,모란,2452,2221,20200129,4673
20200127,8,암사,9076,8706,20200130,17782
20200127,8,천호,10217,11995,20200130,22212
20200127,8,강동구청,4610,4750,20200130,9360
20200127,8,몽촌토성,2598,2872,20200130,5470
20200127,8,잠실,11618,12676,20200130,24294
20200127,8,석촌,4066,5092,20200130,9158
20200127,8,송파,4394,4552,20200130,8946
20200127,8,가락시장,3343,4348,20200130,7691
20200127,8,문정,5009,5597,20200130,10606
20200127,8,장지,10325,10508,20200130,20833
20200127,8,복정,4448,4080,20200130,8528
20200127,8,산성,3186,3229,20200130,6415
20200127,8,남한산성입구,6832,6390,20200130,13222
20200127,8,단대오거리,5568,5442,20200130,11010
20200127,8,신흥,3398,3652,20200130,7050
20200127,8,수진,3207,3125,20200130,6332
20200127,8,모란,2781,2191,20200130,4972
20200128,8,암사,19523,17299,20200131,36822
20200128,8,천호,17696,20245,20200131,37941
20200128,8,강동구청,11121,11581,20200131,22702
20200128,8,몽촌토성,5550,5953,20200131,11503
20200128,8,잠실,14906,16865,20200131,31771
20200128,8,석촌,8378,9661,20200131,18039
20200128,8,송파,9466,9166,20200131,18632
20200128,8,가락시장,8118,9122,20200131,17240
20200128,8,문정,21211,22349,20200131,43560
20200128,8,장지,17883,17225,20200131,35108
20200128,8,복정,10409,8960,20200131,19369
20200128,8,산성,5396,5394,20200131,10790
20200128,8,남한산성입구,13761,12587,20200131,26348
20200128,8,단대오거리,10994,10463,20200131,21457
20200128,8,신흥,5079,5469,20200131,10548
20200128,8,수진,5593,5180,20200131,10773
20200128,8,모란,4557,3365,20200131,7922
20200129,8,암사,20632,18035,20200201,38667
20200129,8,천호,18596,21075,20200201,39671
20200129,8,강동구청,11978,12268,20200201,24246
20200129,8,몽촌토성,5957,6460,20200201,12417
20200129,8,잠실,15292,17740,20200201,33032
20200129,8,석촌,8733,10061,20200201,18794
20200129,8,송파,10170,9512,20200201,19682
20200129,8,가락시장,8655,9673,20200201,18328
20200129,8,문정,23465,24575,20200201,48040
20200129,8,장지,19356,18622,20200201,37978
20200129,8,복정,11631,9756,20200201,21387
20200129,8,산성,5735,5658,20200201,11393
20200129,8,남한산성입구,14768,13497,20200201,28265
20200129,8,단대오거리,11679,11129,20200201,22808
20200129,8,신흥,5241,5700,20200201,10941
20200129,8,수진,6425,5988,20200201,12413
20200129,8,모란,6211,4394,20200201,10605
20200130,8,모란,4639,3437,20200202,8076
20200130,8,수진,5825,5354,20200202,11179
20200130,8,신흥,4858,5410,20200202,10268
20200130,8,단대오거리,11188,10889,20200202,22077
20200130,8,남한산성입구,14759,13271,20200202,28030
20200130,8,산성,5601,5592,20200202,11193
20200130,8,복정,11500,9752,20200202,21252
20200130,8,장지,19313,18088,20200202,37401
20200130,8,문정,23368,24509,20200202,47877
20200130,8,가락시장,8878,9925,20200202,18803
20200130,8,송파,10217,9819,20200202,20036
20200130,8,석촌,8560,9840,20200202,18400
20200130,8,잠실,15733,17984,20200202,33717
20200130,8,몽촌토성,5979,6495,20200202,12474
20200130,8,강동구청,12073,12373,20200202,24446
20200130,8,천호,18774,21387,20200202,40161
20200130,8,암사,20568,18058,20200202,38626
20200131,8,암사,20832,18080,20200203,38912
20200131,8,천호,19247,22578,20200203,41825
20200131,8,강동구청,12041,12239,20200203,24280
20200131,8,몽촌토성,6094,6420,20200203,12514
20200131,8,잠실,15679,18570,20200203,34249
20200131,8,석촌,8880,10193,20200203,19073
20200131,8,송파,10238,9671,20200203,19909
20200131,8,가락시장,8964,10441,20200203,19405
20200131,8,문정,23281,24273,20200203,47554
20200131,8,장지,19625,18549,20200203,38174
20200131,8,복정,11832,9888,20200203,21720
20200131,8,산성,5718,5508,20200203,11226
20200131,8,남한산성입구,14849,13149,20200203,27998
20200131,8,단대오거리,11575,10802,20200203,22377
20200131,8,신흥,5157,5553,20200203,10710
20200131,8,수진,6199,5660,20200203,11859
20200131,8,모란,4884,3730,20200203,8614
20200201,8,암사,12485,11101,20200204,23586
20200201,8,천호,13609,16310,20200204,29919
20200201,8,강동구청,6126,6245,20200204,12371
20200201,8,몽촌토성,3617,3832,20200204,7449
20200201,8,잠실,11358,13031,20200204,24389
20200201,8,석촌,5650,6884,20200204,12534
20200201,8,송파,6178,5839,20200204,12017
20200201,8,가락시장,5603,5873,20200204,11476
20200201,8,문정,8939,8907,20200204,17846
20200201,8,장지,12277,11425,20200204,23702
20200201,8,복정,6836,5895,20200204,12731
20200201,8,산성,4326,4326,20200204,8652
20200201,8,남한산성입구,9342,7965,20200204,17307
20200201,8,단대오거리,7601,6876,20200204,14477
20200201,8,신흥,3954,4406,20200204,8360
20200201,8,수진,4439,4127,20200204,8566
20200201,8,모란,3555,2987,20200204,6542
20200202,8,암사,8544,8002,20200205,16546
20200202,8,천호,9894,11424,20200205,21318
20200202,8,강동구청,4507,4569,20200205,9076
20200202,8,몽촌토성,2862,2830,20200205,5692
20200202,8,잠실,8837,9431,20200205,18268
20200202,8,석촌,4019,4772,20200205,8791
20200202,8,송파,4105,4116,20200205,8221
20200202,8,가락시장,3196,4196,20200205,7392
20200202,8,문정,5738,5990,20200205,11728
20200202,8,장지,9698,9728,20200205,19426
20200202,8,복정,5554,5045,20200205,10599
20200202,8,산성,3221,3111,20200205,6332
20200202,8,남한산성입구,6569,6013,20200205,12582
20200202,8,단대오거리,5312,5115,20200205,10427
20200202,8,신흥,3009,3127,20200205,6136
20200202,8,수진,3735,3561,20200205,7296
20200202,8,모란,2563,2031,20200205,4594
20200203,8,암사,19887,17683,20200206,37570
20200203,8,천호,17759,19965,20200206,37724
20200203,8,강동구청,11595,11989,20200206,23584
20200203,8,몽촌토성,5526,5853,20200206,11379
20200203,8,잠실,14444,16349,20200206,30793
20200203,8,석촌,8292,9418,20200206,17710
20200203,8,송파,9541,9154,20200206,18695
20200203,8,가락시장,8322,9305,20200206,17627
20200203,8,문정,22867,23879,20200206,46746
20200203,8,장지,18117,17339,20200206,35456
20200203,8,복정,10787,9193,20200206,19980
20200203,8,산성,5314,5343,20200206,10657
20200203,8,남한산성입구,13877,12583,20200206,26460
20200203,8,단대오거리,10883,10490,20200206,21373
20200203,8,신흥,4839,5242,20200206,10081
20200203,8,수진,5701,5141,20200206,10842
20200203,8,모란,4394,3234,20200206,7628
20200204,8,암사,19963,17801,20200207,37764
20200204,8,천호,17914,20248,20200207,38162
20200204,8,강동구청,11617,11976,20200207,23593
20200204,8,몽촌토성,5697,6149,20200207,11846
20200204,8,잠실,14539,16381,20200207,30920
20200204,8,석촌,8505,9663,20200207,18168
20200204,8,송파,9674,9378,20200207,19052
20200204,8,가락시장,8312,9243,20200207,17555
20200204,8,문정,23091,23935,20200207,47026
20200204,8,장지,18243,17427,20200207,35670
20200204,8,복정,10734,9325,20200207,20059
20200204,8,산성,5494,5435,20200207,10929
20200204,8,남한산성입구,13963,12763,20200207,26726
20200204,8,단대오거리,10975,10509,20200207,21484
20200204,8,신흥,4766,5174,20200207,9940
20200204,8,수진,5484,5189,20200207,10673
20200204,8,모란,5390,4095,20200207,9485
20200205,8,암사,19436,17203,20200208,36639
20200205,8,천호,17410,19655,20200208,37065
20200205,8,강동구청,11217,11620,20200208,22837
20200205,8,몽촌토성,5584,5903,20200208,11487
20200205,8,잠실,14401,16644,20200208,31045
20200205,8,석촌,8392,9561,20200208,17953
20200205,8,송파,9736,9461,20200208,19197
20200205,8,가락시장,8141,9125,20200208,17266
20200205,8,문정,22965,23963,20200208,46928
20200205,8,장지,18265,17193,20200208,35458
20200205,8,복정,10650,9037,20200208,19687
20200205,8,산성,5288,5205,20200208,10493
20200205,8,남한산성입구,13603,12184,20200208,25787
20200205,8,단대오거리,10573,10223,20200208,20796
20200205,8,신흥,4715,5114,20200208,9829
20200205,8,수진,5765,5435,20200208,11200
20200205,8,모란,4099,3112,20200208,7211
20200206,8,암사,19125,16902,20200209,36027
20200206,8,천호,17249,19365,20200209,36614
20200206,8,강동구청,10989,11437,20200209,22426
20200206,8,몽촌토성,5520,5781,20200209,11301
20200206,8,잠실,13607,15797,20200209,29404
20200206,8,석촌,7651,8895,20200209,16546
20200206,8,송파,9091,8660,20200209,17751
20200206,8,가락시장,7860,8733,20200209,16593
20200206,8,문정,22151,23259,20200209,45410
20200206,8,장지,17621,16640,20200209,34261
20200206,8,복정,10360,8885,20200209,19245
20200206,8,산성,5116,4960,20200209,10076
20200206,8,남한산성입구,13244,12067,20200209,25311
20200206,8,단대오거리,10232,9922,20200209,20154
20200206,8,신흥,4511,4841,20200209,9352
20200206,8,수진,5297,4981,20200209,10278
20200206,8,모란,4061,2956,20200209,7017
20200207,8,암사,19972,17314,20200210,37286
20200207,8,천호,18217,21405,20200210,39622
20200207,8,강동구청,11360,11599,20200210,22959
20200207,8,몽촌토성,5437,5843,20200210,11280
20200207,8,잠실,14207,16420,20200210,30627
20200207,8,석촌,7925,9244,20200210,17169
20200207,8,송파,8872,8447,20200210,17319
20200207,8,가락시장,8171,9280,20200210,17451
20200207,8,문정,22609,23176,20200210,45785
20200207,8,장지,18344,17050,20200210,35394
20200207,8,복정,11146,9513,20200210,20659
20200207,8,산성,5427,5141,20200210,10568
20200207,8,남한산성입구,14153,12255,20200210,26408
20200207,8,단대오거리,11353,10490,20200210,21843
20200207,8,신흥,4889,5329,20200210,10218
20200207,8,수진,5452,4935,20200210,10387
20200207,8,모란,4558,3540,20200210,8098
20200208,8,암사,11560,10481,20200211,22041
20200208,8,천호,13215,15583,20200211,28798
20200208,8,강동구청,5846,5867,20200211,11713
20200208,8,몽촌토성,3356,3427,20200211,6783
20200208,8,잠실,10138,11829,20200211,21967
20200208,8,석촌,5121,6177,20200211,11298
20200208,8,송파,5108,4773,20200211,9881
20200208,8,가락시장,5050,5187,20200211,10237
20200208,8,문정,8807,8750,20200211,17557
20200208,8,장지,11583,10790,20200211,22373
20200208,8,복정,6640,5616,20200211,12256
20200208,8,산성,4171,3957,20200211,8128
20200208,8,남한산성입구,8606,7589,20200211,16195
20200208,8,단대오거리,7083,6568,20200211,13651
20200208,8,신흥,3887,4224,20200211,8111
20200208,8,수진,4253,3861,20200211,8114
20200208,8,모란,3300,2765,20200211,6065
20200209,8,장지,9207,9086,20200212,18293
20200209,8,암사,8348,7794,20200212,16142
20200209,8,천호,9659,11068,20200212,20727
20200209,8,강동구청,4352,4463,20200212,8815
20200209,8,몽촌토성,2578,2692,20200212,5270
20200209,8,잠실,8044,8665,20200212,16709
20200209,8,석촌,3855,4608,20200212,8463
20200209,8,송파,3709,3647,20200212,7356
20200209,8,가락시장,2917,3904,20200212,6821
20200209,8,문정,5529,5756,20200212,11285
20200209,8,복정,5506,5009,20200212,10515
20200209,8,산성,3089,3078,20200212,6167
20200209,8,남한산성입구,6655,5896,20200212,12551
20200209,8,단대오거리,5256,5049,20200212,10305
20200209,8,신흥,3086,3186,20200212,6272
20200209,8,수진,3735,3369,20200212,7104
20200209,8,모란,3675,2930,20200212,6605
20200210,8,암사,19415,17036,20200213,36451
20200210,8,천호,16970,19223,20200213,36193
20200210,8,강동구청,11002,11343,20200213,22345
20200210,8,몽촌토성,5428,5794,20200213,11222
20200210,8,잠실,13604,15594,20200213,29198
20200210,8,석촌,7702,9001,20200213,16703
20200210,8,송파,9020,8815,20200213,17835
20200210,8,가락시장,7972,9109,20200213,17081
20200210,8,문정,22809,23977,20200213,46786
20200210,8,장지,17380,16636,20200213,34016
20200210,8,복정,10521,8877,20200213,19398
20200210,8,산성,5295,5310,20200213,10605
20200210,8,남한산성입구,13780,12503,20200213,26283
20200210,8,단대오거리,10594,10172,20200213,20766
20200210,8,신흥,4705,5147,20200213,9852
20200210,8,수진,5494,5035,20200213,10529
20200210,8,모란,4269,3241,20200213,7510
20200211,8,암사,19938,17353,20200214,37291
20200211,8,천호,18066,20569,20200214,38635
20200211,8,강동구청,11264,11570,20200214,22834
20200211,8,몽촌토성,5577,5865,20200214,11442
20200211,8,잠실,14257,16741,20200214,30998
20200211,8,석촌,8002,9342,20200214,17344
20200211,8,송파,9086,8521,20200214,17607
20200211,8,가락시장,8329,9327,20200214,17656
20200211,8,문정,22776,24159,20200214,46935
20200211,8,장지,18000,17015,20200214,35015
20200211,8,복정,11103,9412,20200214,20515
20200211,8,산성,5463,5432,20200214,10895
20200211,8,남한산성입구,14248,12885,20200214,27133
20200211,8,단대오거리,11016,10639,20200214,21655
20200211,8,신흥,4834,5176,20200214,10010
20200211,8,수진,5358,4946,20200214,10304
20200211,8,모란,4305,3216,20200214,7521
20200212,8,암사,19474,17154,20200215,36628
20200212,8,천호,17573,19929,20200215,37502
20200212,8,강동구청,11127,11523,20200215,22650
20200212,8,몽촌토성,5292,5727,20200215,11019
20200212,8,잠실,14356,16552,20200215,30908
20200212,8,석촌,7978,9097,20200215,17075
20200212,8,송파,9257,8819,20200215,18076
20200212,8,가락시장,8134,9179,20200215,17313
20200212,8,문정,22791,23788,20200215,46579
20200212,8,장지,18251,17308,20200215,35559
20200212,8,복정,10881,9036,20200215,19917
20200212,8,산성,5296,5172,20200215,10468
20200212,8,남한산성입구,13646,12469,20200215,26115
20200212,8,단대오거리,10536,10112,20200215,20648
20200212,8,신흥,4713,5132,20200215,9845
20200212,8,수진,5719,5340,20200215,11059
20200212,8,모란,4301,3141,20200215,7442
20200213,8,암사,20275,17594,20200216,37869
20200213,8,천호,18471,21098,20200216,39569
20200213,8,강동구청,11425,11709,20200216,23134
20200213,8,몽촌토성,5587,6101,20200216,11688
20200213,8,잠실,15378,17624,20200216,33002
20200213,8,석촌,8170,9576,20200216,17746
20200213,8,송파,9358,8876,20200216,18234
20200213,8,가락시장,8642,9789,20200216,18431
20200213,8,문정,23073,24227,20200216,47300
20200213,8,장지,18651,17653,20200216,36304
20200213,8,복정,11076,9270,20200216,20346
20200213,8,산성,5441,5369,20200216,10810
20200213,8,남한산성입구,14285,12821,20200216,27106
20200213,8,단대오거리,10916,10513,20200216,21429
20200213,8,신흥,4932,5342,20200216,10274
20200213,8,수진,5492,5108,20200216,10600
20200213,8,모란,4372,3302,20200216,7674
20200214,8,암사,21037,17927,20200217,38964
20200214,8,천호,19618,23260,20200217,42878
20200214,8,강동구청,11764,11778,20200217,23542
20200214,8,몽촌토성,5925,6297,20200217,12222
20200214,8,잠실,16303,19144,20200217,35447
20200214,8,석촌,8684,9997,20200217,18681
20200214,8,송파,9918,9188,20200217,19106
20200214,8,가락시장,9130,10602,20200217,19732
20200214,8,문정,23405,24177,20200217,47582
20200214,8,장지,19563,18446,20200217,38009
20200214,8,복정,12145,9990,20200217,22135
20200214,8,산성,5890,5659,20200217,11549
20200214,8,남한산성입구,14994,12978,20200217,27972
20200214,8,단대오거리,11757,10896,20200217,22653
20200214,8,신흥,5364,5781,20200217,11145
20200214,8,수진,5992,5407,20200217,11399
20200214,8,모란,6428,4935,20200217,11363
20200215,8,암사,12860,11566,20200218,24426
20200215,8,천호,14395,17246,20200218,31641
20200215,8,강동구청,6559,6438,20200218,12997
20200215,8,몽촌토성,3622,3592,20200218,7214
20200215,8,잠실,12920,14816,20200218,27736
20200215,8,석촌,5824,7068,20200218,12892
20200215,8,송파,6175,5934,20200218,12109
20200215,8,가락시장,6153,6581,20200218,12734
20200215,8,문정,9842,9712,20200218,19554
20200215,8,장지,13283,12283,20200218,25566
20200215,8,복정,7609,6507,20200218,14116
20200215,8,산성,4565,4301,20200218,8866
20200215,8,남한산성입구,9590,8322,20200218,17912
20200215,8,단대오거리,7948,7360,20200218,15308
20200215,8,신흥,4077,4376,20200218,8453
20200215,8,수진,4510,4115,20200218,8625
20200215,8,모란,3638,3086,20200218,6724
20200216,8,암사,8892,8332,20200219,17224
20200216,8,천호,10422,12060,20200219,22482
20200216,8,강동구청,4726,4772,20200219,9498
20200216,8,몽촌토성,2892,2850,20200219,5742
20200216,8,잠실,10105,11118,20200219,21223
20200216,8,석촌,4059,4996,20200219,9055
20200216,8,송파,4506,4395,20200219,8901
20200216,8,가락시장,3575,4324,20200219,7899
20200216,8,문정,5450,5762,20200219,11212
20200216,8,장지,10582,10423,20200219,21005
20200216,8,복정,5660,5338,20200219,10998
20200216,8,산성,3182,3152,20200219,6334
20200216,8,남한산성입구,6639,6148,20200219,12787
20200216,8,단대오거리,5397,5254,20200219,10651
20200216,8,신흥,3132,3382,20200219,6514
20200216,8,수진,3840,3622,20200219,7462
20200216,8,모란,2589,2107,20200219,4696
20200217,8,암사,20324,17885,20200220,38209
20200217,8,천호,18241,20692,20200220,38933
20200217,8,강동구청,11699,12101,20200220,23800
20200217,8,몽촌토성,5876,6209,20200220,12085
20200217,8,잠실,15197,17516,20200220,32713
20200217,8,석촌,8596,9646,20200220,18242
20200217,8,송파,10211,9599,20200220,19810
20200217,8,가락시장,8545,9454,20200220,17999
20200217,8,문정,24592,25594,20200220,50186
20200217,8,장지,19656,18168,20200220,37824
20200217,8,복정,11723,9704,20200220,21427
20200217,8,산성,5589,5462,20200220,11051
20200217,8,남한산성입구,14642,13280,20200220,27922
20200217,8,단대오거리,11627,10893,20200220,22520
20200217,8,신흥,4992,5320,20200220,10312
20200217,8,수진,5865,5392,20200220,11257
20200217,8,모란,4509,3457,20200220,7966
20200218,8,암사,20029,17519,20200221,37548
20200218,8,천호,18074,20524,20200221,38598
20200218,8,강동구청,11505,11826,20200221,23331
20200218,8,몽촌토성,5764,6067,20200221,11831
20200218,8,잠실,15173,17495,20200221,32668
20200218,8,석촌,8269,9482,20200221,17751
20200218,8,송파,9674,9186,20200221,18860
20200218,8,가락시장,8500,9485,20200221,17985
20200218,8,문정,23760,24847,20200221,48607
20200218,8,장지,18507,17722,20200221,36229
20200218,8,복정,11323,9715,20200221,21038
20200218,8,산성,5359,5311,20200221,10670
20200218,8,남한산성입구,14061,12746,20200221,26807
20200218,8,단대오거리,11019,10708,20200221,21727
20200218,8,신흥,4759,5211,20200221,9970
20200218,8,수진,5480,4974,20200221,10454
20200218,8,모란,4335,3204,20200221,7539
20200219,8,암사,20313,17817,20200222,38130
20200219,8,천호,18204,20652,20200222,38856
20200219,8,강동구청,11436,11927,20200222,23363
20200219,8,몽촌토성,5869,6145,20200222,12014
20200219,8,잠실,14969,17446,20200222,32415
20200219,8,석촌,8430,9674,20200222,18104
20200219,8,송파,9736,9150,20200222,18886
20200219,8,가락시장,8638,9519,20200222,18157
20200219,8,문정,23373,24509,20200222,47882
20200219,8,장지,19007,17874,20200222,36881
20200219,8,복정,11345,9773,20200222,21118
20200219,8,산성,5551,5502,20200222,11053
20200219,8,남한산성입구,14424,12934,20200222,27358
20200219,8,단대오거리,11368,10856,20200222,22224
20200219,8,신흥,4891,5412,20200222,10303
20200219,8,수진,5714,5198,20200222,10912
20200219,8,모란,5870,4448,20200222,10318
20200220,8,암사,20084,17503,20200223,37587
20200220,8,천호,18137,20403,20200223,38540
20200220,8,강동구청,11286,11602,20200223,22888
20200220,8,몽촌토성,5531,5948,20200223,11479
20200220,8,잠실,14486,16927,20200223,31413
20200220,8,석촌,8116,9325,20200223,17441
20200220,8,송파,9432,8962,20200223,18394
20200220,8,가락시장,8548,9553,20200223,18101
20200220,8,문정,22794,23873,20200223,46667
20200220,8,장지,18294,17413,20200223,35707
20200220,8,복정,11122,9429,20200223,20551
20200220,8,산성,5343,5279,20200223,10622
20200220,8,남한산성입구,13939,12665,20200223,26604
20200220,8,단대오거리,10858,10350,20200223,21208
20200220,8,신흥,4910,5208,20200223,10118
20200220,8,수진,5351,4808,20200223,10159
20200220,8,모란,4275,3185,20200223,7460
20200221,8,암사,19716,17094,20200224,36810
20200221,8,천호,18012,20824,20200224,38836
20200221,8,강동구청,11128,11374,20200224,22502
20200221,8,몽촌토성,5435,5788,20200224,11223
20200221,8,잠실,14503,16729,20200224,31232
20200221,8,석촌,8060,9167,20200224,17227
20200221,8,송파,9343,8940,20200224,18283
20200221,8,가락시장,8094,9346,20200224,17440
20200221,8,문정,22217,23253,20200224,45470
20200221,8,장지,18109,17079,20200224,35188
20200221,8,복정,11176,9346,20200224,20522
20200221,8,산성,5325,5191,20200224,10516
20200221,8,남한산성입구,14048,12201,20200224,26249
20200221,8,단대오거리,10766,10082,20200224,20848
20200221,8,신흥,4737,5189,20200224,9926
20200221,8,수진,5312,4805,20200224,10117
20200221,8,모란,4264,3243,20200224,7507
20200222,8,암사,10776,9757,20200225,20533
20200222,8,천호,12159,14376,20200225,26535
20200222,8,강동구청,5271,5138,20200225,10409
20200222,8,몽촌토성,3145,3368,20200225,6513
20200222,8,잠실,9688,11157,20200225,20845
20200222,8,석촌,4865,5739,20200225,10604
20200222,8,송파,5245,5046,20200225,10291
20200222,8,가락시장,4923,5122,20200225,10045
20200222,8,문정,8152,8281,20200225,16433
20200222,8,장지,10994,10348,20200225,21342
20200222,8,복정,6153,5238,20200225,11391
20200222,8,산성,3854,3713,20200225,7567
20200222,8,남한산성입구,7919,6909,20200225,14828
20200222,8,단대오거리,6835,6232,20200225,13067
20200222,8,신흥,3510,3676,20200225,7186
20200222,8,수진,3719,3488,20200225,7207
20200222,8,모란,3027,2587,20200225,5614
20200223,8,암사,6937,6461,20200226,13398
20200223,8,천호,8035,9107,20200226,17142
20200223,8,강동구청,3556,3586,20200226,7142
20200223,8,몽촌토성,2173,2198,20200226,4371
20200223,8,잠실,6755,7451,20200226,14206
20200223,8,석촌,3064,3924,20200226,6988
20200223,8,송파,3258,3174,20200226,6432
20200223,8,가락시장,2396,3261,20200226,5657
20200223,8,문정,4819,5071,20200226,9890
20200223,8,장지,7128,7280,20200226,14408
20200223,8,복정,3928,3770,20200226,7698
20200223,8,산성,2583,2716,20200226,5299
20200223,8,남한산성입구,5548,4975,20200226,10523
20200223,8,단대오거리,4243,4151,20200226,8394
20200223,8,신흥,2286,2413,20200226,4699
20200223,8,수진,2465,2223,20200226,4688
20200223,8,모란,2041,1647,20200226,3688
20200224,8,암사,17208,15266,20200227,32474
20200224,8,천호,15158,16900,20200227,32058
20200224,8,강동구청,9669,10000,20200227,19669
20200224,8,몽촌토성,4707,4995,20200227,9702
20200224,8,잠실,11424,13064,20200227,24488
20200224,8,석촌,6610,7549,20200227,14159
20200224,8,송파,7785,7444,20200227,15229
20200224,8,가락시장,6982,7897,20200227,14879
20200224,8,문정,20325,21416,20200227,41741
20200224,8,장지,14816,14450,20200227,29266
20200224,8,복정,9066,7778,20200227,16844
20200224,8,산성,4687,4715,20200227,9402
20200224,8,남한산성입구,12138,11093,20200227,23231
20200224,8,단대오거리,9362,9032,20200227,18394
20200224,8,신흥,4117,4366,20200227,8483
20200224,8,수진,4475,4050,20200227,8525
20200224,8,모란,4125,3029,20200227,7154
20200225,8,암사,15737,13754,20200228,29491
20200225,8,천호,13956,15392,20200228,29348
20200225,8,강동구청,8905,9279,20200228,18184
20200225,8,몽촌토성,4290,4583,20200228,8873
20200225,8,잠실,10570,12307,20200228,22877
20200225,8,석촌,6278,7054,20200228,13332
20200225,8,송파,7312,6821,20200228,14133
20200225,8,가락시장,6302,7151,20200228,13453
20200225,8,문정,18927,20100,20200228,39027
20200225,8,장지,13936,13487,20200228,27423
20200225,8,복정,8298,7233,20200228,15531
20200225,8,산성,4265,4215,20200228,8480
20200225,8,남한산성입구,11189,10152,20200228,21341
20200225,8,단대오거리,8602,8317,20200228,16919
20200225,8,신흥,3557,3949,20200228,7506
20200225,8,수진,4025,3607,20200228,7632
20200225,8,모란,3273,2356,20200228,5629
20200226,8,암사,15410,13587,20200229,28997
20200226,8,천호,13825,15537,20200229,29362
20200226,8,강동구청,8605,8939,20200229,17544
20200226,8,몽촌토성,4170,4420,20200229,8590
20200226,8,잠실,10499,11898,20200229,22397
20200226,8,석촌,6051,7072,20200229,13123
20200226,8,송파,6864,6594,20200229,13458
20200226,8,가락시장,6388,7080,20200229,13468
20200226,8,문정,18416,19337,20200229,37753
20200226,8,장지,13788,13343,20200229,27131
20200226,8,복정,8540,7123,20200229,15663
20200226,8,산성,4403,4318,20200229,8721
20200226,8,남한산성입구,11388,10440,20200229,21828
20200226,8,단대오거리,8612,8412,20200229,17024
20200226,8,신흥,3673,4076,20200229,7749
20200226,8,수진,4040,3645,20200229,7685
20200226,8,모란,3338,2397,20200229,5735
20200227,8,모란,3310,2351,20200301,5661
20200227,8,수진,3980,3530,20200301,7510
20200227,8,신흥,3687,3943,20200301,7630
20200227,8,단대오거리,8450,8280,20200301,16730
20200227,8,남한산성입구,11051,10065,20200301,21116
20200227,8,산성,4307,4297,20200301,8604
20200227,8,복정,8183,7089,20200301,15272
20200227,8,장지,13515,13230,20200301,26745
20200227,8,문정,17878,18875,20200301,36753
20200227,8,가락시장,6381,7158,20200301,13539
20200227,8,송파,6689,6312,20200301,13001
20200227,8,석촌,5806,6880,20200301,12686
20200227,8,잠실,10185,11632,20200301,21817
20200227,8,몽촌토성,4122,4348,20200301,8470
20200227,8,강동구청,8466,8782,20200301,17248
20200227,8,천호,13530,15152,20200301,28682
20200227,8,암사,15168,13254,20200301,28422
20200228,8,암사,14558,12877,20200302,27435
20200228,8,천호,13196,15116,20200302,28312
20200228,8,강동구청,8386,8569,20200302,16955
20200228,8,몽촌토성,3935,4311,20200302,8246
20200228,8,잠실,10423,11839,20200302,22262
20200228,8,석촌,5888,6793,20200302,12681
20200228,8,송파,6529,6221,20200302,12750
20200228,8,가락시장,6014,6902,20200302,12916
20200228,8,문정,17724,18436,20200302,36160
20200228,8,장지,13298,13003,20200302,26301
20200228,8,복정,7777,6520,20200302,14297
20200228,8,산성,4078,3944,20200302,8022
20200228,8,남한산성입구,10565,9517,20200302,20082
20200228,8,단대오거리,8238,7811,20200302,16049
20200228,8,신흥,3576,3987,20200302,7563
20200228,8,수진,3792,3451,20200302,7243
20200228,8,모란,3044,2205,20200302,5249
20200229,8,모란,2595,2142,20200303,4737
20200229,8,수진,2640,2413,20200303,5053
20200229,8,신흥,2507,2666,20200303,5173
20200229,8,단대오거리,4916,4535,20200303,9451
20200229,8,남한산성입구,6111,5266,20200303,11377
20200229,8,산성,2878,2847,20200303,5725
20200229,8,복정,3926,3468,20200303,7394
20200229,8,장지,7548,7310,20200303,14858
20200229,8,문정,5269,5270,20200303,10539
20200229,8,가락시장,3577,3575,20200303,7152
20200229,8,송파,3410,3219,20200303,6629
20200229,8,석촌,3432,4089,20200303,7521
20200229,8,잠실,6310,7130,20200303,13440
20200229,8,몽촌토성,2331,2421,20200303,4752
20200229,8,강동구청,3758,3770,20200303,7528
20200229,8,천호,8360,9783,20200303,18143
20200229,8,암사,7788,6982,20200303,14770
20200301,8,암사,5136,4769,20200304,9905
20200301,8,천호,5677,6356,20200304,12033
20200301,8,강동구청,2469,2554,20200304,5023
20200301,8,몽촌토성,1566,1605,20200304,3171
20200301,8,잠실,4870,5243,20200304,10113
20200301,8,석촌,2329,2734,20200304,5063
20200301,8,송파,2195,2184,20200304,4379
20200301,8,가락시장,1874,2659,20200304,4533
20200301,8,문정,3224,3262,20200304,6486
20200301,8,장지,5165,5486,20200304,10651
20200301,8,복정,2367,2347,20200304,4714
20200301,8,산성,1952,1892,20200304,3844
20200301,8,남한산성입구,3973,3738,20200304,7711
20200301,8,단대오거리,3132,2991,20200304,6123
20200301,8,신흥,1731,1772,20200304,3503
20200301,8,수진,1736,1533,20200304,3269
20200301,8,모란,1356,1218,20200304,2574
20200302,8,암사,14522,12854,20200305,27376
20200302,8,천호,12905,14506,20200305,27411
20200302,8,강동구청,8185,8689,20200305,16874
20200302,8,몽촌토성,3986,4227,20200305,8213
20200302,8,잠실,9750,11154,20200305,20904
20200302,8,석촌,5845,6691,20200305,12536
20200302,8,송파,6558,6310,20200305,12868
20200302,8,가락시장,6220,7078,20200305,13298
20200302,8,문정,17700,18731,20200305,36431
20200302,8,장지,11922,11614,20200305,23536
20200302,8,복정,7883,6702,20200305,14585
20200302,8,산성,4108,4156,20200305,8264
20200302,8,남한산성입구,10683,9721,20200305,20404
20200302,8,단대오거리,8167,8078,20200305,16245
20200302,8,신흥,3625,3888,20200305,7513
20200302,8,수진,3876,3497,20200305,7373
20200302,8,모란,3275,2331,20200305,5606
20200303,8,암사,14629,12871,20200306,27500
20200303,8,천호,13094,14678,20200306,27772
20200303,8,강동구청,8304,8683,20200306,16987
20200303,8,몽촌토성,3916,4169,20200306,8085
20200303,8,잠실,10349,11761,20200306,22110
20200303,8,석촌,5931,6742,20200306,12673
20200303,8,송파,6533,6228,20200306,12761
20200303,8,가락시장,6239,7012,20200306,13251
20200303,8,문정,17573,18515,20200306,36088
20200303,8,장지,13195,13021,20200306,26216
20200303,8,복정,7953,6764,20200306,14717
20200303,8,산성,4217,4166,20200306,8383
20200303,8,남한산성입구,10742,9790,20200306,20532
20200303,8,단대오거리,8333,8030,20200306,16363
20200303,8,신흥,3463,3715,20200306,7178
20200303,8,수진,3758,3408,20200306,7166
20200303,8,모란,3254,2317,20200306,5571
20200304,8,모란,3601,2605,20200307,6206
20200304,8,암사,14698,13031,20200307,27729
20200304,8,천호,13065,14623,20200307,27688
20200304,8,강동구청,8304,8783,20200307,17087
20200304,8,몽촌토성,3941,4181,20200307,8122
20200304,8,잠실,10422,11656,20200307,22078
20200304,8,석촌,6056,6832,20200307,12888
20200304,8,송파,6643,6306,20200307,12949
20200304,8,가락시장,6193,6997,20200307,13190
20200304,8,문정,17777,18535,20200307,36312
20200304,8,장지,13150,12832,20200307,25982
20200304,8,복정,8126,6831,20200307,14957
20200304,8,산성,4148,4199,20200307,8347
20200304,8,남한산성입구,10639,9708,20200307,20347
20200304,8,단대오거리,8299,8136,20200307,16435
20200304,8,신흥,3601,3923,20200307,7524
20200304,8,수진,3958,3542,20200307,7500
20200305,8,암사,14775,12995,20200308,27770
20200305,8,천호,13050,14767,20200308,27817
20200305,8,강동구청,8422,8775,20200308,17197
20200305,8,몽촌토성,4057,4237,20200308,8294
20200305,8,잠실,10615,11876,20200308,22491
20200305,8,석촌,5889,6872,20200308,12761
20200305,8,송파,6602,6280,20200308,12882
20200305,8,가락시장,6454,7229,20200308,13683
20200305,8,문정,17518,18510,20200308,36028
20200305,8,장지,13352,13032,20200308,26384
20200305,8,복정,8074,6807,20200308,14881
20200305,8,산성,4182,4184,20200308,8366
20200305,8,남한산성입구,10684,9823,20200308,20507
20200305,8,단대오거리,8239,7967,20200308,16206
20200305,8,신흥,3578,3880,20200308,7458
20200305,8,수진,3894,3497,20200308,7391
20200305,8,모란,3227,2399,20200308,5626
20200306,8,암사,15145,13218,20200309,28363
20200306,8,천호,13706,16028,20200309,29734
20200306,8,강동구청,8505,8814,20200309,17319
20200306,8,몽촌토성,4067,4454,20200309,8521
20200306,8,잠실,10991,12336,20200309,23327
20200306,8,석촌,6143,7099,20200309,13242
20200306,8,송파,6907,6476,20200309,13383
20200306,8,가락시장,6471,7406,20200309,13877
20200306,8,문정,17624,18255,20200309,35879
20200306,8,장지,13668,13112,20200309,26780
20200306,8,복정,8467,6994,20200309,15461
20200306,8,산성,4291,4193,20200309,8484
20200306,8,남한산성입구,10959,9645,20200309,20604
20200306,8,단대오거리,8410,7950,20200309,16360
20200306,8,신흥,3660,4016,20200309,7676
20200306,8,수진,3964,3545,20200309,7509
20200306,8,모란,3299,2597,20200309,5896
20200307,8,암사,8554,7794,20200310,16348
20200307,8,천호,9134,11108,20200310,20242
20200307,8,강동구청,4134,4089,20200310,8223
20200307,8,몽촌토성,2425,2552,20200310,4977
20200307,8,잠실,7425,8224,20200310,15649
20200307,8,석촌,3836,4619,20200310,8455
20200307,8,송파,3712,3520,20200310,7232
20200307,8,가락시장,3901,4029,20200310,7930
20200307,8,문정,5665,5598,20200310,11263
20200307,8,장지,7903,7514,20200310,15417
20200307,8,복정,4335,3668,20200310,8003
20200307,8,산성,3078,2966,20200310,6044
20200307,8,남한산성입구,6214,5589,20200310,11803
20200307,8,단대오거리,4952,4620,20200310,9572
20200307,8,신흥,2631,2788,20200310,5419
20200307,8,수진,2657,2396,20200310,5053
20200307,8,모란,2384,1910,20200310,4294
20200308,8,암사,5906,5353,20200311,11259
20200308,8,천호,6282,7288,20200311,13570
20200308,8,강동구청,2817,2844,20200311,5661
20200308,8,몽촌토성,1920,1992,20200311,3912
20200308,8,잠실,5769,6146,20200311,11915
20200308,8,석촌,2679,3271,20200311,5950
20200308,8,송파,2579,2495,20200311,5074
20200308,8,가락시장,2011,2813,20200311,4824
20200308,8,문정,3448,3668,20200311,7116
20200308,8,장지,5521,5744,20200311,11265
20200308,8,복정,2694,2593,20200311,5287
20200308,8,산성,2276,2303,20200311,4579
20200308,8,남한산성입구,4462,3928,20200311,8390
20200308,8,단대오거리,3347,3279,20200311,6626
20200308,8,신흥,1764,1843,20200311,3607
20200308,8,수진,1824,1670,20200311,3494
20200308,8,모란,1543,1322,20200311,2865
20200309,8,암사,15543,13571,20200312,29114
20200309,8,천호,13694,15591,20200312,29285
20200309,8,강동구청,8652,9026,20200312,17678
20200309,8,몽촌토성,4269,4581,20200312,8850
20200309,8,잠실,10810,12396,20200312,23206
20200309,8,석촌,6194,7123,20200312,13317
20200309,8,송파,7076,6572,20200312,13648
20200309,8,가락시장,6459,7419,20200312,13878
20200309,8,문정,18495,19368,20200312,37863
20200309,8,장지,13675,13285,20200312,26960
20200309,8,복정,8383,7120,20200312,15503
20200309,8,산성,4329,4322,20200312,8651
20200309,8,남한산성입구,11105,10205,20200312,21310
20200309,8,단대오거리,8707,8374,20200312,17081
20200309,8,신흥,3806,4060,20200312,7866
20200309,8,수진,4088,3682,20200312,7770
20200309,8,모란,3912,2934,20200312,6846
20200310,8,암사,15078,13252,20200313,28330
20200310,8,천호,13159,14882,20200313,28041
20200310,8,강동구청,8427,8761,20200313,17188
20200310,8,몽촌토성,3997,4316,20200313,8313
20200310,8,잠실,10492,11877,20200313,22369
20200310,8,석촌,6066,6916,20200313,12982
20200310,8,송파,7022,6729,20200313,13751
20200310,8,가락시장,6242,7033,20200313,13275
20200310,8,문정,17980,19046,20200313,37026
20200310,8,장지,13435,12964,20200313,26399
20200310,8,복정,7981,6802,20200313,14783
20200310,8,산성,4029,3987,20200313,8016
20200310,8,남한산성입구,10629,9634,20200313,20263
20200310,8,단대오거리,8166,8028,20200313,16194
20200310,8,신흥,3472,3707,20200313,7179
20200310,8,수진,3869,3525,20200313,7394
20200310,8,모란,3090,2229,20200313,5319
20200311,8,암사,15456,13698,20200314,29154
20200311,8,천호,13770,15733,20200314,29503
20200311,8,강동구청,8605,8792,20200314,17397
20200311,8,몽촌토성,4279,4572,20200314,8851
20200311,8,잠실,11165,12764,20200314,23929
20200311,8,석촌,6221,7190,20200314,13411
20200311,8,송파,7044,6711,20200314,13755
20200311,8,가락시장,6626,7417,20200314,14043
20200311,8,문정,18343,19242,20200314,37585
20200311,8,장지,13854,13309,20200314,27163
20200311,8,복정,8406,7126,20200314,15532
20200311,8,산성,4363,4360,20200314,8723
20200311,8,남한산성입구,11042,10116,20200314,21158
20200311,8,단대오거리,8653,8261,20200314,16914
20200311,8,신흥,3784,4053,20200314,7837
20200311,8,수진,4001,3644,20200314,7645
20200311,8,모란,3277,2369,20200314,5646
20200312,8,암사,15246,13412,20200315,28658
20200312,8,천호,13614,15229,20200315,28843
20200312,8,강동구청,8413,8696,20200315,17109
20200312,8,몽촌토성,4161,4416,20200315,8577
20200312,8,잠실,10663,12405,20200315,23068
20200312,8,석촌,5970,7132,20200315,13102
20200312,8,송파,6907,6492,20200315,13399
20200312,8,가락시장,6610,7522,20200315,14132
20200312,8,문정,17936,18918,20200315,36854
20200312,8,장지,13500,13113,20200315,26613
20200312,8,복정,8276,7038,20200315,15314
20200312,8,산성,4318,4286,20200315,8604
20200312,8,남한산성입구,11106,10019,20200315,21125
20200312,8,단대오거리,8381,8228,20200315,16609
20200312,8,신흥,3647,3921,20200315,7568
20200312,8,수진,3946,3627,20200315,7573
20200312,8,모란,3328,2431,20200315,5759
20200313,8,암사,15476,13424,20200316,28900
20200313,8,천호,14237,16591,20200316,30828
20200313,8,강동구청,8603,8781,20200316,17384
20200313,8,몽촌토성,4177,4477,20200316,8654
20200313,8,잠실,11348,13159,20200316,24507
20200313,8,석촌,6394,7396,20200316,13790
20200313,8,송파,7057,6749,20200316,13806
20200313,8,가락시장,6678,7571,20200316,14249
20200313,8,문정,17746,18562,20200316,36308
20200313,8,장지,13842,13258,20200316,27100
20200313,8,복정,8514,7149,20200316,15663
20200313,8,산성,4393,4222,20200316,8615
20200313,8,남한산성입구,11024,9782,20200316,20806
20200313,8,단대오거리,8576,8148,20200316,16724
20200313,8,신흥,3788,4065,20200316,7853
20200313,8,수진,4040,3669,20200316,7709
20200313,8,모란,3418,2620,20200316,6038
20200314,8,암사,9021,8151,20200317,17172
20200314,8,천호,9727,11585,20200317,21312
20200314,8,강동구청,4244,4308,20200317,8552
20200314,8,몽촌토성,2763,2775,20200317,5538
20200314,8,잠실,8456,9151,20200317,17607
20200314,8,석촌,4133,5166,20200317,9299
20200314,8,송파,3977,3854,20200317,7831
20200314,8,가락시장,4048,4205,20200317,8253
20200314,8,문정,6103,6026,20200317,12129
20200314,8,장지,8628,8043,20200317,16671
20200314,8,복정,4752,4011,20200317,8763
20200314,8,산성,3328,3269,20200317,6597
20200314,8,남한산성입구,6730,5844,20200317,12574
20200314,8,단대오거리,5516,5074,20200317,10590
20200314,8,신흥,2772,2904,20200317,5676
20200314,8,수진,2969,2725,20200317,5694
20200314,8,모란,3245,2680,20200317,5925
20200315,8,암사,5862,5481,20200318,11343
20200315,8,천호,6581,7590,20200318,14171
20200315,8,강동구청,2779,2842,20200318,5621
20200315,8,몽촌토성,1848,1874,20200318,3722
20200315,8,잠실,6226,6463,20200318,12689
20200315,8,석촌,2675,3222,20200318,5897
20200315,8,송파,2533,2602,20200318,5135
20200315,8,가락시장,2109,2921,20200318,5030
20200315,8,문정,3492,3676,20200318,7168
20200315,8,장지,5852,5973,20200318,11825
20200315,8,복정,2803,2615,20200318,5418
20200315,8,산성,2124,2198,20200318,4322
20200315,8,남한산성입구,4462,4043,20200318,8505
20200315,8,단대오거리,3535,3488,20200318,7023
20200315,8,신흥,1907,1972,20200318,3879
20200315,8,수진,1978,1759,20200318,3737
20200315,8,모란,1635,1310,20200318,2945
20200316,8,암사,15433,13619,20200319,29052
20200316,8,천호,13401,14910,20200319,28311
20200316,8,강동구청,8516,8871,20200319,17387
20200316,8,몽촌토성,4290,4550,20200319,8840
20200316,8,잠실,10759,12372,20200319,23131
20200316,8,석촌,6091,7067,20200319,13158
20200316,8,송파,6862,6641,20200319,13503
20200316,8,가락시장,6389,7246,20200319,13635
20200316,8,문정,18155,19122,20200319,37277
20200316,8,장지,13425,13203,20200319,26628
20200316,8,복정,8108,6898,20200319,15006
20200316,8,산성,4196,4150,20200319,8346
20200316,8,남한산성입구,10639,9687,20200319,20326
20200316,8,단대오거리,8448,8206,20200319,16654
20200316,8,신흥,3566,3819,20200319,7385
20200316,8,수진,3895,3468,20200319,7363
20200316,8,모란,3269,2346,20200319,5615
20200317,8,암사,15371,13508,20200320,28879
20200317,8,천호,13562,15414,20200320,28976
20200317,8,강동구청,8473,8865,20200320,17338
20200317,8,몽촌토성,4150,4470,20200320,8620
20200317,8,잠실,10740,12153,20200320,22893
20200317,8,석촌,6088,7111,20200320,13199
20200317,8,송파,6827,6550,20200320,13377
20200317,8,가락시장,6432,7294,20200320,13726
20200317,8,문정,17947,18972,20200320,36919
20200317,8,장지,13489,13102,20200320,26591
20200317,8,복정,8240,7036,20200320,15276
20200317,8,산성,4082,4080,20200320,8162
20200317,8,남한산성입구,10351,9253,20200320,19604
20200317,8,단대오거리,8297,8114,20200320,16411
20200317,8,신흥,3433,3645,20200320,7078
20200317,8,수진,3698,3377,20200320,7075
20200317,8,모란,3061,2220,20200320,5281
20200318,8,장지,13955,13520,20200321,27475
20200318,8,암사,15754,13868,20200321,29622
20200318,8,천호,13957,16005,20200321,29962
20200318,8,강동구청,8627,8903,20200321,17530
20200318,8,몽촌토성,4475,4654,20200321,9129
20200318,8,잠실,11085,12501,20200321,23586
20200318,8,석촌,6198,7276,20200321,13474
20200318,8,송파,7011,6742,20200321,13753
20200318,8,가락시장,6675,7389,20200321,14064
20200318,8,문정,18281,19276,20200321,37557
20200318,8,복정,8408,7119,20200321,15527
20200318,8,산성,4316,4331,20200321,8647
20200318,8,남한산성입구,10705,9481,20200321,20186
20200318,8,단대오거리,8408,8293,20200321,16701
20200318,8,신흥,3538,3822,20200321,7360
20200318,8,수진,3772,3414,20200321,7186
20200318,8,모란,3195,2355,20200321,5550
20200319,8,암사,15176,13415,20200322,28591
20200319,8,천호,13403,15091,20200322,28494
20200319,8,강동구청,8442,8653,20200322,17095
20200319,8,몽촌토성,4008,4296,20200322,8304
20200319,8,잠실,10462,12036,20200322,22498
20200319,8,석촌,6043,6983,20200322,13026
20200319,8,송파,6793,6485,20200322,13278
20200319,8,가락시장,6425,7269,20200322,13694
20200319,8,문정,17972,18931,20200322,36903
20200319,8,장지,13213,12901,20200322,26114
20200319,8,복정,8002,6861,20200322,14863
20200319,8,산성,4092,4042,20200322,8134
20200319,8,남한산성입구,10164,9193,20200322,19357
20200319,8,단대오거리,8161,7868,20200322,16029
20200319,8,신흥,3538,3790,20200322,7328
20200319,8,수진,3877,3462,20200322,7339
20200319,8,모란,3527,2614,20200322,6141
20200320,8,암사,16096,13955,20200323,30051
20200320,8,천호,14661,17230,20200323,31891
20200320,8,강동구청,8789,9016,20200323,17805
20200320,8,몽촌토성,4439,4638,20200323,9077
20200320,8,잠실,11570,13557,20200323,25127
20200320,8,석촌,6590,7718,20200323,14308
20200320,8,송파,7390,7008,20200323,14398
20200320,8,가락시장,6873,7854,20200323,14727
20200320,8,문정,18469,19240,20200323,37709
20200320,8,장지,14248,13628,20200323,27876
20200320,8,복정,8716,7323,20200323,16039
20200320,8,산성,4464,4295,20200323,8759
20200320,8,남한산성입구,11054,9489,20200323,20543
20200320,8,단대오거리,8793,8226,20200323,17019
20200320,8,신흥,3666,4002,20200323,7668
20200320,8,수진,4000,3649,20200323,7649
20200320,8,모란,3374,2567,20200323,5941
20200321,8,암사,9246,8288,20200324,17534
20200321,8,천호,9738,11754,20200324,21492
20200321,8,강동구청,4321,4321,20200324,8642
20200321,8,몽촌토성,2995,3062,20200324,6057
20200321,8,잠실,7918,8840,20200324,16758
20200321,8,석촌,4135,5070,20200324,9205
20200321,8,송파,4101,3856,20200324,7957
20200321,8,가락시장,4150,4180,20200324,8330
20200321,8,문정,5994,5858,20200324,11852
20200321,8,장지,8513,8050,20200324,16563
20200321,8,복정,4730,3971,20200324,8701
20200321,8,산성,3361,3168,20200324,6529
20200321,8,남한산성입구,6314,5562,20200324,11876
20200321,8,단대오거리,5433,5085,20200324,10518
20200321,8,신흥,2653,2716,20200324,5369
20200321,8,수진,2866,2532,20200324,5398
20200321,8,모란,2451,2106,20200324,4557
20200322,8,문정,3651,3813,20200325,7464
20200322,8,암사,6194,5592,20200325,11786
20200322,8,천호,6689,7643,20200325,14332
20200322,8,강동구청,2949,2948,20200325,5897
20200322,8,몽촌토성,2281,2414,20200325,4695
20200322,8,잠실,6291,6481,20200325,12772
20200322,8,석촌,2747,3458,20200325,6205
20200322,8,송파,2674,2667,20200325,5341
20200322,8,가락시장,2049,2928,20200325,4977
20200322,8,장지,5996,6130,20200325,12126
20200322,8,복정,2900,2848,20200325,5748
20200322,8,산성,2325,2376,20200325,4701
20200322,8,남한산성입구,4528,4049,20200325,8577
20200322,8,단대오거리,3508,3482,20200325,6990
20200322,8,신흥,1885,1904,20200325,3789
20200322,8,수진,1968,1778,20200325,3746
20200322,8,모란,1697,1421,20200325,3118
20200323,8,암사,15528,13864,20200326,29392
20200323,8,천호,13820,15552,20200326,29372
20200323,8,강동구청,8640,8816,20200326,17456
20200323,8,몽촌토성,4326,4688,20200326,9014
20200323,8,잠실,10776,12272,20200326,23048
20200323,8,석촌,6104,7220,20200326,13324
20200323,8,송파,7025,6776,20200326,13801
20200323,8,가락시장,6562,7434,20200326,13996
20200323,8,문정,18594,19591,20200326,38185
20200323,8,장지,13542,13251,20200326,26793
20200323,8,복정,8355,7148,20200326,15503
20200323,8,산성,4325,4331,20200326,8656
20200323,8,남한산성입구,10749,9855,20200326,20604
20200323,8,단대오거리,8566,8260,20200326,16826
20200323,8,신흥,3718,3920,20200326,7638
20200323,8,수진,3974,3700,20200326,7674
20200323,8,모란,3296,2453,20200326,5749
20200324,8,암사,15573,13691,20200327,29264
20200324,8,천호,13717,15534,20200327,29251
20200324,8,강동구청,8567,8841,20200327,17408
20200324,8,몽촌토성,4506,4638,20200327,9144
20200324,8,잠실,10796,12338,20200327,23134
20200324,8,석촌,6275,7255,20200327,13530
20200324,8,송파,7099,6774,20200327,13873
20200324,8,가락시장,6572,7337,20200327,13909
20200324,8,문정,18511,19563,20200327,38074
20200324,8,장지,13635,13417,20200327,27052
20200324,8,복정,8455,7299,20200327,15754
20200324,8,산성,4383,4351,20200327,8734
20200324,8,남한산성입구,11011,9823,20200327,20834
20200324,8,단대오거리,8693,8384,20200327,17077
20200324,8,신흥,3683,3884,20200327,7567
20200324,8,수진,3942,3676,20200327,7618
20200324,8,모란,3983,2908,20200327,6891
20200325,8,암사,15803,14021,20200328,29824
20200325,8,천호,14105,15856,20200328,29961
20200325,8,강동구청,8809,8981,20200328,17790
20200325,8,몽촌토성,4501,4779,20200328,9280
20200325,8,잠실,11090,12677,20200328,23767
20200325,8,석촌,6352,7358,20200328,13710
20200325,8,송파,7214,6835,20200328,14049
20200325,8,가락시장,6836,7635,20200328,14471
20200325,8,문정,18582,19668,20200328,38250
20200325,8,장지,14294,13778,20200328,28072
20200325,8,복정,8661,7334,20200328,15995
20200325,8,산성,4443,4462,20200328,8905
20200325,8,남한산성입구,11140,10045,20200328,21185
20200325,8,단대오거리,8700,8375,20200328,17075
20200325,8,신흥,3730,4025,20200328,7755
20200325,8,수진,3983,3640,20200328,7623
20200325,8,모란,3305,2500,20200328,5805
20200326,8,가락시장,6674,7521,20200329,14195
20200326,8,암사,15680,13684,20200329,29364
20200326,8,천호,13744,15490,20200329,29234
20200326,8,강동구청,8660,8972,20200329,17632
20200326,8,몽촌토성,4362,4605,20200329,8967
20200326,8,잠실,10780,12397,20200329,23177
20200326,8,석촌,6181,7230,20200329,13411
20200326,8,송파,7010,6736,20200329,13746
20200326,8,문정,18647,19555,20200329,38202
20200326,8,장지,13960,13546,20200329,27506
20200326,8,복정,8233,7187,20200329,15420
20200326,8,산성,4288,4238,20200329,8526
20200326,8,남한산성입구,10705,9701,20200329,20406
20200326,8,단대오거리,8379,8138,20200329,16517
20200326,8,신흥,3624,3852,20200329,7476
20200326,8,수진,4009,3539,20200329,7548
20200326,8,모란,3168,2405,20200329,5573
20200327,8,암사,16056,13914,20200330,29970
20200327,8,천호,14476,16958,20200330,31434
20200327,8,강동구청,8910,8917,20200330,17827
20200327,8,몽촌토성,4523,4798,20200330,9321
20200327,8,잠실,11726,13470,20200330,25196
20200327,8,석촌,6447,7637,20200330,14084
20200327,8,송파,7242,6820,20200330,14062
20200327,8,가락시장,6748,7764,20200330,14512
20200327,8,문정,18630,19483,20200330,38113
20200327,8,장지,14278,13715,20200330,27993
20200327,8,복정,8849,7374,20200330,16223
20200327,8,산성,4272,4268,20200330,8540
20200327,8,남한산성입구,11125,9669,20200330,20794
20200327,8,단대오거리,8795,8218,20200330,17013
20200327,8,신흥,3866,3940,20200330,7806
20200327,8,수진,4103,3660,20200330,7763
20200327,8,모란,3465,2637,20200330,6102
20200328,8,암사,9313,8474,20200331,17787
20200328,8,천호,9957,11865,20200331,21822
20200328,8,강동구청,4407,4393,20200331,8800
20200328,8,몽촌토성,3124,3208,20200331,6332
20200328,8,잠실,8223,9126,20200331,17349
20200328,8,석촌,4232,5185,20200331,9417
20200328,8,송파,4063,3926,20200331,7989
20200328,8,가락시장,4135,4246,20200331,8381
20200328,8,문정,6038,5984,20200331,12022
20200328,8,장지,8914,8461,20200331,17375
20200328,8,복정,4885,4118,20200331,9003
20200328,8,산성,3452,3350,20200331,6802
20200328,8,남한산성입구,6721,5963,20200331,12684
20200328,8,단대오거리,5699,5254,20200331,10953
20200328,8,신흥,2814,2837,20200331,5651
20200328,8,수진,2978,2672,20200331,5650
20200328,8,모란,2628,2201,20200331,4829
20200329,8,암사,6494,6067,20200401,12561
20200329,8,천호,6926,7915,20200401,14841
20200329,8,강동구청,3063,3177,20200401,6240
20200329,8,몽촌토성,2527,2566,20200401,5093
20200329,8,잠실,6167,6515,20200401,12682
20200329,8,석촌,2867,3471,20200401,6338
20200329,8,송파,2759,2789,20200401,5548
20200329,8,가락시장,2374,3192,20200401,5566
20200329,8,문정,3693,3895,20200401,7588
20200329,8,장지,6370,6490,20200401,12860
20200329,8,복정,3205,2995,20200401,6200
20200329,8,산성,2477,2557,20200401,5034
20200329,8,남한산성입구,4987,4593,20200401,9580
20200329,8,단대오거리,3830,3689,20200401,7519
20200329,8,신흥,2069,2063,20200401,4132
20200329,8,수진,2163,2006,20200401,4169
20200329,8,모란,2744,2207,20200401,4951
20200330,8,암사,15853,13891,20200402,29744
20200330,8,천호,13993,15832,20200402,29825
20200330,8,강동구청,8746,9042,20200402,17788
20200330,8,몽촌토성,4569,4877,20200402,9446
20200330,8,잠실,10817,12241,20200402,23058
20200330,8,석촌,6195,7102,20200402,13297
20200330,8,송파,7002,6754,20200402,13756
20200330,8,가락시장,6570,7394,20200402,13964
20200330,8,문정,18941,20093,20200402,39034
20200330,8,장지,13781,13519,20200402,27300
20200330,8,복정,8543,7449,20200402,15992
20200330,8,산성,4358,4414,20200402,8772
20200330,8,남한산성입구,11229,10125,20200402,21354
20200330,8,단대오거리,8640,8417,20200402,17057
20200330,8,신흥,3714,4008,20200402,7722
20200330,8,수진,4143,3723,20200402,7866
20200330,8,모란,3544,2473,20200402,6017
20200331,8,암사,15966,13939,20200403,29905
20200331,8,천호,14009,15750,20200403,29759
20200331,8,강동구청,8912,9103,20200403,18015
20200331,8,몽촌토성,4672,4828,20200403,9500
20200331,8,잠실,10898,12418,20200403,23316
20200331,8,석촌,6245,7123,20200403,13368
20200331,8,송파,7179,6772,20200403,13951
20200331,8,가락시장,6693,7443,20200403,14136
20200331,8,문정,18703,19786,20200403,38489
20200331,8,장지,14121,13642,20200403,27763
20200331,8,복정,8757,7326,20200403,16083
20200331,8,산성,4347,4393,20200403,8740
20200331,8,남한산성입구,11359,10255,20200403,21614
20200331,8,단대오거리,8766,8444,20200403,17210
20200331,8,신흥,3763,3982,20200403,7745
20200331,8,수진,4004,3658,20200403,7662
20200331,8,모란,3443,2456,20200403,5899
20200401,8,암사,15876,13923,20200404,29799
20200401,8,천호,14020,15912,20200404,29932
20200401,8,강동구청,8752,9153,20200404,17905
20200401,8,몽촌토성,4690,4907,20200404,9597
20200401,8,잠실,10883,12402,20200404,23285
20200401,8,석촌,6301,7238,20200404,13539
20200401,8,송파,7290,6880,20200404,14170
20200401,8,가락시장,6716,7592,20200404,14308
20200401,8,문정,19064,20053,20200404,39117
20200401,8,장지,14438,13824,20200404,28262
20200401,8,복정,8805,7478,20200404,16283
20200401,8,산성,4391,4358,20200404,8749
20200401,8,남한산성입구,11260,10154,20200404,21414
20200401,8,단대오거리,8725,8473,20200404,17198
20200401,8,신흥,3669,3929,20200404,7598
20200401,8,수진,4079,3688,20200404,7767
20200401,8,모란,3418,2502,20200404,5920
20200402,8,암사,15925,13970,20200405,29895
20200402,8,천호,14113,15766,20200405,29879
20200402,8,강동구청,8752,8911,20200405,17663
20200402,8,몽촌토성,4732,5049,20200405,9781
20200402,8,잠실,10899,12337,20200405,23236
20200402,8,석촌,6272,7183,20200405,13455
20200402,8,송파,7244,6802,20200405,14046
20200402,8,가락시장,6646,7549,20200405,14195
20200402,8,문정,18830,19838,20200405,38668
20200402,8,장지,14340,13771,20200405,28111
20200402,8,복정,8660,7432,20200405,16092
20200402,8,산성,4366,4369,20200405,8735
20200402,8,남한산성입구,11255,10103,20200405,21358
20200402,8,단대오거리,8572,8282,20200405,16854
20200402,8,신흥,3748,3864,20200405,7612
20200402,8,수진,4013,3597,20200405,7610
20200402,8,모란,3356,2565,20200405,5921
20200403,8,암사,16375,14075,20200406,30450
20200403,8,천호,14609,17377,20200406,31986
20200403,8,강동구청,8872,9151,20200406,18023
20200403,8,몽촌토성,4954,5145,20200406,10099
20200403,8,잠실,11452,13375,20200406,24827
20200403,8,석촌,6486,7558,20200406,14044
20200403,8,송파,7471,7065,20200406,14536
20200403,8,가락시장,6938,8066,20200406,15004
20200403,8,문정,18963,19675,20200406,38638
20200403,8,장지,14915,14000,20200406,28915
20200403,8,복정,9082,7612,20200406,16694
20200403,8,산성,4564,4343,20200406,8907
20200403,8,남한산성입구,11606,9949,20200406,21555
20200403,8,단대오거리,8964,8239,20200406,17203
20200403,8,신흥,3849,4080,20200406,7929
20200403,8,수진,4183,3692,20200406,7875
20200403,8,모란,3604,2727,20200406,6331
20200404,8,암사,9370,8613,20200407,17983
20200404,8,천호,10119,11908,20200407,22027
20200404,8,강동구청,4499,4463,20200407,8962
20200404,8,몽촌토성,3322,3464,20200407,6786
20200404,8,잠실,8224,8914,20200407,17138
20200404,8,석촌,4149,5020,20200407,9169
20200404,8,송파,4161,4017,20200407,8178
20200404,8,가락시장,4215,4207,20200407,8422
20200404,8,문정,5668,5626,20200407,11294
20200404,8,장지,9061,8547,20200407,17608
20200404,8,복정,4940,4094,20200407,9034
20200404,8,산성,3660,3499,20200407,7159
20200404,8,남한산성입구,6905,6192,20200407,13097
20200404,8,단대오거리,5789,5234,20200407,11023
20200404,8,신흥,2820,3076,20200407,5896
20200404,8,수진,3126,2846,20200407,5972
20200404,8,모란,3808,3181,20200407,6989
20200405,8,암사,6377,5842,20200408,12219
20200405,8,천호,6886,7995,20200408,14881
20200405,8,강동구청,3083,3112,20200408,6195
20200405,8,몽촌토성,2390,2522,20200408,4912
20200405,8,잠실,6075,6345,20200408,12420
20200405,8,석촌,2863,3446,20200408,6309
20200405,8,송파,2653,2670,20200408,5323
20200405,8,가락시장,2297,3015,20200408,5312
20200405,8,문정,4035,4274,20200408,8309
20200405,8,장지,6219,6605,20200408,12824
20200405,8,복정,3107,2885,20200408,5992
20200405,8,산성,2431,2457,20200408,4888
20200405,8,남한산성입구,4843,4472,20200408,9315
20200405,8,단대오거리,3753,3692,20200408,7445
20200405,8,신흥,1970,2037,20200408,4007
20200405,8,수진,2062,1782,20200408,3844
20200405,8,모란,1828,1443,20200408,3271
20200406,8,잠실,10904,12493,20200409,23397
20200406,8,석촌,6367,7398,20200409,13765
20200406,8,송파,7374,7131,20200409,14505
20200406,8,가락시장,6733,7568,20200409,14301
20200406,8,문정,19322,20327,20200409,39649
20200406,8,장지,14364,13932,20200409,28296
20200406,8,복정,8664,7503,20200409,16167
20200406,8,산성,4424,4394,20200409,8818
20200406,8,남한산성입구,11434,10464,20200409,21898
20200406,8,단대오거리,8777,8503,20200409,17280
20200406,8,신흥,3812,4097,20200409,7909
20200406,8,수진,4161,3834,20200409,7995
20200406,8,모란,3553,2422,20200409,5975
20200406,8,암사,16362,14525,20200409,30887
20200406,8,천호,14251,16059,20200409,30310
20200406,8,강동구청,8937,9287,20200409,18224
20200406,8,몽촌토성,4707,4992,20200409,9699
20200407,8,암사,16544,14484,20200410,31028
20200407,8,천호,14204,16252,20200410,30456
20200407,8,강동구청,8974,9239,20200410,18213
20200407,8,몽촌토성,4665,4964,20200410,9629
20200407,8,잠실,10996,12379,20200410,23375
20200407,8,석촌,6428,7389,20200410,13817
20200407,8,송파,7511,7209,20200410,14720
20200407,8,가락시장,6927,7836,20200410,14763
20200407,8,문정,19131,20081,20200410,39212
20200407,8,장지,14667,14172,20200410,28839
20200407,8,복정,8883,7800,20200410,16683
20200407,8,산성,4519,4469,20200410,8988
20200407,8,남한산성입구,11620,10459,20200410,22079
20200407,8,단대오거리,9064,8796,20200410,17860
20200407,8,신흥,3707,3957,20200410,7664
20200407,8,수진,4090,3713,20200410,7803
20200407,8,모란,3450,2424,20200410,5874
20200408,8,암사,16448,14511,20200411,30959
20200408,8,천호,14338,16337,20200411,30675
20200408,8,강동구청,9049,9173,20200411,18222
20200408,8,몽촌토성,4717,5037,20200411,9754
20200408,8,잠실,11168,12749,20200411,23917
20200408,8,석촌,6644,7336,20200411,13980
20200408,8,송파,7494,7092,20200411,14586
20200408,8,가락시장,6943,7761,20200411,14704
20200408,8,문정,19324,20237,20200411,39561
20200408,8,장지,14750,14134,20200411,28884
20200408,8,복정,9068,7778,20200411,16846
20200408,8,산성,4460,4448,20200411,8908
20200408,8,남한산성입구,11556,10710,20200411,22266
20200408,8,단대오거리,9017,8727,20200411,17744
20200408,8,신흥,3784,4003,20200411,7787
20200408,8,수진,4213,3810,20200411,8023
20200408,8,모란,3530,2459,20200411,5989
20200409,8,암사,16596,14450,20200412,31046
20200409,8,천호,14459,16411,20200412,30870
20200409,8,강동구청,9147,9304,20200412,18451
20200409,8,몽촌토성,4678,4992,20200412,9670
20200409,8,잠실,11117,12849,20200412,23966
20200409,8,석촌,6564,7480,20200412,14044
20200409,8,송파,7519,7101,20200412,14620
20200409,8,가락시장,6989,7812,20200412,14801
20200409,8,문정,19301,20345,20200412,39646
20200409,8,장지,14901,14232,20200412,29133
20200409,8,복정,8970,7769,20200412,16739
20200409,8,산성,4559,4511,20200412,9070
20200409,8,남한산성입구,11767,10548,20200412,22315
20200409,8,단대오거리,9170,8737,20200412,17907
20200409,8,신흥,3937,4086,20200412,8023
20200409,8,수진,4207,3838,20200412,8045
20200409,8,모란,4675,3379,20200412,8054
20200410,8,암사,16777,14706,20200413,31483
20200410,8,천호,15186,17768,20200413,32954
20200410,8,강동구청,9233,9282,20200413,18515
20200410,8,몽촌토성,4886,5231,20200413,10117
20200410,8,잠실,11773,13804,20200413,25577
20200410,8,석촌,6844,7765,20200413,14609
20200410,8,송파,7741,7098,20200413,14839
20200410,8,가락시장,7142,8218,20200413,15360
20200410,8,문정,19285,19909,20200413,39194
20200410,8,장지,15472,14502,20200413,29974
20200410,8,복정,9455,7720,20200413,17175
20200410,8,산성,4694,4528,20200413,9222
20200410,8,남한산성입구,11977,10376,20200413,22353
20200410,8,단대오거리,9414,8701,20200413,18115
20200410,8,신흥,3963,4223,20200413,8186
20200410,8,수진,4278,3771,20200413,8049
20200410,8,모란,3571,2741,20200413,6312
20200411,8,암사,9868,8954,20200414,18822
20200411,8,천호,10648,12534,20200414,23182
20200411,8,강동구청,4538,4644,20200414,9182
20200411,8,몽촌토성,3301,3229,20200414,6530
20200411,8,잠실,8273,9116,20200414,17389
20200411,8,석촌,4450,5412,20200414,9862
20200411,8,송파,4355,4101,20200414,8456
20200411,8,가락시장,4406,4583,20200414,8989
20200411,8,문정,6217,6290,20200414,12507
20200411,8,장지,9592,9251,20200414,18843
20200411,8,복정,5155,4327,20200414,9482
20200411,8,산성,3707,3643,20200414,7350
20200411,8,남한산성입구,7292,6306,20200414,13598
20200411,8,단대오거리,5990,5450,20200414,11440
20200411,8,신흥,2957,3111,20200414,6068
20200411,8,수진,3126,2862,20200414,5988
20200411,8,모란,2683,2297,20200414,4980
20200412,8,암사,6593,6211,20200415,12804
20200412,8,천호,6979,8108,20200415,15087
20200412,8,강동구청,3120,3184,20200415,6304
20200412,8,몽촌토성,2232,2208,20200415,4440
20200412,8,잠실,6369,6573,20200415,12942
20200412,8,석촌,2880,3595,20200415,6475
20200412,8,송파,2851,2941,20200415,5792
20200412,8,가락시장,2330,3179,20200415,5509
20200412,8,문정,3953,4086,20200415,8039
20200412,8,장지,6590,6789,20200415,13379
20200412,8,복정,3433,3133,20200415,6566
20200412,8,산성,2511,2629,20200415,5140
20200412,8,남한산성입구,4947,4664,20200415,9611
20200412,8,단대오거리,3809,3721,20200415,7530
20200412,8,신흥,2098,2135,20200415,4233
20200412,8,수진,2186,1940,20200415,4126
20200412,8,모란,1890,1508,20200415,3398
20200413,8,문정,19331,20336,20200416,39667
20200413,8,암사,16576,14522,20200416,31098
20200413,8,천호,14441,16585,20200416,31026
20200413,8,강동구청,9154,9396,20200416,18550
20200413,8,몽촌토성,4669,5000,20200416,9669
20200413,8,잠실,10952,12921,20200416,23873
20200413,8,석촌,6457,7347,20200416,13804
20200413,8,송파,7514,7169,20200416,14683
20200413,8,가락시장,6943,7900,20200416,14843
20200413,8,장지,14652,14288,20200416,28940
20200413,8,복정,8893,7669,20200416,16562
20200413,8,산성,4612,4561,20200416,9173
20200413,8,남한산성입구,11612,10572,20200416,22184
20200413,8,단대오거리,9093,8746,20200416,17839
20200413,8,신흥,3994,4251,20200416,8245
20200413,8,수진,4286,3790,20200416,8076
20200413,8,모란,3563,2559,20200416,6122
20200414,8,암사,17163,14659,20200417,31822
20200414,8,천호,15237,17614,20200417,32851
20200414,8,강동구청,9562,9541,20200417,19103
20200414,8,몽촌토성,4811,5180,20200417,9991
20200414,8,잠실,11648,13682,20200417,25330
20200414,8,석촌,6869,7880,20200417,14749
20200414,8,송파,7970,7315,20200417,15285
20200414,8,가락시장,7212,8449,20200417,15661
20200414,8,문정,19669,20673,20200417,40342
20200414,8,장지,15480,14202,20200417,29682
20200414,8,복정,9498,8012,20200417,17510
20200414,8,산성,4780,4609,20200417,9389
20200414,8,남한산성입구,12301,10714,20200417,23015
20200414,8,단대오거리,9702,8912,20200417,18614
20200414,8,신흥,4104,4367,20200417,8471
20200414,8,수진,4425,3972,20200417,8397
20200414,8,모란,5057,3859,20200417,8916
20200415,8,암사,8734,8178,20200418,16912
20200415,8,천호,9037,10368,20200418,19405
20200415,8,강동구청,4323,4274,20200418,8597
20200415,8,몽촌토성,2825,2832,20200418,5657
20200415,8,잠실,7295,7820,20200418,15115
20200415,8,석촌,4141,4852,20200418,8993
20200415,8,송파,3833,3675,20200418,7508
20200415,8,가락시장,3969,4443,20200418,8412
20200415,8,문정,5355,5455,20200418,10810
20200415,8,장지,8513,8628,20200418,17141
20200415,8,복정,4477,4002,20200418,8479
20200415,8,산성,3400,3405,20200418,6805
20200415,8,남한산성입구,6586,6031,20200418,12617
20200415,8,단대오거리,5240,5030,20200418,10270
20200415,8,신흥,2572,2660,20200418,5232
20200415,8,수진,2865,2543,20200418,5408
20200415,8,모란,2481,1915,20200418,4396
20200416,8,암사,16840,14669,20200419,31509
20200416,8,천호,14617,16637,20200419,31254
20200416,8,강동구청,9202,9416,20200419,18618
20200416,8,몽촌토성,4789,5144,20200419,9933
20200416,8,잠실,11258,12904,20200419,24162
20200416,8,석촌,6782,7671,20200419,14453
20200416,8,송파,7550,7149,20200419,14699
20200416,8,가락시장,7153,8114,20200419,15267
20200416,8,문정,19264,20158,20200419,39422
20200416,8,장지,15047,14588,20200419,29635
20200416,8,복정,9151,7934,20200419,17085
20200416,8,산성,4529,4473,20200419,9002
20200416,8,남한산성입구,11529,10397,20200419,21926
20200416,8,단대오거리,9112,8798,20200419,17910
20200416,8,신흥,3961,4178,20200419,8139
20200416,8,수진,4213,3755,20200419,7968
20200416,8,모란,3610,2590,20200419,6200
20200417,8,암사,16715,14502,20200420,31217
20200417,8,천호,15035,17373,20200420,32408
20200417,8,강동구청,9204,9394,20200420,18598
20200417,8,몽촌토성,4557,4861,20200420,9418
20200417,8,잠실,11672,13924,20200420,25596
20200417,8,석촌,6788,7867,20200420,14655
20200417,8,송파,7779,7183,20200420,14962
20200417,8,가락시장,7039,8112,20200420,15151
20200417,8,문정,19500,20312,20200420,39812
20200417,8,장지,15451,14579,20200420,30030
20200417,8,복정,9492,7828,20200420,17320
20200417,8,산성,4392,4151,20200420,8543
20200417,8,남한산성입구,11749,10052,20200420,21801
20200417,8,단대오거리,8896,8465,20200420,17361
20200417,8,신흥,3902,4152,20200420,8054
20200417,8,수진,4239,3843,20200420,8082
20200417,8,모란,3504,2610,20200420,6114
20200418,8,암사,10700,9564,20200421,20264
20200418,8,천호,11241,13209,20200421,24450
20200418,8,강동구청,5045,4956,20200421,10001
20200418,8,몽촌토성,3431,3536,20200421,6967
20200418,8,잠실,9139,10092,20200421,19231
20200418,8,석촌,4631,5764,20200421,10395
20200418,8,송파,4690,4399,20200421,9089
20200418,8,가락시장,4759,5051,20200421,9810
20200418,8,문정,6906,6775,20200421,13681
20200418,8,장지,10163,9541,20200421,19704
20200418,8,복정,5454,4548,20200421,10002
20200418,8,산성,3960,3940,20200421,7900
20200418,8,남한산성입구,7930,6940,20200421,14870
20200418,8,단대오거리,6288,5724,20200421,12012
20200418,8,신흥,3102,3333,20200421,6435
20200418,8,수진,3318,2996,20200421,6314
20200418,8,모란,2949,2545,20200421,5494
20200419,8,암사,6798,6453,20200422,13251
20200419,8,천호,7467,8391,20200422,15858
20200419,8,강동구청,3283,3430,20200422,6713
20200419,8,몽촌토성,2052,2135,20200422,4187
20200419,8,잠실,6884,6927,20200422,13811
20200419,8,석촌,3225,3780,20200422,7005
20200419,8,송파,3085,3185,20200422,6270
20200419,8,가락시장,2634,3476,20200422,6110
20200419,8,문정,4290,4480,20200422,8770
20200419,8,장지,7023,7129,20200422,14152
20200419,8,복정,3468,3196,20200422,6664
20200419,8,산성,2659,2568,20200422,5227
20200419,8,남한산성입구,5199,4780,20200422,9979
20200419,8,단대오거리,4071,4060,20200422,8131
20200419,8,신흥,2269,2365,20200422,4634
20200419,8,수진,2390,2265,20200422,4655
20200419,8,모란,3648,2861,20200422,6509
20200420,8,암사,17134,15161,20200423,32295
20200420,8,천호,15067,16692,20200423,31759
20200420,8,강동구청,9475,9851,20200423,19326
20200420,8,몽촌토성,4722,5086,20200423,9808
20200420,8,잠실,11483,13246,20200423,24729
20200420,8,석촌,6770,7633,20200423,14403
20200420,8,송파,7722,7273,20200423,14995
20200420,8,가락시장,7195,8240,20200423,15435
20200420,8,문정,20069,21016,20200423,41085
20200420,8,장지,14937,14563,20200423,29500
20200420,8,복정,9113,7880,20200423,16993
20200420,8,산성,4605,4486,20200423,9091
20200420,8,남한산성입구,11712,10795,20200423,22507
20200420,8,단대오거리,9149,8759,20200423,17908
20200420,8,신흥,3980,4373,20200423,8353
20200420,8,수진,4519,4091,20200423,8610
20200420,8,모란,3700,2669,20200423,6369
20200421,8,암사,17470,15565,20200424,33035
20200421,8,천호,15470,17461,20200424,32931
20200421,8,강동구청,9534,10068,20200424,19602
20200421,8,몽촌토성,4880,5202,20200424,10082
20200421,8,잠실,12130,13659,20200424,25789
20200421,8,석촌,6967,8074,20200424,15041
20200421,8,송파,8028,7760,20200424,15788
20200421,8,가락시장,7370,8165,20200424,15535
20200421,8,문정,20055,21060,20200424,41115
20200421,8,장지,15508,15052,20200424,30560
20200421,8,복정,9433,8231,20200424,17664
20200421,8,산성,4599,4591,20200424,9190
20200421,8,남한산성입구,12136,10939,20200424,23075
20200421,8,단대오거리,9364,8916,20200424,18280
20200421,8,신흥,3918,4255,20200424,8173
20200421,8,수진,4266,3916,20200424,8182
20200421,8,모란,3701,2685,20200424,6386
20200422,8,암사,17186,15215,20200425,32401
20200422,8,천호,15096,17213,20200425,32309
20200422,8,강동구청,9564,10016,20200425,19580
20200422,8,몽촌토성,4795,5095,20200425,9890
20200422,8,잠실,12059,13860,20200425,25919
20200422,8,석촌,7027,7936,20200425,14963
20200422,8,송파,7934,7528,20200425,15462
20200422,8,가락시장,7404,8221,20200425,15625
20200422,8,문정,20384,21193,20200425,41577
20200422,8,장지,15961,15294,20200425,31255
20200422,8,복정,9358,8121,20200425,17479
20200422,8,산성,4571,4452,20200425,9023
20200422,8,남한산성입구,12074,10969,20200425,23043
20200422,8,단대오거리,9315,8943,20200425,18258
20200422,8,신흥,4022,4285,20200425,8307
20200422,8,수진,4291,3988,20200425,8279
20200422,8,모란,3664,2689,20200425,6353
20200423,8,암사,17484,15231,20200426,32715
20200423,8,천호,15277,17402,20200426,32679
20200423,8,강동구청,9639,10099,20200426,19738
20200423,8,몽촌토성,4907,5267,20200426,10174
20200423,8,잠실,11914,13842,20200426,25756
20200423,8,석촌,6980,8094,20200426,15074
20200423,8,송파,7950,7577,20200426,15527
20200423,8,가락시장,7520,8313,20200426,15833
20200423,8,문정,20337,21346,20200426,41683
20200423,8,장지,15635,14868,20200426,30503
20200423,8,복정,9473,8116,20200426,17589
20200423,8,산성,4689,4638,20200426,9327
20200423,8,남한산성입구,12240,10988,20200426,23228
20200423,8,단대오거리,9390,8885,20200426,18275
20200423,8,신흥,4079,4376,20200426,8455
20200423,8,수진,4332,3955,20200426,8287
20200423,8,모란,3683,2694,20200426,6377
20200424,8,암사,18270,15688,20200427,33958
20200424,8,천호,16331,19107,20200427,35438
20200424,8,강동구청,10056,10337,20200427,20393
20200424,8,몽촌토성,5113,5466,20200427,10579
20200424,8,잠실,13181,15210,20200427,28391
20200424,8,석촌,7359,8551,20200427,15910
20200424,8,송파,8374,7832,20200427,16206
20200424,8,가락시장,7664,9115,20200427,16779
20200424,8,문정,20767,21438,20200427,42205
20200424,8,장지,16717,15597,20200427,32314
20200424,8,복정,10025,8374,20200427,18399
20200424,8,산성,4936,4674,20200427,9610
20200424,8,남한산성입구,12885,11295,20200427,24180
20200424,8,단대오거리,9925,9124,20200427,19049
20200424,8,신흥,4312,4575,20200427,8887
20200424,8,수진,4737,4275,20200427,9012
20200424,8,모란,5525,4261,20200427,9786
20200425,8,암사,10976,9884,20200428,20860
20200425,8,천호,11623,13691,20200428,25314
20200425,8,강동구청,5182,5184,20200428,10366
20200425,8,몽촌토성,3304,3482,20200428,6786
20200425,8,잠실,9746,10813,20200428,20559
20200425,8,석촌,4865,5769,20200428,10634
20200425,8,송파,4785,4594,20200428,9379
20200425,8,가락시장,5021,5234,20200428,10255
20200425,8,문정,7419,7450,20200428,14869
20200425,8,장지,10672,9965,20200428,20637
20200425,8,복정,5981,5110,20200428,11091
20200425,8,산성,4096,3877,20200428,7973
20200425,8,남한산성입구,7945,6981,20200428,14926
20200425,8,단대오거리,6452,5956,20200428,12408
20200425,8,신흥,3266,3393,20200428,6659
20200425,8,수진,3414,3168,20200428,6582
20200425,8,모란,3013,2679,20200428,5692
20200426,8,암사,7576,7089,20200429,14665
20200426,8,천호,8120,9319,20200429,17439
20200426,8,강동구청,3616,3756,20200429,7372
20200426,8,몽촌토성,2607,2593,20200429,5200
20200426,8,잠실,7615,8028,20200429,15643
20200426,8,석촌,3425,4246,20200429,7671
20200426,8,송파,3492,3405,20200429,6897
20200426,8,가락시장,2803,3684,20200429,6487
20200426,8,문정,4717,5001,20200429,9718
20200426,8,장지,7818,7920,20200429,15738
20200426,8,복정,4084,3841,20200429,7925
20200426,8,산성,2937,3144,20200429,6081
20200426,8,남한산성입구,5896,5476,20200429,11372
20200426,8,단대오거리,4507,4348,20200429,8855
20200426,8,신흥,2487,2572,20200429,5059
20200426,8,수진,2600,2330,20200429,4930
20200426,8,모란,2295,1954,20200429,4249
20200427,8,암사,17865,15663,20200430,33528
20200427,8,천호,15357,17383,20200430,32740
20200427,8,강동구청,9709,10147,20200430,19856
20200427,8,몽촌토성,4974,5318,20200430,10292
20200427,8,잠실,12067,13753,20200430,25820
20200427,8,석촌,6992,7938,20200430,14930
20200427,8,송파,8154,7712,20200430,15866
20200427,8,가락시장,7569,8652,20200430,16221
20200427,8,문정,20455,21766,20200430,42221
20200427,8,장지,15687,15247,20200430,30934
20200427,8,복정,9421,8247,20200430,17668
20200427,8,산성,4715,4704,20200430,9419
20200427,8,남한산성입구,12421,11199,20200430,23620
20200427,8,단대오거리,9540,9183,20200430,18723
20200427,8,신흥,4246,4401,20200430,8647
20200427,8,수진,4544,4106,20200430,8650
20200427,8,모란,3930,2779,20200430,6709
20200428,8,암사,17890,15617,20200501,33507
20200428,8,천호,15799,17946,20200501,33745
20200428,8,강동구청,9823,10255,20200501,20078
20200428,8,몽촌토성,5156,5504,20200501,10660
20200428,8,잠실,12420,14334,20200501,26754
20200428,8,석촌,7193,8265,20200501,15458
20200428,8,송파,8327,7856,20200501,16183
20200428,8,가락시장,7693,8812,20200501,16505
20200428,8,문정,20706,21909,20200501,42615
20200428,8,장지,16055,15420,20200501,31475
20200428,8,복정,9817,8455,20200501,18272
20200428,8,산성,4932,4841,20200501,9773
20200428,8,남한산성입구,12669,11368,20200501,24037
20200428,8,단대오거리,9715,9294,20200501,19009
20200428,8,신흥,4160,4363,20200501,8523
20200428,8,수진,4458,4033,20200501,8491
20200428,8,모란,3838,2854,20200501,6692
20200429,8,암사,18680,16010,20200502,34690
20200429,8,천호,16793,19039,20200502,35832
20200429,8,강동구청,10127,10397,20200502,20524
20200429,8,몽촌토성,5267,5533,20200502,10800
20200429,8,잠실,12924,15336,20200502,28260
20200429,8,석촌,7456,8560,20200502,16016
20200429,8,송파,8579,7883,20200502,16462
20200429,8,가락시장,8120,9238,20200502,17358
20200429,8,문정,20787,21800,20200502,42587
20200429,8,장지,17348,15891,20200502,33239
20200429,8,복정,10553,8744,20200502,19297
20200429,8,산성,5102,4852,20200502,9954
20200429,8,남한산성입구,13538,11610,20200502,25148
20200429,8,단대오거리,10522,9577,20200502,20099
20200429,8,신흥,4557,4798,20200502,9355
20200429,8,수진,4921,4404,20200502,9325
20200429,8,모란,6082,4561,20200502,10643
20200430,8,천호,10402,11972,20200503,22374
20200430,8,강동구청,4633,4585,20200503,9218
20200430,8,몽촌토성,3114,3192,20200503,6306
20200430,8,잠실,8982,10029,20200503,19011
20200430,8,석촌,4293,5060,20200503,9353
20200430,8,송파,4425,4094,20200503,8519
20200430,8,가락시장,4582,5234,20200503,9816
20200430,8,문정,5784,5648,20200503,11432
20200430,8,장지,10490,10122,20200503,20612
20200430,8,복정,5057,4440,20200503,9497
20200430,8,산성,4021,3771,20200503,7792
20200430,8,남한산성입구,7782,6614,20200503,14396
20200430,8,단대오거리,6029,5405,20200503,11434
20200430,8,신흥,3007,3153,20200503,6160
20200430,8,수진,3092,2649,20200503,5741
20200430,8,모란,2914,2448,20200503,5362
20200430,8,암사,10113,8961,20200503,19074
20200501,8,모란,3067,2535,20200504,5602
20200501,8,수진,3389,2930,20200504,6319
20200501,8,신흥,3393,3475,20200504,6868
20200501,8,단대오거리,6789,6097,20200504,12886
20200501,8,남한산성입구,8289,7414,20200504,15703
20200501,8,산성,3800,3587,20200504,7387
20200501,8,장지,10922,10555,20200504,21477
20200501,8,문정,6945,6771,20200504,13716
20200501,8,가락시장,4915,5664,20200504,10579
20200501,8,송파,5113,4866,20200504,9979
20200501,8,석촌,4961,5842,20200504,10803
20200501,8,잠실,9576,10491,20200504,20067
20200501,8,몽촌토성,3254,3299,20200504,6553
20200501,8,강동구청,5669,5588,20200504,11257
20200501,8,천호,11167,12962,20200504,24129
20200501,8,암사,11081,9947,20200504,21028
20200501,8,복정,5471,4919,20200504,10390
20200502,8,암사,9876,8891,20200505,18767
20200502,8,천호,10860,12896,20200505,23756
20200502,8,강동구청,4850,4810,20200505,9660
20200502,8,몽촌토성,3029,3133,20200505,6162
20200502,8,잠실,8829,9843,20200505,18672
20200502,8,석촌,4479,5355,20200505,9834
20200502,8,송파,4733,4517,20200505,9250
20200502,8,가락시장,4600,4847,20200505,9447
20200502,8,문정,6496,6578,20200505,13074
20200502,8,장지,10267,9753,20200505,20020
20200502,8,복정,5440,4543,20200505,9983
20200502,8,산성,3567,3508,20200505,7075
20200502,8,남한산성입구,7549,6761,20200505,14310
20200502,8,단대오거리,6196,5771,20200505,11967
20200502,8,신흥,3124,3376,20200505,6500
20200502,8,수진,3169,2833,20200505,6002
20200502,8,모란,2957,2371,20200505,5328
20200503,8,모란,2206,1837,20200506,4043
20200503,8,수진,2613,2369,20200506,4982
20200503,8,신흥,2456,2624,20200506,5080
20200503,8,단대오거리,4504,4341,20200506,8845
20200503,8,남한산성입구,6010,5513,20200506,11523
20200503,8,산성,2863,2940,20200506,5803
20200503,8,복정,4132,3999,20200506,8131
20200503,8,장지,8300,8503,20200506,16803
20200503,8,문정,4710,4943,20200506,9653
20200503,8,가락시장,2901,3682,20200506,6583
20200503,8,송파,3345,3394,20200506,6739
20200503,8,석촌,3305,4139,20200506,7444
20200503,8,잠실,7657,8410,20200506,16067
20200503,8,몽촌토성,2512,2566,20200506,5078
20200503,8,강동구청,3626,3831,20200506,7457
20200503,8,천호,8205,9419,20200506,17624
20200503,8,암사,7737,7064,20200506,14801
20200504,8,모란,5649,4364,20200507,10013
20200504,8,수진,4620,4096,20200507,8716
20200504,8,신흥,4323,4568,20200507,8891
20200504,8,단대오거리,9364,8543,20200507,17907
20200504,8,남한산성입구,11324,10035,20200507,21359
20200504,8,산성,4648,4553,20200507,9201
20200504,8,복정,8085,7123,20200507,15208
20200504,8,장지,14425,13754,20200507,28179
20200504,8,문정,13596,14225,20200507,27821
20200504,8,가락시장,6757,7746,20200507,14503
20200504,8,송파,7300,6870,20200507,14170
20200504,8,석촌,6620,7537,20200507,14157
20200504,8,잠실,11601,13476,20200507,25077
20200504,8,몽촌토성,4187,4601,20200507,8788
20200504,8,강동구청,8606,8862,20200507,17468
20200504,8,천호,14456,16966,20200507,31422
20200504,8,암사,15793,13708,20200507,29501
20200505,8,암사,8717,8219,20200508,16936
20200505,8,천호,9217,10875,20200508,20092
20200505,8,강동구청,4287,4440,20200508,8727
20200505,8,몽촌토성,2707,2781,20200508,5488
20200505,8,잠실,8801,9855,20200508,18656
20200505,8,석촌,3763,4397,20200508,8160
20200505,8,송파,3892,3722,20200508,7614
20200505,8,가락시장,3879,4432,20200508,8311
20200505,8,문정,4837,5224,20200508,10061
20200505,8,장지,9183,9163,20200508,18346
20200505,8,복정,4441,4196,20200508,8637
20200505,8,산성,3395,3406,20200508,6801
20200505,8,남한산성입구,6573,6007,20200508,12580
20200505,8,단대오거리,5324,5231,20200508,10555
20200505,8,신흥,2605,2926,20200508,5531
20200505,8,수진,2839,2485,20200508,5324
20200505,8,모란,2417,2102,20200508,4519
20200506,8,모란,4115,2976,20200509,7091
20200506,8,수진,4880,4296,20200509,9176
20200506,8,신흥,4548,4876,20200509,9424
20200506,8,단대오거리,10261,9820,20200509,20081
20200506,8,남한산성입구,12957,11799,20200509,24756
20200506,8,산성,5573,5443,20200509,11016
20200506,8,복정,10119,8828,20200509,18947
20200506,8,장지,17051,16444,20200509,33495
20200506,8,문정,21006,22188,20200509,43194
20200506,8,가락시장,7731,8659,20200509,16390
20200506,8,송파,8598,8166,20200509,16764
20200506,8,석촌,7319,8367,20200509,15686
20200506,8,잠실,12957,15097,20200509,28054
20200506,8,몽촌토성,5390,5869,20200509,11259
20200506,8,강동구청,10205,10706,20200509,20911
20200506,8,천호,16034,18637,20200509,34671
20200506,8,암사,18651,16203,20200509,34854
20200507,8,모란,4096,2917,20200510,7013
20200507,8,수진,4848,4339,20200510,9187
20200507,8,신흥,4424,4816,20200510,9240
20200507,8,단대오거리,10085,9813,20200510,19898
20200507,8,남한산성입구,13202,11773,20200510,24975
20200507,8,산성,5485,5468,20200510,10953
20200507,8,복정,10366,8874,20200510,19240
20200507,8,장지,17094,16271,20200510,33365
20200507,8,문정,21291,22316,20200510,43607
20200507,8,가락시장,7771,8807,20200510,16578
20200507,8,송파,8778,8297,20200510,17075
20200507,8,석촌,7295,8480,20200510,15775
20200507,8,잠실,13433,15763,20200510,29196
20200507,8,몽촌토성,5478,5857,20200510,11335
20200507,8,강동구청,10344,10881,20200510,21225
20200507,8,천호,16251,18787,20200510,35038
20200507,8,암사,19045,16657,20200510,35702
20200508,8,암사,19159,16983,20200511,36142
20200508,8,천호,16703,19652,20200511,36355
20200508,8,강동구청,10711,11286,20200511,21997
20200508,8,몽촌토성,5660,5965,20200511,11625
20200508,8,잠실,14199,16355,20200511,30554
20200508,8,석촌,7721,8833,20200511,16554
20200508,8,송파,9043,8670,20200511,17713
20200508,8,가락시장,8202,9244,20200511,17446
20200508,8,문정,21848,22471,20200511,44319
20200508,8,장지,17653,16788,20200511,34441
20200508,8,복정,10853,9114,20200511,19967
20200508,8,산성,5652,5359,20200511,11011
20200508,8,남한산성입구,13574,12034,20200511,25608
20200508,8,단대오거리,10503,9997,20200511,20500
20200508,8,신흥,4402,4809,20200511,9211
20200508,8,수진,4808,4414,20200511,9222
20200508,8,모란,4138,3092,20200511,7230
20200509,8,암사,10428,9507,20200512,19935
20200509,8,천호,11277,13441,20200512,24718
20200509,8,강동구청,5100,5212,20200512,10312
20200509,8,몽촌토성,2806,3014,20200512,5820
20200509,8,잠실,9989,11282,20200512,21271
20200509,8,석촌,4656,5483,20200512,10139
20200509,8,송파,5185,4893,20200512,10078
20200509,8,가락시장,4773,4840,20200512,9613
20200509,8,문정,7619,7728,20200512,15347
20200509,8,장지,10549,9903,20200512,20452
20200509,8,복정,5666,4765,20200512,10431
20200509,8,산성,3483,3364,20200512,6847
20200509,8,남한산성입구,7418,6490,20200512,13908
20200509,8,단대오거리,6177,5744,20200512,11921
20200509,8,신흥,3160,3377,20200512,6537
20200509,8,수진,3480,3156,20200512,6636
20200509,8,모란,3578,2866,20200512,6444
20200510,8,암사,7937,7432,20200513,15369
20200510,8,천호,8530,10004,20200513,18534
20200510,8,강동구청,3883,4152,20200513,8035
20200510,8,몽촌토성,2577,2694,20200513,5271
20200510,8,잠실,7828,8379,20200513,16207
20200510,8,석촌,3556,4401,20200513,7957
20200510,8,송파,3651,3564,20200513,7215
20200510,8,가락시장,2791,3601,20200513,6392
20200510,8,문정,5006,5387,20200513,10393
20200510,8,장지,8093,8168,20200513,16261
20200510,8,복정,4589,4160,20200513,8749
20200510,8,산성,2991,3101,20200513,6092
20200510,8,남한산성입구,6096,5651,20200513,11747
20200510,8,단대오거리,4687,4525,20200513,9212
20200510,8,신흥,2521,2597,20200513,5118
20200510,8,수진,2617,2398,20200513,5015
20200510,8,모란,2444,1910,20200513,4354
20200511,8,모란,3912,2834,20200514,6746
20200511,8,수진,4750,4309,20200514,9059
20200511,8,신흥,4260,4570,20200514,8830
20200511,8,단대오거리,9955,9542,20200514,19497
20200511,8,남한산성입구,13354,12109,20200514,25463
20200511,8,산성,5306,5258,20200514,10564
20200511,8,복정,9926,8687,20200514,18613
20200511,8,장지,16127,15715,20200514,31842
20200511,8,문정,20985,22178,20200514,43163
20200511,8,가락시장,7487,8425,20200514,15912
20200511,8,송파,8495,8182,20200514,16677
20200511,8,석촌,7219,8351,20200514,15570
20200511,8,잠실,12613,14458,20200514,27071
20200511,8,몽촌토성,5260,5551,20200514,10811
20200511,8,강동구청,10075,10823,20200514,20898
20200511,8,천호,15773,18086,20200514,33859
20200511,8,암사,18666,16346,20200514,35012
20200512,8,석촌,7203,8256,20200515,15459
20200512,8,암사,18437,16173,20200515,34610
20200512,8,천호,15650,18035,20200515,33685
20200512,8,강동구청,10006,10626,20200515,20632
20200512,8,몽촌토성,5159,5572,20200515,10731
20200512,8,잠실,12519,14364,20200515,26883
20200512,8,송파,8529,8090,20200515,16619
20200512,8,가락시장,7623,8659,20200515,16282
20200512,8,문정,20920,21927,20200515,42847
20200512,8,장지,16287,15663,20200515,31950
20200512,8,복정,10055,8810,20200515,18865
20200512,8,산성,4960,4921,20200515,9881
20200512,8,남한산성입구,13243,12105,20200515,25348
20200512,8,단대오거리,9890,9535,20200515,19425
20200512,8,신흥,4232,4601,20200515,8833
20200512,8,수진,4606,4051,20200515,8657
20200512,8,모란,4005,2882,20200515,6887
20200513,8,장지,16829,15965,20200516,32794
20200513,8,복정,10197,8749,20200516,18946
20200513,8,산성,4975,4903,20200516,9878
20200513,8,남한산성입구,13233,11961,20200516,25194
20200513,8,단대오거리,10045,9606,20200516,19651
20200513,8,신흥,4200,4576,20200516,8776
20200513,8,암사,18570,16253,20200516,34823
20200513,8,천호,16015,18575,20200516,34590
20200513,8,강동구청,10321,10955,20200516,21276
20200513,8,몽촌토성,5373,5703,20200516,11076
20200513,8,잠실,12687,14548,20200516,27235
20200513,8,석촌,7450,8470,20200516,15920
20200513,8,송파,8468,8089,20200516,16557
20200513,8,가락시장,7660,8625,20200516,16285
20200513,8,수진,4674,4216,20200516,8890
20200513,8,모란,4058,2952,20200516,7010
20200513,8,문정,20943,22042,20200516,42985
20200514,8,모란,5778,4371,20200517,10149
20200514,8,수진,4805,4331,20200517,9136
20200514,8,신흥,4386,4775,20200517,9161
20200514,8,단대오거리,10252,9735,20200517,19987
20200514,8,남한산성입구,13368,12259,20200517,25627
20200514,8,산성,5141,5032,20200517,10173
20200514,8,복정,10135,8782,20200517,18917
20200514,8,장지,16614,15671,20200517,32285
20200514,8,문정,20856,21809,20200517,42665
20200514,8,가락시장,7676,8597,20200517,16273
20200514,8,송파,8645,8158,20200517,16803
20200514,8,석촌,7182,8321,20200517,15503
20200514,8,잠실,12737,14684,20200517,27421
20200514,8,몽촌토성,5212,5549,20200517,10761
20200514,8,강동구청,10297,10808,20200517,21105
20200514,8,천호,15654,17956,20200517,33610
20200514,8,암사,18571,16192,20200517,34763
20200515,8,모란,3864,2938,20200518,6802
20200515,8,수진,4736,4111,20200518,8847
20200515,8,신흥,4165,4556,20200518,8721
20200515,8,단대오거리,9601,9091,20200518,18692
20200515,8,남한산성입구,12585,10905,20200518,23490
20200515,8,산성,4916,4602,20200518,9518
20200515,8,복정,10096,8594,20200518,18690
20200515,8,장지,16366,15538,20200518,31904
20200515,8,문정,20834,21732,20200518,42566
20200515,8,가락시장,7538,8593,20200518,16131
20200515,8,송파,8658,8213,20200518,16871
20200515,8,석촌,7360,8454,20200518,15814
20200515,8,잠실,13044,15257,20200518,28301
20200515,8,몽촌토성,4992,5443,20200518,10435
20200515,8,강동구청,10126,10633,20200518,20759
20200515,8,천호,15539,18219,20200518,33758
20200515,8,암사,18121,15978,20200518,34099
20200516,8,모란,3194,2737,20200519,5931
20200516,8,수진,3575,3141,20200519,6716
20200516,8,신흥,3307,3653,20200519,6960
20200516,8,단대오거리,6569,6102,20200519,12671
20200516,8,남한산성입구,8072,7082,20200519,15154
20200516,8,산성,4028,3814,20200519,7842
20200516,8,복정,6218,5409,20200519,11627
20200516,8,장지,10897,10207,20200519,21104
20200516,8,문정,7729,7914,20200519,15643
20200516,8,가락시장,5132,5457,20200519,10589
20200516,8,송파,5313,4995,20200519,10308
20200516,8,석촌,4971,5915,20200519,10886
20200516,8,잠실,9622,10883,20200519,20505
20200516,8,몽촌토성,3331,3483,20200519,6814
20200516,8,강동구청,5410,5518,20200519,10928
20200516,8,천호,11446,13760,20200519,25206
20200516,8,암사,11192,10160,20200519,21352
20200517,8,모란,2327,1948,20200520,4275
20200517,8,수진,2727,2286,20200520,5013
20200517,8,신흥,2578,2623,20200520,5201
20200517,8,단대오거리,4714,4619,20200520,9333
20200517,8,남한산성입구,6313,5782,20200520,12095
20200517,8,산성,3128,3250,20200520,6378
20200517,8,복정,4711,4383,20200520,9094
20200517,8,장지,8042,8413,20200520,16455
20200517,8,문정,5231,5448,20200520,10679
20200517,8,가락시장,2995,3962,20200520,6957
20200517,8,송파,3730,3489,20200520,7219
20200517,8,석촌,3416,4332,20200520,7748
20200517,8,잠실,7536,8141,20200520,15677
20200517,8,몽촌토성,2769,2766,20200520,5535
20200517,8,강동구청,3914,4055,20200520,7969
20200517,8,천호,8450,9872,20200520,18322
20200517,8,암사,8119,7384,20200520,15503
20200518,8,암사,17961,16087,20200521,34048
20200518,8,천호,14964,16801,20200521,31765
20200518,8,강동구청,10000,10819,20200521,20819
20200518,8,몽촌토성,4991,5355,20200521,10346
20200518,8,잠실,12661,13680,20200521,26341
20200518,8,석촌,7063,8124,20200521,15187
20200518,8,송파,8382,8462,20200521,16844
20200518,8,가락시장,7458,8337,20200521,15795
20200518,8,문정,20970,21753,20200521,42723
20200518,8,장지,15837,15434,20200521,31271
20200518,8,복정,9399,8351,20200521,17750
20200518,8,산성,4929,4958,20200521,9887
20200518,8,남한산성입구,12739,11802,20200521,24541
20200518,8,단대오거리,9730,9340,20200521,19070
20200518,8,신흥,4240,4531,20200521,8771
20200518,8,수진,4614,4318,20200521,8932
20200518,8,모란,3948,2854,20200521,6802
20200519,8,모란,4915,3617,20200522,8532
20200519,8,수진,4508,4092,20200522,8600
20200519,8,신흥,4051,4373,20200522,8424
20200519,8,단대오거리,9752,9301,20200522,19053
20200519,8,남한산성입구,12877,11552,20200522,24429
20200519,8,산성,4921,4828,20200522,9749
20200519,8,복정,9648,8538,20200522,18186
20200519,8,장지,16221,15361,20200522,31582
20200519,8,문정,20640,21862,20200522,42502
20200519,8,가락시장,7495,8448,20200522,15943
20200519,8,송파,8661,8054,20200522,16715
20200519,8,석촌,7248,8150,20200522,15398
20200519,8,잠실,12403,14361,20200522,26764
20200519,8,몽촌토성,5107,5489,20200522,10596
20200519,8,강동구청,10187,10714,20200522,20901
20200519,8,천호,15321,17663,20200522,32984
20200519,8,암사,18251,15868,20200522,34119
20200520,8,모란,4201,3134,20200523,7335
20200520,8,수진,4814,4414,20200523,9228
20200520,8,신흥,4506,4768,20200523,9274
20200520,8,단대오거리,10210,9723,20200523,19933
20200520,8,남한산성입구,13721,12368,20200523,26089
20200520,8,산성,5348,5152,20200523,10500
20200520,8,복정,10432,9026,20200523,19458
20200520,8,장지,16907,16103,20200523,33010
20200520,8,문정,21283,22440,20200523,43723
20200520,8,가락시장,7937,8949,20200523,16886
20200520,8,송파,8743,8388,20200523,17131
20200520,8,석촌,7564,8542,20200523,16106
20200520,8,잠실,12976,15087,20200523,28063
20200520,8,몽촌토성,5483,5747,20200523,11230
20200520,8,강동구청,10673,10962,20200523,21635
20200520,8,천호,16062,18439,20200523,34501
20200520,8,암사,18795,16609,20200523,35404
20200521,8,모란,4082,2993,20200524,7075
20200521,8,수진,4743,4269,20200524,9012
20200521,8,신흥,4465,4730,20200524,9195
20200521,8,단대오거리,9979,9643,20200524,19622
20200521,8,남한산성입구,13566,12202,20200524,25768
20200521,8,산성,5235,5219,20200524,10454
20200521,8,복정,10330,9020,20200524,19350
20200521,8,장지,16638,15930,20200524,32568
20200521,8,문정,21028,22256,20200524,43284
20200521,8,가락시장,7847,8832,20200524,16679
20200521,8,송파,8856,8283,20200524,17139
20200521,8,석촌,7263,8514,20200524,15777
20200521,8,잠실,12923,15097,20200524,28020
20200521,8,몽촌토성,5340,5729,20200524,11069
20200521,8,강동구청,10561,11060,20200524,21621
20200521,8,천호,15964,18283,20200524,34247
20200521,8,암사,19206,16548,20200524,35754
20200522,8,암사,19118,16777,20200525,35895
20200522,8,천호,16543,19683,20200525,36226
20200522,8,강동구청,10727,11030,20200525,21757
20200522,8,몽촌토성,5466,5795,20200525,11261
20200522,8,잠실,13460,16004,20200525,29464
20200522,8,석촌,7639,8822,20200525,16461
20200522,8,송파,8807,8293,20200525,17100
20200522,8,가락시장,8155,9299,20200525,17454
20200522,8,문정,21314,21967,20200525,43281
20200522,8,장지,17286,16183,20200525,33469
20200522,8,복정,10778,9045,20200525,19823
20200522,8,산성,5385,5154,20200525,10539
20200522,8,남한산성입구,13538,11627,20200525,25165
20200522,8,단대오거리,10341,9637,20200525,19978
20200522,8,신흥,4491,4742,20200525,9233
20200522,8,수진,5014,4413,20200525,9427
20200522,8,모란,4274,3428,20200525,7702
20200523,8,암사,11964,11034,20200526,22998
20200523,8,천호,12504,14584,20200526,27088
20200523,8,강동구청,5796,5864,20200526,11660
20200523,8,몽촌토성,4070,4176,20200526,8246
20200523,8,잠실,10540,11913,20200526,22453
20200523,8,석촌,5261,6597,20200526,11858
20200523,8,송파,5546,5243,20200526,10789
20200523,8,가락시장,5465,5717,20200526,11182
20200523,8,문정,8403,8575,20200526,16978
20200523,8,장지,11535,10872,20200526,22407
20200523,8,복정,6843,5978,20200526,12821
20200523,8,산성,4650,4523,20200526,9173
20200523,8,남한산성입구,8911,7839,20200526,16750
20200523,8,단대오거리,7071,6577,20200526,13648
20200523,8,신흥,3579,3717,20200526,7296
20200523,8,수진,3792,3376,20200526,7168
20200523,8,모란,3450,2955,20200526,6405
20200524,8,모란,4219,3500,20200527,7719
20200524,8,수진,2690,2414,20200527,5104
20200524,8,신흥,2645,2754,20200527,5399
20200524,8,단대오거리,4812,4786,20200527,9598
20200524,8,남한산성입구,6051,5490,20200527,11541
20200524,8,산성,2978,3008,20200527,5986
20200524,8,복정,4784,4480,20200527,9264
20200524,8,장지,8094,8374,20200527,16468
20200524,8,문정,4824,5043,20200527,9867
20200524,8,가락시장,2987,3874,20200527,6861
20200524,8,송파,3654,3445,20200527,7099
20200524,8,석촌,3640,4232,20200527,7872
20200524,8,잠실,7314,7904,20200527,15218
20200524,8,몽촌토성,2662,2678,20200527,5340
20200524,8,강동구청,3749,3963,20200527,7712
20200524,8,천호,8228,9319,20200527,17547
20200524,8,암사,7854,7236,20200527,15090
20200525,8,모란,4099,3117,20200528,7216
20200525,8,수진,4874,4438,20200528,9312
20200525,8,신흥,4388,4842,20200528,9230
20200525,8,단대오거리,10183,9802,20200528,19985
20200525,8,남한산성입구,13488,12238,20200528,25726
20200525,8,산성,5255,5101,20200528,10356
20200525,8,복정,10016,8832,20200528,18848
20200525,8,장지,16590,15805,20200528,32395
20200525,8,문정,20996,22268,20200528,43264
20200525,8,가락시장,7548,8576,20200528,16124
20200525,8,송파,8623,8284,20200528,16907
20200525,8,석촌,7304,8417,20200528,15721
20200525,8,잠실,12611,14543,20200528,27154
20200525,8,몽촌토성,5400,5750,20200528,11150
20200525,8,강동구청,10287,10883,20200528,21170
20200525,8,천호,15555,18062,20200528,33617
20200525,8,암사,18664,16311,20200528,34975
20200526,8,모란,4026,2981,20200529,7007
20200526,8,수진,4699,4311,20200529,9010
20200526,8,신흥,4312,4662,20200529,8974
20200526,8,단대오거리,10053,9508,20200529,19561
20200526,8,남한산성입구,13686,12629,20200529,26315
20200526,8,산성,5269,5141,20200529,10410
20200526,8,복정,10375,9094,20200529,19469
20200526,8,장지,16721,16093,20200529,32814
20200526,8,문정,21301,22284,20200529,43585
20200526,8,가락시장,7871,8765,20200529,16636
20200526,8,송파,8899,8612,20200529,17511
20200526,8,석촌,7508,8524,20200529,16032
20200526,8,잠실,12870,14675,20200529,27545
20200526,8,몽촌토성,5552,5836,20200529,11388
20200526,8,강동구청,10501,10940,20200529,21441
20200526,8,천호,15781,17896,20200529,33677
20200526,8,암사,18822,16701,20200529,35523
20200527,8,모란,4265,3175,20200530,7440
20200527,8,수진,4799,4328,20200530,9127
20200527,8,신흥,4376,4795,20200530,9171
20200527,8,단대오거리,10201,9848,20200530,20049
20200527,8,남한산성입구,14137,12629,20200530,26766
20200527,8,산성,5349,5277,20200530,10626
20200527,8,복정,10538,9066,20200530,19604
20200527,8,장지,17429,16532,20200530,33961
20200527,8,문정,21136,22267,20200530,43403
20200527,8,가락시장,7914,8973,20200530,16887
20200527,8,송파,9181,8621,20200530,17802
20200527,8,석촌,7563,8621,20200530,16184
20200527,8,잠실,12927,15052,20200530,27979
20200527,8,몽촌토성,5578,5998,20200530,11576
20200527,8,강동구청,10707,11100,20200530,21807
20200527,8,천호,15981,18692,20200530,34673
20200527,8,암사,19200,16580,20200530,35780
20200528,8,모란,4097,3115,20200531,7212
20200528,8,수진,4752,4434,20200531,9186
20200528,8,신흥,4298,4646,20200531,8944
20200528,8,단대오거리,10120,9600,20200531,19720
20200528,8,남한산성입구,13745,12354,20200531,26099
20200528,8,산성,5330,5149,20200531,10479
20200528,8,복정,10489,8985,20200531,19474
20200528,8,장지,16751,15705,20200531,32456
20200528,8,문정,20836,22062,20200531,42898
20200528,8,가락시장,7754,8643,20200531,16397
20200528,8,송파,8973,8406,20200531,17379
20200528,8,석촌,7192,8418,20200531,15610
20200528,8,잠실,12681,14812,20200531,27493
20200528,8,몽촌토성,5483,5909,20200531,11392
20200528,8,강동구청,10505,11025,20200531,21530
20200528,8,천호,15915,18111,20200531,34026
20200528,8,암사,18718,16168,20200531,34886
20200529,8,암사,19056,16533,20200601,35589
20200529,8,천호,16610,19745,20200601,36355
20200529,8,강동구청,10629,11035,20200601,21664
20200529,8,몽촌토성,5590,5886,20200601,11476
20200529,8,잠실,13363,16001,20200601,29364
20200529,8,석촌,7672,8923,20200601,16595
20200529,8,송파,9366,8704,20200601,18070
20200529,8,가락시장,8068,9231,20200601,17299
20200529,8,문정,20864,21715,20200601,42579
20200529,8,장지,17307,16080,20200601,33387
20200529,8,복정,10809,8999,20200601,19808
20200529,8,산성,5517,5231,20200601,10748
20200529,8,남한산성입구,14103,12102,20200601,26205
20200529,8,단대오거리,10719,9891,20200601,20610
20200529,8,신흥,4649,4884,20200601,9533
20200529,8,수진,5011,4540,20200601,9551
20200529,8,모란,5970,4748,20200601,10718
20200530,8,암사,11467,10448,20200602,21915
20200530,8,천호,11978,14392,20200602,26370
20200530,8,강동구청,5584,5624,20200602,11208
20200530,8,몽촌토성,3838,4073,20200602,7911
20200530,8,잠실,10428,11874,20200602,22302
20200530,8,석촌,5303,6411,20200602,11714
20200530,8,송파,5536,5169,20200602,10705
20200530,8,가락시장,5241,5519,20200602,10760
20200530,8,문정,8256,8468,20200602,16724
20200530,8,장지,11699,10866,20200602,22565
20200530,8,복정,6520,5531,20200602,12051
20200530,8,산성,4436,4239,20200602,8675
20200530,8,남한산성입구,8515,7417,20200602,15932
20200530,8,단대오거리,6856,6276,20200602,13132
20200530,8,신흥,3532,3678,20200602,7210
20200530,8,수진,3604,3183,20200602,6787
20200530,8,모란,3237,2854,20200602,6091
20200531,8,모란,2241,1900,20200603,4141
20200531,8,수진,2577,2295,20200603,4872
20200531,8,신흥,2377,2533,20200603,4910
20200531,8,단대오거리,4603,4564,20200603,9167
20200531,8,남한산성입구,6128,5637,20200603,11765
20200531,8,산성,2989,3130,20200603,6119
20200531,8,복정,4551,4242,20200603,8793
20200531,8,장지,8258,8470,20200603,16728
20200531,8,문정,4985,5228,20200603,10213
20200531,8,가락시장,2951,3820,20200603,6771
20200531,8,송파,3626,3557,20200603,7183
20200531,8,석촌,3397,4163,20200603,7560
20200531,8,잠실,7805,8331,20200603,16136
20200531,8,몽촌토성,2667,2609,20200603,5276
20200531,8,강동구청,3845,3955,20200603,7800
20200531,8,천호,8399,9689,20200603,18088
20200531,8,암사,7886,7336,20200603,15222
20200101,9,신논현,15752,14954,20200104,30706
20200101,9,사평,1204,1213,20200104,2417
20200101,9,고속터미널,9488,13501,20200104,22989
20200101,9,신반포,1097,1057,20200104,2154
20200101,9,구반포,987,1079,20200104,2066
20200101,9,동작,1417,1414,20200104,2831
20200101,9,흑석,4011,4288,20200104,8299
20200101,9,노들,2065,1990,20200104,4055
20200101,9,노량진,16032,18069,20200104,34101
20200101,9,샛강,1598,1611,20200104,3209
20200101,9,여의도,4615,4455,20200104,9070
20200101,9,국회의사당,4106,3571,20200104,7677
20200101,9,당산,7609,7744,20200104,15353
20200101,9,선유도,2631,2652,20200104,5283
20200101,9,신목동,1446,1378,20200104,2824
20200101,9,염창,7396,7578,20200104,14974
20200101,9,등촌,4116,4258,20200104,8374
20200101,9,증미,3161,3343,20200104,6504
20200101,9,가양,8940,9185,20200104,18125
20200101,9,양천향교,3694,4075,20200104,7769
20200101,9,마곡나루,4194,4453,20200104,8647
20200101,9,신방화,3132,3107,20200104,6239
20200101,9,공항시장,1543,1815,20200104,3358
20200101,9,김포공항,7514,10298,20200104,17812
20200101,9,개화,1120,940,20200104,2060
20200102,9,개화,3118,2121,20200105,5239
20200102,9,김포공항,8929,12381,20200105,21310
20200102,9,공항시장,3015,3343,20200105,6358
20200102,9,신방화,7458,7266,20200105,14724
20200102,9,마곡나루,10987,10896,20200105,21883
20200102,9,양천향교,9631,9910,20200105,19541
20200102,9,가양,22026,21718,20200105,43744
20200102,9,증미,7544,7788,20200105,15332
20200102,9,등촌,11444,11532,20200105,22976
20200102,9,염창,18607,18081,20200105,36688
20200102,9,신목동,4218,3862,20200105,8080
20200102,9,선유도,7955,7822,20200105,15777
20200102,9,당산,19721,19545,20200105,39266
20200102,9,국회의사당,17564,17569,20200105,35133
20200102,9,여의도,26301,25487,20200105,51788
20200102,9,샛강,5903,6313,20200105,12216
20200102,9,노량진,30571,31459,20200105,62030
20200102,9,노들,4861,4176,20200105,9037
20200102,9,흑석,9453,10090,20200105,19543
20200102,9,동작,2290,2017,20200105,4307
20200102,9,구반포,3253,3391,20200105,6644
20200102,9,신반포,3226,3324,20200105,6550
20200102,9,고속터미널,14460,19400,20200105,33860
20200102,9,사평,3567,3519,20200105,7086
20200102,9,신논현,39166,39799,20200105,78965
20200103,9,개화,3162,2181,20200106,5343
20200103,9,김포공항,9341,12926,20200106,22267
20200103,9,공항시장,3197,3492,20200106,6689
20200103,9,신방화,7767,7523,20200106,15290
20200103,9,마곡나루,11508,11631,20200106,23139
20200103,9,양천향교,10189,10208,20200106,20397
20200103,9,가양,23528,22545,20200106,46073
20200103,9,증미,8135,8128,20200106,16263
20200103,9,등촌,11911,11900,20200106,23811
20200103,9,염창,19817,19072,20200106,38889
20200103,9,신목동,4546,4003,20200106,8549
20200103,9,선유도,8479,8144,20200106,16623
20200103,9,당산,21873,21263,20200106,43136
20200103,9,국회의사당,19509,19296,20200106,38805
20200103,9,여의도,28030,26557,20200106,54587
20200103,9,샛강,6170,6624,20200106,12794
20200103,9,노량진,32934,34233,20200106,67167
20200103,9,노들,5125,4301,20200106,9426
20200103,9,흑석,10128,10531,20200106,20659
20200103,9,동작,2116,1811,20200106,3927
20200103,9,구반포,3365,3436,20200106,6801
20200103,9,신반포,3359,3236,20200106,6595
20200103,9,고속터미널,16228,22882,20200106,39110
20200103,9,사평,3930,3835,20200106,7765
20200103,9,신논현,43788,45751,20200106,89539
20200104,9,개화,1722,1391,20200107,3113
20200104,9,김포공항,8941,12247,20200107,21188
20200104,9,공항시장,2450,2614,20200107,5064
20200104,9,신방화,5253,5018,20200107,10271
20200104,9,마곡나루,8000,8000,20200107,16000
20200104,9,양천향교,6402,5999,20200107,12401
20200104,9,가양,15711,14897,20200107,30608
20200104,9,증미,4453,4436,20200107,8889
20200104,9,등촌,7661,7545,20200107,15206
20200104,9,염창,13142,12029,20200107,25171
20200104,9,신목동,2554,2263,20200107,4817
20200104,9,선유도,3824,3680,20200107,7504
20200104,9,당산,14680,13628,20200107,28308
20200104,9,국회의사당,4969,4950,20200107,9919
20200104,9,여의도,9468,8900,20200107,18368
20200104,9,샛강,3175,3198,20200107,6373
20200104,9,노량진,28097,29704,20200107,57801
20200104,9,노들,3773,3141,20200107,6914
20200104,9,흑석,7036,7145,20200107,14181
20200104,9,동작,1610,1346,20200107,2956
20200104,9,구반포,2787,2888,20200107,5675
20200104,9,신반포,2189,2117,20200107,4306
20200104,9,고속터미널,16148,24145,20200107,40293
20200104,9,사평,2412,2194,20200107,4606
20200104,9,신논현,32898,34244,20200107,67142
20200105,9,개화,1366,1162,20200108,2528
20200105,9,김포공항,8054,11015,20200108,19069
20200105,9,공항시장,1993,2252,20200108,4245
20200105,9,신방화,4077,4068,20200108,8145
20200105,9,마곡나루,5335,5395,20200108,10730
20200105,9,양천향교,4485,4711,20200108,9196
20200105,9,가양,11984,11932,20200108,23916
20200105,9,증미,3368,3473,20200108,6841
20200105,9,등촌,5311,5376,20200108,10687
20200105,9,염창,9467,9151,20200108,18618
20200105,9,신목동,1931,1899,20200108,3830
20200105,9,선유도,2754,2633,20200108,5387
20200105,9,당산,10083,9889,20200108,19972
20200105,9,국회의사당,6073,5363,20200108,11436
20200105,9,여의도,6486,6120,20200108,12606
20200105,9,샛강,2189,2258,20200108,4447
20200105,9,노량진,19266,21148,20200108,40414
20200105,9,노들,3112,2819,20200108,5931
20200105,9,흑석,5175,5487,20200108,10662
20200105,9,동작,1212,1089,20200108,2301
20200105,9,구반포,1455,1719,20200108,3174
20200105,9,신반포,1903,2100,20200108,4003
20200105,9,고속터미널,13050,18653,20200108,31703
20200105,9,사평,1657,1702,20200108,3359
20200105,9,신논현,20412,19420,20200108,39832
20200106,9,개화,3192,2087,20200109,5279
20200106,9,김포공항,9207,12623,20200109,21830
20200106,9,공항시장,3159,3586,20200109,6745
20200106,9,신방화,7439,7430,20200109,14869
20200106,9,마곡나루,11234,11299,20200109,22533
20200106,9,양천향교,9892,10242,20200109,20134
20200106,9,가양,23013,22477,20200109,45490
20200106,9,증미,8077,8173,20200109,16250
20200106,9,등촌,12151,12269,20200109,24420
20200106,9,염창,19123,18690,20200109,37813
20200106,9,신목동,4417,4034,20200109,8451
20200106,9,선유도,8557,8306,20200109,16863
20200106,9,당산,20757,20359,20200109,41116
20200106,9,국회의사당,20018,19377,20200109,39395
20200106,9,여의도,27943,26805,20200109,54748
20200106,9,샛강,6472,6830,20200109,13302
20200106,9,노량진,32144,32518,20200109,64662
20200106,9,노들,5019,4388,20200109,9407
20200106,9,흑석,9752,10426,20200109,20178
20200106,9,동작,2255,1699,20200109,3954
20200106,9,구반포,3706,3970,20200109,7676
20200106,9,신반포,3450,3438,20200109,6888
20200106,9,고속터미널,14564,19485,20200109,34049
20200106,9,사평,3767,3815,20200109,7582
20200106,9,신논현,38539,38682,20200109,77221
20200107,9,개화,2973,2013,20200110,4986
20200107,9,김포공항,9052,12275,20200110,21327
20200107,9,공항시장,3081,3567,20200110,6648
20200107,9,신방화,7455,7448,20200110,14903
20200107,9,마곡나루,11026,11126,20200110,22152
20200107,9,양천향교,9687,10113,20200110,19800
20200107,9,가양,22444,22109,20200110,44553
20200107,9,증미,7837,8073,20200110,15910
20200107,9,등촌,11726,12172,20200110,23898
20200107,9,염창,18665,18053,20200110,36718
20200107,9,신목동,4440,4063,20200110,8503
20200107,9,선유도,8488,8130,20200110,16618
20200107,9,당산,21111,20678,20200110,41789
20200107,9,국회의사당,20207,19728,20200110,39935
20200107,9,여의도,27645,26604,20200110,54249
20200107,9,샛강,6335,6728,20200110,13063
20200107,9,노량진,31487,31505,20200110,62992
20200107,9,노들,4860,4252,20200110,9112
20200107,9,흑석,9639,10170,20200110,19809
20200107,9,동작,2217,1945,20200110,4162
20200107,9,구반포,3225,3475,20200110,6700
20200107,9,신반포,3335,3364,20200110,6699
20200107,9,고속터미널,13470,18431,20200110,31901
20200107,9,사평,3726,3747,20200110,7473
20200107,9,신논현,37836,38022,20200110,75858
20200108,9,개화,3057,2089,20200111,5146
20200108,9,김포공항,9343,12811,20200111,22154
20200108,9,공항시장,3199,3536,20200111,6735
20200108,9,신방화,7691,7468,20200111,15159
20200108,9,마곡나루,11602,11497,20200111,23099
20200108,9,양천향교,9958,10381,20200111,20339
20200108,9,가양,23393,23084,20200111,46477
20200108,9,증미,8127,8150,20200111,16277
20200108,9,등촌,12068,12281,20200111,24349
20200108,9,염창,19464,18971,20200111,38435
20200108,9,신목동,4651,4151,20200111,8802
20200108,9,선유도,8491,8171,20200111,16662
20200108,9,당산,20958,20690,20200111,41648
20200108,9,국회의사당,20442,20308,20200111,40750
20200108,9,여의도,28544,27306,20200111,55850
20200108,9,샛강,6326,6834,20200111,13160
20200108,9,노량진,32930,33311,20200111,66241
20200108,9,노들,5227,4541,20200111,9768
20200108,9,흑석,10062,10721,20200111,20783
20200108,9,동작,2088,1728,20200111,3816
20200108,9,구반포,3461,3594,20200111,7055
20200108,9,신반포,3478,3429,20200111,6907
20200108,9,고속터미널,14675,19350,20200111,34025
20200108,9,사평,3774,3739,20200111,7513
20200108,9,신논현,39343,39264,20200111,78607
20200109,9,개화,3111,2169,20200112,5280
20200109,9,김포공항,9602,12727,20200112,22329
20200109,9,공항시장,3266,3668,20200112,6934
20200109,9,신방화,7803,7690,20200112,15493
20200109,9,마곡나루,11572,11733,20200112,23305
20200109,9,양천향교,10240,10639,20200112,20879
20200109,9,가양,23243,22574,20200112,45817
20200109,9,증미,8049,8213,20200112,16262
20200109,9,등촌,12275,12331,20200112,24606
20200109,9,염창,19731,19028,20200112,38759
20200109,9,신목동,4541,4133,20200112,8674
20200109,9,선유도,8665,8317,20200112,16982
20200109,9,당산,21701,21101,20200112,42802
20200109,9,국회의사당,19853,19736,20200112,39589
20200109,9,여의도,28172,27489,20200112,55661
20200109,9,샛강,6828,7099,20200112,13927
20200109,9,노량진,33624,34394,20200112,68018
20200109,9,노들,5218,4472,20200112,9690
20200109,9,흑석,10139,10731,20200112,20870
20200109,9,동작,2094,1651,20200112,3745
20200109,9,구반포,3544,3674,20200112,7218
20200109,9,신반포,3753,3814,20200112,7567
20200109,9,고속터미널,14992,20408,20200112,35400
20200109,9,사평,3768,3639,20200112,7407
20200109,9,신논현,40184,40552,20200112,80736
20200110,9,개화,3203,2119,20200113,5322
20200110,9,김포공항,10436,13499,20200113,23935
20200110,9,공항시장,3401,3759,20200113,7160
20200110,9,신방화,8161,7839,20200113,16000
20200110,9,마곡나루,12244,12160,20200113,24404
20200110,9,양천향교,10471,10580,20200113,21051
20200110,9,가양,24110,23425,20200113,47535
20200110,9,증미,8352,8417,20200113,16769
20200110,9,등촌,12291,12399,20200113,24690
20200110,9,염창,20159,19182,20200113,39341
20200110,9,신목동,4648,4231,20200113,8879
20200110,9,선유도,8772,8438,20200113,17210
20200110,9,당산,22690,21929,20200113,44619
20200110,9,국회의사당,21354,20909,20200113,42263
20200110,9,여의도,29785,27745,20200113,57530
20200110,9,샛강,6605,6920,20200113,13525
20200110,9,노량진,35466,36857,20200113,72323
20200110,9,노들,5509,4664,20200113,10173
20200110,9,흑석,10509,10896,20200113,21405
20200110,9,동작,2220,1576,20200113,3796
20200110,9,구반포,3640,3795,20200113,7435
20200110,9,신반포,3673,3561,20200113,7234
20200110,9,고속터미널,17055,23984,20200113,41039
20200110,9,사평,3961,3745,20200113,7706
20200110,9,신논현,43607,46252,20200113,89859
20200111,9,개화,1870,1492,20200114,3362
20200111,9,김포공항,9440,12709,20200114,22149
20200111,9,공항시장,2604,2795,20200114,5399
20200111,9,신방화,5718,5397,20200114,11115
20200111,9,마곡나루,8521,8290,20200114,16811
20200111,9,양천향교,6887,6598,20200114,13485
20200111,9,가양,16794,15874,20200114,32668
20200111,9,증미,4896,4847,20200114,9743
20200111,9,등촌,8086,7829,20200114,15915
20200111,9,염창,13882,12531,20200114,26413
20200111,9,신목동,2928,2470,20200114,5398
20200111,9,선유도,4304,4082,20200114,8386
20200111,9,당산,15729,14476,20200114,30205
20200111,9,국회의사당,6001,5951,20200114,11952
20200111,9,여의도,10599,10143,20200114,20742
20200111,9,샛강,3142,3341,20200114,6483
20200111,9,노량진,30378,32232,20200114,62610
20200111,9,노들,3974,3365,20200114,7339
20200111,9,흑석,7783,7812,20200114,15595
20200111,9,동작,1594,1438,20200114,3032
20200111,9,구반포,2891,3128,20200114,6019
20200111,9,신반포,2629,2575,20200114,5204
20200111,9,고속터미널,17650,25958,20200114,43608
20200111,9,사평,2573,2422,20200114,4995
20200111,9,신논현,33872,35119,20200114,68991
20200112,9,개화,1298,1149,20200115,2447
20200112,9,김포공항,8030,11211,20200115,19241
20200112,9,공항시장,2011,2226,20200115,4237
20200112,9,신방화,4073,4141,20200115,8214
20200112,9,마곡나루,5528,5615,20200115,11143
20200112,9,양천향교,4715,4979,20200115,9694
20200112,9,가양,12776,12361,20200115,25137
20200112,9,증미,2884,2977,20200115,5861
20200112,9,등촌,5358,5453,20200115,10811
20200112,9,염창,9928,9619,20200115,19547
20200112,9,신목동,2001,1869,20200115,3870
20200112,9,선유도,3059,3026,20200115,6085
20200112,9,당산,10417,10196,20200115,20613
20200112,9,국회의사당,6049,5242,20200115,11291
20200112,9,여의도,7027,6556,20200115,13583
20200112,9,샛강,2191,2230,20200115,4421
20200112,9,노량진,20177,22393,20200115,42570
20200112,9,노들,3083,2816,20200115,5899
20200112,9,흑석,8229,7943,20200115,16172
20200112,9,동작,1340,1214,20200115,2554
20200112,9,구반포,1571,1614,20200115,3185
20200112,9,신반포,2010,2050,20200115,4060
20200112,9,고속터미널,13302,20335,20200115,33637
20200112,9,사평,1633,1694,20200115,3327
20200112,9,신논현,20083,18916,20200115,38999
20200113,9,개화,3141,2131,20200116,5272
20200113,9,김포공항,9561,13105,20200116,22666
20200113,9,공항시장,3144,3574,20200116,6718
20200113,9,신방화,7716,7642,20200116,15358
20200113,9,마곡나루,11322,11356,20200116,22678
20200113,9,양천향교,9910,10370,20200116,20280
20200113,9,가양,23308,22692,20200116,46000
20200113,9,증미,8263,8449,20200116,16712
20200113,9,등촌,12113,12377,20200116,24490
20200113,9,염창,19331,18641,20200116,37972
20200113,9,신목동,4403,4038,20200116,8441
20200113,9,선유도,8683,8290,20200116,16973
20200113,9,당산,20930,20695,20200116,41625
20200113,9,국회의사당,19753,19569,20200116,39322
20200113,9,여의도,27966,27119,20200116,55085
20200113,9,샛강,6515,6993,20200116,13508
20200113,9,노량진,32618,32984,20200116,65602
20200113,9,노들,4934,4434,20200116,9368
20200113,9,흑석,10080,10743,20200116,20823
20200113,9,동작,2023,1596,20200116,3619
20200113,9,구반포,3664,3738,20200116,7402
20200113,9,신반포,3251,3296,20200116,6547
20200113,9,고속터미널,14715,20376,20200116,35091
20200113,9,사평,3626,3617,20200116,7243
20200113,9,신논현,38571,38508,20200116,77079
20200114,9,신논현,39871,40008,20200117,79879
20200114,9,사평,3754,3727,20200117,7481
20200114,9,고속터미널,14555,19944,20200117,34499
20200114,9,신반포,3363,3332,20200117,6695
20200114,9,구반포,3451,3583,20200117,7034
20200114,9,동작,2139,1623,20200117,3762
20200114,9,흑석,9927,10568,20200117,20495
20200114,9,노들,5187,4453,20200117,9640
20200114,9,노량진,32711,32992,20200117,65703
20200114,9,샛강,6556,7019,20200117,13575
20200114,9,여의도,28579,27352,20200117,55931
20200114,9,국회의사당,21071,20865,20200117,41936
20200114,9,당산,21336,21124,20200117,42460
20200114,9,선유도,8624,8091,20200117,16715
20200114,9,신목동,4492,3990,20200117,8482
20200114,9,염창,19549,18780,20200117,38329
20200114,9,등촌,12266,12408,20200117,24674
20200114,9,증미,8160,8356,20200117,16516
20200114,9,가양,23673,23184,20200117,46857
20200114,9,양천향교,9969,10384,20200117,20353
20200114,9,마곡나루,11704,11671,20200117,23375
20200114,9,신방화,7838,7685,20200117,15523
20200114,9,공항시장,3318,3686,20200117,7004
20200114,9,김포공항,9412,13051,20200117,22463
20200114,9,개화,3077,2094,20200117,5171
20200115,9,개화,3129,2124,20200118,5253
20200115,9,김포공항,9588,13370,20200118,22958
20200115,9,공항시장,3210,3671,20200118,6881
20200115,9,신방화,7818,7723,20200118,15541
20200115,9,마곡나루,11789,11556,20200118,23345
20200115,9,양천향교,10282,10559,20200118,20841
20200115,9,가양,23650,22950,20200118,46600
20200115,9,증미,8387,8503,20200118,16890
20200115,9,등촌,12293,12402,20200118,24695
20200115,9,염창,19846,19145,20200118,38991
20200115,9,신목동,4593,4205,20200118,8798
20200115,9,선유도,8544,8396,20200118,16940
20200115,9,당산,21591,21442,20200118,43033
20200115,9,국회의사당,20414,20289,20200118,40703
20200115,9,여의도,28752,27676,20200118,56428
20200115,9,샛강,6671,7079,20200118,13750
20200115,9,노량진,33743,34343,20200118,68086
20200115,9,노들,5141,4467,20200118,9608
20200115,9,흑석,10086,10606,20200118,20692
20200115,9,동작,2024,1567,20200118,3591
20200115,9,구반포,3528,3811,20200118,7339
20200115,9,신반포,3500,3372,20200118,6872
20200115,9,고속터미널,15100,19986,20200118,35086
20200115,9,사평,3686,3638,20200118,7324
20200115,9,신논현,39901,40188,20200118,80089
20200116,9,신논현,40401,40972,20200119,81373
20200116,9,사평,3711,3615,20200119,7326
20200116,9,고속터미널,15562,20796,20200119,36358
20200116,9,신반포,3443,3610,20200119,7053
20200116,9,구반포,3637,3748,20200119,7385
20200116,9,동작,1990,1604,20200119,3594
20200116,9,흑석,10129,10551,20200119,20680
20200116,9,노들,5189,4446,20200119,9635
20200116,9,노량진,34176,34851,20200119,69027
20200116,9,샛강,6627,7073,20200119,13700
20200116,9,여의도,28779,27958,20200119,56737
20200116,9,국회의사당,20371,20508,20200119,40879
20200116,9,당산,22098,21356,20200119,43454
20200116,9,선유도,8443,8357,20200119,16800
20200116,9,신목동,4584,4126,20200119,8710
20200116,9,염창,19821,18998,20200119,38819
20200116,9,등촌,12411,12403,20200119,24814
20200116,9,증미,8230,8351,20200119,16581
20200116,9,가양,23729,23133,20200119,46862
20200116,9,양천향교,10169,10523,20200119,20692
20200116,9,마곡나루,11832,11596,20200119,23428
20200116,9,신방화,7968,7849,20200119,15817
20200116,9,공항시장,3356,3731,20200119,7087
20200116,9,김포공항,9789,13119,20200119,22908
20200116,9,개화,3108,2129,20200119,5237
20200117,9,개화,3151,2233,20200120,5384
20200117,9,김포공항,11003,13873,20200120,24876
20200117,9,공항시장,3433,3706,20200120,7139
20200117,9,신방화,8122,7884,20200120,16006
20200117,9,마곡나루,12008,11991,20200120,23999
20200117,9,양천향교,10537,10686,20200120,21223
20200117,9,가양,24214,23230,20200120,47444
20200117,9,증미,8409,8384,20200120,16793
20200117,9,등촌,12575,12344,20200120,24919
20200117,9,염창,20393,19414,20200120,39807
20200117,9,신목동,4825,4280,20200120,9105
20200117,9,선유도,8963,8665,20200120,17628
20200117,9,당산,22485,22177,20200120,44662
20200117,9,국회의사당,21296,21210,20200120,42506
20200117,9,여의도,29808,28071,20200120,57879
20200117,9,샛강,6905,7224,20200120,14129
20200117,9,노량진,35959,37005,20200120,72964
20200117,9,노들,5470,4459,20200120,9929
20200117,9,흑석,10771,11218,20200120,21989
20200117,9,동작,2143,1637,20200120,3780
20200117,9,구반포,3613,3730,20200120,7343
20200117,9,신반포,3482,3413,20200120,6895
20200117,9,고속터미널,17784,24393,20200120,42177
20200117,9,사평,3979,3740,20200120,7719
20200117,9,신논현,44323,46998,20200120,91321
20200118,9,개화,1845,1513,20200121,3358
20200118,9,김포공항,9414,12573,20200121,21987
20200118,9,공항시장,2588,2764,20200121,5352
20200118,9,신방화,5708,5322,20200121,11030
20200118,9,마곡나루,8372,8288,20200121,16660
20200118,9,양천향교,6643,6196,20200121,12839
20200118,9,가양,16894,15825,20200121,32719
20200118,9,증미,4887,5042,20200121,9929
20200118,9,등촌,7967,7864,20200121,15831
20200118,9,염창,13968,12699,20200121,26667
20200118,9,신목동,2845,2417,20200121,5262
20200118,9,선유도,4043,3832,20200121,7875
20200118,9,당산,15989,14489,20200121,30478
20200118,9,국회의사당,5424,5431,20200121,10855
20200118,9,여의도,10224,9443,20200121,19667
20200118,9,샛강,3285,3356,20200121,6641
20200118,9,노량진,30230,32015,20200121,62245
20200118,9,노들,4081,3437,20200121,7518
20200118,9,흑석,7834,7799,20200121,15633
20200118,9,동작,1832,1496,20200121,3328
20200118,9,구반포,2744,3046,20200121,5790
20200118,9,신반포,2417,2286,20200121,4703
20200118,9,고속터미널,17670,26285,20200121,43955
20200118,9,사평,2456,2326,20200121,4782
20200118,9,신논현,33864,35813,20200121,69677
20200119,9,개화,1204,1059,20200122,2263
20200119,9,김포공항,8066,11469,20200122,19535
20200119,9,공항시장,2100,2370,20200122,4470
20200119,9,신방화,4180,4106,20200122,8286
20200119,9,마곡나루,5604,5655,20200122,11259
20200119,9,양천향교,4626,4791,20200122,9417
20200119,9,가양,13022,12647,20200122,25669
20200119,9,증미,3655,3610,20200122,7265
20200119,9,등촌,5616,5767,20200122,11383
20200119,9,염창,9692,9266,20200122,18958
20200119,9,신목동,1961,1864,20200122,3825
20200119,9,선유도,2871,2847,20200122,5718
20200119,9,당산,10649,10050,20200122,20699
20200119,9,국회의사당,6073,5421,20200122,11494
20200119,9,여의도,6697,6368,20200122,13065
20200119,9,샛강,2126,2197,20200122,4323
20200119,9,노량진,20681,21993,20200122,42674
20200119,9,노들,3025,2748,20200122,5773
20200119,9,흑석,5501,5623,20200122,11124
20200119,9,동작,1444,1239,20200122,2683
20200119,9,구반포,1708,1785,20200122,3493
20200119,9,신반포,2068,2230,20200122,4298
20200119,9,고속터미널,12652,19605,20200122,32257
20200119,9,사평,1591,1623,20200122,3214
20200119,9,신논현,20102,18864,20200122,38966
20200120,9,신논현,39808,39881,20200123,79689
20200120,9,사평,3609,3543,20200123,7152
20200120,9,고속터미널,14919,20252,20200123,35171
20200120,9,신반포,3282,3474,20200123,6756
20200120,9,구반포,3628,3824,20200123,7452
20200120,9,동작,2361,1712,20200123,4073
20200120,9,흑석,9893,10470,20200123,20363
20200120,9,노들,5152,4452,20200123,9604
20200120,9,노량진,32944,33289,20200123,66233
20200120,9,샛강,6840,7068,20200123,13908
20200120,9,여의도,28382,27688,20200123,56070
20200120,9,국회의사당,19714,20033,20200123,39747
20200120,9,당산,21492,21048,20200123,42540
20200120,9,선유도,8616,8313,20200123,16929
20200120,9,신목동,4558,4137,20200123,8695
20200120,9,염창,19482,18921,20200123,38403
20200120,9,등촌,12603,12590,20200123,25193
20200120,9,증미,8330,8508,20200123,16838
20200120,9,가양,23622,22833,20200123,46455
20200120,9,양천향교,10034,10325,20200123,20359
20200120,9,마곡나루,11612,11630,20200123,23242
20200120,9,신방화,7820,7806,20200123,15626
20200120,9,공항시장,3274,3706,20200123,6980
20200120,9,김포공항,9864,12517,20200123,22381
20200120,9,개화,3130,2149,20200123,5279
20200121,9,개화,3145,2082,20200124,5227
20200121,9,김포공항,9653,12539,20200124,22192
20200121,9,공항시장,3193,3491,20200124,6684
20200121,9,신방화,7824,7374,20200124,15198
20200121,9,마곡나루,11893,11801,20200124,23694
20200121,9,양천향교,10010,9994,20200124,20004
20200121,9,가양,24232,23281,20200124,47513
20200121,9,증미,8218,8365,20200124,16583
20200121,9,등촌,12617,12355,20200124,24972
20200121,9,염창,19652,18781,20200124,38433
20200121,9,신목동,4604,3989,20200124,8593
20200121,9,선유도,8687,8004,20200124,16691
20200121,9,당산,21999,22210,20200124,44209
20200121,9,국회의사당,20410,20587,20200124,40997
20200121,9,여의도,28584,28055,20200124,56639
20200121,9,샛강,6672,7183,20200124,13855
20200121,9,노량진,33080,33455,20200124,66535
20200121,9,노들,5241,4381,20200124,9622
20200121,9,흑석,9812,10262,20200124,20074
20200121,9,동작,2073,1711,20200124,3784
20200121,9,구반포,3931,4098,20200124,8029
20200121,9,신반포,3446,3382,20200124,6828
20200121,9,고속터미널,14853,20879,20200124,35732
20200121,9,사평,3808,3770,20200124,7578
20200121,9,신논현,40577,41181,20200124,81758
20200122,9,증미,8481,8571,20200125,17052
20200122,9,가양,23992,22806,20200125,46798
20200122,9,양천향교,10020,10388,20200125,20408
20200122,9,마곡나루,11720,11531,20200125,23251
20200122,9,신방화,7935,7692,20200125,15627
20200122,9,염창,19968,18863,20200125,38831
20200122,9,신목동,4639,4178,20200125,8817
20200122,9,선유도,8743,8250,20200125,16993
20200122,9,당산,21591,20840,20200125,42431
20200122,9,국회의사당,19935,19952,20200125,39887
20200122,9,여의도,28712,27864,20200125,56576
20200122,9,샛강,6522,6883,20200125,13405
20200122,9,노량진,33983,34148,20200125,68131
20200122,9,노들,5301,4537,20200125,9838
20200122,9,흑석,9779,10125,20200125,19904
20200122,9,동작,2186,1588,20200125,3774
20200122,9,구반포,3660,3771,20200125,7431
20200122,9,신반포,3413,3322,20200125,6735
20200122,9,고속터미널,14770,22993,20200125,37763
20200122,9,등촌,12464,12399,20200125,24863
20200122,9,사평,3713,3591,20200125,7304
20200122,9,신논현,40481,40764,20200125,81245
20200122,9,개화,3053,2065,20200125,5118
20200122,9,김포공항,9910,14213,20200125,24123
20200122,9,공항시장,3283,3673,20200125,6956
20200123,9,개화,2845,1935,20200126,4780
20200123,9,김포공항,9482,14187,20200126,23669
20200123,9,공항시장,3167,3392,20200126,6559
20200123,9,신방화,7642,7127,20200126,14769
20200123,9,마곡나루,10635,10102,20200126,20737
20200123,9,양천향교,9812,9106,20200126,18918
20200123,9,가양,23223,21312,20200126,44535
20200123,9,증미,8199,8066,20200126,16265
20200123,9,등촌,12017,11436,20200126,23453
20200123,9,염창,19148,17210,20200126,36358
20200123,9,신목동,4318,3721,20200126,8039
20200123,9,선유도,7928,7168,20200126,15096
20200123,9,당산,20863,18968,20200126,39831
20200123,9,국회의사당,16303,15711,20200126,32014
20200123,9,여의도,26973,24272,20200126,51245
20200123,9,샛강,5837,6034,20200126,11871
20200123,9,노량진,33094,31674,20200126,64768
20200123,9,노들,5100,4110,20200126,9210
20200123,9,흑석,9357,9294,20200126,18651
20200123,9,동작,2037,1544,20200126,3581
20200123,9,구반포,3412,3491,20200126,6903
20200123,9,신반포,3469,3362,20200126,6831
20200123,9,고속터미널,14519,32263,20200126,46782
20200123,9,사평,3665,3370,20200126,7035
20200123,9,신논현,38369,38806,20200126,77175
20200124,9,양천향교,3921,2923,20200127,6844
20200124,9,가양,9924,8003,20200127,17927
20200124,9,증미,3192,2831,20200127,6023
20200124,9,등촌,4502,3906,20200127,8408
20200124,9,마곡나루,3976,3338,20200127,7314
20200124,9,신방화,3303,3080,20200127,6383
20200124,9,공항시장,1659,1607,20200127,3266
20200124,9,김포공항,6482,11198,20200127,17680
20200124,9,개화,1139,961,20200127,2100
20200124,9,신논현,13715,13133,20200127,26848
20200124,9,사평,1228,961,20200127,2189
20200124,9,고속터미널,7572,22403,20200127,29975
20200124,9,신반포,1104,1114,20200127,2218
20200124,9,구반포,1026,985,20200127,2011
20200124,9,동작,1369,1262,20200127,2631
20200124,9,흑석,3803,3463,20200127,7266
20200124,9,노들,2056,1636,20200127,3692
20200124,9,노량진,18931,16432,20200127,35363
20200124,9,샛강,1558,1414,20200127,2972
20200124,9,여의도,4108,3699,20200127,7807
20200124,9,국회의사당,2156,2053,20200127,4209
20200124,9,당산,7565,5767,20200127,13332
20200124,9,선유도,2187,1684,20200127,3871
20200124,9,신목동,1569,1185,20200127,2754
20200124,9,염창,8013,6277,20200127,14290
20200125,9,개화,1060,731,20200128,1791
20200125,9,김포공항,6051,8492,20200128,14543
20200125,9,공항시장,1284,1393,20200128,2677
20200125,9,신방화,2816,2853,20200128,5669
20200125,9,마곡나루,2881,2983,20200128,5864
20200125,9,양천향교,2892,3012,20200128,5904
20200125,9,가양,7913,7946,20200128,15859
20200125,9,증미,2173,2271,20200128,4444
20200125,9,등촌,3288,3387,20200128,6675
20200125,9,염창,6289,6311,20200128,12600
20200125,9,신목동,1276,1122,20200128,2398
20200125,9,선유도,1532,1593,20200128,3125
20200125,9,당산,5436,5440,20200128,10876
20200125,9,국회의사당,1501,1459,20200128,2960
20200125,9,여의도,3296,3233,20200128,6529
20200125,9,샛강,1024,895,20200128,1919
20200125,9,노량진,11520,12729,20200128,24249
20200125,9,노들,1897,1599,20200128,3496
20200125,9,흑석,3487,3572,20200128,7059
20200125,9,동작,2699,2295,20200128,4994
20200125,9,구반포,696,734,20200128,1430
20200125,9,신반포,755,766,20200128,1521
20200125,9,고속터미널,8114,9430,20200128,17544
20200125,9,사평,894,939,20200128,1833
20200125,9,신논현,7955,8360,20200128,16315
20200126,9,개화,1175,1035,20200129,2210
20200126,9,김포공항,7956,9631,20200129,17587
20200126,9,공항시장,1643,1818,20200129,3461
20200126,9,신방화,3445,3490,20200129,6935
20200126,9,마곡나루,3688,4287,20200129,7975
20200126,9,양천향교,3341,3846,20200129,7187
20200126,9,가양,9207,9852,20200129,19059
20200126,9,증미,2078,2341,20200129,4419
20200126,9,등촌,3959,4456,20200129,8415
20200126,9,염창,7175,8001,20200129,15176
20200126,9,신목동,1625,1529,20200129,3154
20200126,9,선유도,2060,2264,20200129,4324
20200126,9,당산,6935,7664,20200129,14599
20200126,9,국회의사당,4028,3716,20200129,7744
20200126,9,여의도,4840,4720,20200129,9560
20200126,9,샛강,1455,1377,20200129,2832
20200126,9,노량진,14467,17635,20200129,32102
20200126,9,노들,2433,2269,20200129,4702
20200126,9,흑석,3777,4117,20200129,7894
20200126,9,동작,1725,1455,20200129,3180
20200126,9,구반포,1041,1142,20200129,2183
20200126,9,신반포,1533,1510,20200129,3043
20200126,9,고속터미널,14160,12056,20200129,26216
20200126,9,사평,1205,1226,20200129,2431
20200126,9,신논현,12666,14445,20200129,27111
20200127,9,개화,1262,1085,20200130,2347
20200127,9,김포공항,8421,10203,20200130,18624
20200127,9,공항시장,1572,1938,20200130,3510
20200127,9,신방화,3423,3643,20200130,7066
20200127,9,마곡나루,4203,4848,20200130,9051
20200127,9,양천향교,3799,4543,20200130,8342
20200127,9,가양,9477,10128,20200130,19605
20200127,9,증미,2938,3302,20200130,6240
20200127,9,등촌,4365,4849,20200130,9214
20200127,9,염창,7875,8440,20200130,16315
20200127,9,신목동,1612,1618,20200130,3230
20200127,9,선유도,2330,2529,20200130,4859
20200127,9,당산,8228,9193,20200130,17421
20200127,9,국회의사당,2659,2629,20200130,5288
20200127,9,여의도,5120,5305,20200130,10425
20200127,9,샛강,1739,1858,20200130,3597
20200127,9,노량진,16320,19085,20200130,35405
20200127,9,노들,2101,2063,20200130,4164
20200127,9,흑석,3820,4338,20200130,8158
20200127,9,동작,1345,1248,20200130,2593
20200127,9,구반포,1371,1491,20200130,2862
20200127,9,신반포,1257,1268,20200130,2525
20200127,9,고속터미널,14641,13514,20200130,28155
20200127,9,사평,1257,1368,20200130,2625
20200127,9,신논현,16103,16622,20200130,32725
20200128,9,개화,2876,1970,20200131,4846
20200128,9,김포공항,8248,10171,20200131,18419
20200128,9,공항시장,2871,3287,20200131,6158
20200128,9,신방화,7296,7201,20200131,14497
20200128,9,마곡나루,9779,10046,20200131,19825
20200128,9,양천향교,8596,9087,20200131,17683
20200128,9,가양,21150,21225,20200131,42375
20200128,9,증미,7296,7426,20200131,14722
20200128,9,등촌,10771,11220,20200131,21991
20200128,9,염창,17425,17287,20200131,34712
20200128,9,신목동,3967,3605,20200131,7572
20200128,9,선유도,7577,7331,20200131,14908
20200128,9,당산,18475,18781,20200131,37256
20200128,9,국회의사당,17421,17408,20200131,34829
20200128,9,여의도,24799,24001,20200131,48800
20200128,9,샛강,5655,5995,20200131,11650
20200128,9,노량진,27763,28798,20200131,56561
20200128,9,노들,4515,3976,20200131,8491
20200128,9,흑석,8513,9272,20200131,17785
20200128,9,동작,2082,1474,20200131,3556
20200128,9,구반포,2993,3125,20200131,6118
20200128,9,신반포,2973,3028,20200131,6001
20200128,9,고속터미널,13870,16387,20200131,30257
20200128,9,사평,3333,3292,20200131,6625
20200128,9,신논현,32644,33398,20200131,66042
20200129,9,개화,2909,2052,20200201,4961
20200129,9,김포공항,8303,10725,20200201,19028
20200129,9,공항시장,3105,3436,20200201,6541
20200129,9,신방화,7530,7352,20200201,14882
20200129,9,마곡나루,10786,11027,20200201,21813
20200129,9,양천향교,9538,9964,20200201,19502
20200129,9,가양,22374,22061,20200201,44435
20200129,9,증미,7565,7678,20200201,15243
20200129,9,등촌,11477,11488,20200201,22965
20200129,9,염창,18601,18324,20200201,36925
20200129,9,신목동,4357,3961,20200201,8318
20200129,9,선유도,8075,7818,20200201,15893
20200129,9,당산,20216,19945,20200201,40161
20200129,9,국회의사당,18905,18946,20200201,37851
20200129,9,여의도,26974,26286,20200201,53260
20200129,9,샛강,6172,6473,20200201,12645
20200129,9,노량진,29801,30465,20200201,60266
20200129,9,노들,4918,4227,20200201,9145
20200129,9,흑석,8889,9309,20200201,18198
20200129,9,동작,1951,1485,20200201,3436
20200129,9,구반포,3278,3410,20200201,6688
20200129,9,신반포,3104,3127,20200201,6231
20200129,9,고속터미널,12739,16824,20200201,29563
20200129,9,사평,3412,3352,20200201,6764
20200129,9,신논현,35653,36444,20200201,72097
20200130,9,신논현,36335,36800,20200202,73135
20200130,9,사평,3489,3420,20200202,6909
20200130,9,고속터미널,12895,17370,20200202,30265
20200130,9,신반포,3270,3221,20200202,6491
20200130,9,구반포,3262,3460,20200202,6722
20200130,9,동작,1968,1551,20200202,3519
20200130,9,흑석,8779,9341,20200202,18120
20200130,9,노들,4910,4152,20200202,9062
20200130,9,노량진,30135,30514,20200202,60649
20200130,9,샛강,6432,6793,20200202,13225
20200130,9,여의도,27354,26650,20200202,54004
20200130,9,국회의사당,18462,18734,20200202,37196
20200130,9,당산,20540,20312,20200202,40852
20200130,9,선유도,8118,7813,20200202,15931
20200130,9,신목동,4250,3889,20200202,8139
20200130,9,염창,18750,18046,20200202,36796
20200130,9,등촌,11285,11407,20200202,22692
20200130,9,증미,7469,7592,20200202,15061
20200130,9,가양,22432,21845,20200202,44277
20200130,9,양천향교,9581,9927,20200202,19508
20200130,9,마곡나루,10851,10987,20200202,21838
20200130,9,신방화,7640,7538,20200202,15178
20200130,9,공항시장,2986,3362,20200202,6348
20200130,9,김포공항,8259,10034,20200202,18293
20200130,9,개화,2947,1973,20200202,4920
20200131,9,개화,2938,2012,20200203,4950
20200131,9,김포공항,7938,10440,20200203,18378
20200131,9,공항시장,3038,3351,20200203,6389
20200131,9,신방화,7648,7354,20200203,15002
20200131,9,마곡나루,11061,11260,20200203,22321
20200131,9,양천향교,9826,9981,20200203,19807
20200131,9,가양,22802,22015,20200203,44817
20200131,9,증미,7604,7607,20200203,15211
20200131,9,등촌,11524,11439,20200203,22963
20200131,9,염창,18950,18132,20200203,37082
20200131,9,신목동,4364,3955,20200203,8319
20200131,9,선유도,8235,7811,20200203,16046
20200131,9,당산,21062,20670,20200203,41732
20200131,9,국회의사당,18667,18756,20200203,37423
20200131,9,여의도,27486,26232,20200203,53718
20200131,9,샛강,6207,6669,20200203,12876
20200131,9,노량진,31229,31806,20200203,63035
20200131,9,노들,4998,4161,20200203,9159
20200131,9,흑석,8882,9279,20200203,18161
20200131,9,동작,2051,1481,20200203,3532
20200131,9,구반포,3190,3295,20200203,6485
20200131,9,신반포,3099,3036,20200203,6135
20200131,9,고속터미널,13750,19041,20200203,32791
20200131,9,사평,3550,3411,20200203,6961
20200131,9,신논현,37409,39308,20200203,76717
20200201,9,개화,1321,1079,20200204,2400
20200201,9,김포공항,6284,8349,20200204,14633
20200201,9,공항시장,2244,2428,20200204,4672
20200201,9,신방화,4753,4484,20200204,9237
20200201,9,마곡나루,6888,6832,20200204,13720
20200201,9,양천향교,5460,5360,20200204,10820
20200201,9,가양,13754,13177,20200204,26931
20200201,9,증미,4027,3955,20200204,7982
20200201,9,등촌,6431,6372,20200204,12803
20200201,9,염창,11033,10158,20200204,21191
20200201,9,신목동,2201,1960,20200204,4161
20200201,9,선유도,3283,3194,20200204,6477
20200201,9,당산,12726,11718,20200204,24444
20200201,9,국회의사당,4387,4342,20200204,8729
20200201,9,여의도,7946,7724,20200204,15670
20200201,9,샛강,2506,2665,20200204,5171
20200201,9,노량진,23549,24719,20200204,48268
20200201,9,노들,3170,2682,20200204,5852
20200201,9,흑석,5881,6048,20200204,11929
20200201,9,동작,1358,1160,20200204,2518
20200201,9,구반포,2223,2353,20200204,4576
20200201,9,신반포,1936,1887,20200204,3823
20200201,9,고속터미널,11048,16729,20200204,27777
20200201,9,사평,1809,1756,20200204,3565
20200201,9,신논현,24146,25109,20200204,49255
20200202,9,개화,1020,930,20200205,1950
20200202,9,김포공항,5403,7356,20200205,12759
20200202,9,공항시장,1737,1911,20200205,3648
20200202,9,신방화,3442,3458,20200205,6900
20200202,9,마곡나루,4615,4720,20200205,9335
20200202,9,양천향교,3806,3901,20200205,7707
20200202,9,가양,10125,9820,20200205,19945
20200202,9,증미,2914,3045,20200205,5959
20200202,9,등촌,4568,4692,20200205,9260
20200202,9,염창,7975,7724,20200205,15699
20200202,9,신목동,1558,1443,20200205,3001
20200202,9,선유도,2368,2318,20200205,4686
20200202,9,당산,8626,8334,20200205,16960
20200202,9,국회의사당,5129,4441,20200205,9570
20200202,9,여의도,5491,5141,20200205,10632
20200202,9,샛강,1821,1861,20200205,3682
20200202,9,노량진,15518,16912,20200205,32430
20200202,9,노들,2475,2231,20200205,4706
20200202,9,흑석,4016,4134,20200205,8150
20200202,9,동작,1092,873,20200205,1965
20200202,9,구반포,1387,1449,20200205,2836
20200202,9,신반포,1629,1617,20200205,3246
20200202,9,고속터미널,8479,12937,20200205,21416
20200202,9,사평,1161,1269,20200205,2430
20200202,9,신논현,14023,13576,20200205,27599
20200203,9,개화,2829,1871,20200206,4700
20200203,9,김포공항,6971,8779,20200206,15750
20200203,9,공항시장,2928,3274,20200206,6202
20200203,9,신방화,7214,7162,20200206,14376
20200203,9,마곡나루,10353,10324,20200206,20677
20200203,9,양천향교,9097,9587,20200206,18684
20200203,9,가양,21412,20926,20200206,42338
20200203,9,증미,7342,7497,20200206,14839
20200203,9,등촌,10956,11174,20200206,22130
20200203,9,염창,17631,17377,20200206,35008
20200203,9,신목동,4068,3685,20200206,7753
20200203,9,선유도,8129,7929,20200206,16058
20200203,9,당산,18963,18724,20200206,37687
20200203,9,국회의사당,17919,17998,20200206,35917
20200203,9,여의도,25442,25162,20200206,50604
20200203,9,샛강,5825,5996,20200206,11821
20200203,9,노량진,28195,28005,20200206,56200
20200203,9,노들,4600,4037,20200206,8637
20200203,9,흑석,8111,8833,20200206,16944
20200203,9,동작,1808,1468,20200206,3276
20200203,9,구반포,3005,3150,20200206,6155
20200203,9,신반포,2863,2866,20200206,5729
20200203,9,고속터미널,11286,15305,20200206,26591
20200203,9,사평,3233,3227,20200206,6460
20200203,9,신논현,33444,33701,20200206,67145
20200204,9,개화,2760,1859,20200207,4619
20200204,9,김포공항,6925,8751,20200207,15676
20200204,9,공항시장,2862,3362,20200207,6224
20200204,9,신방화,7263,7311,20200207,14574
20200204,9,마곡나루,10620,10611,20200207,21231
20200204,9,양천향교,9325,9801,20200207,19126
20200204,9,가양,21585,20985,20200207,42570
20200204,9,증미,7534,7566,20200207,15100
20200204,9,등촌,11039,11433,20200207,22472
20200204,9,염창,17979,17697,20200207,35676
20200204,9,신목동,4130,3758,20200207,7888
20200204,9,선유도,8264,7859,20200207,16123
20200204,9,당산,19755,19399,20200207,39154
20200204,9,국회의사당,18695,18147,20200207,36842
20200204,9,여의도,26276,25211,20200207,51487
20200204,9,샛강,5811,6216,20200207,12027
20200204,9,노량진,28390,28378,20200207,56768
20200204,9,노들,4645,4080,20200207,8725
20200204,9,흑석,8256,8928,20200207,17184
20200204,9,동작,1822,1419,20200207,3241
20200204,9,구반포,3084,3201,20200207,6285
20200204,9,신반포,2906,2958,20200207,5864
20200204,9,고속터미널,11340,15021,20200207,26361
20200204,9,사평,3163,3247,20200207,6410
20200204,9,신논현,34381,34547,20200207,68928
20200205,9,개화,2637,1816,20200208,4453
20200205,9,김포공항,6778,8399,20200208,15177
20200205,9,공항시장,2808,3153,20200208,5961
20200205,9,신방화,7044,7150,20200208,14194
20200205,9,마곡나루,10464,10494,20200208,20958
20200205,9,양천향교,9075,9528,20200208,18603
20200205,9,가양,20852,20429,20200208,41281
20200205,9,증미,7311,7378,20200208,14689
20200205,9,등촌,10668,10954,20200208,21622
20200205,9,염창,17595,16968,20200208,34563
20200205,9,신목동,4002,3581,20200208,7583
20200205,9,선유도,7795,7617,20200208,15412
20200205,9,당산,19464,19190,20200208,38654
20200205,9,국회의사당,18953,18689,20200208,37642
20200205,9,여의도,25506,24922,20200208,50428
20200205,9,샛강,5762,6102,20200208,11864
20200205,9,노량진,28220,28295,20200208,56515
20200205,9,노들,4633,4023,20200208,8656
20200205,9,흑석,7999,8417,20200208,16416
20200205,9,동작,1719,1331,20200208,3050
20200205,9,구반포,3041,3175,20200208,6216
20200205,9,신반포,2971,2915,20200208,5886
20200205,9,고속터미널,11025,14997,20200208,26022
20200205,9,사평,3143,3139,20200208,6282
20200205,9,신논현,33773,34111,20200208,67884
20200206,9,개화,2594,1786,20200209,4380
20200206,9,김포공항,6771,8728,20200209,15499
20200206,9,공항시장,2790,3163,20200209,5953
20200206,9,신방화,6819,6801,20200209,13620
20200206,9,마곡나루,10290,10267,20200209,20557
20200206,9,양천향교,9065,9489,20200209,18554
20200206,9,가양,20677,20166,20200209,40843
20200206,9,증미,7118,7235,20200209,14353
20200206,9,등촌,10633,10670,20200209,21303
20200206,9,염창,17408,16808,20200209,34216
20200206,9,신목동,4067,3611,20200209,7678
20200206,9,선유도,7956,7763,20200209,15719
20200206,9,당산,18884,18681,20200209,37565
20200206,9,국회의사당,17597,17690,20200209,35287
20200206,9,여의도,25579,24955,20200209,50534
20200206,9,샛강,5709,6045,20200209,11754
20200206,9,노량진,28319,28534,20200209,56853
20200206,9,노들,4583,3951,20200209,8534
20200206,9,흑석,7976,8545,20200209,16521
20200206,9,동작,1723,1333,20200209,3056
20200206,9,구반포,2878,3003,20200209,5881
20200206,9,신반포,2825,2932,20200209,5757
20200206,9,고속터미널,11072,14740,20200209,25812
20200206,9,사평,3092,2998,20200209,6090
20200206,9,신논현,33300,33882,20200209,67182
20200207,9,개화,2650,1896,20200210,4546
20200207,9,김포공항,7065,9581,20200210,16646
20200207,9,공항시장,2952,3276,20200210,6228
20200207,9,신방화,7303,7115,20200210,14418
20200207,9,마곡나루,10767,10715,20200210,21482
20200207,9,양천향교,9449,9558,20200210,19007
20200207,9,가양,21806,20961,20200210,42767
20200207,9,증미,7628,7566,20200210,15194
20200207,9,등촌,11092,11098,20200210,22190
20200207,9,염창,18227,17606,20200210,35833
20200207,9,신목동,4127,3778,20200210,7905
20200207,9,선유도,8181,7768,20200210,15949
20200207,9,당산,19855,19403,20200210,39258
20200207,9,국회의사당,18125,18107,20200210,36232
20200207,9,여의도,26508,24954,20200210,51462
20200207,9,샛강,5840,6230,20200210,12070
20200207,9,노량진,30231,30784,20200210,61015
20200207,9,노들,4711,3846,20200210,8557
20200207,9,흑석,8307,8827,20200210,17134
20200207,9,동작,1816,1385,20200210,3201
20200207,9,구반포,2973,3100,20200210,6073
20200207,9,신반포,2938,2967,20200210,5905
20200207,9,고속터미널,12516,17748,20200210,30264
20200207,9,사평,3218,3150,20200210,6368
20200207,9,신논현,35831,37662,20200210,73493
20200208,9,개화,1327,1119,20200211,2446
20200208,9,김포공항,5858,8044,20200211,13902
20200208,9,공항시장,2195,2290,20200211,4485
20200208,9,신방화,4564,4283,20200211,8847
20200208,9,마곡나루,6673,6588,20200211,13261
20200208,9,양천향교,5243,5170,20200211,10413
20200208,9,가양,13220,12531,20200211,25751
20200208,9,증미,3778,3713,20200211,7491
20200208,9,등촌,6111,6121,20200211,12232
20200208,9,염창,10745,9927,20200211,20672
20200208,9,신목동,2054,1759,20200211,3813
20200208,9,선유도,3250,3132,20200211,6382
20200208,9,당산,12447,11479,20200211,23926
20200208,9,국회의사당,4134,4123,20200211,8257
20200208,9,여의도,7885,7447,20200211,15332
20200208,9,샛강,2560,2639,20200211,5199
20200208,9,노량진,22672,24067,20200211,46739
20200208,9,노들,3067,2603,20200211,5670
20200208,9,흑석,5802,5884,20200211,11686
20200208,9,동작,1268,1058,20200211,2326
20200208,9,구반포,2361,2510,20200211,4871
20200208,9,신반포,1988,1940,20200211,3928
20200208,9,고속터미널,10724,16220,20200211,26944
20200208,9,사평,1781,1705,20200211,3486
20200208,9,신논현,24288,25136,20200211,49424
20200209,9,개화,920,843,20200212,1763
20200209,9,김포공항,5401,7435,20200212,12836
20200209,9,공항시장,1696,1851,20200212,3547
20200209,9,신방화,3412,3444,20200212,6856
20200209,9,마곡나루,4780,4943,20200212,9723
20200209,9,양천향교,3727,3940,20200212,7667
20200209,9,가양,10037,9720,20200212,19757
20200209,9,증미,2277,2451,20200212,4728
20200209,9,등촌,4406,4587,20200212,8993
20200209,9,염창,8024,7753,20200212,15777
20200209,9,신목동,1524,1444,20200212,2968
20200209,9,선유도,2267,2242,20200212,4509
20200209,9,당산,8604,8366,20200212,16970
20200209,9,국회의사당,5053,4504,20200212,9557
20200209,9,여의도,5325,4995,20200212,10320
20200209,9,샛강,1585,1673,20200212,3258
20200209,9,노량진,15400,16914,20200212,32314
20200209,9,노들,2370,2122,20200212,4492
20200209,9,흑석,4052,4275,20200212,8327
20200209,9,동작,1054,886,20200212,1940
20200209,9,구반포,1396,1521,20200212,2917
20200209,9,신반포,1558,1577,20200212,3135
20200209,9,고속터미널,9205,13247,20200212,22452
20200209,9,사평,1117,1176,20200212,2293
20200209,9,신논현,15155,14844,20200212,29999
20200210,9,개화,2914,1925,20200213,4839
20200210,9,김포공항,6764,8875,20200213,15639
20200210,9,공항시장,2928,3328,20200213,6256
20200210,9,신방화,7003,6921,20200213,13924
20200210,9,마곡나루,10468,10417,20200213,20885
20200210,9,양천향교,9185,9581,20200213,18766
20200210,9,가양,21201,20720,20200213,41921
20200210,9,증미,7400,7454,20200213,14854
20200210,9,등촌,10888,11022,20200213,21910
20200210,9,염창,17597,17362,20200213,34959
20200210,9,신목동,4205,3772,20200213,7977
20200210,9,선유도,7986,7724,20200213,15710
20200210,9,당산,19226,19023,20200213,38249
20200210,9,국회의사당,17497,17660,20200213,35157
20200210,9,여의도,25647,25166,20200213,50813
20200210,9,샛강,5748,6119,20200213,11867
20200210,9,노량진,28275,28799,20200213,57074
20200210,9,노들,4508,3854,20200213,8362
20200210,9,흑석,7952,8565,20200213,16517
20200210,9,동작,1813,1419,20200213,3232
20200210,9,구반포,2986,3156,20200213,6142
20200210,9,신반포,2925,2953,20200213,5878
20200210,9,고속터미널,11176,15403,20200213,26579
20200210,9,사평,3047,3027,20200213,6074
20200210,9,신논현,34514,34768,20200213,69282
20200211,9,개화,2845,1914,20200214,4759
20200211,9,김포공항,7140,9471,20200214,16611
20200211,9,공항시장,2919,3254,20200214,6173
20200211,9,신방화,7154,6969,20200214,14123
20200211,9,마곡나루,10851,10840,20200214,21691
20200211,9,양천향교,9480,9727,20200214,19207
20200211,9,가양,22073,21384,20200214,43457
20200211,9,증미,7473,7583,20200214,15056
20200211,9,등촌,11145,11021,20200214,22166
20200211,9,염창,18183,17668,20200214,35851
20200211,9,신목동,4246,3767,20200214,8013
20200211,9,선유도,8039,7856,20200214,15895
20200211,9,당산,19667,19051,20200214,38718
20200211,9,국회의사당,17786,17973,20200214,35759
20200211,9,여의도,26291,25652,20200214,51943
20200211,9,샛강,5962,6298,20200214,12260
20200211,9,노량진,29155,29608,20200214,58763
20200211,9,노들,4749,4014,20200214,8763
20200211,9,흑석,8397,9005,20200214,17402
20200211,9,동작,1941,1513,20200214,3454
20200211,9,구반포,3010,3231,20200214,6241
20200211,9,신반포,2901,2949,20200214,5850
20200211,9,고속터미널,12053,16034,20200214,28087
20200211,9,사평,3224,3090,20200214,6314
20200211,9,신논현,35577,35945,20200214,71522
20200212,9,개화,2703,1893,20200215,4596
20200212,9,김포공항,6972,9173,20200215,16145
20200212,9,공항시장,2850,3249,20200215,6099
20200212,9,신방화,6995,6920,20200215,13915
20200212,9,마곡나루,10543,10625,20200215,21168
20200212,9,양천향교,9138,9610,20200215,18748
20200212,9,가양,21090,20605,20200215,41695
20200212,9,증미,7229,7350,20200215,14579
20200212,9,등촌,10866,11022,20200215,21888
20200212,9,염창,17952,17544,20200215,35496
20200212,9,신목동,4087,3656,20200215,7743
20200212,9,선유도,8042,7871,20200215,15913
20200212,9,당산,19559,19191,20200215,38750
20200212,9,국회의사당,18757,18326,20200215,37083
20200212,9,여의도,26249,25150,20200215,51399
20200212,9,샛강,5828,6234,20200215,12062
20200212,9,노량진,28856,28851,20200215,57707
20200212,9,노들,4640,4071,20200215,8711
20200212,9,흑석,8279,8779,20200215,17058
20200212,9,동작,1794,1339,20200215,3133
20200212,9,구반포,3126,3377,20200215,6503
20200212,9,신반포,2956,3013,20200215,5969
20200212,9,고속터미널,11570,15947,20200215,27517
20200212,9,사평,3134,3215,20200215,6349
20200212,9,신논현,34570,35134,20200215,69704
20200213,9,개화,2751,1892,20200216,4643
20200213,9,김포공항,7497,10383,20200216,17880
20200213,9,공항시장,2981,3226,20200216,6207
20200213,9,신방화,7294,7068,20200216,14362
20200213,9,마곡나루,11002,10899,20200216,21901
20200213,9,양천향교,9349,9701,20200216,19050
20200213,9,가양,22022,21395,20200216,43417
20200213,9,증미,7497,7502,20200216,14999
20200213,9,등촌,10971,11110,20200216,22081
20200213,9,염창,18389,17648,20200216,36037
20200213,9,신목동,4162,3718,20200216,7880
20200213,9,선유도,7832,7535,20200216,15367
20200213,9,당산,20161,20041,20200216,40202
20200213,9,국회의사당,17843,18136,20200216,35979
20200213,9,여의도,26750,26153,20200216,52903
20200213,9,샛강,6056,6476,20200216,12532
20200213,9,노량진,29811,30295,20200216,60106
20200213,9,노들,4760,4010,20200216,8770
20200213,9,흑석,8439,8946,20200216,17385
20200213,9,동작,1886,1463,20200216,3349
20200213,9,구반포,3315,3399,20200216,6714
20200213,9,신반포,2931,2921,20200216,5852
20200213,9,고속터미널,12558,17066,20200216,29624
20200213,9,사평,3256,3227,20200216,6483
20200213,9,신논현,36252,36758,20200216,73010
20200214,9,노량진,32085,32964,20200217,65049
20200214,9,노들,4998,4042,20200217,9040
20200214,9,흑석,9003,9471,20200217,18474
20200214,9,동작,1950,1520,20200217,3470
20200214,9,구반포,3130,3278,20200217,6408
20200214,9,신반포,3105,3156,20200217,6261
20200214,9,고속터미널,14500,20446,20200217,34946
20200214,9,사평,3478,3300,20200217,6778
20200214,9,신논현,38584,40735,20200217,79319
20200214,9,개화,2931,1998,20200217,4929
20200214,9,김포공항,8096,11170,20200217,19266
20200214,9,공항시장,3229,3395,20200217,6624
20200214,9,신방화,7554,7144,20200217,14698
20200214,9,마곡나루,11483,11493,20200217,22976
20200214,9,양천향교,9796,9950,20200217,19746
20200214,9,가양,23015,21890,20200217,44905
20200214,9,증미,7850,7924,20200217,15774
20200214,9,등촌,11516,11245,20200217,22761
20200214,9,염창,19060,18120,20200217,37180
20200214,9,신목동,4450,3873,20200217,8323
20200214,9,선유도,8146,7723,20200217,15869
20200214,9,당산,20975,20421,20200217,41396
20200214,9,국회의사당,18608,18517,20200217,37125
20200214,9,여의도,28018,26469,20200217,54487
20200214,9,샛강,6031,6315,20200217,12346
20200215,9,개화,1530,1264,20200218,2794
20200215,9,김포공항,7305,10057,20200218,17362
20200215,9,공항시장,2294,2479,20200218,4773
20200215,9,신방화,4944,4685,20200218,9629
20200215,9,마곡나루,7611,7503,20200218,15114
20200215,9,양천향교,5784,5630,20200218,11414
20200215,9,가양,14941,13803,20200218,28744
20200215,9,증미,4171,4117,20200218,8288
20200215,9,등촌,6777,6752,20200218,13529
20200215,9,염창,11872,10960,20200218,22832
20200215,9,신목동,2284,2023,20200218,4307
20200215,9,선유도,3541,3360,20200218,6901
20200215,9,당산,13454,12248,20200218,25702
20200215,9,국회의사당,4786,5053,20200218,9839
20200215,9,여의도,8789,8576,20200218,17365
20200215,9,샛강,2657,2596,20200218,5253
20200215,9,노량진,25328,26744,20200218,52072
20200215,9,노들,3166,2675,20200218,5841
20200215,9,흑석,5976,5955,20200218,11931
20200215,9,동작,1430,1217,20200218,2647
20200215,9,구반포,2583,2729,20200218,5312
20200215,9,신반포,2189,2178,20200218,4367
20200215,9,고속터미널,12780,19246,20200218,32026
20200215,9,사평,1915,1843,20200218,3758
20200215,9,신논현,26965,27843,20200218,54808
20200216,9,개화,980,907,20200219,1887
20200216,9,김포공항,6904,9200,20200219,16104
20200216,9,공항시장,1777,1940,20200219,3717
20200216,9,신방화,3686,3663,20200219,7349
20200216,9,마곡나루,5124,5171,20200219,10295
20200216,9,양천향교,3957,4211,20200219,8168
20200216,9,가양,10425,10389,20200219,20814
20200216,9,증미,2991,3114,20200219,6105
20200216,9,등촌,4770,4957,20200219,9727
20200216,9,염창,8492,8210,20200219,16702
20200216,9,신목동,1608,1494,20200219,3102
20200216,9,선유도,2497,2471,20200219,4968
20200216,9,당산,9061,8871,20200219,17932
20200216,9,국회의사당,5446,4795,20200219,10241
20200216,9,여의도,5934,5506,20200219,11440
20200216,9,샛강,1766,1857,20200219,3623
20200216,9,노량진,17317,18847,20200219,36164
20200216,9,노들,2457,2307,20200219,4764
20200216,9,흑석,4208,4453,20200219,8661
20200216,9,동작,953,792,20200219,1745
20200216,9,구반포,1312,1359,20200219,2671
20200216,9,신반포,1763,1707,20200219,3470
20200216,9,고속터미널,9529,14428,20200219,23957
20200216,9,사평,1291,1324,20200219,2615
20200216,9,신논현,16354,15707,20200219,32061
20200217,9,개화,2870,1913,20200220,4783
20200217,9,김포공항,8009,10234,20200220,18243
20200217,9,공항시장,2926,3256,20200220,6182
20200217,9,신방화,7157,7083,20200220,14240
20200217,9,마곡나루,10599,10755,20200220,21354
20200217,9,양천향교,9438,9818,20200220,19256
20200217,9,가양,21820,21069,20200220,42889
20200217,9,증미,7636,7765,20200220,15401
20200217,9,등촌,11192,11299,20200220,22491
20200217,9,염창,18353,17861,20200220,36214
20200217,9,신목동,4236,3881,20200220,8117
20200217,9,선유도,8200,7978,20200220,16178
20200217,9,당산,19352,19195,20200220,38547
20200217,9,국회의사당,18868,19126,20200220,37994
20200217,9,여의도,26783,26319,20200220,53102
20200217,9,샛강,5913,6300,20200220,12213
20200217,9,노량진,28981,28870,20200220,57851
20200217,9,노들,4635,3985,20200220,8620
20200217,9,흑석,8206,8843,20200220,17049
20200217,9,동작,1781,1402,20200220,3183
20200217,9,구반포,3094,3265,20200220,6359
20200217,9,신반포,2877,2927,20200220,5804
20200217,9,고속터미널,12281,16908,20200220,29189
20200217,9,사평,3428,3360,20200220,6788
20200217,9,신논현,35342,35637,20200220,70979
20200218,9,개화,2753,1913,20200221,4666
20200218,9,김포공항,7698,10248,20200221,17946
20200218,9,공항시장,2904,3294,20200221,6198
20200218,9,신방화,7086,7040,20200221,14126
20200218,9,마곡나루,10772,10707,20200221,21479
20200218,9,양천향교,9460,9826,20200221,19286
20200218,9,가양,21913,21382,20200221,43295
20200218,9,증미,7544,7751,20200221,15295
20200218,9,등촌,11229,11364,20200221,22593
20200218,9,염창,18351,17706,20200221,36057
20200218,9,신목동,4192,3755,20200221,7947
20200218,9,선유도,8054,7810,20200221,15864
20200218,9,당산,19716,19557,20200221,39273
20200218,9,국회의사당,18552,18772,20200221,37324
20200218,9,여의도,26636,25950,20200221,52586
20200218,9,샛강,5954,6381,20200221,12335
20200218,9,노량진,28985,29146,20200221,58131
20200218,9,노들,4696,3976,20200221,8672
20200218,9,흑석,8325,8803,20200221,17128
20200218,9,동작,1845,1458,20200221,3303
20200218,9,구반포,3092,3275,20200221,6367
20200218,9,신반포,2812,2884,20200221,5696
20200218,9,고속터미널,12176,16686,20200221,28862
20200218,9,사평,3324,3344,20200221,6668
20200218,9,신논현,36196,36371,20200221,72567
20200219,9,개화,2853,1973,20200222,4826
20200219,9,김포공항,7481,10084,20200222,17565
20200219,9,공항시장,2985,3358,20200222,6343
20200219,9,신방화,7319,7158,20200222,14477
20200219,9,마곡나루,11155,10968,20200222,22123
20200219,9,양천향교,9543,10003,20200222,19546
20200219,9,가양,21958,21218,20200222,43176
20200219,9,증미,7617,7698,20200222,15315
20200219,9,등촌,11326,11341,20200222,22667
20200219,9,염창,18304,17951,20200222,36255
20200219,9,신목동,4323,3935,20200222,8258
20200219,9,선유도,7961,7746,20200222,15707
20200219,9,당산,20056,19731,20200222,39787
20200219,9,국회의사당,19038,18968,20200222,38006
20200219,9,여의도,26922,25923,20200222,52845
20200219,9,샛강,5904,6293,20200222,12197
20200219,9,노량진,29879,29841,20200222,59720
20200219,9,노들,4783,4065,20200222,8848
20200219,9,흑석,8606,9144,20200222,17750
20200219,9,동작,1910,1463,20200222,3373
20200219,9,구반포,3234,3339,20200222,6573
20200219,9,신반포,2847,2930,20200222,5777
20200219,9,고속터미널,12502,16708,20200222,29210
20200219,9,사평,3295,3288,20200222,6583
20200219,9,신논현,36152,36682,20200222,72834
20200220,9,개화,2816,1969,20200223,4785
20200220,9,김포공항,7968,10259,20200223,18227
20200220,9,공항시장,3054,3398,20200223,6452
20200220,9,신방화,7161,7036,20200223,14197
20200220,9,마곡나루,11076,10963,20200223,22039
20200220,9,양천향교,9303,9696,20200223,18999
20200220,9,가양,21661,20863,20200223,42524
20200220,9,증미,7412,7410,20200223,14822
20200220,9,등촌,11074,11064,20200223,22138
20200220,9,염창,18161,17572,20200223,35733
20200220,9,신목동,4227,3779,20200223,8006
20200220,9,선유도,7947,7566,20200223,15513
20200220,9,당산,19796,19685,20200223,39481
20200220,9,국회의사당,18117,18463,20200223,36580
20200220,9,여의도,26456,25864,20200223,52320
20200220,9,샛강,5875,6244,20200223,12119
20200220,9,노량진,29398,29509,20200223,58907
20200220,9,노들,4645,3960,20200223,8605
20200220,9,흑석,8435,8819,20200223,17254
20200220,9,동작,1843,1535,20200223,3378
20200220,9,구반포,2953,3100,20200223,6053
20200220,9,신반포,2780,2919,20200223,5699
20200220,9,고속터미널,12107,16474,20200223,28581
20200220,9,사평,3214,3143,20200223,6357
20200220,9,신논현,35889,36658,20200223,72547
20200221,9,개화,2722,1877,20200224,4599
20200221,9,김포공항,7652,10015,20200224,17667
20200221,9,공항시장,2903,3212,20200224,6115
20200221,9,신방화,6939,6783,20200224,13722
20200221,9,마곡나루,10607,10567,20200224,21174
20200221,9,양천향교,9317,9524,20200224,18841
20200221,9,가양,21197,20225,20200224,41422
20200221,9,증미,7213,7332,20200224,14545
20200221,9,등촌,10837,10776,20200224,21613
20200221,9,염창,17730,17146,20200224,34876
20200221,9,신목동,4039,3646,20200224,7685
20200221,9,선유도,7797,7419,20200224,15216
20200221,9,당산,20058,19407,20200224,39465
20200221,9,국회의사당,18236,18065,20200224,36301
20200221,9,여의도,25961,24790,20200224,50751
20200221,9,샛강,5774,5953,20200224,11727
20200221,9,노량진,30291,29393,20200224,59684
20200221,9,노들,4684,3891,20200224,8575
20200221,9,흑석,8161,8448,20200224,16609
20200221,9,동작,1766,1399,20200224,3165
20200221,9,구반포,2801,2969,20200224,5770
20200221,9,신반포,2796,2793,20200224,5589
20200221,9,고속터미널,12307,17484,20200224,29791
20200221,9,사평,3125,3065,20200224,6190
20200221,9,신논현,35985,37498,20200224,73483
20200222,9,개화,1070,950,20200225,2020
20200222,9,김포공항,5581,7652,20200225,13233
20200222,9,공항시장,1973,2133,20200225,4106
20200222,9,신방화,4024,3781,20200225,7805
20200222,9,마곡나루,6081,6010,20200225,12091
20200222,9,양천향교,4837,4637,20200225,9474
20200222,9,가양,11875,11293,20200225,23168
20200222,9,증미,3425,3456,20200225,6881
20200222,9,등촌,5629,5448,20200225,11077
20200222,9,염창,9711,9212,20200225,18923
20200222,9,신목동,1844,1654,20200225,3498
20200222,9,선유도,2845,2815,20200225,5660
20200222,9,당산,10954,10052,20200225,21006
20200222,9,국회의사당,3961,4042,20200225,8003
20200222,9,여의도,7063,6634,20200225,13697
20200222,9,샛강,2165,2189,20200225,4354
20200222,9,노량진,20515,21119,20200225,41634
20200222,9,노들,2670,2154,20200225,4824
20200222,9,흑석,4844,4963,20200225,9807
20200222,9,동작,1053,866,20200225,1919
20200222,9,구반포,2726,2793,20200225,5519
20200222,9,신반포,1672,1601,20200225,3273
20200222,9,고속터미널,9253,13903,20200225,23156
20200222,9,사평,1453,1436,20200225,2889
20200222,9,신논현,21536,22398,20200225,43934
20200223,9,개화,774,665,20200226,1439
20200223,9,김포공항,4968,6395,20200226,11363
20200223,9,공항시장,1393,1565,20200226,2958
20200223,9,신방화,2768,2746,20200226,5514
20200223,9,마곡나루,4015,4038,20200226,8053
20200223,9,양천향교,3145,3331,20200226,6476
20200223,9,가양,8096,8046,20200226,16142
20200223,9,증미,1772,1832,20200226,3604
20200223,9,등촌,3673,3736,20200226,7409
20200223,9,염창,6457,6392,20200226,12849
20200223,9,신목동,1188,1115,20200226,2303
20200223,9,선유도,2038,1980,20200226,4018
20200223,9,당산,6762,6634,20200226,13396
20200223,9,국회의사당,3540,3276,20200226,6816
20200223,9,여의도,4584,4392,20200226,8976
20200223,9,샛강,1317,1342,20200226,2659
20200223,9,노량진,12770,13966,20200226,26736
20200223,9,노들,1870,1655,20200226,3525
20200223,9,흑석,3630,3541,20200226,7171
20200223,9,동작,800,711,20200226,1511
20200223,9,구반포,907,937,20200226,1844
20200223,9,신반포,1003,1059,20200226,2062
20200223,9,고속터미널,6343,9371,20200226,15714
20200223,9,사평,766,841,20200226,1607
20200223,9,신논현,12237,11728,20200226,23965
20200224,9,개화,2502,1712,20200227,4214
20200224,9,김포공항,6179,7238,20200227,13417
20200224,9,공항시장,2479,2811,20200227,5290
20200224,9,신방화,5908,5929,20200227,11837
20200224,9,마곡나루,9097,9120,20200227,18217
20200224,9,양천향교,7925,8377,20200227,16302
20200224,9,가양,18431,18046,20200227,36477
20200224,9,증미,6526,6779,20200227,13305
20200224,9,등촌,9560,9705,20200227,19265
20200224,9,염창,15446,15268,20200227,30714
20200224,9,신목동,3495,3180,20200227,6675
20200224,9,선유도,6940,6667,20200227,13607
20200224,9,당산,16168,16100,20200227,32268
20200224,9,국회의사당,15710,15831,20200227,31541
20200224,9,여의도,22296,21682,20200227,43978
20200224,9,샛강,4895,5168,20200227,10063
20200224,9,노량진,24063,24055,20200227,48118
20200224,9,노들,3921,3312,20200227,7233
20200224,9,흑석,6513,7021,20200227,13534
20200224,9,동작,1561,1191,20200227,2752
20200224,9,구반포,2247,2459,20200227,4706
20200224,9,신반포,2185,2251,20200227,4436
20200224,9,고속터미널,8690,11426,20200227,20116
20200224,9,사평,2376,2398,20200227,4774
20200224,9,신논현,28542,28637,20200227,57179
20200225,9,개화,2260,1533,20200228,3793
20200225,9,김포공항,5621,6392,20200228,12013
20200225,9,공항시장,2369,2632,20200228,5001
20200225,9,신방화,5559,5416,20200228,10975
20200225,9,마곡나루,8480,8694,20200228,17174
20200225,9,양천향교,7351,7768,20200228,15119
20200225,9,가양,17051,16774,20200228,33825
20200225,9,증미,6089,6273,20200228,12362
20200225,9,등촌,8837,8935,20200228,17772
20200225,9,염창,14229,14058,20200228,28287
20200225,9,신목동,3018,2785,20200228,5803
20200225,9,선유도,6559,6510,20200228,13069
20200225,9,당산,15239,15148,20200228,30387
20200225,9,국회의사당,13531,14009,20200228,27540
20200225,9,여의도,20797,20107,20200228,40904
20200225,9,샛강,4505,4738,20200228,9243
20200225,9,노량진,19939,19243,20200228,39182
20200225,9,노들,3537,3006,20200228,6543
20200225,9,흑석,5779,6144,20200228,11923
20200225,9,동작,1360,998,20200228,2358
20200225,9,구반포,1996,2123,20200228,4119
20200225,9,신반포,1916,1946,20200228,3862
20200225,9,고속터미널,7410,9956,20200228,17366
20200225,9,사평,2189,2134,20200228,4323
20200225,9,신논현,26122,26497,20200228,52619
20200226,9,개화,2239,1537,20200229,3776
20200226,9,김포공항,5156,6345,20200229,11501
20200226,9,공항시장,2398,2673,20200229,5071
20200226,9,신방화,5454,5334,20200229,10788
20200226,9,마곡나루,8467,8430,20200229,16897
20200226,9,양천향교,7330,7647,20200229,14977
20200226,9,가양,17197,16862,20200229,34059
20200226,9,증미,5993,6172,20200229,12165
20200226,9,등촌,8697,8692,20200229,17389
20200226,9,염창,14199,13960,20200229,28159
20200226,9,신목동,3117,2835,20200229,5952
20200226,9,선유도,6367,6127,20200229,12494
20200226,9,당산,14795,14627,20200229,29422
20200226,9,국회의사당,14686,14857,20200229,29543
20200226,9,여의도,20453,19881,20200229,40334
20200226,9,샛강,4418,4782,20200229,9200
20200226,9,노량진,19598,19346,20200229,38944
20200226,9,노들,3607,3101,20200229,6708
20200226,9,흑석,5850,6152,20200229,12002
20200226,9,동작,1447,1180,20200229,2627
20200226,9,구반포,1932,1975,20200229,3907
20200226,9,신반포,1941,1951,20200229,3892
20200226,9,고속터미널,7646,9822,20200229,17468
20200226,9,사평,2112,2166,20200229,4278
20200226,9,신논현,25592,25813,20200229,51405
20200227,9,신논현,24641,24973,20200301,49614
20200227,9,사평,2050,2067,20200301,4117
20200227,9,고속터미널,7231,9504,20200301,16735
20200227,9,신반포,1841,1836,20200301,3677
20200227,9,구반포,1827,1921,20200301,3748
20200227,9,동작,1423,1142,20200301,2565
20200227,9,흑석,5730,6048,20200301,11778
20200227,9,노들,3443,2913,20200301,6356
20200227,9,노량진,19180,18842,20200301,38022
20200227,9,샛강,4391,4675,20200301,9066
20200227,9,여의도,19470,18796,20200301,38266
20200227,9,국회의사당,14061,14175,20200301,28236
20200227,9,당산,14612,14370,20200301,28982
20200227,9,선유도,6148,5941,20200301,12089
20200227,9,신목동,2943,2707,20200301,5650
20200227,9,염창,13790,13564,20200301,27354
20200227,9,등촌,8418,8424,20200301,16842
20200227,9,증미,6007,6029,20200301,12036
20200227,9,가양,16719,16228,20200301,32947
20200227,9,양천향교,7168,7498,20200301,14666
20200227,9,마곡나루,8224,8242,20200301,16466
20200227,9,신방화,5376,5190,20200301,10566
20200227,9,공항시장,2389,2657,20200301,5046
20200227,9,김포공항,4960,6144,20200301,11104
20200227,9,개화,2176,1487,20200301,3663
20200228,9,개화,2068,1453,20200302,3521
20200228,9,김포공항,5098,6454,20200302,11552
20200228,9,공항시장,2270,2523,20200302,4793
20200228,9,신방화,5171,5176,20200302,10347
20200228,9,마곡나루,8166,8108,20200302,16274
20200228,9,양천향교,7002,7346,20200302,14348
20200228,9,가양,16002,15619,20200302,31621
20200228,9,증미,5752,5884,20200302,11636
20200228,9,등촌,8247,8224,20200302,16471
20200228,9,염창,13294,12957,20200302,26251
20200228,9,신목동,2817,2506,20200302,5323
20200228,9,선유도,5684,5488,20200302,11172
20200228,9,당산,14512,14107,20200302,28619
20200228,9,국회의사당,13612,13333,20200302,26945
20200228,9,여의도,17546,17171,20200302,34717
20200228,9,샛강,4249,4446,20200302,8695
20200228,9,노량진,19143,18596,20200302,37739
20200228,9,노들,3319,2841,20200302,6160
20200228,9,흑석,5507,5722,20200302,11229
20200228,9,동작,1257,988,20200302,2245
20200228,9,구반포,1866,1921,20200302,3787
20200228,9,신반포,1808,1788,20200302,3596
20200228,9,고속터미널,6739,9448,20200302,16187
20200228,9,사평,2040,2029,20200302,4069
20200228,9,신논현,24252,24599,20200302,48851
20200229,9,신논현,13310,13839,20200303,27149
20200229,9,사평,889,858,20200303,1747
20200229,9,고속터미널,4978,6941,20200303,11919
20200229,9,신반포,1017,969,20200303,1986
20200229,9,구반포,1109,1194,20200303,2303
20200229,9,동작,846,684,20200303,1530
20200229,9,흑석,3349,3436,20200303,6785
20200229,9,노들,1825,1559,20200303,3384
20200229,9,노량진,12077,12267,20200303,24344
20200229,9,샛강,1469,1520,20200303,2989
20200229,9,여의도,3640,3577,20200303,7217
20200229,9,국회의사당,2411,2298,20200303,4709
20200229,9,당산,6978,6550,20200303,13528
20200229,9,선유도,2048,1984,20200303,4032
20200229,9,신목동,1227,1057,20200303,2284
20200229,9,염창,6816,6450,20200303,13266
20200229,9,등촌,4309,4132,20200303,8441
20200229,9,증미,2646,2533,20200303,5179
20200229,9,가양,8624,8285,20200303,16909
20200229,9,양천향교,3603,3501,20200303,7104
20200229,9,마곡나루,4429,4522,20200303,8951
20200229,9,신방화,3020,2825,20200303,5845
20200229,9,공항시장,1527,1618,20200303,3145
20200229,9,김포공항,3838,5415,20200303,9253
20200229,9,개화,919,782,20200303,1701
20200301,9,개화,576,538,20200304,1114
20200301,9,김포공항,3526,4448,20200304,7974
20200301,9,공항시장,1119,1175,20200304,2294
20200301,9,신방화,1938,1982,20200304,3920
20200301,9,마곡나루,2814,2842,20200304,5656
20200301,9,양천향교,2211,2431,20200304,4642
20200301,9,가양,5835,5576,20200304,11411
20200301,9,증미,1748,1760,20200304,3508
20200301,9,등촌,2661,2715,20200304,5376
20200301,9,염창,4431,4424,20200304,8855
20200301,9,신목동,806,710,20200304,1516
20200301,9,선유도,1422,1351,20200304,2773
20200301,9,당산,4455,4307,20200304,8762
20200301,9,국회의사당,1805,1690,20200304,3495
20200301,9,여의도,2534,2421,20200304,4955
20200301,9,샛강,905,936,20200304,1841
20200301,9,노량진,8023,8833,20200304,16856
20200301,9,노들,1217,1106,20200304,2323
20200301,9,흑석,2083,2172,20200304,4255
20200301,9,동작,651,538,20200304,1189
20200301,9,구반포,575,647,20200304,1222
20200301,9,신반포,590,611,20200304,1201
20200301,9,고속터미널,3711,5039,20200304,8750
20200301,9,사평,514,555,20200304,1069
20200301,9,신논현,7580,7491,20200304,15071
20200302,9,개화,2220,1537,20200305,3757
20200302,9,김포공항,4786,5769,20200305,10555
20200302,9,공항시장,2342,2609,20200305,4951
20200302,9,신방화,5260,5110,20200305,10370
20200302,9,마곡나루,7920,8036,20200305,15956
20200302,9,양천향교,6898,7295,20200305,14193
20200302,9,가양,16230,16014,20200305,32244
20200302,9,증미,5927,5947,20200305,11874
20200302,9,등촌,8304,8352,20200305,16656
20200302,9,염창,13203,13052,20200305,26255
20200302,9,신목동,2855,2653,20200305,5508
20200302,9,선유도,5604,5521,20200305,11125
20200302,9,당산,13544,13466,20200305,27010
20200302,9,국회의사당,13138,13218,20200305,26356
20200302,9,여의도,17388,17122,20200305,34510
20200302,9,샛강,4020,4292,20200305,8312
20200302,9,노량진,20228,20170,20200305,40398
20200302,9,노들,3254,2867,20200305,6121
20200302,9,흑석,5553,6039,20200305,11592
20200302,9,동작,1400,1130,20200305,2530
20200302,9,구반포,1948,1987,20200305,3935
20200302,9,신반포,1758,1845,20200305,3603
20200302,9,고속터미널,6461,8233,20200305,14694
20200302,9,사평,1999,2024,20200305,4023
20200302,9,신논현,22498,22595,20200305,45093
20200303,9,개화,2118,1473,20200306,3591
20200303,9,김포공항,4701,5770,20200306,10471
20200303,9,공항시장,2334,2609,20200306,4943
20200303,9,신방화,5076,5037,20200306,10113
20200303,9,마곡나루,8225,8257,20200306,16482
20200303,9,양천향교,6999,7377,20200306,14376
20200303,9,가양,16161,15725,20200306,31886
20200303,9,증미,5780,5807,20200306,11587
20200303,9,등촌,8260,8213,20200306,16473
20200303,9,염창,13264,13061,20200306,26325
20200303,9,신목동,2858,2633,20200306,5491
20200303,9,선유도,5600,5419,20200306,11019
20200303,9,당산,13611,13503,20200306,27114
20200303,9,국회의사당,12748,12764,20200306,25512
20200303,9,여의도,17565,16993,20200306,34558
20200303,9,샛강,4030,4181,20200306,8211
20200303,9,노량진,19896,20045,20200306,39941
20200303,9,노들,3282,2829,20200306,6111
20200303,9,흑석,5598,5985,20200306,11583
20200303,9,동작,1322,1076,20200306,2398
20200303,9,구반포,1813,1903,20200306,3716
20200303,9,신반포,1779,1800,20200306,3579
20200303,9,고속터미널,6466,7941,20200306,14407
20200303,9,사평,1962,1979,20200306,3941
20200303,9,신논현,22727,22730,20200306,45457
20200304,9,개화,2079,1415,20200307,3494
20200304,9,김포공항,4779,5799,20200307,10578
20200304,9,공항시장,2258,2465,20200307,4723
20200304,9,신방화,5226,5144,20200307,10370
20200304,9,마곡나루,8136,8184,20200307,16320
20200304,9,양천향교,7166,7458,20200307,14624
20200304,9,가양,15868,15558,20200307,31426
20200304,9,증미,5768,5813,20200307,11581
20200304,9,등촌,8125,8300,20200307,16425
20200304,9,염창,13293,13150,20200307,26443
20200304,9,신목동,2830,2622,20200307,5452
20200304,9,선유도,5618,5381,20200307,10999
20200304,9,당산,13929,13774,20200307,27703
20200304,9,국회의사당,13490,13423,20200307,26913
20200304,9,여의도,17866,17117,20200307,34983
20200304,9,샛강,4077,4297,20200307,8374
20200304,9,노량진,20471,20243,20200307,40714
20200304,9,노들,3222,2828,20200307,6050
20200304,9,흑석,5574,5934,20200307,11508
20200304,9,동작,1338,1018,20200307,2356
20200304,9,구반포,1897,1966,20200307,3863
20200304,9,신반포,1800,1808,20200307,3608
20200304,9,고속터미널,6401,7910,20200307,14311
20200304,9,사평,1982,2002,20200307,3984
20200304,9,신논현,22993,23087,20200307,46080
20200305,9,개화,2084,1430,20200308,3514
20200305,9,김포공항,4953,6029,20200308,10982
20200305,9,공항시장,2241,2578,20200308,4819
20200305,9,신방화,5174,5152,20200308,10326
20200305,9,마곡나루,8251,8064,20200308,16315
20200305,9,양천향교,7067,7451,20200308,14518
20200305,9,가양,15964,15620,20200308,31584
20200305,9,증미,5721,5780,20200308,11501
20200305,9,등촌,8123,8120,20200308,16243
20200305,9,염창,13252,13178,20200308,26430
20200305,9,신목동,2906,2655,20200308,5561
20200305,9,선유도,5635,5339,20200308,10974
20200305,9,당산,14248,14066,20200308,28314
20200305,9,국회의사당,13244,13267,20200308,26511
20200305,9,여의도,18065,17743,20200308,35808
20200305,9,샛강,4026,4245,20200308,8271
20200305,9,노량진,20445,20130,20200308,40575
20200305,9,노들,3287,2921,20200308,6208
20200305,9,흑석,5581,5871,20200308,11452
20200305,9,동작,1388,1043,20200308,2431
20200305,9,구반포,1882,1969,20200308,3851
20200305,9,신반포,1755,1828,20200308,3583
20200305,9,고속터미널,6449,8223,20200308,14672
20200305,9,사평,2033,2057,20200308,4090
20200305,9,신논현,23509,23449,20200308,46958
20200306,9,개화,2211,1494,20200309,3705
20200306,9,김포공항,5400,6526,20200309,11926
20200306,9,공항시장,2399,2685,20200309,5084
20200306,9,신방화,5478,5250,20200309,10728
20200306,9,마곡나루,8307,8475,20200309,16782
20200306,9,양천향교,7215,7374,20200309,14589
20200306,9,가양,16729,16170,20200309,32899
20200306,9,증미,5942,5923,20200309,11865
20200306,9,등촌,8319,8256,20200309,16575
20200306,9,염창,13686,13238,20200309,26924
20200306,9,신목동,2996,2650,20200309,5646
20200306,9,선유도,5790,5578,20200309,11368
20200306,9,당산,14848,14399,20200309,29247
20200306,9,국회의사당,13067,13255,20200309,26322
20200306,9,여의도,18665,17684,20200309,36349
20200306,9,샛강,4121,4376,20200309,8497
20200306,9,노량진,21645,21763,20200309,43408
20200306,9,노들,3464,2791,20200309,6255
20200306,9,흑석,5817,5984,20200309,11801
20200306,9,동작,1447,1101,20200309,2548
20200306,9,구반포,1931,2064,20200309,3995
20200306,9,신반포,1968,1881,20200309,3849
20200306,9,고속터미널,7333,9958,20200309,17291
20200306,9,사평,2064,2019,20200309,4083
20200306,9,신논현,25109,26130,20200309,51239
20200307,9,개화,961,744,20200310,1705
20200307,9,김포공항,4222,5735,20200310,9957
20200307,9,공항시장,1652,1739,20200310,3391
20200307,9,신방화,3106,3009,20200310,6115
20200307,9,마곡나루,4685,4651,20200310,9336
20200307,9,양천향교,3780,3654,20200310,7434
20200307,9,가양,9323,8845,20200310,18168
20200307,9,증미,2820,2768,20200310,5588
20200307,9,등촌,4490,4318,20200310,8808
20200307,9,염창,7312,6822,20200310,14134
20200307,9,신목동,1327,1141,20200310,2468
20200307,9,선유도,2253,2183,20200310,4436
20200307,9,당산,7960,7355,20200310,15315
20200307,9,국회의사당,2385,2400,20200310,4785
20200307,9,여의도,4528,4573,20200310,9101
20200307,9,샛강,1627,1585,20200310,3212
20200307,9,노량진,14306,14621,20200310,28927
20200307,9,노들,2006,1786,20200310,3792
20200307,9,흑석,3451,3565,20200310,7016
20200307,9,동작,907,705,20200310,1612
20200307,9,구반포,1159,1172,20200310,2331
20200307,9,신반포,1020,979,20200310,1999
20200307,9,고속터미널,5822,7959,20200310,13781
20200307,9,사평,1020,937,20200310,1957
20200307,9,신논현,15247,15809,20200310,31056
20200308,9,개화,739,627,20200311,1366
20200308,9,김포공항,3857,4732,20200311,8589
20200308,9,공항시장,1175,1252,20200311,2427
20200308,9,신방화,2147,2090,20200311,4237
20200308,9,마곡나루,3220,3317,20200311,6537
20200308,9,양천향교,2522,2610,20200311,5132
20200308,9,가양,6477,6228,20200311,12705
20200308,9,증미,1508,1521,20200311,3029
20200308,9,등촌,2975,3000,20200311,5975
20200308,9,염창,5084,4941,20200311,10025
20200308,9,신목동,865,812,20200311,1677
20200308,9,선유도,1611,1570,20200311,3181
20200308,9,당산,5267,5084,20200311,10351
20200308,9,국회의사당,1992,1798,20200311,3790
20200308,9,여의도,3514,3371,20200311,6885
20200308,9,샛강,1032,1031,20200311,2063
20200308,9,노량진,10015,11052,20200311,21067
20200308,9,노들,1455,1250,20200311,2705
20200308,9,흑석,2390,2526,20200311,4916
20200308,9,동작,800,639,20200311,1439
20200308,9,구반포,655,684,20200311,1339
20200308,9,신반포,722,793,20200311,1515
20200308,9,고속터미널,4892,6582,20200311,11474
20200308,9,사평,604,583,20200311,1187
20200308,9,신논현,9075,9063,20200311,18138
20200309,9,개화,2242,1486,20200312,3728
20200309,9,김포공항,4941,5898,20200312,10839
20200309,9,공항시장,2327,2697,20200312,5024
20200309,9,신방화,5418,5343,20200312,10761
20200309,9,마곡나루,8365,8550,20200312,16915
20200309,9,양천향교,7194,7503,20200312,14697
20200309,9,가양,16775,16289,20200312,33064
20200309,9,증미,5904,5965,20200312,11869
20200309,9,등촌,8510,8606,20200312,17116
20200309,9,염창,13758,13764,20200312,27522
20200309,9,신목동,2996,2700,20200312,5696
20200309,9,선유도,5968,5802,20200312,11770
20200309,9,당산,14593,14464,20200312,29057
20200309,9,국회의사당,13412,13645,20200312,27057
20200309,9,여의도,18981,18667,20200312,37648
20200309,9,샛강,4386,4691,20200312,9077
20200309,9,노량진,20426,20291,20200312,40717
20200309,9,노들,3453,2972,20200312,6425
20200309,9,흑석,5854,6291,20200312,12145
20200309,9,동작,1475,1160,20200312,2635
20200309,9,구반포,2002,2126,20200312,4128
20200309,9,신반포,1983,2019,20200312,4002
20200309,9,고속터미널,7645,9538,20200312,17183
20200309,9,사평,2125,2061,20200312,4186
20200309,9,신논현,25284,25501,20200312,50785
20200310,9,개화,2059,1433,20200313,3492
20200310,9,김포공항,4569,5788,20200313,10357
20200310,9,공항시장,2305,2569,20200313,4874
20200310,9,신방화,5330,5197,20200313,10527
20200310,9,마곡나루,8139,8169,20200313,16308
20200310,9,양천향교,7096,7410,20200313,14506
20200310,9,가양,16132,15729,20200313,31861
20200310,9,증미,5700,5839,20200313,11539
20200310,9,등촌,8178,8304,20200313,16482
20200310,9,염창,13297,13244,20200313,26541
20200310,9,신목동,2831,2587,20200313,5418
20200310,9,선유도,5869,5609,20200313,11478
20200310,9,당산,14269,14142,20200313,28411
20200310,9,국회의사당,13598,13620,20200313,27218
20200310,9,여의도,18908,18295,20200313,37203
20200310,9,샛강,4247,4433,20200313,8680
20200310,9,노량진,18512,18012,20200313,36524
20200310,9,노들,3285,2895,20200313,6180
20200310,9,흑석,5484,5947,20200313,11431
20200310,9,동작,1328,1025,20200313,2353
20200310,9,구반포,1877,1963,20200313,3840
20200310,9,신반포,1871,1920,20200313,3791
20200310,9,고속터미널,6902,8677,20200313,15579
20200310,9,사평,2085,2075,20200313,4160
20200310,9,신논현,24588,24829,20200313,49417
20200311,9,개화,2062,1455,20200314,3517
20200311,9,김포공항,4705,6112,20200314,10817
20200311,9,공항시장,2361,2636,20200314,4997
20200311,9,신방화,5288,5137,20200314,10425
20200311,9,마곡나루,8402,8387,20200314,16789
20200311,9,양천향교,7200,7591,20200314,14791
20200311,9,가양,16545,16226,20200314,32771
20200311,9,증미,5760,5828,20200314,11588
20200311,9,등촌,8289,8314,20200314,16603
20200311,9,염창,13677,13540,20200314,27217
20200311,9,신목동,2950,2652,20200314,5602
20200311,9,선유도,5843,5711,20200314,11554
20200311,9,당산,14794,14251,20200314,29045
20200311,9,국회의사당,13063,13186,20200314,26249
20200311,9,여의도,19122,18658,20200314,37780
20200311,9,샛강,4266,4474,20200314,8740
20200311,9,노량진,19116,18683,20200314,37799
20200311,9,노들,3326,2897,20200314,6223
20200311,9,흑석,5732,6042,20200314,11774
20200311,9,동작,1508,1156,20200314,2664
20200311,9,구반포,1866,1954,20200314,3820
20200311,9,신반포,1924,1945,20200314,3869
20200311,9,고속터미널,7326,9157,20200314,16483
20200311,9,사평,2084,2061,20200314,4145
20200311,9,신논현,25331,25550,20200314,50881
20200312,9,개화,2005,1428,20200315,3433
20200312,9,김포공항,4729,5904,20200315,10633
20200312,9,공항시장,2310,2576,20200315,4886
20200312,9,신방화,5232,5087,20200315,10319
20200312,9,마곡나루,8266,8178,20200315,16444
20200312,9,양천향교,7104,7317,20200315,14421
20200312,9,가양,16107,15675,20200315,31782
20200312,9,증미,5720,5739,20200315,11459
20200312,9,등촌,8287,8201,20200315,16488
20200312,9,염창,13525,13426,20200315,26951
20200312,9,신목동,2878,2632,20200315,5510
20200312,9,선유도,5773,5517,20200315,11290
20200312,9,당산,14307,14167,20200315,28474
20200312,9,국회의사당,12880,12827,20200315,25707
20200312,9,여의도,18759,18475,20200315,37234
20200312,9,샛강,4078,4450,20200315,8528
20200312,9,노량진,18600,18285,20200315,36885
20200312,9,노들,3384,2827,20200315,6211
20200312,9,흑석,5716,6186,20200315,11902
20200312,9,동작,1467,1119,20200315,2586
20200312,9,구반포,1863,1932,20200315,3795
20200312,9,신반포,1877,1941,20200315,3818
20200312,9,고속터미널,7174,9179,20200315,16353
20200312,9,사평,2004,2011,20200315,4015
20200312,9,신논현,25055,25619,20200315,50674
20200313,9,개화,2060,1444,20200316,3504
20200313,9,김포공항,5079,6183,20200316,11262
20200313,9,공항시장,2431,2662,20200316,5093
20200313,9,신방화,5333,5057,20200316,10390
20200313,9,마곡나루,8322,8472,20200316,16794
20200313,9,양천향교,7152,7275,20200316,14427
20200313,9,가양,16653,15867,20200316,32520
20200313,9,증미,5801,5859,20200316,11660
20200313,9,등촌,8430,8406,20200316,16836
20200313,9,염창,13930,13433,20200316,27363
20200313,9,신목동,2930,2591,20200316,5521
20200313,9,선유도,5681,5637,20200316,11318
20200313,9,당산,15003,14594,20200316,29597
20200313,9,국회의사당,13037,12912,20200316,25949
20200313,9,여의도,19063,17965,20200316,37028
20200313,9,샛강,4366,4457,20200316,8823
20200313,9,노량진,19783,19465,20200316,39248
20200313,9,노들,3401,2833,20200316,6234
20200313,9,흑석,5851,6347,20200316,12198
20200313,9,동작,1416,1144,20200316,2560
20200313,9,구반포,1944,2050,20200316,3994
20200313,9,신반포,1866,1933,20200316,3799
20200313,9,고속터미널,8007,10912,20200316,18919
20200313,9,사평,2052,2020,20200316,4072
20200313,9,신논현,26480,27749,20200316,54229
20200314,9,개화,930,823,20200317,1753
20200314,9,김포공항,4303,5695,20200317,9998
20200314,9,공항시장,1711,1811,20200317,3522
20200314,9,신방화,3316,3085,20200317,6401
20200314,9,마곡나루,4722,4799,20200317,9521
20200314,9,양천향교,3776,3717,20200317,7493
20200314,9,가양,9213,8784,20200317,17997
20200314,9,증미,2793,2732,20200317,5525
20200314,9,등촌,4579,4534,20200317,9113
20200314,9,염창,7653,7174,20200317,14827
20200314,9,신목동,1314,1173,20200317,2487
20200314,9,선유도,2359,2286,20200317,4645
20200314,9,당산,8019,7413,20200317,15432
20200314,9,국회의사당,2400,2379,20200317,4779
20200314,9,여의도,5224,5065,20200317,10289
20200314,9,샛강,1724,1662,20200317,3386
20200314,9,노량진,12880,13322,20200317,26202
20200314,9,노들,2069,1750,20200317,3819
20200314,9,흑석,3573,3687,20200317,7260
20200314,9,동작,1021,840,20200317,1861
20200314,9,구반포,1199,1196,20200317,2395
20200314,9,신반포,1133,1123,20200317,2256
20200314,9,고속터미널,6151,8712,20200317,14863
20200314,9,사평,1002,940,20200317,1942
20200314,9,신논현,16357,17218,20200317,33575
20200315,9,개화,656,582,20200318,1238
20200315,9,김포공항,3586,4408,20200318,7994
20200315,9,공항시장,1148,1257,20200318,2405
20200315,9,신방화,2158,2134,20200318,4292
20200315,9,마곡나루,3046,3011,20200318,6057
20200315,9,양천향교,2559,2688,20200318,5247
20200315,9,가양,6364,6275,20200318,12639
20200315,9,증미,1845,1939,20200318,3784
20200315,9,등촌,2966,3014,20200318,5980
20200315,9,염창,5174,5104,20200318,10278
20200315,9,신목동,927,867,20200318,1794
20200315,9,선유도,1540,1461,20200318,3001
20200315,9,당산,5296,5054,20200318,10350
20200315,9,국회의사당,1815,1708,20200318,3523
20200315,9,여의도,3252,3078,20200318,6330
20200315,9,샛강,990,993,20200318,1983
20200315,9,노량진,8844,9919,20200318,18763
20200315,9,노들,1312,1227,20200318,2539
20200315,9,흑석,2414,2598,20200318,5012
20200315,9,동작,790,689,20200318,1479
20200315,9,구반포,733,775,20200318,1508
20200315,9,신반포,656,637,20200318,1293
20200315,9,고속터미널,4707,6456,20200318,11163
20200315,9,사평,596,605,20200318,1201
20200315,9,신논현,9434,9018,20200318,18452
20200316,9,개화,2119,1443,20200319,3562
20200316,9,김포공항,4766,5617,20200319,10383
20200316,9,공항시장,2352,2687,20200319,5039
20200316,9,신방화,5394,5308,20200319,10702
20200316,9,마곡나루,8246,8275,20200319,16521
20200316,9,양천향교,7285,7624,20200319,14909
20200316,9,가양,16562,16174,20200319,32736
20200316,9,증미,5924,5969,20200319,11893
20200316,9,등촌,8324,8395,20200319,16719
20200316,9,염창,13689,13806,20200319,27495
20200316,9,신목동,2971,2721,20200319,5692
20200316,9,선유도,5857,5677,20200319,11534
20200316,9,당산,14251,14197,20200319,28448
20200316,9,국회의사당,13227,13185,20200319,26412
20200316,9,여의도,18850,18599,20200319,37449
20200316,9,샛강,4372,4579,20200319,8951
20200316,9,노량진,20946,20822,20200319,41768
20200316,9,노들,3384,2926,20200319,6310
20200316,9,흑석,5796,6240,20200319,12036
20200316,9,동작,1470,1179,20200319,2649
20200316,9,구반포,2124,2172,20200319,4296
20200316,9,신반포,1869,1965,20200319,3834
20200316,9,고속터미널,7526,9366,20200319,16892
20200316,9,사평,2044,2029,20200319,4073
20200316,9,신논현,24777,24855,20200319,49632
20200317,9,개화,2059,1421,20200320,3480
20200317,9,김포공항,4611,5645,20200320,10256
20200317,9,공항시장,2360,2707,20200320,5067
20200317,9,신방화,5378,5303,20200320,10681
20200317,9,마곡나루,8360,8266,20200320,16626
20200317,9,양천향교,7409,7777,20200320,15186
20200317,9,가양,16499,16064,20200320,32563
20200317,9,증미,5705,5664,20200320,11369
20200317,9,등촌,8359,8342,20200320,16701
20200317,9,염창,13655,13591,20200320,27246
20200317,9,신목동,2988,2702,20200320,5690
20200317,9,선유도,5823,5692,20200320,11515
20200317,9,당산,14438,14166,20200320,28604
20200317,9,국회의사당,12850,13032,20200320,25882
20200317,9,여의도,19085,18727,20200320,37812
20200317,9,샛강,4167,4486,20200320,8653
20200317,9,노량진,20885,20782,20200320,41667
20200317,9,노들,3325,2899,20200320,6224
20200317,9,흑석,5689,6093,20200320,11782
20200317,9,동작,1492,1141,20200320,2633
20200317,9,구반포,1947,2074,20200320,4021
20200317,9,신반포,1845,1920,20200320,3765
20200317,9,고속터미널,7310,9140,20200320,16450
20200317,9,사평,2016,2026,20200320,4042
20200317,9,신논현,25037,25472,20200320,50509
20200318,9,개화,2169,1495,20200321,3664
20200318,9,김포공항,4704,5508,20200321,10212
20200318,9,공항시장,2333,2638,20200321,4971
20200318,9,신방화,5433,5312,20200321,10745
20200318,9,마곡나루,8586,8605,20200321,17191
20200318,9,양천향교,7431,7838,20200321,15269
20200318,9,가양,16779,16316,20200321,33095
20200318,9,증미,5854,5925,20200321,11779
20200318,9,등촌,8374,8449,20200321,16823
20200318,9,염창,13907,13854,20200321,27761
20200318,9,신목동,3002,2751,20200321,5753
20200318,9,선유도,6030,5874,20200321,11904
20200318,9,당산,14672,14504,20200321,29176
20200318,9,국회의사당,13149,13285,20200321,26434
20200318,9,여의도,19438,19152,20200321,38590
20200318,9,샛강,4387,4669,20200321,9056
20200318,9,노량진,21509,21655,20200321,43164
20200318,9,노들,3482,2971,20200321,6453
20200318,9,흑석,5927,6243,20200321,12170
20200318,9,동작,1561,1277,20200321,2838
20200318,9,구반포,2046,2155,20200321,4201
20200318,9,신반포,2022,2091,20200321,4113
20200318,9,고속터미널,7802,9779,20200321,17581
20200318,9,사평,2066,2085,20200321,4151
20200318,9,신논현,25663,25900,20200321,51563
20200319,9,개화,2026,1405,20200322,3431
20200319,9,김포공항,4657,5524,20200322,10181
20200319,9,공항시장,2304,2632,20200322,4936
20200319,9,신방화,5268,5137,20200322,10405
20200319,9,마곡나루,8272,8152,20200322,16424
20200319,9,양천향교,7135,7523,20200322,14658
20200319,9,가양,16102,15602,20200322,31704
20200319,9,증미,5665,5725,20200322,11390
20200319,9,등촌,8084,8234,20200322,16318
20200319,9,염창,13670,13528,20200322,27198
20200319,9,신목동,2879,2625,20200322,5504
20200319,9,선유도,5923,5749,20200322,11672
20200319,9,당산,14308,14094,20200322,28402
20200319,9,국회의사당,13124,13204,20200322,26328
20200319,9,여의도,19213,18508,20200322,37721
20200319,9,샛강,4189,4451,20200322,8640
20200319,9,노량진,20740,20264,20200322,41004
20200319,9,노들,3330,2841,20200322,6171
20200319,9,흑석,5526,5830,20200322,11356
20200319,9,동작,1322,1060,20200322,2382
20200319,9,구반포,1951,2039,20200322,3990
20200319,9,신반포,1788,1843,20200322,3631
20200319,9,고속터미널,7239,8960,20200322,16199
20200319,9,사평,1953,1980,20200322,3933
20200319,9,신논현,24790,25084,20200322,49874
20200320,9,개화,2157,1477,20200323,3634
20200320,9,김포공항,5059,6221,20200323,11280
20200320,9,공항시장,2462,2736,20200323,5198
20200320,9,신방화,5639,5445,20200323,11084
20200320,9,마곡나루,8719,8712,20200323,17431
20200320,9,양천향교,7584,7702,20200323,15286
20200320,9,가양,17367,16523,20200323,33890
20200320,9,증미,5982,6096,20200323,12078
20200320,9,등촌,8818,8798,20200323,17616
20200320,9,염창,14678,14096,20200323,28774
20200320,9,신목동,3113,2838,20200323,5951
20200320,9,선유도,6027,5771,20200323,11798
20200320,9,당산,15592,15225,20200323,30817
20200320,9,국회의사당,13076,12864,20200323,25940
20200320,9,여의도,20166,19007,20200323,39173
20200320,9,샛강,4523,4651,20200323,9174
20200320,9,노량진,22944,23030,20200323,45974
20200320,9,노들,3574,2946,20200323,6520
20200320,9,흑석,6328,6496,20200323,12824
20200320,9,동작,1587,1259,20200323,2846
20200320,9,구반포,2157,2265,20200323,4422
20200320,9,신반포,2020,2050,20200323,4070
20200320,9,고속터미널,8808,11971,20200323,20779
20200320,9,사평,2258,2126,20200323,4384
20200320,9,신논현,27681,29008,20200323,56689
20200321,9,개화,1042,852,20200324,1894
20200321,9,김포공항,4074,5534,20200324,9608
20200321,9,공항시장,1588,1780,20200324,3368
20200321,9,신방화,3390,3178,20200324,6568
20200321,9,마곡나루,4554,4644,20200324,9198
20200321,9,양천향교,4087,3876,20200324,7963
20200321,9,가양,9714,9150,20200324,18864
20200321,9,증미,2998,2880,20200324,5878
20200321,9,등촌,4821,4581,20200324,9402
20200321,9,염창,7963,7451,20200324,15414
20200321,9,신목동,1431,1293,20200324,2724
20200321,9,선유도,2540,2542,20200324,5082
20200321,9,당산,8807,7988,20200324,16795
20200321,9,국회의사당,2689,2626,20200324,5315
20200321,9,여의도,5621,5472,20200324,11093
20200321,9,샛강,1840,1771,20200324,3611
20200321,9,노량진,16302,16737,20200324,33039
20200321,9,노들,2171,1822,20200324,3993
20200321,9,흑석,3872,3993,20200324,7865
20200321,9,동작,1152,859,20200324,2011
20200321,9,구반포,1209,1320,20200324,2529
20200321,9,신반포,1284,1289,20200324,2573
20200321,9,고속터미널,6892,9754,20200324,16646
20200321,9,사평,1080,1010,20200324,2090
20200321,9,신논현,17492,18228,20200324,35720
20200322,9,개화,811,655,20200325,1466
20200322,9,김포공항,3574,4640,20200325,8214
20200322,9,공항시장,1251,1314,20200325,2565
20200322,9,신방화,2322,2185,20200325,4507
20200322,9,마곡나루,3447,3568,20200325,7015
20200322,9,양천향교,2663,2823,20200325,5486
20200322,9,가양,6923,6878,20200325,13801
20200322,9,증미,1620,1655,20200325,3275
20200322,9,등촌,3133,3150,20200325,6283
20200322,9,염창,5597,5481,20200325,11078
20200322,9,신목동,1091,944,20200325,2035
20200322,9,선유도,1853,1856,20200325,3709
20200322,9,당산,5952,5614,20200325,11566
20200322,9,국회의사당,2179,1893,20200325,4072
20200322,9,여의도,4350,3897,20200325,8247
20200322,9,샛강,1126,1039,20200325,2165
20200322,9,노량진,10289,11435,20200325,21724
20200322,9,노들,1579,1448,20200325,3027
20200322,9,흑석,2627,2846,20200325,5473
20200322,9,동작,964,832,20200325,1796
20200322,9,구반포,800,866,20200325,1666
20200322,9,신반포,899,1016,20200325,1915
20200322,9,고속터미널,5926,7834,20200325,13760
20200322,9,사평,636,651,20200325,1287
20200322,9,신논현,10337,10158,20200325,20495
20200323,9,개화,2198,1575,20200326,3773
20200323,9,김포공항,4777,5748,20200326,10525
20200323,9,공항시장,2300,2655,20200326,4955
20200323,9,신방화,5401,5318,20200326,10719
20200323,9,마곡나루,8324,8343,20200326,16667
20200323,9,양천향교,7427,7758,20200326,15185
20200323,9,가양,16917,16372,20200326,33289
20200323,9,증미,5906,5934,20200326,11840
20200323,9,등촌,8509,8568,20200326,17077
20200323,9,염창,14110,14021,20200326,28131
20200323,9,신목동,3152,2816,20200326,5968
20200323,9,선유도,6051,5910,20200326,11961
20200323,9,당산,14469,14508,20200326,28977
20200323,9,국회의사당,13040,13239,20200326,26279
20200323,9,여의도,19599,19314,20200326,38913
20200323,9,샛강,4424,4628,20200326,9052
20200323,9,노량진,22159,22489,20200326,44648
20200323,9,노들,3456,2986,20200326,6442
20200323,9,흑석,5844,6252,20200326,12096
20200323,9,동작,1598,1269,20200326,2867
20200323,9,구반포,1982,2105,20200326,4087
20200323,9,신반포,2025,2107,20200326,4132
20200323,9,고속터미널,7987,9846,20200326,17833
20200323,9,사평,2032,2051,20200326,4083
20200323,9,신논현,25106,25331,20200326,50437
20200324,9,개화,2141,1499,20200327,3640
20200324,9,김포공항,4767,5581,20200327,10348
20200324,9,공항시장,2361,2656,20200327,5017
20200324,9,신방화,5391,5264,20200327,10655
20200324,9,마곡나루,8502,8479,20200327,16981
20200324,9,양천향교,7250,7557,20200327,14807
20200324,9,가양,16655,16264,20200327,32919
20200324,9,증미,5729,5783,20200327,11512
20200324,9,등촌,8501,8519,20200327,17020
20200324,9,염창,14096,13902,20200327,27998
20200324,9,신목동,3123,2892,20200327,6015
20200324,9,선유도,6153,5979,20200327,12132
20200324,9,당산,14603,14354,20200327,28957
20200324,9,국회의사당,12953,13135,20200327,26088
20200324,9,여의도,19956,19541,20200327,39497
20200324,9,샛강,4371,4558,20200327,8929
20200324,9,노량진,22097,22346,20200327,44443
20200324,9,노들,3436,2963,20200327,6399
20200324,9,흑석,5920,6328,20200327,12248
20200324,9,동작,1637,1310,20200327,2947
20200324,9,구반포,2000,2127,20200327,4127
20200324,9,신반포,2059,2137,20200327,4196
20200324,9,고속터미널,7806,9633,20200327,17439
20200324,9,사평,2136,2053,20200327,4189
20200324,9,신논현,25637,25772,20200327,51409
20200325,9,개화,2118,1482,20200328,3600
20200325,9,김포공항,4779,5460,20200328,10239
20200325,9,공항시장,2412,2617,20200328,5029
20200325,9,신방화,5448,5363,20200328,10811
20200325,9,마곡나루,8572,8670,20200328,17242
20200325,9,양천향교,7283,7557,20200328,14840
20200325,9,가양,16830,16444,20200328,33274
20200325,9,증미,5640,5712,20200328,11352
20200325,9,등촌,8549,8616,20200328,17165
20200325,9,염창,14190,13999,20200328,28189
20200325,9,신목동,3157,2845,20200328,6002
20200325,9,선유도,6195,5988,20200328,12183
20200325,9,당산,14957,14679,20200328,29636
20200325,9,국회의사당,12963,13159,20200328,26122
20200325,9,여의도,20026,19610,20200328,39636
20200325,9,샛강,4540,4626,20200328,9166
20200325,9,노량진,22724,22680,20200328,45404
20200325,9,노들,3542,3049,20200328,6591
20200325,9,흑석,6047,6400,20200328,12447
20200325,9,동작,1668,1301,20200328,2969
20200325,9,구반포,2012,2183,20200328,4195
20200325,9,신반포,2063,2152,20200328,4215
20200325,9,고속터미널,8194,10359,20200328,18553
20200325,9,사평,2143,2156,20200328,4299
20200325,9,신논현,25980,26268,20200328,52248
20200326,9,개화,2086,1431,20200329,3517
20200326,9,김포공항,4435,5493,20200329,9928
20200326,9,공항시장,2325,2706,20200329,5031
20200326,9,신방화,5276,5157,20200329,10433
20200326,9,마곡나루,8475,8397,20200329,16872
20200326,9,양천향교,7247,7609,20200329,14856
20200326,9,가양,16767,16253,20200329,33020
20200326,9,증미,5786,5724,20200329,11510
20200326,9,등촌,8487,8401,20200329,16888
20200326,9,염창,14144,13779,20200329,27923
20200326,9,신목동,3045,2793,20200329,5838
20200326,9,선유도,6148,5867,20200329,12015
20200326,9,당산,14654,14394,20200329,29048
20200326,9,국회의사당,13076,13248,20200329,26324
20200326,9,여의도,19572,19187,20200329,38759
20200326,9,샛강,4309,4467,20200329,8776
20200326,9,노량진,22288,22207,20200329,44495
20200326,9,노들,3520,3017,20200329,6537
20200326,9,흑석,5841,6113,20200329,11954
20200326,9,동작,1566,1285,20200329,2851
20200326,9,구반포,1996,2105,20200329,4101
20200326,9,신반포,1853,1887,20200329,3740
20200326,9,고속터미널,7652,9607,20200329,17259
20200326,9,사평,2150,2117,20200329,4267
20200326,9,신논현,25237,25689,20200329,50926
20200327,9,개화,2166,1526,20200330,3692
20200327,9,김포공항,4974,6091,20200330,11065
20200327,9,공항시장,2423,2699,20200330,5122
20200327,9,신방화,5676,5476,20200330,11152
20200327,9,마곡나루,8736,8796,20200330,17532
20200327,9,양천향교,7668,7641,20200330,15309
20200327,9,가양,17164,16508,20200330,33672
20200327,9,증미,5906,5866,20200330,11772
20200327,9,등촌,8748,8564,20200330,17312
20200327,9,염창,14544,14096,20200330,28640
20200327,9,신목동,3169,2840,20200330,6009
20200327,9,선유도,6105,5969,20200330,12074
20200327,9,당산,15587,15187,20200330,30774
20200327,9,국회의사당,13245,13303,20200330,26548
20200327,9,여의도,20525,19452,20200330,39977
20200327,9,샛강,4562,4737,20200330,9299
20200327,9,노량진,23647,23743,20200330,47390
20200327,9,노들,3687,3075,20200330,6762
20200327,9,흑석,6247,6448,20200330,12695
20200327,9,동작,1646,1293,20200330,2939
20200327,9,구반포,2084,2162,20200330,4246
20200327,9,신반포,2088,2082,20200330,4170
20200327,9,고속터미널,8927,12080,20200330,21007
20200327,9,사평,2184,2144,20200330,4328
20200327,9,신논현,27847,29182,20200330,57029
20200328,9,개화,1020,888,20200331,1908
20200328,9,김포공항,3943,5249,20200331,9192
20200328,9,공항시장,1754,1869,20200331,3623
20200328,9,신방화,3385,3192,20200331,6577
20200328,9,마곡나루,4984,4826,20200331,9810
20200328,9,양천향교,4154,3945,20200331,8099
20200328,9,가양,9999,9512,20200331,19511
20200328,9,증미,3004,2879,20200331,5883
20200328,9,등촌,4761,4783,20200331,9544
20200328,9,염창,8121,7565,20200331,15686
20200328,9,신목동,1508,1326,20200331,2834
20200328,9,선유도,2864,2879,20200331,5743
20200328,9,당산,9070,8430,20200331,17500
20200328,9,국회의사당,3226,3133,20200331,6359
20200328,9,여의도,6217,5898,20200331,12115
20200328,9,샛강,2098,2002,20200331,4100
20200328,9,노량진,16994,17591,20200331,34585
20200328,9,노들,2318,1965,20200331,4283
20200328,9,흑석,3884,3980,20200331,7864
20200328,9,동작,1409,1157,20200331,2566
20200328,9,구반포,1333,1448,20200331,2781
20200328,9,신반포,1384,1427,20200331,2811
20200328,9,고속터미널,7112,10441,20200331,17553
20200328,9,사평,1125,1067,20200331,2192
20200328,9,신논현,17341,17831,20200331,35172
20200329,9,개화,754,687,20200401,1441
20200329,9,김포공항,3562,4235,20200401,7797
20200329,9,공항시장,1196,1344,20200401,2540
20200329,9,신방화,2334,2309,20200401,4643
20200329,9,마곡나루,3383,3430,20200401,6813
20200329,9,양천향교,2615,2796,20200401,5411
20200329,9,가양,7007,6923,20200401,13930
20200329,9,증미,2048,2095,20200401,4143
20200329,9,등촌,3155,3200,20200401,6355
20200329,9,염창,5582,5595,20200401,11177
20200329,9,신목동,1119,1011,20200401,2130
20200329,9,선유도,1966,1912,20200401,3878
20200329,9,당산,5924,5769,20200401,11693
20200329,9,국회의사당,2594,2240,20200401,4834
20200329,9,여의도,4394,4032,20200401,8426
20200329,9,샛강,1299,1213,20200401,2512
20200329,9,노량진,11091,12202,20200401,23293
20200329,9,노들,1590,1436,20200401,3026
20200329,9,흑석,2649,2863,20200401,5512
20200329,9,동작,1276,1069,20200401,2345
20200329,9,구반포,827,842,20200401,1669
20200329,9,신반포,913,1018,20200401,1931
20200329,9,고속터미널,5923,8057,20200401,13980
20200329,9,사평,676,699,20200401,1375
20200329,9,신논현,9897,9672,20200401,19569
20200330,9,개화,2199,1469,20200402,3668
20200330,9,김포공항,4628,5035,20200402,9663
20200330,9,공항시장,2388,2698,20200402,5086
20200330,9,신방화,5543,5399,20200402,10942
20200330,9,마곡나루,8317,8293,20200402,16610
20200330,9,양천향교,7937,8286,20200402,16223
20200330,9,가양,17273,16752,20200402,34025
20200330,9,증미,5798,5943,20200402,11741
20200330,9,등촌,8541,8562,20200402,17103
20200330,9,염창,14106,14097,20200402,28203
20200330,9,신목동,3139,2931,20200402,6070
20200330,9,선유도,6238,6104,20200402,12342
20200330,9,당산,14957,14928,20200402,29885
20200330,9,국회의사당,13638,13775,20200402,27413
20200330,9,여의도,20157,19747,20200402,39904
20200330,9,샛강,4494,4748,20200402,9242
20200330,9,노량진,22299,22515,20200402,44814
20200330,9,노들,3453,3065,20200402,6518
20200330,9,흑석,5998,6365,20200402,12363
20200330,9,동작,1905,1587,20200402,3492
20200330,9,구반포,2032,2199,20200402,4231
20200330,9,신반포,2020,2144,20200402,4164
20200330,9,고속터미널,8079,9750,20200402,17829
20200330,9,사평,2143,2148,20200402,4291
20200330,9,신논현,25444,25538,20200402,50982
20200331,9,개화,2096,1482,20200403,3578
20200331,9,김포공항,4560,5400,20200403,9960
20200331,9,공항시장,2363,2693,20200403,5056
20200331,9,신방화,5517,5309,20200403,10826
20200331,9,마곡나루,8554,8574,20200403,17128
20200331,9,양천향교,7894,8252,20200403,16146
20200331,9,가양,17088,16675,20200403,33763
20200331,9,증미,5824,5853,20200403,11677
20200331,9,등촌,8614,8745,20200403,17359
20200331,9,염창,14411,14093,20200403,28504
20200331,9,신목동,3177,2880,20200403,6057
20200331,9,선유도,6187,6129,20200403,12316
20200331,9,당산,15247,14776,20200403,30023
20200331,9,국회의사당,13697,13935,20200403,27632
20200331,9,여의도,20295,20183,20200403,40478
20200331,9,샛강,4478,4711,20200403,9189
20200331,9,노량진,22576,22527,20200403,45103
20200331,9,노들,3658,3106,20200403,6764
20200331,9,흑석,5939,6225,20200403,12164
20200331,9,동작,2069,1705,20200403,3774
20200331,9,구반포,2023,2137,20200403,4160
20200331,9,신반포,2042,2098,20200403,4140
20200331,9,고속터미널,7908,10026,20200403,17934
20200331,9,사평,2168,2161,20200403,4329
20200331,9,신논현,25737,25822,20200403,51559
20200401,9,개화,2097,1491,20200404,3588
20200401,9,김포공항,4507,5770,20200404,10277
20200401,9,공항시장,2358,2674,20200404,5032
20200401,9,신방화,5516,5298,20200404,10814
20200401,9,마곡나루,8564,8518,20200404,17082
20200401,9,양천향교,7909,8183,20200404,16092
20200401,9,가양,17162,16656,20200404,33818
20200401,9,증미,5848,5868,20200404,11716
20200401,9,등촌,8697,8531,20200404,17228
20200401,9,염창,14311,14118,20200404,28429
20200401,9,신목동,3283,2998,20200404,6281
20200401,9,선유도,6322,6027,20200404,12349
20200401,9,당산,15211,14977,20200404,30188
20200401,9,국회의사당,13711,13870,20200404,27581
20200401,9,여의도,20494,19790,20200404,40284
20200401,9,샛강,4549,4825,20200404,9374
20200401,9,노량진,22929,22736,20200404,45665
20200401,9,노들,3567,3114,20200404,6681
20200401,9,흑석,5953,6382,20200404,12335
20200401,9,동작,1970,1727,20200404,3697
20200401,9,구반포,2069,2148,20200404,4217
20200401,9,신반포,2040,2157,20200404,4197
20200401,9,고속터미널,7912,10096,20200404,18008
20200401,9,사평,2215,2171,20200404,4386
20200401,9,신논현,25517,25872,20200404,51389
20200402,9,개화,2148,1498,20200405,3646
20200402,9,김포공항,4550,5892,20200405,10442
20200402,9,공항시장,2427,2639,20200405,5066
20200402,9,신방화,5594,5242,20200405,10836
20200402,9,마곡나루,8500,8422,20200405,16922
20200402,9,양천향교,7981,8258,20200405,16239
20200402,9,가양,17237,16511,20200405,33748
20200402,9,증미,5992,5979,20200405,11971
20200402,9,등촌,8564,8509,20200405,17073
20200402,9,염창,14554,14196,20200405,28750
20200402,9,신목동,3264,2914,20200405,6178
20200402,9,선유도,6263,6019,20200405,12282
20200402,9,당산,15233,15164,20200405,30397
20200402,9,국회의사당,13334,13468,20200405,26802
20200402,9,여의도,20003,19564,20200405,39567
20200402,9,샛강,4539,4785,20200405,9324
20200402,9,노량진,22289,22261,20200405,44550
20200402,9,노들,3592,3036,20200405,6628
20200402,9,흑석,6113,6360,20200405,12473
20200402,9,동작,1674,1555,20200405,3229
20200402,9,구반포,2115,2263,20200405,4378
20200402,9,신반포,2099,2065,20200405,4164
20200402,9,고속터미널,7936,10138,20200405,18074
20200402,9,사평,2217,2205,20200405,4422
20200402,9,신논현,25334,25698,20200405,51032
20200403,9,개화,2246,1527,20200406,3773
20200403,9,김포공항,4705,6104,20200406,10809
20200403,9,공항시장,2554,2655,20200406,5209
20200403,9,신방화,5770,5438,20200406,11208
20200403,9,마곡나루,8807,8867,20200406,17674
20200403,9,양천향교,7917,7908,20200406,15825
20200403,9,가양,17528,16854,20200406,34382
20200403,9,증미,6077,5903,20200406,11980
20200403,9,등촌,8868,8697,20200406,17565
20200403,9,염창,14680,14291,20200406,28971
20200403,9,신목동,3204,2908,20200406,6112
20200403,9,선유도,6449,6133,20200406,12582
20200403,9,당산,15970,15629,20200406,31599
20200403,9,국회의사당,13370,13296,20200406,26666
20200403,9,여의도,20643,19645,20200406,40288
20200403,9,샛강,4802,4929,20200406,9731
20200403,9,노량진,23736,23795,20200406,47531
20200403,9,노들,3773,3095,20200406,6868
20200403,9,흑석,6234,6489,20200406,12723
20200403,9,동작,1583,1434,20200406,3017
20200403,9,구반포,2196,2259,20200406,4455
20200403,9,신반포,2132,2243,20200406,4375
20200403,9,고속터미널,9185,12424,20200406,21609
20200403,9,사평,2278,2188,20200406,4466
20200403,9,신논현,27368,28862,20200406,56230
20200404,9,개화,1098,915,20200407,2013
20200404,9,김포공항,4075,5382,20200407,9457
20200404,9,공항시장,1697,1864,20200407,3561
20200404,9,신방화,3563,3273,20200407,6836
20200404,9,마곡나루,4702,4719,20200407,9421
20200404,9,양천향교,4102,4097,20200407,8199
20200404,9,가양,10088,9444,20200407,19532
20200404,9,증미,3064,3043,20200407,6107
20200404,9,등촌,4942,4872,20200407,9814
20200404,9,염창,8249,7732,20200407,15981
20200404,9,신목동,1631,1425,20200407,3056
20200404,9,선유도,2922,3118,20200407,6040
20200404,9,당산,9050,8522,20200407,17572
20200404,9,국회의사당,3032,2748,20200407,5780
20200404,9,여의도,5840,5503,20200407,11343
20200404,9,샛강,1996,1869,20200407,3865
20200404,9,노량진,16394,16961,20200407,33355
20200404,9,노들,2275,1957,20200407,4232
20200404,9,흑석,4018,4035,20200407,8053
20200404,9,동작,1129,1029,20200407,2158
20200404,9,구반포,1456,1519,20200407,2975
20200404,9,신반포,1335,1419,20200407,2754
20200404,9,고속터미널,6957,10302,20200407,17259
20200404,9,사평,1224,1142,20200407,2366
20200404,9,신논현,17247,17929,20200407,35176
20200405,9,개화,814,787,20200408,1601
20200405,9,김포공항,3674,4169,20200408,7843
20200405,9,공항시장,1242,1334,20200408,2576
20200405,9,신방화,2268,2296,20200408,4564
20200405,9,마곡나루,3173,3330,20200408,6503
20200405,9,양천향교,2731,2941,20200408,5672
20200405,9,가양,6970,6794,20200408,13764
20200405,9,증미,2044,2128,20200408,4172
20200405,9,등촌,3222,3355,20200408,6577
20200405,9,염창,5547,5481,20200408,11028
20200405,9,신목동,1166,1060,20200408,2226
20200405,9,선유도,2041,2044,20200408,4085
20200405,9,당산,5977,5878,20200408,11855
20200405,9,국회의사당,2560,2247,20200408,4807
20200405,9,여의도,3695,3514,20200408,7209
20200405,9,샛강,1198,1200,20200408,2398
20200405,9,노량진,10710,11973,20200408,22683
20200405,9,노들,1497,1418,20200408,2915
20200405,9,흑석,2677,2868,20200408,5545
20200405,9,동작,861,831,20200408,1692
20200405,9,구반포,866,892,20200408,1758
20200405,9,신반포,829,890,20200408,1719
20200405,9,고속터미널,5855,7776,20200408,13631
20200405,9,사평,673,733,20200408,1406
20200405,9,신논현,9993,9825,20200408,19818
20200406,9,신논현,26124,26523,20200409,52647
20200406,9,사평,2261,2278,20200409,4539
20200406,9,고속터미널,8363,10015,20200409,18378
20200406,9,신반포,2146,2175,20200409,4321
20200406,9,구반포,2078,2207,20200409,4285
20200406,9,개화,2297,1616,20200409,3913
20200406,9,김포공항,4771,5591,20200409,10362
20200406,9,공항시장,2459,2720,20200409,5179
20200406,9,신방화,5722,5576,20200409,11298
20200406,9,마곡나루,8481,8474,20200409,16955
20200406,9,양천향교,8160,8389,20200409,16549
20200406,9,가양,17582,17244,20200409,34826
20200406,9,증미,6220,6183,20200409,12403
20200406,9,등촌,8814,8857,20200409,17671
20200406,9,염창,14737,14339,20200409,29076
20200406,9,신목동,3349,3087,20200409,6436
20200406,9,선유도,6478,6337,20200409,12815
20200406,9,당산,15151,15268,20200409,30419
20200406,9,국회의사당,13874,14112,20200409,27986
20200406,9,여의도,20616,20301,20200409,40917
20200406,9,샛강,4661,4902,20200409,9563
20200406,9,노량진,22800,23038,20200409,45838
20200406,9,노들,3556,3127,20200409,6683
20200406,9,흑석,6020,6522,20200409,12542
20200406,9,동작,1411,1138,20200409,2549
20200407,9,개화,2222,1589,20200410,3811
20200407,9,김포공항,4614,5486,20200410,10100
20200407,9,공항시장,2429,2710,20200410,5139
20200407,9,신방화,5765,5573,20200410,11338
20200407,9,마곡나루,8619,8605,20200410,17224
20200407,9,양천향교,8129,8514,20200410,16643
20200407,9,가양,17589,17074,20200410,34663
20200407,9,증미,6176,6182,20200410,12358
20200407,9,등촌,8827,8782,20200410,17609
20200407,9,염창,14703,14401,20200410,29104
20200407,9,신목동,3285,3041,20200410,6326
20200407,9,선유도,6604,6380,20200410,12984
20200407,9,당산,15642,15518,20200410,31160
20200407,9,국회의사당,13670,13772,20200410,27442
20200407,9,여의도,20738,20172,20200410,40910
20200407,9,샛강,4645,4869,20200410,9514
20200407,9,노량진,23192,23260,20200410,46452
20200407,9,노들,3709,3142,20200410,6851
20200407,9,흑석,6118,6551,20200410,12669
20200407,9,동작,1474,1219,20200410,2693
20200407,9,구반포,2057,2147,20200410,4204
20200407,9,신반포,2055,2144,20200410,4199
20200407,9,고속터미널,8031,10206,20200410,18237
20200407,9,사평,2335,2296,20200410,4631
20200407,9,신논현,26383,26645,20200410,53028
20200408,9,개화,2210,1566,20200411,3776
20200408,9,김포공항,4618,5567,20200411,10185
20200408,9,공항시장,2386,2685,20200411,5071
20200408,9,신방화,5723,5565,20200411,11288
20200408,9,마곡나루,8768,8686,20200411,17454
20200408,9,양천향교,8177,8448,20200411,16625
20200408,9,가양,17673,17229,20200411,34902
20200408,9,증미,6343,6180,20200411,12523
20200408,9,등촌,8908,8805,20200411,17713
20200408,9,염창,14779,14590,20200411,29369
20200408,9,신목동,3282,2976,20200411,6258
20200408,9,선유도,6524,6340,20200411,12864
20200408,9,당산,15656,15682,20200411,31338
20200408,9,국회의사당,14040,14069,20200411,28109
20200408,9,여의도,20802,20189,20200411,40991
20200408,9,샛강,4704,4975,20200411,9679
20200408,9,노량진,22948,22359,20200411,45307
20200408,9,노들,3625,3146,20200411,6771
20200408,9,흑석,6085,6541,20200411,12626
20200408,9,동작,1455,1184,20200411,2639
20200408,9,구반포,2104,2224,20200411,4328
20200408,9,신반포,2151,2144,20200411,4295
20200408,9,고속터미널,8345,10369,20200411,18714
20200408,9,사평,2325,2221,20200411,4546
20200408,9,신논현,26291,26459,20200411,52750
20200409,9,개화,2256,1592,20200412,3848
20200409,9,김포공항,4595,5648,20200412,10243
20200409,9,공항시장,2462,2671,20200412,5133
20200409,9,신방화,5687,5499,20200412,11186
20200409,9,마곡나루,8689,8845,20200412,17534
20200409,9,양천향교,8117,8358,20200412,16475
20200409,9,가양,17586,16905,20200412,34491
20200409,9,증미,6264,6239,20200412,12503
20200409,9,등촌,8883,8794,20200412,17677
20200409,9,염창,14971,14507,20200412,29478
20200409,9,신목동,3275,2958,20200412,6233
20200409,9,선유도,6496,6294,20200412,12790
20200409,9,당산,15781,15688,20200412,31469
20200409,9,국회의사당,13824,14059,20200412,27883
20200409,9,여의도,20732,20474,20200412,41206
20200409,9,샛강,4688,4836,20200412,9524
20200409,9,노량진,22171,21979,20200412,44150
20200409,9,노들,3622,3042,20200412,6664
20200409,9,흑석,6046,6431,20200412,12477
20200409,9,동작,1475,1215,20200412,2690
20200409,9,구반포,2139,2264,20200412,4403
20200409,9,신반포,2059,2056,20200412,4115
20200409,9,고속터미널,7957,10416,20200412,18373
20200409,9,사평,2301,2251,20200412,4552
20200409,9,신논현,26263,26760,20200412,53023
20200410,9,동작,1389,1204,20200413,2593
20200410,9,구반포,2237,2372,20200413,4609
20200410,9,신반포,2233,2167,20200413,4400
20200410,9,고속터미널,9330,12712,20200413,22042
20200410,9,사평,2491,2314,20200413,4805
20200410,9,신논현,28332,29799,20200413,58131
20200410,9,개화,2198,1593,20200413,3791
20200410,9,김포공항,4977,6141,20200413,11118
20200410,9,공항시장,2496,2754,20200413,5250
20200410,9,신방화,5930,5575,20200413,11505
20200410,9,마곡나루,8432,8557,20200413,16989
20200410,9,양천향교,8138,8140,20200413,16278
20200410,9,가양,17813,17057,20200413,34870
20200410,9,증미,6309,6200,20200413,12509
20200410,9,등촌,9070,8825,20200413,17895
20200410,9,염창,15052,14374,20200413,29426
20200410,9,신목동,3300,2931,20200413,6231
20200410,9,선유도,6645,6407,20200413,13052
20200410,9,당산,16379,15901,20200413,32280
20200410,9,국회의사당,13816,13835,20200413,27651
20200410,9,여의도,20618,20009,20200413,40627
20200410,9,샛강,5079,5084,20200413,10163
20200410,9,노량진,23471,22944,20200413,46415
20200410,9,노들,3765,3085,20200413,6850
20200410,9,흑석,6503,6747,20200413,13250
20200411,9,개화,1134,921,20200414,2055
20200411,9,김포공항,4026,5658,20200414,9684
20200411,9,공항시장,1782,1869,20200414,3651
20200411,9,신방화,3739,3487,20200414,7226
20200411,9,마곡나루,5069,5210,20200414,10279
20200411,9,양천향교,4395,4364,20200414,8759
20200411,9,가양,10361,9755,20200414,20116
20200411,9,증미,3172,3115,20200414,6287
20200411,9,등촌,5043,4893,20200414,9936
20200411,9,염창,8692,8113,20200414,16805
20200411,9,신목동,1615,1454,20200414,3069
20200411,9,선유도,2990,2965,20200414,5955
20200411,9,당산,9322,8908,20200414,18230
20200411,9,국회의사당,2860,2743,20200414,5603
20200411,9,여의도,5596,5293,20200414,10889
20200411,9,샛강,2120,1925,20200414,4045
20200411,9,노량진,16383,16612,20200414,32995
20200411,9,노들,2360,1951,20200414,4311
20200411,9,흑석,4168,4190,20200414,8358
20200411,9,동작,979,789,20200414,1768
20200411,9,구반포,1903,2016,20200414,3919
20200411,9,신반포,1345,1357,20200414,2702
20200411,9,고속터미널,7602,10923,20200414,18525
20200411,9,사평,1366,1180,20200414,2546
20200411,9,신논현,17835,18437,20200414,36272
20200412,9,개화,867,818,20200415,1685
20200412,9,김포공항,3709,4667,20200415,8376
20200412,9,공항시장,1150,1366,20200415,2516
20200412,9,신방화,2345,2279,20200415,4624
20200412,9,마곡나루,3346,3417,20200415,6763
20200412,9,양천향교,2831,2989,20200415,5820
20200412,9,가양,7197,6918,20200415,14115
20200412,9,증미,1679,1740,20200415,3419
20200412,9,등촌,3361,3455,20200415,6816
20200412,9,염창,5806,5670,20200415,11476
20200412,9,신목동,1210,996,20200415,2206
20200412,9,선유도,1888,1869,20200415,3757
20200412,9,당산,6024,5889,20200415,11913
20200412,9,국회의사당,2746,2418,20200415,5164
20200412,9,여의도,3802,3536,20200415,7338
20200412,9,샛강,1246,1139,20200415,2385
20200412,9,노량진,10749,11673,20200415,22422
20200412,9,노들,1558,1430,20200415,2988
20200412,9,흑석,2758,2922,20200415,5680
20200412,9,동작,703,567,20200415,1270
20200412,9,구반포,828,858,20200415,1686
20200412,9,신반포,823,888,20200415,1711
20200412,9,고속터미널,6105,8248,20200415,14353
20200412,9,사평,742,769,20200415,1511
20200412,9,신논현,10248,10042,20200415,20290
20200413,9,개화,2359,1574,20200416,3933
20200413,9,김포공항,4862,5862,20200416,10724
20200413,9,공항시장,2413,2709,20200416,5122
20200413,9,신방화,5804,5625,20200416,11429
20200413,9,마곡나루,8407,8535,20200416,16942
20200413,9,양천향교,8263,8652,20200416,16915
20200413,9,가양,17884,17324,20200416,35208
20200413,9,증미,6322,6289,20200416,12611
20200413,9,등촌,8986,9000,20200416,17986
20200413,9,염창,14916,14661,20200416,29577
20200413,9,신목동,3353,3018,20200416,6371
20200413,9,선유도,6663,6371,20200416,13034
20200413,9,당산,15488,15424,20200416,30912
20200413,9,국회의사당,13918,14133,20200416,28051
20200413,9,여의도,20789,20632,20200416,41421
20200413,9,샛강,4621,4964,20200416,9585
20200413,9,노량진,21571,21573,20200416,43144
20200413,9,노들,3735,3163,20200416,6898
20200413,9,흑석,6366,6854,20200416,13220
20200413,9,동작,1457,1208,20200416,2665
20200413,9,구반포,2116,2252,20200416,4368
20200413,9,신반포,2149,2142,20200416,4291
20200413,9,고속터미널,8749,10829,20200416,19578
20200413,9,사평,2329,2276,20200416,4605
20200413,9,신논현,26618,26802,20200416,53420
20200414,9,구반포,2216,2301,20200417,4517
20200414,9,신논현,28175,29723,20200417,57898
20200414,9,사평,2502,2288,20200417,4790
20200414,9,고속터미널,9044,11325,20200417,20369
20200414,9,신반포,2162,2138,20200417,4300
20200414,9,개화,2274,1650,20200417,3924
20200414,9,김포공항,5066,6376,20200417,11442
20200414,9,공항시장,2573,2862,20200417,5435
20200414,9,신방화,5932,5655,20200417,11587
20200414,9,마곡나루,9105,9195,20200417,18300
20200414,9,양천향교,8573,8549,20200417,17122
20200414,9,가양,18488,17649,20200417,36137
20200414,9,증미,6390,6299,20200417,12689
20200414,9,등촌,9390,9050,20200417,18440
20200414,9,염창,15341,14795,20200417,30136
20200414,9,신목동,3481,2975,20200417,6456
20200414,9,선유도,6579,6466,20200417,13045
20200414,9,당산,16400,16252,20200417,32652
20200414,9,국회의사당,14052,13839,20200417,27891
20200414,9,여의도,21704,20954,20200417,42658
20200414,9,샛강,4744,4968,20200417,9712
20200414,9,노량진,22883,23082,20200417,45965
20200414,9,노들,3870,3149,20200417,7019
20200414,9,흑석,6701,6869,20200417,13570
20200414,9,동작,1528,1285,20200417,2813
20200415,9,개화,1042,873,20200418,1915
20200415,9,김포공항,4196,5352,20200418,9548
20200415,9,공항시장,1693,1708,20200418,3401
20200415,9,신방화,3348,3320,20200418,6668
20200415,9,마곡나루,4339,4457,20200418,8796
20200415,9,양천향교,3810,3933,20200418,7743
20200415,9,가양,9229,9039,20200418,18268
20200415,9,증미,2773,2772,20200418,5545
20200415,9,등촌,4646,4552,20200418,9198
20200415,9,염창,7574,7286,20200418,14860
20200415,9,신목동,1408,1347,20200418,2755
20200415,9,선유도,2683,2721,20200418,5404
20200415,9,당산,7769,7404,20200418,15173
20200415,9,국회의사당,3080,3147,20200418,6227
20200415,9,여의도,4606,4444,20200418,9050
20200415,9,샛강,1710,1647,20200418,3357
20200415,9,노량진,14254,14842,20200418,29096
20200415,9,노들,2052,1809,20200418,3861
20200415,9,흑석,3540,3599,20200418,7139
20200415,9,동작,824,719,20200418,1543
20200415,9,구반포,1139,1217,20200418,2356
20200415,9,신반포,1120,1149,20200418,2269
20200415,9,고속터미널,6278,8288,20200418,14566
20200415,9,사평,1061,1008,20200418,2069
20200415,9,신논현,14595,14467,20200418,29062
20200416,9,개화,2291,1605,20200419,3896
20200416,9,김포공항,4928,6007,20200419,10935
20200416,9,공항시장,2537,2802,20200419,5339
20200416,9,신방화,5895,5702,20200419,11597
20200416,9,마곡나루,8921,8671,20200419,17592
20200416,9,양천향교,8353,8534,20200419,16887
20200416,9,가양,18135,17446,20200419,35581
20200416,9,증미,6261,6205,20200419,12466
20200416,9,등촌,9271,9191,20200419,18462
20200416,9,염창,15180,14748,20200419,29928
20200416,9,신목동,3433,3074,20200419,6507
20200416,9,선유도,6486,6251,20200419,12737
20200416,9,당산,15931,15751,20200419,31682
20200416,9,국회의사당,13697,13864,20200419,27561
20200416,9,여의도,21195,20915,20200419,42110
20200416,9,샛강,4559,4883,20200419,9442
20200416,9,노량진,22158,22133,20200419,44291
20200416,9,노들,3763,3203,20200419,6966
20200416,9,흑석,6527,6921,20200419,13448
20200416,9,동작,1502,1224,20200419,2726
20200416,9,구반포,2158,2321,20200419,4479
20200416,9,신반포,2140,2107,20200419,4247
20200416,9,고속터미널,8921,10993,20200419,19914
20200416,9,사평,2338,2326,20200419,4664
20200416,9,신논현,26930,27638,20200419,54568
20200417,9,개화,2279,1525,20200420,3804
20200417,9,김포공항,5163,6558,20200420,11721
20200417,9,공항시장,2566,2804,20200420,5370
20200417,9,신방화,5983,5701,20200420,11684
20200417,9,마곡나루,8726,8903,20200420,17629
20200417,9,양천향교,8245,8295,20200420,16540
20200417,9,가양,17804,17037,20200420,34841
20200417,9,증미,6270,6176,20200420,12446
20200417,9,등촌,9002,8892,20200420,17894
20200417,9,염창,15126,14420,20200420,29546
20200417,9,신목동,3337,2955,20200420,6292
20200417,9,선유도,6658,6470,20200420,13128
20200417,9,당산,16315,15992,20200420,32307
20200417,9,국회의사당,14205,14310,20200420,28515
20200417,9,여의도,21570,20488,20200420,42058
20200417,9,샛강,4791,4952,20200420,9743
20200417,9,노량진,22686,22704,20200420,45390
20200417,9,노들,3773,3078,20200420,6851
20200417,9,흑석,6487,6740,20200420,13227
20200417,9,동작,1375,1173,20200420,2548
20200417,9,구반포,2295,2379,20200420,4674
20200417,9,신반포,2204,2141,20200420,4345
20200417,9,고속터미널,9200,12487,20200420,21687
20200417,9,사평,2533,2311,20200420,4844
20200417,9,신논현,28186,30034,20200420,58220
20200418,9,개화,1253,1025,20200421,2278
20200418,9,김포공항,4629,6127,20200421,10756
20200418,9,공항시장,1917,2034,20200421,3951
20200418,9,신방화,3821,3647,20200421,7468
20200418,9,마곡나루,5552,5430,20200421,10982
20200418,9,양천향교,4718,4527,20200421,9245
20200418,9,가양,11327,10566,20200421,21893
20200418,9,증미,3220,3152,20200421,6372
20200418,9,등촌,5297,5255,20200421,10552
20200418,9,염창,9082,8407,20200421,17489
20200418,9,신목동,1764,1497,20200421,3261
20200418,9,선유도,3195,3239,20200421,6434
20200418,9,당산,10088,9204,20200421,19292
20200418,9,국회의사당,2767,2642,20200421,5409
20200418,9,여의도,6227,6151,20200421,12378
20200418,9,샛강,2049,1972,20200421,4021
20200418,9,노량진,17285,17933,20200421,35218
20200418,9,노들,2548,2061,20200421,4609
20200418,9,흑석,4419,4398,20200421,8817
20200418,9,동작,1057,869,20200421,1926
20200418,9,구반포,1602,1594,20200421,3196
20200418,9,신반포,1545,1458,20200421,3003
20200418,9,고속터미널,8922,12363,20200421,21285
20200418,9,사평,1342,1188,20200421,2530
20200418,9,신논현,19175,20095,20200421,39270
20200419,9,개화,848,750,20200422,1598
20200419,9,김포공항,4231,4847,20200422,9078
20200419,9,공항시장,1253,1475,20200422,2728
20200419,9,신방화,2558,2523,20200422,5081
20200419,9,마곡나루,3408,3404,20200422,6812
20200419,9,양천향교,2761,2915,20200422,5676
20200419,9,가양,7003,7027,20200422,14030
20200419,9,증미,2074,2132,20200422,4206
20200419,9,등촌,3367,3516,20200422,6883
20200419,9,염창,5961,5832,20200422,11793
20200419,9,신목동,1133,1047,20200422,2180
20200419,9,선유도,1859,1850,20200422,3709
20200419,9,당산,6241,6067,20200422,12308
20200419,9,국회의사당,2149,2092,20200422,4241
20200419,9,여의도,3593,3355,20200422,6948
20200419,9,샛강,1181,1184,20200422,2365
20200419,9,노량진,10867,11727,20200422,22594
20200419,9,노들,1654,1550,20200422,3204
20200419,9,흑석,2731,2917,20200422,5648
20200419,9,동작,632,552,20200422,1184
20200419,9,구반포,859,918,20200422,1777
20200419,9,신반포,719,804,20200422,1523
20200419,9,고속터미널,5907,8100,20200422,14007
20200419,9,사평,749,775,20200422,1524
20200419,9,신논현,10601,10481,20200422,21082
20200420,9,개화,2347,1687,20200423,4034
20200420,9,김포공항,4978,6157,20200423,11135
20200420,9,공항시장,2541,2832,20200423,5373
20200420,9,신방화,6061,5988,20200423,12049
20200420,9,마곡나루,8810,8881,20200423,17691
20200420,9,양천향교,8345,8745,20200423,17090
20200420,9,가양,18460,17940,20200423,36400
20200420,9,증미,6447,6392,20200423,12839
20200420,9,등촌,9324,9320,20200423,18644
20200420,9,염창,15207,15119,20200423,30326
20200420,9,신목동,3465,3142,20200423,6607
20200420,9,선유도,7068,6804,20200423,13872
20200420,9,당산,15846,15984,20200423,31830
20200420,9,국회의사당,14717,14918,20200423,29635
20200420,9,여의도,21735,21235,20200423,42970
20200420,9,샛강,4754,5102,20200423,9856
20200420,9,노량진,23683,23621,20200423,47304
20200420,9,노들,3848,3234,20200423,7082
20200420,9,흑석,6391,6953,20200423,13344
20200420,9,동작,1530,1291,20200423,2821
20200420,9,구반포,2243,2406,20200423,4649
20200420,9,신반포,2214,2211,20200423,4425
20200420,9,고속터미널,8845,10931,20200423,19776
20200420,9,사평,2438,2380,20200423,4818
20200420,9,신논현,27410,27711,20200423,55121
20200421,9,개화,2385,1623,20200424,4008
20200421,9,김포공항,5151,6469,20200424,11620
20200421,9,공항시장,2538,2817,20200424,5355
20200421,9,신방화,6165,6103,20200424,12268
20200421,9,마곡나루,9136,9022,20200424,18158
20200421,9,양천향교,8422,8832,20200424,17254
20200421,9,가양,18675,18170,20200424,36845
20200421,9,증미,6459,6379,20200424,12838
20200421,9,등촌,9535,9363,20200424,18898
20200421,9,염창,15533,15165,20200424,30698
20200421,9,신목동,3569,3268,20200424,6837
20200421,9,선유도,7192,6951,20200424,14143
20200421,9,당산,16503,16461,20200424,32964
20200421,9,국회의사당,14879,15001,20200424,29880
20200421,9,여의도,22220,21535,20200424,43755
20200421,9,샛강,4961,5205,20200424,10166
20200421,9,노량진,24368,24019,20200424,48387
20200421,9,노들,3860,3400,20200424,7260
20200421,9,흑석,6549,6968,20200424,13517
20200421,9,동작,1535,1264,20200424,2799
20200421,9,구반포,2315,2451,20200424,4766
20200421,9,신반포,2220,2240,20200424,4460
20200421,9,고속터미널,8702,10957,20200424,19659
20200421,9,사평,2514,2483,20200424,4997
20200421,9,신논현,27964,28572,20200424,56536
20200422,9,개화,2219,1536,20200425,3755
20200422,9,김포공항,5067,6484,20200425,11551
20200422,9,공항시장,2553,2844,20200425,5397
20200422,9,신방화,6142,5933,20200425,12075
20200422,9,마곡나루,9128,8969,20200425,18097
20200422,9,양천향교,8512,8969,20200425,17481
20200422,9,가양,18349,17722,20200425,36071
20200422,9,증미,6530,6466,20200425,12996
20200422,9,등촌,9435,9348,20200425,18783
20200422,9,염창,15392,15263,20200425,30655
20200422,9,신목동,3502,3156,20200425,6658
20200422,9,선유도,7105,6854,20200425,13959
20200422,9,당산,16506,16250,20200425,32756
20200422,9,국회의사당,15018,15026,20200425,30044
20200422,9,여의도,22191,21660,20200425,43851
20200422,9,샛강,5044,5298,20200425,10342
20200422,9,노량진,24420,24275,20200425,48695
20200422,9,노들,3863,3317,20200425,7180
20200422,9,흑석,6689,7077,20200425,13766
20200422,9,동작,1439,1224,20200425,2663
20200422,9,구반포,2371,2492,20200425,4863
20200422,9,신반포,2218,2264,20200425,4482
20200422,9,고속터미널,9135,11523,20200425,20658
20200422,9,사평,2551,2519,20200425,5070
20200422,9,신논현,27750,28414,20200425,56164
20200423,9,등촌,9592,9275,20200426,18867
20200423,9,개화,2293,1598,20200426,3891
20200423,9,김포공항,5273,6940,20200426,12213
20200423,9,공항시장,2592,2975,20200426,5567
20200423,9,신방화,6072,5830,20200426,11902
20200423,9,마곡나루,9233,9097,20200426,18330
20200423,9,양천향교,8611,8858,20200426,17469
20200423,9,가양,18684,17985,20200426,36669
20200423,9,증미,6531,6538,20200426,13069
20200423,9,염창,15793,15431,20200426,31224
20200423,9,신목동,3572,3187,20200426,6759
20200423,9,선유도,7181,6873,20200426,14054
20200423,9,당산,16695,16684,20200426,33379
20200423,9,국회의사당,14883,15302,20200426,30185
20200423,9,여의도,22456,21655,20200426,44111
20200423,9,샛강,5032,5307,20200426,10339
20200423,9,노량진,24535,24725,20200426,49260
20200423,9,노들,3976,3341,20200426,7317
20200423,9,흑석,6709,7016,20200426,13725
20200423,9,동작,1520,1261,20200426,2781
20200423,9,구반포,2437,2537,20200426,4974
20200423,9,신반포,2261,2200,20200426,4461
20200423,9,고속터미널,9177,11635,20200426,20812
20200423,9,사평,2567,2494,20200426,5061
20200423,9,신논현,28694,29570,20200426,58264
20200424,9,개화,2483,1740,20200427,4223
20200424,9,김포공항,5609,7559,20200427,13168
20200424,9,공항시장,2730,2958,20200427,5688
20200424,9,신방화,6418,6117,20200427,12535
20200424,9,마곡나루,9644,9524,20200427,19168
20200424,9,양천향교,8808,8608,20200427,17416
20200424,9,가양,19357,18547,20200427,37904
20200424,9,증미,6845,6673,20200427,13518
20200424,9,등촌,9937,9529,20200427,19466
20200424,9,염창,16361,15673,20200427,32034
20200424,9,신목동,3735,3232,20200427,6967
20200424,9,선유도,7393,7111,20200427,14504
20200424,9,당산,17619,17292,20200427,34911
20200424,9,국회의사당,15275,15412,20200427,30687
20200424,9,여의도,23206,22082,20200427,45288
20200424,9,샛강,5170,5484,20200427,10654
20200424,9,노량진,26161,26236,20200427,52397
20200424,9,노들,4197,3421,20200427,7618
20200424,9,흑석,7181,7305,20200427,14486
20200424,9,동작,1568,1292,20200427,2860
20200424,9,구반포,2514,2618,20200427,5132
20200424,9,신반포,2451,2421,20200427,4872
20200424,9,고속터미널,10643,14335,20200427,24978
20200424,9,사평,2765,2592,20200427,5357
20200424,9,신논현,31322,33718,20200427,65040
20200425,9,개화,1332,1159,20200428,2491
20200425,9,김포공항,5092,6922,20200428,12014
20200425,9,공항시장,1963,2040,20200428,4003
20200425,9,신방화,4097,3771,20200428,7868
20200425,9,마곡나루,5757,5749,20200428,11506
20200425,9,양천향교,5010,4680,20200428,9690
20200425,9,가양,12016,11114,20200428,23130
20200425,9,증미,3456,3319,20200428,6775
20200425,9,등촌,5776,5584,20200428,11360
20200425,9,염창,9859,9191,20200428,19050
20200425,9,신목동,1835,1646,20200428,3481
20200425,9,선유도,3156,3239,20200428,6395
20200425,9,당산,10588,9814,20200428,20402
20200425,9,국회의사당,3143,3189,20200428,6332
20200425,9,여의도,6893,6586,20200428,13479
20200425,9,샛강,2158,2021,20200428,4179
20200425,9,노량진,19278,20044,20200428,39322
20200425,9,노들,2788,2249,20200428,5037
20200425,9,흑석,4764,4760,20200428,9524
20200425,9,동작,1093,910,20200428,2003
20200425,9,구반포,1832,1965,20200428,3797
20200425,9,신반포,1519,1413,20200428,2932
20200425,9,고속터미널,9193,13474,20200428,22667
20200425,9,사평,1403,1327,20200428,2730
20200425,9,신논현,21369,22354,20200428,43723
20200426,9,개화,1025,957,20200429,1982
20200426,9,김포공항,4464,5851,20200429,10315
20200426,9,공항시장,1426,1594,20200429,3020
20200426,9,신방화,2768,2836,20200429,5604
20200426,9,마곡나루,4164,4151,20200429,8315
20200426,9,양천향교,3164,3340,20200429,6504
20200426,9,가양,8480,8242,20200429,16722
20200426,9,증미,2014,2032,20200429,4046
20200426,9,등촌,4014,4018,20200429,8032
20200426,9,염창,6734,6645,20200429,13379
20200426,9,신목동,1313,1218,20200429,2531
20200426,9,선유도,2336,2194,20200429,4530
20200426,9,당산,7299,7047,20200429,14346
20200426,9,국회의사당,3390,2983,20200429,6373
20200426,9,여의도,4629,4131,20200429,8760
20200426,9,샛강,1336,1338,20200429,2674
20200426,9,노량진,13297,14619,20200429,27916
20200426,9,노들,1939,1712,20200429,3651
20200426,9,흑석,3282,3493,20200429,6775
20200426,9,동작,870,696,20200429,1566
20200426,9,구반포,943,1023,20200429,1966
20200426,9,신반포,996,1119,20200429,2115
20200426,9,고속터미널,7584,10257,20200429,17841
20200426,9,사평,906,920,20200429,1826
20200426,9,신논현,12431,12259,20200429,24690
20200427,9,개화,2527,1737,20200430,4264
20200427,9,김포공항,5669,7308,20200430,12977
20200427,9,공항시장,2631,2943,20200430,5574
20200427,9,신방화,6196,6007,20200430,12203
20200427,9,마곡나루,9166,9222,20200430,18388
20200427,9,양천향교,8607,8956,20200430,17563
20200427,9,가양,19313,18563,20200430,37876
20200427,9,증미,6662,6716,20200430,13378
20200427,9,등촌,9764,9572,20200430,19336
20200427,9,염창,16020,15588,20200430,31608
20200427,9,신목동,3598,3256,20200430,6854
20200427,9,선유도,7292,7123,20200430,14415
20200427,9,당산,16718,16800,20200430,33518
20200427,9,국회의사당,15263,15639,20200430,30902
20200427,9,여의도,22715,22515,20200430,45230
20200427,9,샛강,5106,5425,20200430,10531
20200427,9,노량진,24727,24635,20200430,49362
20200427,9,노들,3945,3446,20200430,7391
20200427,9,흑석,6966,7448,20200430,14414
20200427,9,동작,1497,1227,20200430,2724
20200427,9,구반포,2406,2621,20200430,5027
20200427,9,신반포,2345,2334,20200430,4679
20200427,9,고속터미널,9669,12274,20200430,21943
20200427,9,사평,2619,2536,20200430,5155
20200427,9,신논현,29294,29604,20200430,58898
20200428,9,개화,2505,1799,20200501,4304
20200428,9,김포공항,5503,8148,20200501,13651
20200428,9,공항시장,2774,3084,20200501,5858
20200428,9,신방화,6335,6122,20200501,12457
20200428,9,마곡나루,9520,9557,20200501,19077
20200428,9,양천향교,8812,9121,20200501,17933
20200428,9,가양,19640,18681,20200501,38321
20200428,9,증미,6796,6672,20200501,13468
20200428,9,등촌,10032,9793,20200501,19825
20200428,9,염창,16360,15863,20200501,32223
20200428,9,신목동,3769,3358,20200501,7127
20200428,9,선유도,7361,7218,20200501,14579
20200428,9,당산,17199,17047,20200501,34246
20200428,9,국회의사당,15498,15802,20200501,31300
20200428,9,여의도,23163,22838,20200501,46001
20200428,9,샛강,5237,5535,20200501,10772
20200428,9,노량진,25336,25182,20200501,50518
20200428,9,노들,4118,3485,20200501,7603
20200428,9,흑석,7263,7590,20200501,14853
20200428,9,동작,1628,1332,20200501,2960
20200428,9,구반포,2468,2587,20200501,5055
20200428,9,신반포,2382,2383,20200501,4765
20200428,9,고속터미널,9854,12548,20200501,22402
20200428,9,사평,2710,2564,20200501,5274
20200428,9,신논현,29847,30670,20200501,60517
20200429,9,개화,2620,1800,20200502,4420
20200429,9,김포공항,6346,9583,20200502,15929
20200429,9,공항시장,2754,2958,20200502,5712
20200429,9,신방화,6559,6180,20200502,12739
20200429,9,마곡나루,9747,9630,20200502,19377
20200429,9,양천향교,9208,9123,20200502,18331
20200429,9,가양,19971,18718,20200502,38689
20200429,9,증미,6924,6703,20200502,13627
20200429,9,등촌,10230,9833,20200502,20063
20200429,9,염창,16986,16076,20200502,33062
20200429,9,신목동,4013,3432,20200502,7445
20200429,9,선유도,7591,7331,20200502,14922
20200429,9,당산,18289,17502,20200502,35791
20200429,9,국회의사당,16007,16057,20200502,32064
20200429,9,여의도,24191,22961,20200502,47152
20200429,9,샛강,5409,5675,20200502,11084
20200429,9,노량진,26993,27010,20200502,54003
20200429,9,노들,4272,3483,20200502,7755
20200429,9,흑석,7526,7574,20200502,15100
20200429,9,동작,1729,1369,20200502,3098
20200429,9,구반포,2516,2657,20200502,5173
20200429,9,신반포,2597,2537,20200502,5134
20200429,9,고속터미널,11333,16886,20200502,28219
20200429,9,사평,2794,2613,20200502,5407
20200429,9,신논현,32063,33990,20200502,66053
20200430,9,개화,1393,1183,20200503,2576
20200430,9,김포공항,5203,8902,20200503,14105
20200430,9,공항시장,1778,1872,20200503,3650
20200430,9,신방화,3629,3242,20200503,6871
20200430,9,마곡나루,5011,4841,20200503,9852
20200430,9,양천향교,4471,4033,20200503,8504
20200430,9,가양,10887,9789,20200503,20676
20200430,9,증미,3211,3010,20200503,6221
20200430,9,등촌,5305,4885,20200503,10190
20200430,9,염창,8983,8006,20200503,16989
20200430,9,신목동,1723,1473,20200503,3196
20200430,9,선유도,3204,3189,20200503,6393
20200430,9,당산,9151,7966,20200503,17117
20200430,9,국회의사당,2801,2724,20200503,5525
20200430,9,여의도,5480,5419,20200503,10899
20200430,9,샛강,1985,1951,20200503,3936
20200430,9,노량진,17959,18177,20200503,36136
20200430,9,노들,2417,2016,20200503,4433
20200430,9,흑석,4279,4108,20200503,8387
20200430,9,동작,1159,1009,20200503,2168
20200430,9,구반포,1452,1550,20200503,3002
20200430,9,신반포,1403,1396,20200503,2799
20200430,9,고속터미널,9107,15236,20200503,24343
20200430,9,사평,1269,1140,20200503,2409
20200430,9,신논현,16558,16822,20200503,33380
20200501,9,신논현,19223,20437,20200504,39660
20200501,9,사평,1530,1395,20200504,2925
20200501,9,고속터미널,9737,14167,20200504,23904
20200501,9,신반포,1781,1723,20200504,3504
20200501,9,구반포,1487,1569,20200504,3056
20200501,9,동작,1193,1023,20200504,2216
20200501,9,흑석,4729,4615,20200504,9344
20200501,9,노들,2748,2191,20200504,4939
20200501,9,노량진,18943,19562,20200504,38505
20200501,9,샛강,2224,2308,20200504,4532
20200501,9,여의도,6040,5807,20200504,11847
20200501,9,국회의사당,4413,4387,20200504,8800
20200501,9,당산,9801,9165,20200504,18966
20200501,9,선유도,3195,3214,20200504,6409
20200501,9,신목동,1969,1669,20200504,3638
20200501,9,염창,9376,8741,20200504,18117
20200501,9,등촌,5629,5499,20200504,11128
20200501,9,증미,3353,3203,20200504,6556
20200501,9,가양,11490,10854,20200504,22344
20200501,9,양천향교,4558,4377,20200504,8935
20200501,9,마곡나루,5142,5152,20200504,10294
20200501,9,신방화,4028,3714,20200504,7742
20200501,9,공항시장,1974,2028,20200504,4002
20200501,9,김포공항,5445,7945,20200504,13390
20200501,9,개화,1455,1070,20200504,2525
20200502,9,개화,1242,1085,20200505,2327
20200502,9,김포공항,5352,6784,20200505,12136
20200502,9,공항시장,1855,1967,20200505,3822
20200502,9,신방화,3702,3448,20200505,7150
20200502,9,마곡나루,5377,5414,20200505,10791
20200502,9,양천향교,4239,3968,20200505,8207
20200502,9,가양,10760,10189,20200505,20949
20200502,9,증미,3011,3019,20200505,6030
20200502,9,등촌,5196,5137,20200505,10333
20200502,9,염창,8873,8308,20200505,17181
20200502,9,신목동,1678,1521,20200505,3199
20200502,9,선유도,2918,2887,20200505,5805
20200502,9,당산,9128,8576,20200505,17704
20200502,9,국회의사당,2591,2431,20200505,5022
20200502,9,여의도,5665,5577,20200505,11242
20200502,9,샛강,2003,1945,20200505,3948
20200502,9,노량진,18439,19045,20200505,37484
20200502,9,노들,2516,2052,20200505,4568
20200502,9,흑석,4383,4357,20200505,8740
20200502,9,동작,951,784,20200505,1735
20200502,9,구반포,1472,1547,20200505,3019
20200502,9,신반포,1544,1553,20200505,3097
20200502,9,고속터미널,10229,14446,20200505,24675
20200502,9,사평,1337,1282,20200505,2619
20200502,9,신논현,18705,19361,20200505,38066
20200503,9,샛강,1373,1377,20200506,2750
20200503,9,신논현,12343,12165,20200506,24508
20200503,9,사평,864,907,20200506,1771
20200503,9,고속터미널,9358,11299,20200506,20657
20200503,9,신반포,1111,1203,20200506,2314
20200503,9,구반포,1006,1075,20200506,2081
20200503,9,동작,815,700,20200506,1515
20200503,9,흑석,3180,3338,20200506,6518
20200503,9,노들,2054,1870,20200506,3924
20200503,9,노량진,13336,14789,20200506,28125
20200503,9,여의도,4213,4314,20200506,8527
20200503,9,국회의사당,3233,2888,20200506,6121
20200503,9,당산,6912,7014,20200506,13926
20200503,9,선유도,2241,2317,20200506,4558
20200503,9,신목동,1334,1211,20200506,2545
20200503,9,염창,6739,6846,20200506,13585
20200503,9,등촌,3931,4118,20200506,8049
20200503,9,증미,2386,2518,20200506,4904
20200503,9,가양,8575,8717,20200506,17292
20200503,9,양천향교,3029,3376,20200506,6405
20200503,9,마곡나루,3969,4263,20200506,8232
20200503,9,신방화,2878,2863,20200506,5741
20200503,9,공항시장,1452,1595,20200506,3047
20200503,9,김포공항,5955,6327,20200506,12282
20200503,9,개화,1036,988,20200506,2024
20200504,9,신논현,25682,27436,20200507,53118
20200504,9,사평,2356,2231,20200507,4587
20200504,9,고속터미널,10743,13584,20200507,24327
20200504,9,신반포,2249,2239,20200507,4488
20200504,9,구반포,2160,2304,20200507,4464
20200504,9,동작,1388,1141,20200507,2529
20200504,9,흑석,6587,6951,20200507,13538
20200504,9,노들,3612,3073,20200507,6685
20200504,9,노량진,23403,24163,20200507,47566
20200504,9,샛강,4336,4514,20200507,8850
20200504,9,여의도,17796,17283,20200507,35079
20200504,9,국회의사당,11094,11187,20200507,22281
20200504,9,당산,14345,14310,20200507,28655
20200504,9,선유도,5505,5344,20200507,10849
20200504,9,신목동,3070,2587,20200507,5657
20200504,9,염창,13591,13065,20200507,26656
20200504,9,등촌,8644,8533,20200507,17177
20200504,9,증미,5480,5460,20200507,10940
20200504,9,가양,16682,16112,20200507,32794
20200504,9,양천향교,7269,7559,20200507,14828
20200504,9,마곡나루,7282,7399,20200507,14681
20200504,9,신방화,5661,5510,20200507,11171
20200504,9,공항시장,2564,2729,20200507,5293
20200504,9,김포공항,6486,6445,20200507,12931
20200504,9,개화,2013,1481,20200507,3494
20200505,9,개화,1142,1028,20200508,2170
20200505,9,김포공항,6102,6298,20200508,12400
20200505,9,공항시장,1576,1718,20200508,3294
20200505,9,신방화,3160,3055,20200508,6215
20200505,9,마곡나루,4653,4810,20200508,9463
20200505,9,양천향교,3472,3799,20200508,7271
20200505,9,가양,9060,8776,20200508,17836
20200505,9,증미,2755,2763,20200508,5518
20200505,9,등촌,4537,4570,20200508,9107
20200505,9,염창,7464,7418,20200508,14882
20200505,9,신목동,1534,1434,20200508,2968
20200505,9,선유도,2561,2641,20200508,5202
20200505,9,당산,7647,7374,20200508,15021
20200505,9,국회의사당,2342,2324,20200508,4666
20200505,9,여의도,4751,4626,20200508,9377
20200505,9,샛강,1685,1701,20200508,3386
20200505,9,노량진,15806,16706,20200508,32512
20200505,9,노들,2047,1768,20200508,3815
20200505,9,흑석,3551,3651,20200508,7202
20200505,9,동작,865,720,20200508,1585
20200505,9,구반포,1078,1200,20200508,2278
20200505,9,신반포,1196,1183,20200508,2379
20200505,9,고속터미널,8550,10998,20200508,19548
20200505,9,사평,1088,1090,20200508,2178
20200505,9,신논현,13183,13287,20200508,26470
20200506,9,신논현,30892,31113,20200509,62005
20200506,9,사평,2842,2843,20200509,5685
20200506,9,고속터미널,11051,13850,20200509,24901
20200506,9,신반포,2563,2664,20200509,5227
20200506,9,구반포,2649,2805,20200509,5454
20200506,9,동작,1841,1507,20200509,3348
20200506,9,흑석,7355,7715,20200509,15070
20200506,9,노들,4251,3742,20200509,7993
20200506,9,노량진,25987,26118,20200509,52105
20200506,9,샛강,5306,5728,20200509,11034
20200506,9,여의도,23648,23408,20200509,47056
20200506,9,국회의사당,16374,16711,20200509,33085
20200506,9,당산,17755,17673,20200509,35428
20200506,9,선유도,7615,7517,20200509,15132
20200506,9,신목동,3802,3446,20200509,7248
20200506,9,염창,17003,16379,20200509,33382
20200506,9,등촌,10210,10105,20200509,20315
20200506,9,증미,6752,6770,20200509,13522
20200506,9,가양,20060,19347,20200509,39407
20200506,9,양천향교,9037,9332,20200509,18369
20200506,9,마곡나루,9666,9834,20200509,19500
20200506,9,신방화,6581,6364,20200509,12945
20200506,9,공항시장,2760,3073,20200509,5833
20200506,9,김포공항,6452,7286,20200509,13738
20200506,9,개화,2574,1828,20200509,4402
20200507,9,개화,2503,1840,20200510,4343
20200507,9,신논현,31212,32118,20200510,63330
20200507,9,사평,2960,2821,20200510,5781
20200507,9,고속터미널,11451,14760,20200510,26211
20200507,9,신반포,2710,2671,20200510,5381
20200507,9,구반포,2675,2858,20200510,5533
20200507,9,동작,2048,1636,20200510,3684
20200507,9,흑석,7469,7706,20200510,15175
20200507,9,노들,4383,3662,20200510,8045
20200507,9,노량진,26402,26096,20200510,52498
20200507,9,샛강,5527,5971,20200510,11498
20200507,9,여의도,24160,23933,20200510,48093
20200507,9,국회의사당,16165,16674,20200510,32839
20200507,9,당산,18023,17631,20200510,35654
20200507,9,선유도,7665,7495,20200510,15160
20200507,9,신목동,4004,3509,20200510,7513
20200507,9,염창,17200,16680,20200510,33880
20200507,9,등촌,10306,10151,20200510,20457
20200507,9,증미,6978,6832,20200510,13810
20200507,9,가양,20270,19311,20200510,39581
20200507,9,양천향교,9271,9532,20200510,18803
20200507,9,마곡나루,9790,9791,20200510,19581
20200507,9,신방화,6635,6293,20200510,12928
20200507,9,공항시장,2750,3050,20200510,5800
20200507,9,김포공항,6160,7744,20200510,13904
20200508,9,개화,2720,1944,20200511,4664
20200508,9,김포공항,6807,8486,20200511,15293
20200508,9,공항시장,2753,3096,20200511,5849
20200508,9,신방화,6843,6606,20200511,13449
20200508,9,마곡나루,10130,9775,20200511,19905
20200508,9,양천향교,9320,9354,20200511,18674
20200508,9,가양,20650,19991,20200511,40641
20200508,9,증미,7150,7128,20200511,14278
20200508,9,등촌,10483,10700,20200511,21183
20200508,9,염창,17375,17036,20200511,34411
20200508,9,신목동,4053,3634,20200511,7687
20200508,9,선유도,7926,7563,20200511,15489
20200508,9,당산,18921,18103,20200511,37024
20200508,9,국회의사당,17968,16472,20200511,34440
20200508,9,여의도,25255,23382,20200511,48637
20200508,9,샛강,5917,5859,20200511,11776
20200508,9,노량진,27827,27797,20200511,55624
20200508,9,노들,4473,3836,20200511,8309
20200508,9,흑석,7810,8215,20200511,16025
20200508,9,동작,2039,1648,20200511,3687
20200508,9,구반포,2723,2927,20200511,5650
20200508,9,신반포,2776,2815,20200511,5591
20200508,9,고속터미널,12443,18064,20200511,30507
20200508,9,사평,3120,3043,20200511,6163
20200508,9,신논현,33039,33809,20200511,66848
20200509,9,개화,1162,969,20200512,2131
20200509,9,김포공항,5013,6708,20200512,11721
20200509,9,공항시장,1925,2029,20200512,3954
20200509,9,신방화,3919,3751,20200512,7670
20200509,9,마곡나루,5436,5473,20200512,10909
20200509,9,양천향교,4578,4409,20200512,8987
20200509,9,가양,11204,10605,20200512,21809
20200509,9,증미,3151,3017,20200512,6168
20200509,9,등촌,5431,5379,20200512,10810
20200509,9,염창,9411,8604,20200512,18015
20200509,9,신목동,1847,1589,20200512,3436
20200509,9,선유도,2874,2779,20200512,5653
20200509,9,당산,10248,9467,20200512,19715
20200509,9,국회의사당,3189,3297,20200512,6486
20200509,9,여의도,6564,6204,20200512,12768
20200509,9,샛강,2048,2003,20200512,4051
20200509,9,노량진,18350,18722,20200512,37072
20200509,9,노들,2538,2174,20200512,4712
20200509,9,흑석,4421,4517,20200512,8938
20200509,9,동작,1043,799,20200512,1842
20200509,9,구반포,1747,1802,20200512,3549
20200509,9,신반포,1502,1464,20200512,2966
20200509,9,고속터미널,9411,13702,20200512,23113
20200509,9,사평,1529,1328,20200512,2857
20200509,9,신논현,20397,21401,20200512,41798
20200510,9,개화,981,877,20200513,1858
20200510,9,김포공항,4956,6606,20200513,11562
20200510,9,공항시장,1546,1679,20200513,3225
20200510,9,신방화,3002,2945,20200513,5947
20200510,9,마곡나루,4334,4387,20200513,8721
20200510,9,양천향교,3272,3599,20200513,6871
20200510,9,가양,9024,8750,20200513,17774
20200510,9,증미,2060,2152,20200513,4212
20200510,9,등촌,4061,4179,20200513,8240
20200510,9,염창,7228,7151,20200513,14379
20200510,9,신목동,1452,1319,20200513,2771
20200510,9,선유도,2348,2327,20200513,4675
20200510,9,당산,7609,7397,20200513,15006
20200510,9,국회의사당,3893,3400,20200513,7293
20200510,9,여의도,4763,4572,20200513,9335
20200510,9,샛강,1540,1574,20200513,3114
20200510,9,노량진,13314,14487,20200513,27801
20200510,9,노들,2031,1956,20200513,3987
20200510,9,흑석,3530,3726,20200513,7256
20200510,9,동작,1061,862,20200513,1923
20200510,9,구반포,1329,1484,20200513,2813
20200510,9,신반포,1151,1222,20200513,2373
20200510,9,고속터미널,8839,11423,20200513,20262
20200510,9,사평,995,1041,20200513,2036
20200510,9,신논현,12572,12166,20200513,24738
20200511,9,신논현,29581,29801,20200514,59382
20200511,9,사평,2780,2715,20200514,5495
20200511,9,고속터미널,10534,13116,20200514,23650
20200511,9,신반포,2526,2574,20200514,5100
20200511,9,구반포,2623,2760,20200514,5383
20200511,9,동작,1773,1437,20200514,3210
20200511,9,흑석,7248,7696,20200514,14944
20200511,9,노들,4069,3541,20200514,7610
20200511,9,노량진,24835,24811,20200514,49646
20200511,9,샛강,5489,5727,20200514,11216
20200511,9,여의도,23666,23150,20200514,46816
20200511,9,국회의사당,16534,16646,20200514,33180
20200511,9,당산,17223,17125,20200514,34348
20200511,9,선유도,7682,7540,20200514,15222
20200511,9,신목동,3785,3451,20200514,7236
20200511,9,염창,16369,16121,20200514,32490
20200511,9,등촌,10106,10132,20200514,20238
20200511,9,증미,6979,7019,20200514,13998
20200511,9,가양,19934,19488,20200514,39422
20200511,9,양천향교,8828,9344,20200514,18172
20200511,9,마곡나루,9379,9546,20200514,18925
20200511,9,신방화,6576,6417,20200514,12993
20200511,9,공항시장,2700,3000,20200514,5700
20200511,9,김포공항,5797,7286,20200514,13083
20200511,9,개화,2599,1849,20200514,4448
20200512,9,개화,2552,1881,20200515,4433
20200512,9,김포공항,5677,7199,20200515,12876
20200512,9,공항시장,2596,2925,20200515,5521
20200512,9,신방화,6484,6271,20200515,12755
20200512,9,마곡나루,9527,9639,20200515,19166
20200512,9,양천향교,8767,8976,20200515,17743
20200512,9,가양,19540,19109,20200515,38649
20200512,9,증미,6751,6773,20200515,13524
20200512,9,등촌,10051,9977,20200515,20028
20200512,9,염창,16419,16137,20200515,32556
20200512,9,신목동,3921,3521,20200515,7442
20200512,9,선유도,7538,7265,20200515,14803
20200512,9,당산,17129,17276,20200515,34405
20200512,9,국회의사당,15995,16167,20200515,32162
20200512,9,여의도,23765,22952,20200515,46717
20200512,9,샛강,5324,5683,20200515,11007
20200512,9,노량진,24953,24763,20200515,49716
20200512,9,노들,4162,3539,20200515,7701
20200512,9,흑석,7278,7615,20200515,14893
20200512,9,동작,1770,1458,20200515,3228
20200512,9,구반포,2501,2705,20200515,5206
20200512,9,신반포,2448,2529,20200515,4977
20200512,9,고속터미널,9986,12478,20200515,22464
20200512,9,사평,2782,2779,20200515,5561
20200512,9,신논현,29249,29752,20200515,59001
20200513,9,개화,2510,1776,20200516,4286
20200513,9,김포공항,5958,7484,20200516,13442
20200513,9,공항시장,2754,3030,20200516,5784
20200513,9,신방화,6478,6287,20200516,12765
20200513,9,마곡나루,9782,9830,20200516,19612
20200513,9,양천향교,8929,9105,20200516,18034
20200513,9,가양,19799,19063,20200516,38862
20200513,9,증미,6676,6645,20200516,13321
20200513,9,등촌,10133,10070,20200516,20203
20200513,9,염창,16527,16368,20200516,32895
20200513,9,신목동,3991,3619,20200516,7610
20200513,9,선유도,7715,7516,20200516,15231
20200513,9,당산,17447,17460,20200516,34907
20200513,9,국회의사당,16449,16526,20200516,32975
20200513,9,여의도,23811,23459,20200516,47270
20200513,9,샛강,5388,5531,20200516,10919
20200513,9,노량진,25305,25329,20200516,50634
20200513,9,노들,4197,3630,20200516,7827
20200513,9,흑석,7442,7921,20200516,15363
20200513,9,동작,1775,1413,20200516,3188
20200513,9,구반포,2601,2746,20200516,5347
20200513,9,신반포,2627,2611,20200516,5238
20200513,9,고속터미널,10541,13380,20200516,23921
20200513,9,사평,2839,2705,20200516,5544
20200513,9,신논현,29491,29717,20200516,59208
20200514,9,신목동,3888,3420,20200517,7308
20200514,9,사평,2788,2679,20200517,5467
20200514,9,신논현,29020,29792,20200517,58812
20200514,9,등촌,10082,9885,20200517,19967
20200514,9,증미,6869,6756,20200517,13625
20200514,9,가양,19476,19077,20200517,38553
20200514,9,양천향교,8983,9292,20200517,18275
20200514,9,마곡나루,9619,9659,20200517,19278
20200514,9,신방화,6416,6233,20200517,12649
20200514,9,공항시장,2657,2932,20200517,5589
20200514,9,김포공항,6240,7775,20200517,14015
20200514,9,개화,2450,1785,20200517,4235
20200514,9,염창,16587,16133,20200517,32720
20200514,9,선유도,7522,7331,20200517,14853
20200514,9,당산,17467,17359,20200517,34826
20200514,9,국회의사당,15628,15924,20200517,31552
20200514,9,여의도,23587,23352,20200517,46939
20200514,9,샛강,5455,5674,20200517,11129
20200514,9,노량진,25223,24912,20200517,50135
20200514,9,노들,4177,3550,20200517,7727
20200514,9,흑석,7480,7894,20200517,15374
20200514,9,동작,1753,1457,20200517,3210
20200514,9,구반포,2491,2680,20200517,5171
20200514,9,신반포,2470,2528,20200517,4998
20200514,9,고속터미널,10390,13235,20200517,23625
20200515,9,신논현,30208,31442,20200518,61650
20200515,9,사평,2919,2787,20200518,5706
20200515,9,고속터미널,10436,14548,20200518,24984
20200515,9,신반포,2562,2478,20200518,5040
20200515,9,구반포,2611,2740,20200518,5351
20200515,9,동작,1538,1277,20200518,2815
20200515,9,흑석,7352,7740,20200518,15092
20200515,9,노들,4069,3460,20200518,7529
20200515,9,노량진,25129,25145,20200518,50274
20200515,9,샛강,5352,5577,20200518,10929
20200515,9,여의도,23803,22361,20200518,46164
20200515,9,국회의사당,16735,16424,20200518,33159
20200515,9,당산,17601,17269,20200518,34870
20200515,9,선유도,7544,7372,20200518,14916
20200515,9,신목동,3699,3392,20200518,7091
20200515,9,염창,16303,15777,20200518,32080
20200515,9,등촌,9961,9907,20200518,19868
20200515,9,증미,6855,6722,20200518,13577
20200515,9,가양,19337,18698,20200518,38035
20200515,9,양천향교,8860,8937,20200518,17797
20200515,9,마곡나루,9843,9942,20200518,19785
20200515,9,신방화,6357,6191,20200518,12548
20200515,9,공항시장,2713,2966,20200518,5679
20200515,9,김포공항,6277,8001,20200518,14278
20200515,9,개화,2366,1659,20200518,4025
20200516,9,신논현,20154,20449,20200519,40603
20200516,9,사평,1527,1466,20200519,2993
20200516,9,고속터미널,9560,13541,20200519,23101
20200516,9,신반포,1783,1762,20200519,3545
20200516,9,구반포,2046,2139,20200519,4185
20200516,9,동작,1305,1131,20200519,2436
20200516,9,흑석,5076,5120,20200519,10196
20200516,9,노들,2771,2363,20200519,5134
20200516,9,노량진,18827,19272,20200519,38099
20200516,9,샛강,2284,2279,20200519,4563
20200516,9,여의도,7165,7015,20200519,14180
20200516,9,국회의사당,3192,3310,20200519,6502
20200516,9,당산,10860,10230,20200519,21090
20200516,9,선유도,3198,3073,20200519,6271
20200516,9,신목동,1970,1745,20200519,3715
20200516,9,염창,9887,9185,20200519,19072
20200516,9,등촌,6038,5813,20200519,11851
20200516,9,증미,3384,3216,20200519,6600
20200516,9,가양,12179,11562,20200519,23741
20200516,9,양천향교,4848,4526,20200519,9374
20200516,9,마곡나루,5948,6057,20200519,12005
20200516,9,신방화,4111,3981,20200519,8092
20200516,9,공항시장,2001,2133,20200519,4134
20200516,9,김포공항,5277,7382,20200519,12659
20200516,9,개화,1252,1065,20200519,2317
20200517,9,신논현,12106,11831,20200520,23937
20200517,9,사평,1000,1011,20200520,2011
20200517,9,고속터미널,8157,10978,20200520,19135
20200517,9,신반포,1266,1317,20200520,2583
20200517,9,구반포,1108,1207,20200520,2315
20200517,9,동작,1077,914,20200520,1991
20200517,9,흑석,3446,3677,20200520,7123
20200517,9,노들,2077,1942,20200520,4019
20200517,9,노량진,13293,14489,20200520,27782
20200517,9,샛강,1619,1611,20200520,3230
20200517,9,여의도,5314,4856,20200520,10170
20200517,9,국회의사당,3677,3406,20200520,7083
20200517,9,당산,7785,7426,20200520,15211
20200517,9,선유도,2425,2336,20200520,4761
20200517,9,신목동,1571,1411,20200520,2982
20200517,9,염창,7362,7136,20200520,14498
20200517,9,등촌,4348,4433,20200520,8781
20200517,9,증미,2366,2463,20200520,4829
20200517,9,가양,9117,8915,20200520,18032
20200517,9,양천향교,3399,3575,20200520,6974
20200517,9,마곡나루,4500,4526,20200520,9026
20200517,9,신방화,3073,2974,20200520,6047
20200517,9,공항시장,1589,1722,20200520,3311
20200517,9,김포공항,5005,6476,20200520,11481
20200517,9,개화,1088,948,20200520,2036
20200518,9,개화,2471,1748,20200521,4219
20200518,9,김포공항,5897,7326,20200521,13223
20200518,9,공항시장,2618,2962,20200521,5580
20200518,9,신방화,6350,6351,20200521,12701
20200518,9,마곡나루,9222,9148,20200521,18370
20200518,9,양천향교,8730,9080,20200521,17810
20200518,9,가양,19003,18513,20200521,37516
20200518,9,증미,6745,6817,20200521,13562
20200518,9,등촌,9921,10155,20200521,20076
20200518,9,염창,15814,15631,20200521,31445
20200518,9,신목동,3687,3460,20200521,7147
20200518,9,선유도,7434,7126,20200521,14560
20200518,9,당산,16386,16807,20200521,33193
20200518,9,국회의사당,16605,15981,20200521,32586
20200518,9,여의도,23088,22236,20200521,45324
20200518,9,샛강,5479,5624,20200521,11103
20200518,9,노량진,24352,24042,20200521,48394
20200518,9,노들,4069,3656,20200521,7725
20200518,9,흑석,6949,7549,20200521,14498
20200518,9,동작,1757,1465,20200521,3222
20200518,9,구반포,2465,2650,20200521,5115
20200518,9,신반포,2456,2470,20200521,4926
20200518,9,고속터미널,9619,11971,20200521,21590
20200518,9,사평,2747,2834,20200521,5581
20200518,9,신논현,28400,28409,20200521,56809
20200519,9,국회의사당,15938,16542,20200522,32480
20200519,9,당산,17167,17089,20200522,34256
20200519,9,선유도,7473,7225,20200522,14698
20200519,9,신목동,3809,3390,20200522,7199
20200519,9,염창,15898,15784,20200522,31682
20200519,9,등촌,10072,9805,20200522,19877
20200519,9,증미,6705,6666,20200522,13371
20200519,9,가양,19170,18563,20200522,37733
20200519,9,양천향교,8809,9077,20200522,17886
20200519,9,마곡나루,9631,9614,20200522,19245
20200519,9,신방화,6416,6248,20200522,12664
20200519,9,공항시장,2658,2923,20200522,5581
20200519,9,김포공항,5908,7327,20200522,13235
20200519,9,개화,2367,1701,20200522,4068
20200519,9,신논현,28868,29339,20200522,58207
20200519,9,사평,2790,2660,20200522,5450
20200519,9,고속터미널,9617,12097,20200522,21714
20200519,9,신반포,2455,2458,20200522,4913
20200519,9,구반포,2545,2773,20200522,5318
20200519,9,동작,1656,1327,20200522,2983
20200519,9,흑석,7256,7540,20200522,14796
20200519,9,노들,4135,3524,20200522,7659
20200519,9,노량진,24870,24587,20200522,49457
20200519,9,샛강,5283,5695,20200522,10978
20200519,9,여의도,23388,22903,20200522,46291
20200520,9,신논현,30184,30701,20200523,60885
20200520,9,사평,2867,2809,20200523,5676
20200520,9,고속터미널,10648,13381,20200523,24029
20200520,9,신반포,2665,2736,20200523,5401
20200520,9,구반포,2728,2815,20200523,5543
20200520,9,동작,1941,1661,20200523,3602
20200520,9,흑석,7547,7928,20200523,15475
20200520,9,노들,4381,3815,20200523,8196
20200520,9,노량진,26340,26295,20200523,52635
20200520,9,샛강,5384,5741,20200523,11125
20200520,9,여의도,24255,23685,20200523,47940
20200520,9,국회의사당,16198,16505,20200523,32703
20200520,9,당산,17646,17541,20200523,35187
20200520,9,선유도,7696,7348,20200523,15044
20200520,9,신목동,4011,3551,20200523,7562
20200520,9,염창,16833,16480,20200523,33313
20200520,9,등촌,10429,10305,20200523,20734
20200520,9,증미,6744,6808,20200523,13552
20200520,9,가양,20306,19660,20200523,39966
20200520,9,양천향교,9099,9303,20200523,18402
20200520,9,마곡나루,9945,9944,20200523,19889
20200520,9,신방화,6688,6456,20200523,13144
20200520,9,공항시장,2784,3078,20200523,5862
20200520,9,김포공항,5945,7933,20200523,13878
20200520,9,개화,2546,1813,20200523,4359
20200521,9,신논현,30232,30726,20200524,60958
20200521,9,사평,2964,2845,20200524,5809
20200521,9,고속터미널,10752,13850,20200524,24602
20200521,9,신반포,2569,2685,20200524,5254
20200521,9,구반포,2724,2881,20200524,5605
20200521,9,동작,1919,1523,20200524,3442
20200521,9,흑석,7474,7875,20200524,15349
20200521,9,노들,4381,3724,20200524,8105
20200521,9,노량진,26081,25748,20200524,51829
20200521,9,샛강,5347,5775,20200524,11122
20200521,9,여의도,24109,23747,20200524,47856
20200521,9,국회의사당,16116,16539,20200524,32655
20200521,9,당산,17795,17687,20200524,35482
20200521,9,선유도,7624,7327,20200524,14951
20200521,9,신목동,3906,3409,20200524,7315
20200521,9,염창,16871,16361,20200524,33232
20200521,9,등촌,10380,9965,20200524,20345
20200521,9,증미,6713,6742,20200524,13455
20200521,9,가양,20292,19588,20200524,39880
20200521,9,양천향교,9061,9409,20200524,18470
20200521,9,마곡나루,10152,10066,20200524,20218
20200521,9,신방화,6752,6425,20200524,13177
20200521,9,공항시장,2713,2991,20200524,5704
20200521,9,김포공항,6139,8547,20200524,14686
20200521,9,개화,2516,1817,20200524,4333
20200522,9,개화,2573,1862,20200525,4435
20200522,9,김포공항,6461,9343,20200525,15804
20200522,9,공항시장,2816,3073,20200525,5889
20200522,9,신방화,6708,6381,20200525,13089
20200522,9,마곡나루,10356,10256,20200525,20612
20200522,9,양천향교,9044,9058,20200525,18102
20200522,9,가양,20450,19558,20200525,40008
20200522,9,증미,6942,6789,20200525,13731
20200522,9,등촌,10390,10245,20200525,20635
20200522,9,염창,17275,16375,20200525,33650
20200522,9,신목동,3910,3431,20200525,7341
20200522,9,선유도,7447,7238,20200525,14685
20200522,9,당산,18384,18324,20200525,36708
20200522,9,국회의사당,17209,16952,20200525,34161
20200522,9,여의도,24859,23604,20200525,48463
20200522,9,샛강,5410,5680,20200525,11090
20200522,9,노량진,27176,27282,20200525,54458
20200522,9,노들,4416,3634,20200525,8050
20200522,9,흑석,7795,8116,20200525,15911
20200522,9,동작,1973,1560,20200525,3533
20200522,9,구반포,2727,2946,20200525,5673
20200522,9,신반포,2812,2747,20200525,5559
20200522,9,고속터미널,11933,16134,20200525,28067
20200522,9,사평,3077,2899,20200525,5976
20200522,9,신논현,31827,33550,20200525,65377
20200523,9,개화,1409,1207,20200526,2616
20200523,9,김포공항,6022,8201,20200526,14223
20200523,9,공항시장,2169,2174,20200526,4343
20200523,9,신방화,4291,4163,20200526,8454
20200523,9,마곡나루,6566,6583,20200526,13149
20200523,9,양천향교,5204,5071,20200526,10275
20200523,9,가양,13282,12680,20200526,25962
20200523,9,증미,3747,3660,20200526,7407
20200523,9,등촌,6619,6297,20200526,12916
20200523,9,염창,10850,10061,20200526,20911
20200523,9,신목동,2305,1936,20200526,4241
20200523,9,선유도,3785,3813,20200526,7598
20200523,9,당산,11781,11161,20200526,22942
20200523,9,국회의사당,3727,3695,20200526,7422
20200523,9,여의도,8334,8094,20200526,16428
20200523,9,샛강,2567,2484,20200526,5051
20200523,9,노량진,21588,22291,20200526,43879
20200523,9,노들,3190,2643,20200526,5833
20200523,9,흑석,5282,5322,20200526,10604
20200523,9,동작,1651,1358,20200526,3009
20200523,9,구반포,2118,2225,20200526,4343
20200523,9,신반포,2123,2175,20200526,4298
20200523,9,고속터미널,11319,16030,20200526,27349
20200523,9,사평,1708,1546,20200526,3254
20200523,9,신논현,21365,21801,20200526,43166
20200524,9,신논현,11774,11460,20200527,23234
20200524,9,사평,959,1014,20200527,1973
20200524,9,고속터미널,8395,10744,20200527,19139
20200524,9,신반포,1198,1327,20200527,2525
20200524,9,구반포,1298,1365,20200527,2663
20200524,9,동작,970,906,20200527,1876
20200524,9,흑석,3305,3546,20200527,6851
20200524,9,노들,2151,1823,20200527,3974
20200524,9,노량진,13818,14903,20200527,28721
20200524,9,샛강,1753,1744,20200527,3497
20200524,9,여의도,4853,4727,20200527,9580
20200524,9,국회의사당,4026,3594,20200527,7620
20200524,9,당산,7362,7225,20200527,14587
20200524,9,선유도,2355,2257,20200527,4612
20200524,9,신목동,1357,1258,20200527,2615
20200524,9,염창,7241,6992,20200527,14233
20200524,9,등촌,4047,4116,20200527,8163
20200524,9,증미,2065,2094,20200527,4159
20200524,9,가양,9031,8828,20200527,17859
20200524,9,양천향교,3461,3640,20200527,7101
20200524,9,마곡나루,4587,4559,20200527,9146
20200524,9,신방화,3104,2967,20200527,6071
20200524,9,공항시장,1829,1800,20200527,3629
20200524,9,김포공항,6353,7558,20200527,13911
20200524,9,개화,984,838,20200527,1822
20200525,9,신논현,29480,29698,20200528,59178
20200525,9,사평,2854,2744,20200528,5598
20200525,9,고속터미널,10465,13234,20200528,23699
20200525,9,신반포,2655,2722,20200528,5377
20200525,9,구반포,2808,2921,20200528,5729
20200525,9,동작,1892,1611,20200528,3503
20200525,9,흑석,7417,7949,20200528,15366
20200525,9,노들,4309,3732,20200528,8041
20200525,9,노량진,25542,25407,20200528,50949
20200525,9,샛강,5261,5589,20200528,10850
20200525,9,여의도,23612,23235,20200528,46847
20200525,9,국회의사당,16185,16536,20200528,32721
20200525,9,당산,17190,17130,20200528,34320
20200525,9,선유도,7614,7465,20200528,15079
20200525,9,신목동,3857,3433,20200528,7290
20200525,9,염창,16545,16393,20200528,32938
20200525,9,등촌,10101,10060,20200528,20161
20200525,9,증미,6861,6905,20200528,13766
20200525,9,가양,20320,19836,20200528,40156
20200525,9,양천향교,8798,9111,20200528,17909
20200525,9,마곡나루,9467,9598,20200528,19065
20200525,9,신방화,6450,6277,20200528,12727
20200525,9,공항시장,2747,3046,20200528,5793
20200525,9,김포공항,6274,8006,20200528,14280
20200525,9,개화,2619,1792,20200528,4411
20200526,9,신논현,29751,30252,20200529,60003
20200526,9,사평,2968,2886,20200529,5854
20200526,9,고속터미널,10198,12734,20200529,22932
20200526,9,신반포,2626,2670,20200529,5296
20200526,9,구반포,2765,2904,20200529,5669
20200526,9,동작,1930,1535,20200529,3465
20200526,9,흑석,7542,8094,20200529,15636
20200526,9,노들,4330,3831,20200529,8161
20200526,9,노량진,25864,25641,20200529,51505
20200526,9,샛강,5538,5714,20200529,11252
20200526,9,여의도,24376,23560,20200529,47936
20200526,9,국회의사당,17121,17088,20200529,34209
20200526,9,당산,17380,17406,20200529,34786
20200526,9,선유도,7879,7543,20200529,15422
20200526,9,신목동,3999,3524,20200529,7523
20200526,9,염창,16633,16315,20200529,32948
20200526,9,등촌,10293,10273,20200529,20566
20200526,9,증미,6824,6877,20200529,13701
20200526,9,가양,20219,19563,20200529,39782
20200526,9,양천향교,8899,9205,20200529,18104
20200526,9,마곡나루,9883,9800,20200529,19683
20200526,9,신방화,6532,6445,20200529,12977
20200526,9,공항시장,2740,3070,20200529,5810
20200526,9,김포공항,6255,7826,20200529,14081
20200526,9,개화,2499,1859,20200529,4358
20200527,9,신논현,30154,30523,20200530,60677
20200527,9,사평,3000,2838,20200530,5838
20200527,9,고속터미널,10847,13694,20200530,24541
20200527,9,신반포,2817,2837,20200530,5654
20200527,9,구반포,2785,2934,20200530,5719
20200527,9,동작,2034,1661,20200530,3695
20200527,9,흑석,7548,7987,20200530,15535
20200527,9,노들,4526,3852,20200530,8378
20200527,9,노량진,26363,26160,20200530,52523
20200527,9,샛강,5699,5882,20200530,11581
20200527,9,여의도,24571,24174,20200530,48745
20200527,9,국회의사당,16675,17134,20200530,33809
20200527,9,당산,18109,17973,20200530,36082
20200527,9,선유도,7964,7675,20200530,15639
20200527,9,신목동,4000,3571,20200530,7571
20200527,9,염창,16913,16565,20200530,33478
20200527,9,등촌,10454,10332,20200530,20786
20200527,9,증미,6914,6852,20200530,13766
20200527,9,가양,20527,19869,20200530,40396
20200527,9,양천향교,9103,9467,20200530,18570
20200527,9,마곡나루,9997,10088,20200530,20085
20200527,9,신방화,6704,6447,20200530,13151
20200527,9,공항시장,2752,3078,20200530,5830
20200527,9,김포공항,6128,7933,20200530,14061
20200527,9,개화,2577,1844,20200530,4421
20200528,9,신논현,29693,30242,20200531,59935
20200528,9,사평,2997,2876,20200531,5873
20200528,9,고속터미널,10880,13653,20200531,24533
20200528,9,신반포,2787,2825,20200531,5612
20200528,9,구반포,2779,2960,20200531,5739
20200528,9,동작,1947,1590,20200531,3537
20200528,9,흑석,7588,8001,20200531,15589
20200528,9,노들,4392,3683,20200531,8075
20200528,9,노량진,25437,24970,20200531,50407
20200528,9,샛강,5482,5780,20200531,11262
20200528,9,여의도,24232,23797,20200531,48029
20200528,9,국회의사당,16084,16378,20200531,32462
20200528,9,당산,17716,17550,20200531,35266
20200528,9,선유도,7603,7400,20200531,15003
20200528,9,신목동,3990,3517,20200531,7507
20200528,9,염창,16828,16319,20200531,33147
20200528,9,등촌,10182,10032,20200531,20214
20200528,9,증미,6802,6740,20200531,13542
20200528,9,가양,20288,19535,20200531,39823
20200528,9,양천향교,8448,8719,20200531,17167
20200528,9,마곡나루,9916,9907,20200531,19823
20200528,9,신방화,6456,6176,20200531,12632
20200528,9,공항시장,2720,2950,20200531,5670
20200528,9,김포공항,6201,8398,20200531,14599
20200528,9,개화,2482,1827,20200531,4309
20200529,9,개화,2534,1776,20200601,4310
20200529,9,김포공항,6656,9245,20200601,15901
20200529,9,공항시장,2768,2961,20200601,5729
20200529,9,신방화,6606,6317,20200601,12923
20200529,9,마곡나루,10119,10174,20200601,20293
20200529,9,양천향교,8678,8708,20200601,17386
20200529,9,가양,20254,19369,20200601,39623
20200529,9,증미,6879,6759,20200601,13638
20200529,9,등촌,10462,10080,20200601,20542
20200529,9,염창,16998,16417,20200601,33415
20200529,9,신목동,3976,3444,20200601,7420
20200529,9,선유도,7829,7515,20200601,15344
20200529,9,당산,18401,18080,20200601,36481
20200529,9,국회의사당,17216,17090,20200601,34306
20200529,9,여의도,23937,22627,20200601,46564
20200529,9,샛강,4987,5220,20200601,10207
20200529,9,노량진,26868,26081,20200601,52949
20200529,9,노들,4461,3739,20200601,8200
20200529,9,흑석,7828,7981,20200601,15809
20200529,9,동작,2065,1671,20200601,3736
20200529,9,구반포,2862,3043,20200601,5905
20200529,9,신반포,2983,3016,20200601,5999
20200529,9,고속터미널,11985,16768,20200601,28753
20200529,9,사평,3113,2940,20200601,6053
20200529,9,신논현,31731,32839,20200601,64570
20200530,9,개화,1297,1086,20200602,2383
20200530,9,김포공항,5664,8204,20200602,13868
20200530,9,공항시장,1972,2136,20200602,4108
20200530,9,신방화,4079,3781,20200602,7860
20200530,9,마곡나루,6300,6218,20200602,12518
20200530,9,양천향교,5018,4723,20200602,9741
20200530,9,가양,12732,11953,20200602,24685
20200530,9,증미,3416,3390,20200602,6806
20200530,9,등촌,6082,5815,20200602,11897
20200530,9,염창,10359,9446,20200602,19805
20200530,9,신목동,1975,1704,20200602,3679
20200530,9,선유도,3487,3580,20200602,7067
20200530,9,당산,11381,10571,20200602,21952
20200530,9,국회의사당,3505,3531,20200602,7036
20200530,9,여의도,7271,7068,20200602,14339
20200530,9,샛강,2229,2253,20200602,4482
20200530,9,노량진,20109,20452,20200602,40561
20200530,9,노들,2938,2495,20200602,5433
20200530,9,흑석,5015,5106,20200602,10121
20200530,9,동작,1745,1559,20200602,3304
20200530,9,구반포,2157,2397,20200602,4554
20200530,9,신반포,2049,2042,20200602,4091
20200530,9,고속터미널,10855,15553,20200602,26408
20200530,9,사평,1708,1607,20200602,3315
20200530,9,신논현,20811,21307,20200602,42118
20200531,9,신논현,12081,11617,20200603,23698
20200531,9,사평,1007,1059,20200603,2066
20200531,9,고속터미널,8252,10945,20200603,19197
20200531,9,신반포,1244,1301,20200603,2545
20200531,9,구반포,1095,1120,20200603,2215
20200531,9,동작,1355,1156,20200603,2511
20200531,9,흑석,3414,3617,20200603,7031
20200531,9,노들,2094,1879,20200603,3973
20200531,9,노량진,12987,14159,20200603,27146
20200531,9,샛강,1374,1367,20200603,2741
20200531,9,여의도,5029,4657,20200603,9686
20200531,9,국회의사당,4014,3593,20200603,7607
20200531,9,당산,7601,7379,20200603,14980
20200531,9,선유도,2476,2366,20200603,4842
20200531,9,신목동,1228,1185,20200603,2413
20200531,9,염창,7026,6811,20200603,13837
20200531,9,등촌,4031,4142,20200603,8173
20200531,9,증미,2396,2401,20200603,4797
20200531,9,가양,8943,8872,20200603,17815
20200531,9,양천향교,3207,3371,20200603,6578
20200531,9,마곡나루,4185,4268,20200603,8453
20200531,9,신방화,2901,2833,20200603,5734
20200531,9,공항시장,1577,1665,20200603,3242
20200531,9,김포공항,5401,7084,20200603,12485
20200531,9,개화,954,899,20200603,1853
20200101,9,중앙보훈병원,2911,2864,20200104,5775
20200101,9,둔촌오륜,333,354,20200104,687
20200101,9,올림픽공원,2371,2475,20200104,4846
20200101,9,한성백제,1482,1185,20200104,2667
20200101,9,송파나루,2060,2100,20200104,4160
20200101,9,석촌,3354,2750,20200104,6104
20200101,9,석촌고분,2533,2525,20200104,5058
20200101,9,삼전,2921,3037,20200104,5958
20200101,9,종합운동장,2212,1780,20200104,3992
20200101,9,봉은사,10651,10456,20200104,21107
20200101,9,삼성중앙,1724,1713,20200104,3437
20200101,9,선정릉,2246,2396,20200104,4642
20200101,9,언주,3261,2794,20200104,6055
20200102,9,언주,10594,10766,20200105,21360
20200102,9,선정릉,9739,10489,20200105,20228
20200102,9,삼성중앙,6955,7205,20200105,14160
20200102,9,봉은사,19242,19476,20200105,38718
20200102,9,종합운동장,4789,4474,20200105,9263
20200102,9,삼전,6319,6340,20200105,12659
20200102,9,석촌고분,5595,5622,20200105,11217
20200102,9,석촌,7641,6610,20200105,14251
20200102,9,송파나루,4327,4559,20200105,8886
20200102,9,한성백제,2404,2231,20200105,4635
20200102,9,올림픽공원,5431,5290,20200105,10721
20200102,9,둔촌오륜,1130,1022,20200105,2152
20200102,9,중앙보훈병원,10286,9400,20200105,19686
20200103,9,언주,11527,11409,20200106,22936
20200103,9,선정릉,10372,11116,20200106,21488
20200103,9,삼성중앙,7696,7852,20200106,15548
20200103,9,봉은사,21703,21851,20200106,43554
20200103,9,종합운동장,5183,5069,20200106,10252
20200103,9,삼전,6891,6709,20200106,13600
20200103,9,석촌고분,5781,5787,20200106,11568
20200103,9,석촌,8034,6853,20200106,14887
20200103,9,송파나루,4615,4925,20200106,9540
20200103,9,한성백제,2597,2316,20200106,4913
20200103,9,올림픽공원,6050,5906,20200106,11956
20200103,9,둔촌오륜,1200,1091,20200106,2291
20200103,9,중앙보훈병원,10542,9525,20200106,20067
20200104,9,언주,6213,5962,20200107,12175
20200104,9,선정릉,5175,5652,20200107,10827
20200104,9,삼성중앙,3344,3271,20200107,6615
20200104,9,봉은사,15832,16120,20200107,31952
20200104,9,종합운동장,3764,3147,20200107,6911
20200104,9,삼전,5014,4663,20200107,9677
20200104,9,석촌고분,4308,4017,20200107,8325
20200104,9,석촌,6213,4958,20200107,11171
20200104,9,송파나루,3819,3909,20200107,7728
20200104,9,한성백제,2109,1850,20200107,3959
20200104,9,올림픽공원,8389,8303,20200107,16692
20200104,9,둔촌오륜,550,550,20200107,1100
20200104,9,중앙보훈병원,5127,4727,20200107,9854
20200105,9,언주,3856,3696,20200108,7552
20200105,9,선정릉,3195,3513,20200108,6708
20200105,9,삼성중앙,2095,2202,20200108,4297
20200105,9,봉은사,11479,11150,20200108,22629
20200105,9,종합운동장,2850,2499,20200108,5349
20200105,9,삼전,3508,3553,20200108,7061
20200105,9,석촌고분,3092,3143,20200108,6235
20200105,9,석촌,4475,3669,20200108,8144
20200105,9,송파나루,2766,2888,20200108,5654
20200105,9,한성백제,1715,1560,20200108,3275
20200105,9,올림픽공원,5901,6015,20200108,11916
20200105,9,둔촌오륜,690,717,20200108,1407
20200105,9,중앙보훈병원,3915,3828,20200108,7743
20200106,9,언주,11316,11324,20200109,22640
20200106,9,선정릉,10289,11068,20200109,21357
20200106,9,삼성중앙,7526,7753,20200109,15279
20200106,9,봉은사,19340,19443,20200109,38783
20200106,9,종합운동장,5137,4819,20200109,9956
20200106,9,삼전,6676,6810,20200109,13486
20200106,9,석촌고분,5844,5899,20200109,11743
20200106,9,석촌,7878,6763,20200109,14641
20200106,9,송파나루,4428,4778,20200109,9206
20200106,9,한성백제,2392,2209,20200109,4601
20200106,9,올림픽공원,5667,5528,20200109,11195
20200106,9,둔촌오륜,1188,1126,20200109,2314
20200106,9,중앙보훈병원,10587,9825,20200109,20412
20200107,9,언주,11296,11267,20200110,22563
20200107,9,선정릉,9997,10854,20200110,20851
20200107,9,삼성중앙,7493,7702,20200110,15195
20200107,9,봉은사,20371,19831,20200110,40202
20200107,9,종합운동장,5124,4746,20200110,9870
20200107,9,삼전,6744,6884,20200110,13628
20200107,9,석촌고분,5843,5907,20200110,11750
20200107,9,석촌,7699,6661,20200110,14360
20200107,9,송파나루,4572,4924,20200110,9496
20200107,9,한성백제,2534,2365,20200110,4899
20200107,9,올림픽공원,5420,5432,20200110,10852
20200107,9,둔촌오륜,1257,1174,20200110,2431
20200107,9,중앙보훈병원,10905,9824,20200110,20729
20200108,9,언주,11209,11192,20200111,22401
20200108,9,선정릉,10250,11164,20200111,21414
20200108,9,삼성중앙,7449,7850,20200111,15299
20200108,9,봉은사,19619,19787,20200111,39406
20200108,9,종합운동장,5698,5152,20200111,10850
20200108,9,삼전,6811,6919,20200111,13730
20200108,9,석촌고분,5960,5916,20200111,11876
20200108,9,석촌,8089,6926,20200111,15015
20200108,9,송파나루,4700,4990,20200111,9690
20200108,9,한성백제,2702,2401,20200111,5103
20200108,9,올림픽공원,5866,5682,20200111,11548
20200108,9,둔촌오륜,962,1015,20200111,1977
20200108,9,중앙보훈병원,10755,9802,20200111,20557
20200109,9,언주,11335,11411,20200112,22746
20200109,9,선정릉,10337,11199,20200112,21536
20200109,9,삼성중앙,7353,7760,20200112,15113
20200109,9,봉은사,20102,20253,20200112,40355
20200109,9,종합운동장,5076,4845,20200112,9921
20200109,9,삼전,6939,6625,20200112,13564
20200109,9,석촌고분,6317,6237,20200112,12554
20200109,9,석촌,8227,6905,20200112,15132
20200109,9,송파나루,4736,5117,20200112,9853
20200109,9,한성백제,2652,2378,20200112,5030
20200109,9,올림픽공원,5876,5803,20200112,11679
20200109,9,둔촌오륜,1137,1140,20200112,2277
20200109,9,중앙보훈병원,10521,9559,20200112,20080
20200110,9,언주,11780,11820,20200113,23600
20200110,9,선정릉,10670,11539,20200113,22209
20200110,9,삼성중앙,7735,7954,20200113,15689
20200110,9,봉은사,21776,21793,20200113,43569
20200110,9,종합운동장,5441,5166,20200113,10607
20200110,9,삼전,7244,6976,20200113,14220
20200110,9,석촌고분,6343,6197,20200113,12540
20200110,9,석촌,8552,7148,20200113,15700
20200110,9,송파나루,4791,5188,20200113,9979
20200110,9,한성백제,2765,2523,20200113,5288
20200110,9,올림픽공원,5935,5854,20200113,11789
20200110,9,둔촌오륜,985,905,20200113,1890
20200110,9,중앙보훈병원,10840,9657,20200113,20497
20200111,9,언주,6694,6513,20200114,13207
20200111,9,선정릉,5879,6408,20200114,12287
20200111,9,삼성중앙,3670,3850,20200114,7520
20200111,9,봉은사,15744,15882,20200114,31626
20200111,9,종합운동장,4094,3317,20200114,7411
20200111,9,삼전,5296,4896,20200114,10192
20200111,9,석촌고분,4515,4192,20200114,8707
20200111,9,석촌,6591,5243,20200114,11834
20200111,9,송파나루,3981,4190,20200114,8171
20200111,9,한성백제,2264,1981,20200114,4245
20200111,9,올림픽공원,6412,6509,20200114,12921
20200111,9,둔촌오륜,634,619,20200114,1253
20200111,9,중앙보훈병원,5528,4996,20200114,10524
20200112,9,언주,4238,3973,20200115,8211
20200112,9,선정릉,3697,3875,20200115,7572
20200112,9,삼성중앙,2291,2309,20200115,4600
20200112,9,봉은사,11904,11561,20200115,23465
20200112,9,종합운동장,3123,2606,20200115,5729
20200112,9,삼전,3878,3855,20200115,7733
20200112,9,석촌고분,3169,3148,20200115,6317
20200112,9,석촌,4690,3721,20200115,8411
20200112,9,송파나루,2970,3040,20200115,6010
20200112,9,한성백제,1671,1443,20200115,3114
20200112,9,올림픽공원,3010,3165,20200115,6175
20200112,9,둔촌오륜,773,748,20200115,1521
20200112,9,중앙보훈병원,4181,4057,20200115,8238
20200113,9,언주,11047,11172,20200116,22219
20200113,9,선정릉,10360,11292,20200116,21652
20200113,9,삼성중앙,7428,7842,20200116,15270
20200113,9,봉은사,19708,20277,20200116,39985
20200113,9,종합운동장,5127,4764,20200116,9891
20200113,9,삼전,6788,6698,20200116,13486
20200113,9,석촌고분,6012,5931,20200116,11943
20200113,9,석촌,8154,6988,20200116,15142
20200113,9,송파나루,4577,4851,20200116,9428
20200113,9,한성백제,2482,2313,20200116,4795
20200113,9,올림픽공원,5722,5620,20200116,11342
20200113,9,둔촌오륜,873,904,20200116,1777
20200113,9,중앙보훈병원,10730,9666,20200116,20396
20200114,9,중앙보훈병원,10642,9696,20200117,20338
20200114,9,둔촌오륜,878,912,20200117,1790
20200114,9,올림픽공원,5870,5750,20200117,11620
20200114,9,한성백제,2542,2392,20200117,4934
20200114,9,송파나루,4818,5114,20200117,9932
20200114,9,석촌,8219,6972,20200117,15191
20200114,9,석촌고분,6091,6078,20200117,12169
20200114,9,삼전,6882,6839,20200117,13721
20200114,9,종합운동장,5199,4812,20200117,10011
20200114,9,봉은사,19593,19807,20200117,39400
20200114,9,삼성중앙,7779,8114,20200117,15893
20200114,9,선정릉,10487,11323,20200117,21810
20200114,9,언주,11432,11474,20200117,22906
20200115,9,언주,11642,11674,20200118,23316
20200115,9,선정릉,10689,11380,20200118,22069
20200115,9,삼성중앙,7635,7998,20200118,15633
20200115,9,봉은사,19910,20045,20200118,39955
20200115,9,종합운동장,5344,4994,20200118,10338
20200115,9,삼전,6884,6805,20200118,13689
20200115,9,석촌고분,6071,6161,20200118,12232
20200115,9,석촌,8410,7145,20200118,15555
20200115,9,송파나루,4914,5211,20200118,10125
20200115,9,한성백제,2629,2479,20200118,5108
20200115,9,올림픽공원,5703,5641,20200118,11344
20200115,9,둔촌오륜,1002,1033,20200118,2035
20200115,9,중앙보훈병원,10816,9839,20200118,20655
20200116,9,중앙보훈병원,10567,9991,20200119,20558
20200116,9,둔촌오륜,897,848,20200119,1745
20200116,9,올림픽공원,5820,5738,20200119,11558
20200116,9,한성백제,2748,2488,20200119,5236
20200116,9,송파나루,4687,5218,20200119,9905
20200116,9,석촌,8441,7135,20200119,15576
20200116,9,석촌고분,6192,6225,20200119,12417
20200116,9,삼전,6928,6839,20200119,13767
20200116,9,종합운동장,5218,4935,20200119,10153
20200116,9,봉은사,21359,21422,20200119,42781
20200116,9,삼성중앙,7846,8015,20200119,15861
20200116,9,선정릉,10602,11689,20200119,22291
20200116,9,언주,11479,11602,20200119,23081
20200117,9,언주,11815,12036,20200120,23851
20200117,9,선정릉,11070,12028,20200120,23098
20200117,9,삼성중앙,7910,8097,20200120,16007
20200117,9,봉은사,23429,23493,20200120,46922
20200117,9,종합운동장,5568,5222,20200120,10790
20200117,9,삼전,7245,7108,20200120,14353
20200117,9,석촌고분,6415,6368,20200120,12783
20200117,9,석촌,8783,7329,20200120,16112
20200117,9,송파나루,4915,5362,20200120,10277
20200117,9,한성백제,2703,2494,20200120,5197
20200117,9,올림픽공원,9441,9313,20200120,18754
20200117,9,둔촌오륜,968,906,20200120,1874
20200117,9,중앙보훈병원,11350,9780,20200120,21130
20200118,9,언주,6900,6754,20200121,13654
20200118,9,선정릉,6308,6818,20200121,13126
20200118,9,삼성중앙,3756,3658,20200121,7414
20200118,9,봉은사,17181,17532,20200121,34713
20200118,9,종합운동장,4999,4019,20200121,9018
20200118,9,삼전,5385,5039,20200121,10424
20200118,9,석촌고분,4729,4340,20200121,9069
20200118,9,석촌,6796,5245,20200121,12041
20200118,9,송파나루,4089,4349,20200121,8438
20200118,9,한성백제,2170,1882,20200121,4052
20200118,9,올림픽공원,13167,12078,20200121,25245
20200118,9,둔촌오륜,704,631,20200121,1335
20200118,9,중앙보훈병원,5374,4918,20200121,10292
20200119,9,언주,4186,3953,20200122,8139
20200119,9,선정릉,3670,3869,20200122,7539
20200119,9,삼성중앙,2411,2495,20200122,4906
20200119,9,봉은사,10973,10619,20200122,21592
20200119,9,종합운동장,3841,2798,20200122,6639
20200119,9,삼전,3860,3782,20200122,7642
20200119,9,석촌고분,3370,3308,20200122,6678
20200119,9,석촌,4591,3710,20200122,8301
20200119,9,송파나루,2937,3089,20200122,6026
20200119,9,한성백제,1570,1400,20200122,2970
20200119,9,올림픽공원,6408,6443,20200122,12851
20200119,9,둔촌오륜,774,759,20200122,1533
20200119,9,중앙보훈병원,3990,3845,20200122,7835
20200120,9,중앙보훈병원,10802,9968,20200123,20770
20200120,9,둔촌오륜,887,887,20200123,1774
20200120,9,올림픽공원,5901,5791,20200123,11692
20200120,9,한성백제,2603,2336,20200123,4939
20200120,9,송파나루,4645,4968,20200123,9613
20200120,9,석촌,8158,6897,20200123,15055
20200120,9,석촌고분,5981,5995,20200123,11976
20200120,9,삼전,6901,6885,20200123,13786
20200120,9,종합운동장,5178,4936,20200123,10114
20200120,9,봉은사,19845,20007,20200123,39852
20200120,9,삼성중앙,7751,8021,20200123,15772
20200120,9,선정릉,10794,11617,20200123,22411
20200120,9,언주,11417,11299,20200123,22716
20200121,9,언주,11482,11506,20200124,22988
20200121,9,선정릉,10687,11737,20200124,22424
20200121,9,삼성중앙,7709,7911,20200124,15620
20200121,9,봉은사,20356,20585,20200124,40941
20200121,9,종합운동장,5493,5043,20200124,10536
20200121,9,삼전,6914,6775,20200124,13689
20200121,9,석촌고분,6031,6047,20200124,12078
20200121,9,석촌,8334,7327,20200124,15661
20200121,9,송파나루,4571,4872,20200124,9443
20200121,9,한성백제,2599,2362,20200124,4961
20200121,9,올림픽공원,6604,6533,20200124,13137
20200121,9,둔촌오륜,988,882,20200124,1870
20200121,9,중앙보훈병원,10679,9791,20200124,20470
20200122,9,한성백제,2465,2298,20200125,4763
20200122,9,올림픽공원,5753,5591,20200125,11344
20200122,9,둔촌오륜,1001,1012,20200125,2013
20200122,9,중앙보훈병원,10885,9652,20200125,20537
20200122,9,언주,11448,11310,20200125,22758
20200122,9,선정릉,10623,11481,20200125,22104
20200122,9,삼성중앙,7735,7914,20200125,15649
20200122,9,봉은사,19958,20161,20200125,40119
20200122,9,종합운동장,5187,4767,20200125,9954
20200122,9,삼전,6941,6712,20200125,13653
20200122,9,석촌고분,6088,5994,20200125,12082
20200122,9,석촌,8420,7112,20200125,15532
20200122,9,송파나루,4931,5173,20200125,10104
20200123,9,언주,10240,9768,20200126,20008
20200123,9,선정릉,10027,10017,20200126,20044
20200123,9,삼성중앙,7045,6818,20200126,13863
20200123,9,봉은사,18330,17949,20200126,36279
20200123,9,종합운동장,4858,4415,20200126,9273
20200123,9,삼전,6681,6002,20200126,12683
20200123,9,석촌고분,5873,5314,20200126,11187
20200123,9,석촌,7957,6233,20200126,14190
20200123,9,송파나루,4492,4476,20200126,8968
20200123,9,한성백제,2383,1997,20200126,4380
20200123,9,올림픽공원,5361,5073,20200126,10434
20200123,9,둔촌오륜,738,739,20200126,1477
20200123,9,중앙보훈병원,9922,8552,20200126,18474
20200124,9,중앙보훈병원,2872,2638,20200127,5510
20200124,9,둔촌오륜,270,254,20200127,524
20200124,9,올림픽공원,1895,1848,20200127,3743
20200124,9,한성백제,940,696,20200127,1636
20200124,9,송파나루,2036,1774,20200127,3810
20200124,9,석촌,3461,2106,20200127,5567
20200124,9,석촌고분,2504,1828,20200127,4332
20200124,9,삼전,3038,2228,20200127,5266
20200124,9,종합운동장,1839,1384,20200127,3223
20200124,9,봉은사,6581,6363,20200127,12944
20200124,9,삼성중앙,1690,1281,20200127,2971
20200124,9,선정릉,2351,1904,20200127,4255
20200124,9,언주,2702,2001,20200127,4703
20200125,9,언주,1715,1695,20200128,3410
20200125,9,선정릉,1559,1694,20200128,3253
20200125,9,삼성중앙,1071,1042,20200128,2113
20200125,9,봉은사,7040,6994,20200128,14034
20200125,9,종합운동장,1426,1340,20200128,2766
20200125,9,삼전,2233,2214,20200128,4447
20200125,9,석촌고분,1823,1928,20200128,3751
20200125,9,석촌,2696,2187,20200128,4883
20200125,9,송파나루,1380,1428,20200128,2808
20200125,9,한성백제,745,713,20200128,1458
20200125,9,올림픽공원,1639,1731,20200128,3370
20200125,9,둔촌오륜,265,199,20200128,464
20200125,9,중앙보훈병원,2682,2486,20200128,5168
20200126,9,언주,2294,2553,20200129,4847
20200126,9,선정릉,2019,2463,20200129,4482
20200126,9,삼성중앙,1402,1629,20200129,3031
20200126,9,봉은사,7705,7638,20200129,15343
20200126,9,종합운동장,1864,1868,20200129,3732
20200126,9,삼전,2741,3077,20200129,5818
20200126,9,석촌고분,2482,2696,20200129,5178
20200126,9,석촌,3282,3019,20200129,6301
20200126,9,송파나루,2008,2327,20200129,4335
20200126,9,한성백제,1193,1122,20200129,2315
20200126,9,올림픽공원,2454,2485,20200129,4939
20200126,9,둔촌오륜,522,534,20200129,1056
20200126,9,중앙보훈병원,3277,3101,20200129,6378
20200127,9,언주,2673,2928,20200130,5601
20200127,9,선정릉,2443,2937,20200130,5380
20200127,9,삼성중앙,1809,2046,20200130,3855
20200127,9,봉은사,9207,8916,20200130,18123
20200127,9,종합운동장,2287,2133,20200130,4420
20200127,9,삼전,3037,3482,20200130,6519
20200127,9,석촌고분,2591,2946,20200130,5537
20200127,9,석촌,3687,3434,20200130,7121
20200127,9,송파나루,2333,2593,20200130,4926
20200127,9,한성백제,1113,1098,20200130,2211
20200127,9,올림픽공원,2513,2725,20200130,5238
20200127,9,둔촌오륜,309,339,20200130,648
20200127,9,중앙보훈병원,3511,3476,20200130,6987
20200128,9,언주,9734,10001,20200131,19735
20200128,9,선정릉,9232,10169,20200131,19401
20200128,9,삼성중앙,6665,6918,20200131,13583
20200128,9,봉은사,17331,17327,20200131,34658
20200128,9,종합운동장,4529,4417,20200131,8946
20200128,9,삼전,6123,6257,20200131,12380
20200128,9,석촌고분,5253,5401,20200131,10654
20200128,9,석촌,7376,6500,20200131,13876
20200128,9,송파나루,4105,4420,20200131,8525
20200128,9,한성백제,2173,2016,20200131,4189
20200128,9,올림픽공원,5125,5133,20200131,10258
20200128,9,둔촌오륜,764,801,20200131,1565
20200128,9,중앙보훈병원,9726,9058,20200131,18784
20200129,9,언주,10625,10824,20200201,21449
20200129,9,선정릉,10162,10952,20200201,21114
20200129,9,삼성중앙,7208,7504,20200201,14712
20200129,9,봉은사,18263,18329,20200201,36592
20200129,9,종합운동장,4794,4648,20200201,9442
20200129,9,삼전,6489,6427,20200201,12916
20200129,9,석촌고분,5796,5882,20200201,11678
20200129,9,석촌,7705,6744,20200201,14449
20200129,9,송파나루,4502,4797,20200201,9299
20200129,9,한성백제,2472,2254,20200201,4726
20200129,9,올림픽공원,5575,5489,20200201,11064
20200129,9,둔촌오륜,977,1009,20200201,1986
20200129,9,중앙보훈병원,10440,9446,20200201,19886
20200130,9,중앙보훈병원,10289,9316,20200202,19605
20200130,9,둔촌오륜,961,961,20200202,1922
20200130,9,올림픽공원,5461,5561,20200202,11022
20200130,9,한성백제,2435,2190,20200202,4625
20200130,9,송파나루,4349,4641,20200202,8990
20200130,9,석촌,7892,6848,20200202,14740
20200130,9,석촌고분,5817,5784,20200202,11601
20200130,9,삼전,6586,6391,20200202,12977
20200130,9,종합운동장,4842,4571,20200202,9413
20200130,9,봉은사,18749,19220,20200202,37969
20200130,9,삼성중앙,7220,7627,20200202,14847
20200130,9,선정릉,10187,11032,20200202,21219
20200130,9,언주,10711,10815,20200202,21526
20200131,9,언주,10755,11000,20200203,21755
20200131,9,선정릉,10173,10832,20200203,21005
20200131,9,삼성중앙,7335,7591,20200203,14926
20200131,9,봉은사,18625,18527,20200203,37152
20200131,9,종합운동장,4897,4697,20200203,9594
20200131,9,삼전,6617,6470,20200203,13087
20200131,9,석촌고분,5732,5663,20200203,11395
20200131,9,석촌,7983,6921,20200203,14904
20200131,9,송파나루,4451,4715,20200203,9166
20200131,9,한성백제,2481,2218,20200203,4699
20200131,9,올림픽공원,5622,5432,20200203,11054
20200131,9,둔촌오륜,982,902,20200203,1884
20200131,9,중앙보훈병원,10118,8917,20200203,19035
20200201,9,언주,5337,4979,20200204,10316
20200201,9,선정릉,4224,4661,20200204,8885
20200201,9,삼성중앙,3014,3015,20200204,6029
20200201,9,봉은사,10337,10581,20200204,20918
20200201,9,종합운동장,3336,2800,20200204,6136
20200201,9,삼전,4403,4071,20200204,8474
20200201,9,석촌고분,3674,3433,20200204,7107
20200201,9,석촌,5331,4255,20200204,9586
20200201,9,송파나루,3342,3330,20200204,6672
20200201,9,한성백제,1583,1361,20200204,2944
20200201,9,올림픽공원,4907,4797,20200204,9704
20200201,9,둔촌오륜,509,527,20200204,1036
20200201,9,중앙보훈병원,4351,3973,20200204,8324
20200202,9,언주,3194,3016,20200205,6210
20200202,9,선정릉,2924,3305,20200205,6229
20200202,9,삼성중앙,1914,1953,20200205,3867
20200202,9,봉은사,7630,7251,20200205,14881
20200202,9,종합운동장,2213,1960,20200205,4173
20200202,9,삼전,3216,3209,20200205,6425
20200202,9,석촌고분,2714,2691,20200205,5405
20200202,9,석촌,3734,3045,20200205,6779
20200202,9,송파나루,2364,2516,20200205,4880
20200202,9,한성백제,1181,1070,20200205,2251
20200202,9,올림픽공원,4121,4153,20200205,8274
20200202,9,둔촌오륜,623,614,20200205,1237
20200202,9,중앙보훈병원,3571,3499,20200205,7070
20200203,9,언주,10316,10454,20200206,20770
20200203,9,선정릉,9720,10540,20200206,20260
20200203,9,삼성중앙,7008,7340,20200206,14348
20200203,9,봉은사,17489,17487,20200206,34976
20200203,9,종합운동장,4511,4270,20200206,8781
20200203,9,삼전,6275,6379,20200206,12654
20200203,9,석촌고분,5497,5507,20200206,11004
20200203,9,석촌,7428,6446,20200206,13874
20200203,9,송파나루,4127,4395,20200206,8522
20200203,9,한성백제,2239,2030,20200206,4269
20200203,9,올림픽공원,5200,5019,20200206,10219
20200203,9,둔촌오륜,891,897,20200206,1788
20200203,9,중앙보훈병원,9946,9099,20200206,19045
20200204,9,언주,10623,10613,20200207,21236
20200204,9,선정릉,9536,10476,20200207,20012
20200204,9,삼성중앙,7065,7324,20200207,14389
20200204,9,봉은사,18099,18134,20200207,36233
20200204,9,종합운동장,4665,4387,20200207,9052
20200204,9,삼전,6434,6312,20200207,12746
20200204,9,석촌고분,5437,5524,20200207,10961
20200204,9,석촌,7646,6534,20200207,14180
20200204,9,송파나루,4267,4698,20200207,8965
20200204,9,한성백제,2240,2046,20200207,4286
20200204,9,올림픽공원,5179,5024,20200207,10203
20200204,9,둔촌오륜,823,846,20200207,1669
20200204,9,중앙보훈병원,9866,9014,20200207,18880
20200205,9,언주,10581,10571,20200208,21152
20200205,9,선정릉,9696,10360,20200208,20056
20200205,9,삼성중앙,7090,7374,20200208,14464
20200205,9,봉은사,17423,17734,20200208,35157
20200205,9,종합운동장,4608,4383,20200208,8991
20200205,9,삼전,6308,6333,20200208,12641
20200205,9,석촌고분,5345,5451,20200208,10796
20200205,9,석촌,7465,6421,20200208,13886
20200205,9,송파나루,4424,4766,20200208,9190
20200205,9,한성백제,2170,2030,20200208,4200
20200205,9,올림픽공원,5417,5148,20200208,10565
20200205,9,둔촌오륜,912,949,20200208,1861
20200205,9,중앙보훈병원,9542,8650,20200208,18192
20200206,9,언주,10136,10263,20200209,20399
20200206,9,선정릉,9426,10009,20200209,19435
20200206,9,삼성중앙,6893,7389,20200209,14282
20200206,9,봉은사,16834,16975,20200209,33809
20200206,9,종합운동장,4335,4330,20200209,8665
20200206,9,삼전,6118,6013,20200209,12131
20200206,9,석촌고분,5254,5361,20200209,10615
20200206,9,석촌,6994,6082,20200209,13076
20200206,9,송파나루,4130,4409,20200209,8539
20200206,9,한성백제,2108,1932,20200209,4040
20200206,9,올림픽공원,5425,5350,20200209,10775
20200206,9,둔촌오륜,811,767,20200209,1578
20200206,9,중앙보훈병원,9494,8573,20200209,18067
20200207,9,언주,10286,10333,20200210,20619
20200207,9,선정릉,9665,10354,20200210,20019
20200207,9,삼성중앙,7211,7400,20200210,14611
20200207,9,봉은사,17221,16915,20200210,34136
20200207,9,종합운동장,4670,4486,20200210,9156
20200207,9,삼전,6410,6253,20200210,12663
20200207,9,석촌고분,5390,5259,20200210,10649
20200207,9,석촌,7299,6327,20200210,13626
20200207,9,송파나루,4251,4620,20200210,8871
20200207,9,한성백제,2240,1950,20200210,4190
20200207,9,올림픽공원,8209,7963,20200210,16172
20200207,9,둔촌오륜,807,802,20200210,1609
20200207,9,중앙보훈병원,9556,8394,20200210,17950
20200208,9,언주,5122,5078,20200211,10200
20200208,9,선정릉,4498,4867,20200211,9365
20200208,9,삼성중앙,3027,2987,20200211,6014
20200208,9,봉은사,10157,10123,20200211,20280
20200208,9,종합운동장,3021,2648,20200211,5669
20200208,9,삼전,4268,3932,20200211,8200
20200208,9,석촌고분,3548,3298,20200211,6846
20200208,9,석촌,5020,3927,20200211,8947
20200208,9,송파나루,3147,3342,20200211,6489
20200208,9,한성백제,1415,1239,20200211,2654
20200208,9,올림픽공원,7047,6545,20200211,13592
20200208,9,둔촌오륜,453,500,20200211,953
20200208,9,중앙보훈병원,4146,3747,20200211,7893
20200209,9,언주,3283,3124,20200212,6407
20200209,9,선정릉,2996,3287,20200212,6283
20200209,9,삼성중앙,1738,1758,20200212,3496
20200209,9,봉은사,7314,7303,20200212,14617
20200209,9,종합운동장,2161,1912,20200212,4073
20200209,9,삼전,3206,3129,20200212,6335
20200209,9,석촌고분,2629,2549,20200212,5178
20200209,9,석촌,3647,2980,20200212,6627
20200209,9,송파나루,2371,2473,20200212,4844
20200209,9,한성백제,1231,985,20200212,2216
20200209,9,올림픽공원,6639,6586,20200212,13225
20200209,9,둔촌오륜,579,568,20200212,1147
20200209,9,중앙보훈병원,3100,3055,20200212,6155
20200210,9,언주,10103,10285,20200213,20388
20200210,9,선정릉,9559,10091,20200213,19650
20200210,9,삼성중앙,6817,7189,20200213,14006
20200210,9,봉은사,16673,16711,20200213,33384
20200210,9,종합운동장,4425,4293,20200213,8718
20200210,9,삼전,6253,6128,20200213,12381
20200210,9,석촌고분,5123,5233,20200213,10356
20200210,9,석촌,7070,6277,20200213,13347
20200210,9,송파나루,3994,4299,20200213,8293
20200210,9,한성백제,2195,1940,20200213,4135
20200210,9,올림픽공원,4976,5055,20200213,10031
20200210,9,둔촌오륜,855,828,20200213,1683
20200210,9,중앙보훈병원,9824,8864,20200213,18688
20200211,9,언주,10303,10508,20200214,20811
20200211,9,선정릉,9784,10535,20200214,20319
20200211,9,삼성중앙,6835,7243,20200214,14078
20200211,9,봉은사,17402,17495,20200214,34897
20200211,9,종합운동장,4522,4406,20200214,8928
20200211,9,삼전,6461,6349,20200214,12810
20200211,9,석촌고분,5333,5357,20200214,10690
20200211,9,석촌,7539,6540,20200214,14079
20200211,9,송파나루,4255,4485,20200214,8740
20200211,9,한성백제,2236,2046,20200214,4282
20200211,9,올림픽공원,5260,5190,20200214,10450
20200211,9,둔촌오륜,911,867,20200214,1778
20200211,9,중앙보훈병원,10184,9197,20200214,19381
20200212,9,송파나루,4206,4516,20200215,8722
20200212,9,중앙보훈병원,9874,8984,20200215,18858
20200212,9,둔촌오륜,940,921,20200215,1861
20200212,9,올림픽공원,5073,5056,20200215,10129
20200212,9,한성백제,2201,2087,20200215,4288
20200212,9,언주,10298,10415,20200215,20713
20200212,9,선정릉,9605,10346,20200215,19951
20200212,9,삼성중앙,6930,7208,20200215,14138
20200212,9,봉은사,17650,17721,20200215,35371
20200212,9,종합운동장,4620,4417,20200215,9037
20200212,9,삼전,6408,6413,20200215,12821
20200212,9,석촌고분,5461,5563,20200215,11024
20200212,9,석촌,7269,6256,20200215,13525
20200213,9,언주,10286,10505,20200216,20791
20200213,9,선정릉,9851,10660,20200216,20511
20200213,9,삼성중앙,6980,7485,20200216,14465
20200213,9,봉은사,18398,18502,20200216,36900
20200213,9,종합운동장,4769,4434,20200216,9203
20200213,9,삼전,6471,6344,20200216,12815
20200213,9,석촌고분,5534,5530,20200216,11064
20200213,9,석촌,7639,6496,20200216,14135
20200213,9,송파나루,4374,4662,20200216,9036
20200213,9,한성백제,2204,2022,20200216,4226
20200213,9,올림픽공원,5320,5240,20200216,10560
20200213,9,둔촌오륜,879,856,20200216,1735
20200213,9,중앙보훈병원,10216,9007,20200216,19223
20200214,9,한성백제,2462,2159,20200217,4621
20200214,9,올림픽공원,5644,5563,20200217,11207
20200214,9,둔촌오륜,907,839,20200217,1746
20200214,9,중앙보훈병원,10401,9356,20200217,19757
20200214,9,송파나루,4472,4991,20200217,9463
20200214,9,석촌,8102,6879,20200217,14981
20200214,9,석촌고분,5835,5704,20200217,11539
20200214,9,삼전,6873,6579,20200217,13452
20200214,9,종합운동장,4749,4741,20200217,9490
20200214,9,봉은사,19555,19484,20200217,39039
20200214,9,삼성중앙,7345,7665,20200217,15010
20200214,9,선정릉,10332,11032,20200217,21364
20200214,9,언주,10675,10564,20200217,21239
20200215,9,언주,5549,5401,20200218,10950
20200215,9,선정릉,5082,5576,20200218,10658
20200215,9,삼성중앙,3103,3117,20200218,6220
20200215,9,봉은사,11431,11473,20200218,22904
20200215,9,종합운동장,3280,2847,20200218,6127
20200215,9,삼전,4682,4405,20200218,9087
20200215,9,석촌고분,3984,3718,20200218,7702
20200215,9,석촌,5890,4449,20200218,10339
20200215,9,송파나루,3589,3504,20200218,7093
20200215,9,한성백제,1629,1354,20200218,2983
20200215,9,올림픽공원,5503,5233,20200218,10736
20200215,9,둔촌오륜,598,578,20200218,1176
20200215,9,중앙보훈병원,4691,4346,20200218,9037
20200216,9,언주,3282,3184,20200219,6466
20200216,9,선정릉,3158,3286,20200219,6444
20200216,9,삼성중앙,1966,2080,20200219,4046
20200216,9,봉은사,8596,8283,20200219,16879
20200216,9,종합운동장,2425,2091,20200219,4516
20200216,9,삼전,3455,3426,20200219,6881
20200216,9,석촌고분,3091,3001,20200219,6092
20200216,9,석촌,3892,3198,20200219,7090
20200216,9,송파나루,2546,2747,20200219,5293
20200216,9,한성백제,1203,1123,20200219,2326
20200216,9,올림픽공원,4610,4561,20200219,9171
20200216,9,둔촌오륜,596,643,20200219,1239
20200216,9,중앙보훈병원,3422,3273,20200219,6695
20200217,9,언주,10647,10814,20200220,21461
20200217,9,선정릉,9690,10537,20200220,20227
20200217,9,삼성중앙,7150,7455,20200220,14605
20200217,9,봉은사,18433,18679,20200220,37112
20200217,9,종합운동장,4955,4577,20200220,9532
20200217,9,삼전,6902,6805,20200220,13707
20200217,9,석촌고분,5836,5792,20200220,11628
20200217,9,석촌,7422,6525,20200220,13947
20200217,9,송파나루,4501,4812,20200220,9313
20200217,9,한성백제,2405,2176,20200220,4581
20200217,9,올림픽공원,5473,5416,20200220,10889
20200217,9,둔촌오륜,986,952,20200220,1938
20200217,9,중앙보훈병원,10402,9386,20200220,19788
20200218,9,언주,10763,10824,20200221,21587
20200218,9,선정릉,9712,10526,20200221,20238
20200218,9,삼성중앙,7058,7322,20200221,14380
20200218,9,봉은사,17961,18236,20200221,36197
20200218,9,종합운동장,4718,4594,20200221,9312
20200218,9,삼전,6599,6451,20200221,13050
20200218,9,석촌고분,5601,5647,20200221,11248
20200218,9,석촌,7726,6665,20200221,14391
20200218,9,송파나루,4435,4721,20200221,9156
20200218,9,한성백제,2311,2097,20200221,4408
20200218,9,올림픽공원,5257,5243,20200221,10500
20200218,9,둔촌오륜,914,858,20200221,1772
20200218,9,중앙보훈병원,10320,9383,20200221,19703
20200219,9,언주,10665,10830,20200222,21495
20200219,9,선정릉,9879,10571,20200222,20450
20200219,9,삼성중앙,7087,7509,20200222,14596
20200219,9,봉은사,18153,18158,20200222,36311
20200219,9,종합운동장,4627,4469,20200222,9096
20200219,9,삼전,6595,6524,20200222,13119
20200219,9,석촌고분,5670,5647,20200222,11317
20200219,9,석촌,7557,6561,20200222,14118
20200219,9,송파나루,4388,4785,20200222,9173
20200219,9,한성백제,2314,2102,20200222,4416
20200219,9,올림픽공원,5449,5315,20200222,10764
20200219,9,둔촌오륜,890,851,20200222,1741
20200219,9,중앙보훈병원,10191,9225,20200222,19416
20200220,9,언주,10309,10600,20200223,20909
20200220,9,선정릉,9618,10659,20200223,20277
20200220,9,삼성중앙,7012,7244,20200223,14256
20200220,9,봉은사,17592,17897,20200223,35489
20200220,9,종합운동장,4630,4428,20200223,9058
20200220,9,삼전,6549,6340,20200223,12889
20200220,9,석촌고분,5563,5609,20200223,11172
20200220,9,석촌,7612,6507,20200223,14119
20200220,9,송파나루,4281,4681,20200223,8962
20200220,9,한성백제,2331,2095,20200223,4426
20200220,9,올림픽공원,5412,5327,20200223,10739
20200220,9,둔촌오륜,884,812,20200223,1696
20200220,9,중앙보훈병원,9806,8836,20200223,18642
20200221,9,언주,10282,10224,20200224,20506
20200221,9,선정릉,9537,10317,20200224,19854
20200221,9,삼성중앙,6835,6974,20200224,13809
20200221,9,봉은사,17380,17312,20200224,34692
20200221,9,종합운동장,4437,4301,20200224,8738
20200221,9,삼전,6568,6410,20200224,12978
20200221,9,석촌고분,5697,5612,20200224,11309
20200221,9,석촌,7564,6333,20200224,13897
20200221,9,송파나루,4391,4582,20200224,8973
20200221,9,한성백제,2278,2047,20200224,4325
20200221,9,올림픽공원,5282,5169,20200224,10451
20200221,9,둔촌오륜,798,794,20200224,1592
20200221,9,중앙보훈병원,9591,8403,20200224,17994
20200222,9,언주,4589,4516,20200225,9105
20200222,9,선정릉,4375,4696,20200225,9071
20200222,9,삼성중앙,2692,2617,20200225,5309
20200222,9,봉은사,9137,9244,20200225,18381
20200222,9,종합운동장,2550,2207,20200225,4757
20200222,9,삼전,4047,3796,20200225,7843
20200222,9,석촌고분,3484,3370,20200225,6854
20200222,9,석촌,4686,3669,20200225,8355
20200222,9,송파나루,2921,2995,20200225,5916
20200222,9,한성백제,1384,1121,20200225,2505
20200222,9,올림픽공원,2943,2903,20200225,5846
20200222,9,둔촌오륜,442,427,20200225,869
20200222,9,중앙보훈병원,3536,3354,20200225,6890
20200223,9,언주,2609,2501,20200226,5110
20200223,9,선정릉,2474,2657,20200226,5131
20200223,9,삼성중앙,1548,1655,20200226,3203
20200223,9,봉은사,5931,5949,20200226,11880
20200223,9,종합운동장,1619,1491,20200226,3110
20200223,9,삼전,2640,2614,20200226,5254
20200223,9,석촌고분,2269,2237,20200226,4506
20200223,9,석촌,3048,2534,20200226,5582
20200223,9,송파나루,1948,2044,20200226,3992
20200223,9,한성백제,923,826,20200226,1749
20200223,9,올림픽공원,2133,2141,20200226,4274
20200223,9,둔촌오륜,357,359,20200226,716
20200223,9,중앙보훈병원,2531,2360,20200226,4891
20200224,9,언주,8709,8970,20200227,17679
20200224,9,선정릉,8471,8991,20200227,17462
20200224,9,삼성중앙,5914,6273,20200227,12187
20200224,9,봉은사,14635,14743,20200227,29378
20200224,9,종합운동장,3645,3561,20200227,7206
20200224,9,삼전,5504,5442,20200227,10946
20200224,9,석촌고분,4602,4674,20200227,9276
20200224,9,석촌,6215,5445,20200227,11660
20200224,9,송파나루,3510,3776,20200227,7286
20200224,9,한성백제,1888,1696,20200227,3584
20200224,9,올림픽공원,4234,4200,20200227,8434
20200224,9,둔촌오륜,724,674,20200227,1398
20200224,9,중앙보훈병원,8302,7517,20200227,15819
20200225,9,언주,8420,8575,20200228,16995
20200225,9,선정릉,7897,8426,20200228,16323
20200225,9,삼성중앙,5712,6006,20200228,11718
20200225,9,봉은사,13252,13363,20200228,26615
20200225,9,종합운동장,3292,3306,20200228,6598
20200225,9,삼전,5229,5154,20200228,10383
20200225,9,석촌고분,4464,4491,20200228,8955
20200225,9,석촌,5661,5022,20200228,10683
20200225,9,송파나루,3287,3547,20200228,6834
20200225,9,한성백제,1802,1589,20200228,3391
20200225,9,올림픽공원,3843,3649,20200228,7492
20200225,9,둔촌오륜,636,589,20200228,1225
20200225,9,중앙보훈병원,7579,6943,20200228,14522
20200226,9,언주,8155,8261,20200229,16416
20200226,9,선정릉,7667,8186,20200229,15853
20200226,9,삼성중앙,5605,5816,20200229,11421
20200226,9,봉은사,12661,12650,20200229,25311
20200226,9,종합운동장,3166,3113,20200229,6279
20200226,9,삼전,5077,5027,20200229,10104
20200226,9,석촌고분,4317,4392,20200229,8709
20200226,9,석촌,5705,4976,20200229,10681
20200226,9,송파나루,3251,3471,20200229,6722
20200226,9,한성백제,1732,1552,20200229,3284
20200226,9,올림픽공원,3734,3689,20200229,7423
20200226,9,둔촌오륜,615,582,20200229,1197
20200226,9,중앙보훈병원,7254,6571,20200229,13825
20200227,9,중앙보훈병원,7010,6397,20200301,13407
20200227,9,둔촌오륜,599,601,20200301,1200
20200227,9,올림픽공원,3648,3611,20200301,7259
20200227,9,한성백제,1680,1478,20200301,3158
20200227,9,송파나루,3221,3378,20200301,6599
20200227,9,석촌,5616,4882,20200301,10498
20200227,9,석촌고분,4239,4337,20200301,8576
20200227,9,삼전,5001,4889,20200301,9890
20200227,9,종합운동장,3130,3058,20200301,6188
20200227,9,봉은사,11650,11836,20200301,23486
20200227,9,삼성중앙,5347,5435,20200301,10782
20200227,9,선정릉,7194,7835,20200301,15029
20200227,9,언주,7998,8040,20200301,16038
20200228,9,언주,7819,7686,20200302,15505
20200228,9,선정릉,6981,7652,20200302,14633
20200228,9,삼성중앙,4905,5044,20200302,9949
20200228,9,봉은사,11428,11279,20200302,22707
20200228,9,종합운동장,3128,2964,20200302,6092
20200228,9,삼전,4944,4897,20200302,9841
20200228,9,석촌고분,4158,4203,20200302,8361
20200228,9,석촌,5311,4619,20200302,9930
20200228,9,송파나루,3181,3408,20200302,6589
20200228,9,한성백제,1650,1446,20200302,3096
20200228,9,올림픽공원,3404,3301,20200302,6705
20200228,9,둔촌오륜,661,622,20200302,1283
20200228,9,중앙보훈병원,6836,6022,20200302,12858
20200229,9,석촌,3310,2607,20200303,5917
20200229,9,석촌고분,2419,2294,20200303,4713
20200229,9,삼전,2966,2829,20200303,5795
20200229,9,종합운동장,1668,1434,20200303,3102
20200229,9,봉은사,5092,5176,20200303,10268
20200229,9,삼성중앙,1778,1731,20200303,3509
20200229,9,선정릉,2775,2931,20200303,5706
20200229,9,언주,3148,3024,20200303,6172
20200229,9,송파나루,2027,1959,20200303,3986
20200229,9,중앙보훈병원,2344,2179,20200303,4523
20200229,9,둔촌오륜,312,332,20200303,644
20200229,9,올림픽공원,1868,1860,20200303,3728
20200229,9,한성백제,892,763,20200303,1655
20200301,9,중앙보훈병원,1540,1528,20200304,3068
20200301,9,둔촌오륜,165,176,20200304,341
20200301,9,올림픽공원,1334,1271,20200304,2605
20200301,9,한성백제,652,540,20200304,1192
20200301,9,송파나루,1324,1351,20200304,2675
20200301,9,석촌,2157,1812,20200304,3969
20200301,9,석촌고분,1578,1606,20200304,3184
20200301,9,삼전,2075,2047,20200304,4122
20200301,9,종합운동장,1042,986,20200304,2028
20200301,9,봉은사,3435,3363,20200304,6798
20200301,9,삼성중앙,1116,1077,20200304,2193
20200301,9,선정릉,1549,1695,20200304,3244
20200301,9,언주,1682,1678,20200304,3360
20200302,9,언주,7611,7818,20200305,15429
20200302,9,선정릉,7146,7610,20200305,14756
20200302,9,삼성중앙,4812,4991,20200305,9803
20200302,9,봉은사,11150,11153,20200305,22303
20200302,9,종합운동장,3039,2981,20200305,6020
20200302,9,삼전,4807,4715,20200305,9522
20200302,9,석촌고분,4138,4230,20200305,8368
20200302,9,석촌,5386,4744,20200305,10130
20200302,9,송파나루,3168,3240,20200305,6408
20200302,9,한성백제,1591,1410,20200305,3001
20200302,9,올림픽공원,3519,3491,20200305,7010
20200302,9,둔촌오륜,610,596,20200305,1206
20200302,9,중앙보훈병원,7236,6381,20200305,13617
20200303,9,언주,7359,7511,20200306,14870
20200303,9,선정릉,6897,7400,20200306,14297
20200303,9,삼성중앙,4696,4998,20200306,9694
20200303,9,봉은사,11024,10973,20200306,21997
20200303,9,종합운동장,3095,2969,20200306,6064
20200303,9,삼전,4779,4693,20200306,9472
20200303,9,석촌고분,4062,4186,20200306,8248
20200303,9,석촌,5344,4642,20200306,9986
20200303,9,송파나루,3247,3390,20200306,6637
20200303,9,한성백제,1619,1456,20200306,3075
20200303,9,올림픽공원,3548,3466,20200306,7014
20200303,9,둔촌오륜,624,555,20200306,1179
20200303,9,중앙보훈병원,7195,6533,20200306,13728
20200304,9,언주,7651,7682,20200307,15333
20200304,9,선정릉,7022,7541,20200307,14563
20200304,9,삼성중앙,4773,5008,20200307,9781
20200304,9,봉은사,11146,11055,20200307,22201
20200304,9,종합운동장,3179,2990,20200307,6169
20200304,9,삼전,4815,4804,20200307,9619
20200304,9,석촌고분,4262,4275,20200307,8537
20200304,9,석촌,5330,4722,20200307,10052
20200304,9,송파나루,3301,3470,20200307,6771
20200304,9,한성백제,1631,1447,20200307,3078
20200304,9,올림픽공원,3460,3311,20200307,6771
20200304,9,둔촌오륜,587,594,20200307,1181
20200304,9,중앙보훈병원,7108,6422,20200307,13530
20200305,9,언주,7534,7656,20200308,15190
20200305,9,선정릉,6932,7547,20200308,14479
20200305,9,삼성중앙,4840,5023,20200308,9863
20200305,9,봉은사,11249,11319,20200308,22568
20200305,9,종합운동장,3124,3061,20200308,6185
20200305,9,삼전,4807,4663,20200308,9470
20200305,9,석촌고분,4152,4170,20200308,8322
20200305,9,석촌,5381,4702,20200308,10083
20200305,9,송파나루,3268,3471,20200308,6739
20200305,9,한성백제,1692,1481,20200308,3173
20200305,9,올림픽공원,3573,3500,20200308,7073
20200305,9,둔촌오륜,603,576,20200308,1179
20200305,9,중앙보훈병원,7149,6475,20200308,13624
20200306,9,언주,7672,7751,20200309,15423
20200306,9,선정릉,7182,7645,20200309,14827
20200306,9,삼성중앙,4815,5058,20200309,9873
20200306,9,봉은사,11449,11463,20200309,22912
20200306,9,종합운동장,3257,3169,20200309,6426
20200306,9,삼전,5012,4830,20200309,9842
20200306,9,석촌고분,4359,4321,20200309,8680
20200306,9,석촌,5774,4832,20200309,10606
20200306,9,송파나루,3434,3650,20200309,7084
20200306,9,한성백제,1711,1485,20200309,3196
20200306,9,올림픽공원,3816,3642,20200309,7458
20200306,9,둔촌오륜,590,581,20200309,1171
20200306,9,중앙보훈병원,7322,6441,20200309,13763
20200307,9,언주,3322,3132,20200310,6454
20200307,9,선정릉,2787,3011,20200310,5798
20200307,9,삼성중앙,1944,1868,20200310,3812
20200307,9,봉은사,5758,5697,20200310,11455
20200307,9,종합운동장,1875,1731,20200310,3606
20200307,9,삼전,3182,2938,20200310,6120
20200307,9,석촌고분,2665,2475,20200310,5140
20200307,9,석촌,3622,3017,20200310,6639
20200307,9,송파나루,2223,2289,20200310,4512
20200307,9,한성백제,985,776,20200310,1761
20200307,9,올림픽공원,2191,2139,20200310,4330
20200307,9,둔촌오륜,305,308,20200310,613
20200307,9,중앙보훈병원,2564,2393,20200310,4957
20200308,9,언주,1855,1788,20200311,3643
20200308,9,선정릉,1775,1945,20200311,3720
20200308,9,삼성중앙,1238,1313,20200311,2551
20200308,9,봉은사,4051,4102,20200311,8153
20200308,9,종합운동장,1292,1220,20200311,2512
20200308,9,삼전,2226,2237,20200311,4463
20200308,9,석촌고분,1854,1796,20200311,3650
20200308,9,석촌,2638,2263,20200311,4901
20200308,9,송파나루,1599,1639,20200311,3238
20200308,9,한성백제,839,708,20200311,1547
20200308,9,올림픽공원,1767,1835,20200311,3602
20200308,9,둔촌오륜,220,224,20200311,444
20200308,9,중앙보훈병원,1994,1908,20200311,3902
20200309,9,언주,7856,8002,20200312,15858
20200309,9,선정릉,7587,8076,20200312,15663
20200309,9,삼성중앙,4977,5283,20200312,10260
20200309,9,봉은사,11940,12156,20200312,24096
20200309,9,종합운동장,3290,3186,20200312,6476
20200309,9,삼전,5003,4945,20200312,9948
20200309,9,석촌고분,4254,4409,20200312,8663
20200309,9,석촌,5708,4917,20200312,10625
20200309,9,송파나루,3243,3413,20200312,6656
20200309,9,한성백제,1826,1568,20200312,3394
20200309,9,올림픽공원,3838,3763,20200312,7601
20200309,9,둔촌오륜,745,695,20200312,1440
20200309,9,중앙보훈병원,7602,6927,20200312,14529
20200310,9,언주,7995,8094,20200313,16089
20200310,9,선정릉,7324,7906,20200313,15230
20200310,9,삼성중앙,5293,5504,20200313,10797
20200310,9,봉은사,11477,11596,20200313,23073
20200310,9,종합운동장,3346,3231,20200313,6577
20200310,9,삼전,4996,4903,20200313,9899
20200310,9,석촌고분,4323,4392,20200313,8715
20200310,9,석촌,5426,4770,20200313,10196
20200310,9,송파나루,3272,3502,20200313,6774
20200310,9,한성백제,1658,1494,20200313,3152
20200310,9,올림픽공원,3601,3477,20200313,7078
20200310,9,둔촌오륜,618,598,20200313,1216
20200310,9,중앙보훈병원,7347,6673,20200313,14020
20200311,9,송파나루,3495,3784,20200314,7279
20200311,9,한성백제,1752,1553,20200314,3305
20200311,9,올림픽공원,3881,3813,20200314,7694
20200311,9,둔촌오륜,616,589,20200314,1205
20200311,9,중앙보훈병원,7416,6696,20200314,14112
20200311,9,언주,7884,8015,20200314,15899
20200311,9,선정릉,7425,8064,20200314,15489
20200311,9,삼성중앙,5272,5390,20200314,10662
20200311,9,봉은사,11765,11775,20200314,23540
20200311,9,종합운동장,3310,3139,20200314,6449
20200311,9,삼전,5068,4863,20200314,9931
20200311,9,석촌고분,4473,4513,20200314,8986
20200311,9,석촌,5709,5082,20200314,10791
20200312,9,언주,7802,7770,20200315,15572
20200312,9,선정릉,7317,7919,20200315,15236
20200312,9,삼성중앙,5163,5356,20200315,10519
20200312,9,봉은사,11374,11603,20200315,22977
20200312,9,종합운동장,3332,3199,20200315,6531
20200312,9,삼전,5055,4850,20200315,9905
20200312,9,석촌고분,4401,4347,20200315,8748
20200312,9,석촌,5716,4829,20200315,10545
20200312,9,송파나루,3323,3641,20200315,6964
20200312,9,한성백제,1724,1535,20200315,3259
20200312,9,올림픽공원,3817,3758,20200315,7575
20200312,9,둔촌오륜,661,637,20200315,1298
20200312,9,중앙보훈병원,7313,6626,20200315,13939
20200313,9,언주,8054,8042,20200316,16096
20200313,9,선정릉,7544,7998,20200316,15542
20200313,9,삼성중앙,5057,5435,20200316,10492
20200313,9,봉은사,11581,11522,20200316,23103
20200313,9,종합운동장,3361,3233,20200316,6594
20200313,9,삼전,5123,4965,20200316,10088
20200313,9,석촌고분,4433,4336,20200316,8769
20200313,9,석촌,5802,5074,20200316,10876
20200313,9,송파나루,3427,3705,20200316,7132
20200313,9,한성백제,1840,1566,20200316,3406
20200313,9,올림픽공원,3734,3689,20200316,7423
20200313,9,둔촌오륜,658,598,20200316,1256
20200313,9,중앙보훈병원,7169,6384,20200316,13553
20200314,9,언주,3565,3450,20200317,7015
20200314,9,선정릉,3088,3341,20200317,6429
20200314,9,삼성중앙,2084,2024,20200317,4108
20200314,9,봉은사,5836,5757,20200317,11593
20200314,9,종합운동장,1974,1831,20200317,3805
20200314,9,삼전,3313,3145,20200317,6458
20200314,9,석촌고분,2815,2635,20200317,5450
20200314,9,석촌,4010,3145,20200317,7155
20200314,9,송파나루,2430,2474,20200317,4904
20200314,9,한성백제,1133,952,20200317,2085
20200314,9,올림픽공원,2272,2219,20200317,4491
20200314,9,둔촌오륜,331,347,20200317,678
20200314,9,중앙보훈병원,2667,2446,20200317,5113
20200315,9,언주,1872,1912,20200318,3784
20200315,9,선정릉,1898,2031,20200318,3929
20200315,9,삼성중앙,1221,1245,20200318,2466
20200315,9,봉은사,4072,3991,20200318,8063
20200315,9,종합운동장,1420,1200,20200318,2620
20200315,9,삼전,2303,2295,20200318,4598
20200315,9,석촌고분,1916,1873,20200318,3789
20200315,9,석촌,2516,2096,20200318,4612
20200315,9,송파나루,1697,1726,20200318,3423
20200315,9,한성백제,771,605,20200318,1376
20200315,9,올림픽공원,1544,1539,20200318,3083
20200315,9,둔촌오륜,188,204,20200318,392
20200315,9,중앙보훈병원,1874,1818,20200318,3692
20200316,9,언주,7892,7972,20200319,15864
20200316,9,선정릉,7541,8140,20200319,15681
20200316,9,삼성중앙,5350,5536,20200319,10886
20200316,9,봉은사,11789,11759,20200319,23548
20200316,9,종합운동장,3203,3126,20200319,6329
20200316,9,삼전,5045,5049,20200319,10094
20200316,9,석촌고분,4311,4346,20200319,8657
20200316,9,석촌,5775,5054,20200319,10829
20200316,9,송파나루,3318,3654,20200319,6972
20200316,9,한성백제,1763,1589,20200319,3352
20200316,9,올림픽공원,3770,3796,20200319,7566
20200316,9,둔촌오륜,629,598,20200319,1227
20200316,9,중앙보훈병원,7350,6730,20200319,14080
20200317,9,언주,7853,7928,20200320,15781
20200317,9,선정릉,7622,8131,20200320,15753
20200317,9,삼성중앙,5174,5478,20200320,10652
20200317,9,봉은사,11469,11427,20200320,22896
20200317,9,종합운동장,3206,3164,20200320,6370
20200317,9,삼전,4990,4824,20200320,9814
20200317,9,석촌고분,4313,4331,20200320,8644
20200317,9,석촌,5716,5031,20200320,10747
20200317,9,송파나루,3405,3671,20200320,7076
20200317,9,한성백제,1758,1604,20200320,3362
20200317,9,올림픽공원,3773,3769,20200320,7542
20200317,9,둔촌오륜,700,640,20200320,1340
20200317,9,중앙보훈병원,7525,6789,20200320,14314
20200318,9,언주,7956,8041,20200321,15997
20200318,9,선정릉,7717,8286,20200321,16003
20200318,9,삼성중앙,5321,5545,20200321,10866
20200318,9,봉은사,11595,11692,20200321,23287
20200318,9,종합운동장,3316,3239,20200321,6555
20200318,9,삼전,5079,4979,20200321,10058
20200318,9,석촌고분,4491,4419,20200321,8910
20200318,9,석촌,5907,5064,20200321,10971
20200318,9,송파나루,3379,3688,20200321,7067
20200318,9,한성백제,1777,1567,20200321,3344
20200318,9,올림픽공원,3978,3981,20200321,7959
20200318,9,둔촌오륜,658,605,20200321,1263
20200318,9,중앙보훈병원,7546,6765,20200321,14311
20200319,9,중앙보훈병원,7336,6653,20200322,13989
20200319,9,둔촌오륜,653,590,20200322,1243
20200319,9,올림픽공원,3592,3479,20200322,7071
20200319,9,한성백제,1649,1477,20200322,3126
20200319,9,송파나루,3354,3581,20200322,6935
20200319,9,석촌,5654,4991,20200322,10645
20200319,9,석촌고분,4307,4368,20200322,8675
20200319,9,삼전,5064,4905,20200322,9969
20200319,9,종합운동장,3305,3112,20200322,6417
20200319,9,봉은사,11632,11671,20200322,23303
20200319,9,삼성중앙,5199,5421,20200322,10620
20200319,9,선정릉,7603,8181,20200322,15784
20200319,9,언주,7776,7937,20200322,15713
20200320,9,언주,8145,8270,20200323,16415
20200320,9,선정릉,7730,8214,20200323,15944
20200320,9,삼성중앙,5214,5419,20200323,10633
20200320,9,봉은사,11672,11834,20200323,23506
20200320,9,종합운동장,3484,3340,20200323,6824
20200320,9,삼전,5309,5161,20200323,10470
20200320,9,석촌고분,4607,4498,20200323,9105
20200320,9,석촌,6158,5353,20200323,11511
20200320,9,송파나루,3586,3785,20200323,7371
20200320,9,한성백제,1897,1628,20200323,3525
20200320,9,올림픽공원,4146,3986,20200323,8132
20200320,9,둔촌오륜,707,639,20200323,1346
20200320,9,중앙보훈병원,7632,6689,20200323,14321
20200321,9,언주,3572,3449,20200324,7021
20200321,9,선정릉,3079,3370,20200324,6449
20200321,9,삼성중앙,2026,1965,20200324,3991
20200321,9,봉은사,5748,5674,20200324,11422
20200321,9,종합운동장,2004,1837,20200324,3841
20200321,9,삼전,3359,3226,20200324,6585
20200321,9,석촌고분,2893,2720,20200324,5613
20200321,9,석촌,4022,3375,20200324,7397
20200321,9,송파나루,2312,2455,20200324,4767
20200321,9,한성백제,1219,1008,20200324,2227
20200321,9,올림픽공원,2524,2619,20200324,5143
20200321,9,둔촌오륜,403,392,20200324,795
20200321,9,중앙보훈병원,2945,2829,20200324,5774
20200322,9,언주,2002,1982,20200325,3984
20200322,9,선정릉,1966,2191,20200325,4157
20200322,9,삼성중앙,1300,1276,20200325,2576
20200322,9,봉은사,4153,4136,20200325,8289
20200322,9,종합운동장,1427,1289,20200325,2716
20200322,9,삼전,2397,2383,20200325,4780
20200322,9,석촌고분,2056,2053,20200325,4109
20200322,9,석촌,2930,2478,20200325,5408
20200322,9,송파나루,1772,1815,20200325,3587
20200322,9,한성백제,973,807,20200325,1780
20200322,9,올림픽공원,2065,2128,20200325,4193
20200322,9,둔촌오륜,254,238,20200325,492
20200322,9,중앙보훈병원,2099,1941,20200325,4040
20200323,9,중앙보훈병원,7605,6973,20200326,14578
20200323,9,둔촌오륜,694,614,20200326,1308
20200323,9,올림픽공원,3921,3943,20200326,7864
20200323,9,한성백제,1823,1656,20200326,3479
20200323,9,송파나루,3302,3461,20200326,6763
20200323,9,석촌,5855,5064,20200326,10919
20200323,9,석촌고분,4316,4346,20200326,8662
20200323,9,삼전,5097,4985,20200326,10082
20200323,9,종합운동장,3237,3188,20200326,6425
20200323,9,봉은사,11685,11764,20200326,23449
20200323,9,삼성중앙,5326,5575,20200326,10901
20200323,9,선정릉,7734,8328,20200326,16062
20200323,9,언주,8076,8140,20200326,16216
20200324,9,언주,8013,8029,20200327,16042
20200324,9,선정릉,7803,8324,20200327,16127
20200324,9,삼성중앙,5323,5528,20200327,10851
20200324,9,봉은사,11841,11897,20200327,23738
20200324,9,종합운동장,3222,3180,20200327,6402
20200324,9,삼전,5235,5047,20200327,10282
20200324,9,석촌고분,4437,4291,20200327,8728
20200324,9,석촌,5946,5236,20200327,11182
20200324,9,송파나루,3429,3577,20200327,7006
20200324,9,한성백제,1862,1637,20200327,3499
20200324,9,올림픽공원,4054,3963,20200327,8017
20200324,9,둔촌오륜,688,643,20200327,1331
20200324,9,중앙보훈병원,7863,7136,20200327,14999
20200325,9,중앙보훈병원,7618,6937,20200328,14555
20200325,9,언주,7973,8082,20200328,16055
20200325,9,선정릉,7969,8494,20200328,16463
20200325,9,삼성중앙,5265,5519,20200328,10784
20200325,9,봉은사,11902,11841,20200328,23743
20200325,9,종합운동장,3313,3204,20200328,6517
20200325,9,삼전,5152,5004,20200328,10156
20200325,9,석촌고분,4491,4616,20200328,9107
20200325,9,석촌,6021,5342,20200328,11363
20200325,9,송파나루,3409,3593,20200328,7002
20200325,9,한성백제,1820,1575,20200328,3395
20200325,9,올림픽공원,4154,4174,20200328,8328
20200325,9,둔촌오륜,651,637,20200328,1288
20200326,9,언주,8160,8165,20200329,16325
20200326,9,선정릉,7670,8286,20200329,15956
20200326,9,삼성중앙,5344,5485,20200329,10829
20200326,9,봉은사,11759,11826,20200329,23585
20200326,9,종합운동장,3272,3142,20200329,6414
20200326,9,삼전,5170,5095,20200329,10265
20200326,9,석촌고분,4430,4409,20200329,8839
20200326,9,석촌,5830,5105,20200329,10935
20200326,9,송파나루,3444,3683,20200329,7127
20200326,9,한성백제,1792,1559,20200329,3351
20200326,9,올림픽공원,3858,3642,20200329,7500
20200326,9,둔촌오륜,698,656,20200329,1354
20200326,9,중앙보훈병원,7631,6820,20200329,14451
20200327,9,언주,8241,8257,20200330,16498
20200327,9,선정릉,7933,8293,20200330,16226
20200327,9,삼성중앙,5430,5619,20200330,11049
20200327,9,봉은사,11600,11589,20200330,23189
20200327,9,종합운동장,3449,3341,20200330,6790
20200327,9,삼전,5349,5166,20200330,10515
20200327,9,석촌고분,4607,4517,20200330,9124
20200327,9,석촌,6234,5423,20200330,11657
20200327,9,송파나루,3576,3789,20200330,7365
20200327,9,한성백제,1865,1601,20200330,3466
20200327,9,올림픽공원,4103,3993,20200330,8096
20200327,9,둔촌오륜,663,630,20200330,1293
20200327,9,중앙보훈병원,7489,6681,20200330,14170
20200328,9,언주,3740,3529,20200331,7269
20200328,9,선정릉,3145,3389,20200331,6534
20200328,9,삼성중앙,2068,1979,20200331,4047
20200328,9,봉은사,5543,5515,20200331,11058
20200328,9,종합운동장,2132,1774,20200331,3906
20200328,9,삼전,3498,3290,20200331,6788
20200328,9,석촌고분,2859,2696,20200331,5555
20200328,9,석촌,4116,3251,20200331,7367
20200328,9,송파나루,2633,2694,20200331,5327
20200328,9,한성백제,1296,1079,20200331,2375
20200328,9,올림픽공원,2676,2791,20200331,5467
20200328,9,둔촌오륜,322,371,20200331,693
20200328,9,중앙보훈병원,3051,2788,20200331,5839
20200329,9,언주,2025,2063,20200401,4088
20200329,9,선정릉,2026,2214,20200401,4240
20200329,9,삼성중앙,1290,1284,20200401,2574
20200329,9,봉은사,3761,3599,20200401,7360
20200329,9,종합운동장,1318,1275,20200401,2593
20200329,9,삼전,2405,2480,20200401,4885
20200329,9,석촌고분,1945,1925,20200401,3870
20200329,9,석촌,2785,2442,20200401,5227
20200329,9,송파나루,1770,1807,20200401,3577
20200329,9,한성백제,1075,890,20200401,1965
20200329,9,올림픽공원,2167,2241,20200401,4408
20200329,9,둔촌오륜,210,222,20200401,432
20200329,9,중앙보훈병원,2136,2121,20200401,4257
20200330,9,언주,8076,8237,20200402,16313
20200330,9,선정릉,7776,8492,20200402,16268
20200330,9,삼성중앙,5398,5643,20200402,11041
20200330,9,봉은사,11506,11579,20200402,23085
20200330,9,종합운동장,3290,3247,20200402,6537
20200330,9,삼전,5186,5066,20200402,10252
20200330,9,석촌고분,4394,4400,20200402,8794
20200330,9,석촌,5879,5153,20200402,11032
20200330,9,송파나루,3344,3556,20200402,6900
20200330,9,한성백제,1862,1607,20200402,3469
20200330,9,올림픽공원,4054,4062,20200402,8116
20200330,9,둔촌오륜,709,644,20200402,1353
20200330,9,중앙보훈병원,7873,7235,20200402,15108
20200331,9,송파나루,3403,3654,20200403,7057
20200331,9,중앙보훈병원,7853,7163,20200403,15016
20200331,9,둔촌오륜,695,639,20200403,1334
20200331,9,올림픽공원,4108,4146,20200403,8254
20200331,9,한성백제,1898,1641,20200403,3539
20200331,9,언주,7924,8081,20200403,16005
20200331,9,선정릉,7873,8470,20200403,16343
20200331,9,삼성중앙,5475,5798,20200403,11273
20200331,9,봉은사,11506,11670,20200403,23176
20200331,9,종합운동장,3252,3232,20200403,6484
20200331,9,삼전,5226,5149,20200403,10375
20200331,9,석촌고분,4394,4382,20200403,8776
20200331,9,석촌,5935,5241,20200403,11176
20200401,9,언주,8028,8120,20200404,16148
20200401,9,선정릉,7960,8485,20200404,16445
20200401,9,삼성중앙,5449,5641,20200404,11090
20200401,9,봉은사,11717,11772,20200404,23489
20200401,9,종합운동장,3369,3164,20200404,6533
20200401,9,삼전,5222,5191,20200404,10413
20200401,9,석촌고분,4511,4504,20200404,9015
20200401,9,석촌,5948,5181,20200404,11129
20200401,9,송파나루,3486,3706,20200404,7192
20200401,9,한성백제,1985,1724,20200404,3709
20200401,9,올림픽공원,4228,4175,20200404,8403
20200401,9,둔촌오륜,783,720,20200404,1503
20200401,9,중앙보훈병원,7623,6929,20200404,14552
20200402,9,올림픽공원,4134,4157,20200405,8291
20200402,9,중앙보훈병원,7750,7030,20200405,14780
20200402,9,둔촌오륜,756,709,20200405,1465
20200402,9,언주,7844,8031,20200405,15875
20200402,9,선정릉,7805,8459,20200405,16264
20200402,9,삼성중앙,5329,5627,20200405,10956
20200402,9,봉은사,11630,11778,20200405,23408
20200402,9,종합운동장,3316,3252,20200405,6568
20200402,9,삼전,5131,4954,20200405,10085
20200402,9,석촌고분,4525,4544,20200405,9069
20200402,9,석촌,5991,5113,20200405,11104
20200402,9,송파나루,3537,3657,20200405,7194
20200402,9,한성백제,1964,1660,20200405,3624
20200403,9,언주,8193,8178,20200406,16371
20200403,9,선정릉,7975,8465,20200406,16440
20200403,9,삼성중앙,5544,5664,20200406,11208
20200403,9,봉은사,11716,11678,20200406,23394
20200403,9,종합운동장,3464,3411,20200406,6875
20200403,9,삼전,5399,5109,20200406,10508
20200403,9,석촌고분,4711,4532,20200406,9243
20200403,9,석촌,6270,5278,20200406,11548
20200403,9,송파나루,3650,3800,20200406,7450
20200403,9,한성백제,1969,1695,20200406,3664
20200403,9,올림픽공원,4274,4151,20200406,8425
20200403,9,둔촌오륜,714,680,20200406,1394
20200403,9,중앙보훈병원,7627,6683,20200406,14310
20200404,9,중앙보훈병원,2978,2742,20200407,5720
20200404,9,둔촌오륜,385,414,20200407,799
20200404,9,올림픽공원,2659,2904,20200407,5563
20200404,9,한성백제,1374,1036,20200407,2410
20200404,9,송파나루,2579,2486,20200407,5065
20200404,9,석촌,3988,3185,20200407,7173
20200404,9,석촌고분,2818,2661,20200407,5479
20200404,9,삼전,3468,3186,20200407,6654
20200404,9,종합운동장,2071,1849,20200407,3920
20200404,9,봉은사,5097,5093,20200407,10190
20200404,9,삼성중앙,2105,1977,20200407,4082
20200404,9,선정릉,3081,3282,20200407,6363
20200404,9,언주,3500,3362,20200407,6862
20200405,9,언주,1925,1964,20200408,3889
20200405,9,선정릉,1914,2075,20200408,3989
20200405,9,삼성중앙,1267,1330,20200408,2597
20200405,9,봉은사,3615,3611,20200408,7226
20200405,9,종합운동장,1367,1259,20200408,2626
20200405,9,삼전,2245,2374,20200408,4619
20200405,9,석촌고분,1925,1976,20200408,3901
20200405,9,석촌,2746,2253,20200408,4999
20200405,9,송파나루,1855,1809,20200408,3664
20200405,9,한성백제,1014,858,20200408,1872
20200405,9,올림픽공원,2013,2148,20200408,4161
20200405,9,둔촌오륜,251,289,20200408,540
20200405,9,중앙보훈병원,2123,2125,20200408,4248
20200406,9,언주,8229,8395,20200409,16624
20200406,9,선정릉,8193,8622,20200409,16815
20200406,9,삼성중앙,5748,5921,20200409,11669
20200406,9,봉은사,11912,12105,20200409,24017
20200406,9,종합운동장,3348,3297,20200409,6645
20200406,9,삼전,5270,5282,20200409,10552
20200406,9,석촌고분,4611,4632,20200409,9243
20200406,9,석촌,6026,5276,20200409,11302
20200406,9,송파나루,3329,3510,20200409,6839
20200406,9,한성백제,1954,1696,20200409,3650
20200406,9,올림픽공원,4183,4084,20200409,8267
20200406,9,둔촌오륜,735,687,20200409,1422
20200406,9,중앙보훈병원,8043,7397,20200409,15440
20200407,9,언주,8188,8351,20200410,16539
20200407,9,선정릉,8248,8767,20200410,17015
20200407,9,삼성중앙,5640,5973,20200410,11613
20200407,9,봉은사,12102,12202,20200410,24304
20200407,9,종합운동장,3338,3367,20200410,6705
20200407,9,삼전,5305,5175,20200410,10480
20200407,9,석촌고분,4647,4447,20200410,9094
20200407,9,석촌,6071,5253,20200410,11324
20200407,9,송파나루,3566,3651,20200410,7217
20200407,9,한성백제,1959,1725,20200410,3684
20200407,9,올림픽공원,4160,4148,20200410,8308
20200407,9,둔촌오륜,768,704,20200410,1472
20200407,9,중앙보훈병원,8081,7360,20200410,15441
20200408,9,중앙보훈병원,7903,7166,20200411,15069
20200408,9,둔촌오륜,700,655,20200411,1355
20200408,9,올림픽공원,4190,4131,20200411,8321
20200408,9,한성백제,1965,1805,20200411,3770
20200408,9,송파나루,3529,3726,20200411,7255
20200408,9,석촌,6120,5337,20200411,11457
20200408,9,석촌고분,4649,4592,20200411,9241
20200408,9,삼전,5416,5312,20200411,10728
20200408,9,종합운동장,3444,3297,20200411,6741
20200408,9,봉은사,11988,12100,20200411,24088
20200408,9,삼성중앙,5580,5719,20200411,11299
20200408,9,선정릉,8165,8807,20200411,16972
20200408,9,언주,8304,8345,20200411,16649
20200409,9,언주,8377,8386,20200412,16763
20200409,9,선정릉,8138,8784,20200412,16922
20200409,9,삼성중앙,5727,5956,20200412,11683
20200409,9,봉은사,12108,12246,20200412,24354
20200409,9,종합운동장,3385,3345,20200412,6730
20200409,9,삼전,5368,5272,20200412,10640
20200409,9,석촌고분,4578,4520,20200412,9098
20200409,9,석촌,6093,5304,20200412,11397
20200409,9,송파나루,3505,3673,20200412,7178
20200409,9,한성백제,2002,1684,20200412,3686
20200409,9,올림픽공원,4190,4124,20200412,8314
20200409,9,둔촌오륜,766,674,20200412,1440
20200409,9,중앙보훈병원,8111,7342,20200412,15453
20200410,9,중앙보훈병원,8025,7066,20200413,15091
20200410,9,언주,8622,8503,20200413,17125
20200410,9,선정릉,8444,8887,20200413,17331
20200410,9,삼성중앙,5722,5847,20200413,11569
20200410,9,봉은사,12613,12631,20200413,25244
20200410,9,종합운동장,3462,3396,20200413,6858
20200410,9,삼전,5597,5335,20200413,10932
20200410,9,석촌고분,4773,4546,20200413,9319
20200410,9,석촌,6419,5494,20200413,11913
20200410,9,송파나루,3630,3875,20200413,7505
20200410,9,한성백제,2038,1715,20200413,3753
20200410,9,올림픽공원,4351,4164,20200413,8515
20200410,9,둔촌오륜,749,661,20200413,1410
20200411,9,언주,3671,3568,20200414,7239
20200411,9,선정릉,3443,3712,20200414,7155
20200411,9,삼성중앙,2013,1971,20200414,3984
20200411,9,봉은사,5599,5652,20200414,11251
20200411,9,종합운동장,2264,1981,20200414,4245
20200411,9,삼전,3644,3402,20200414,7046
20200411,9,석촌고분,3009,2871,20200414,5880
20200411,9,석촌,4448,3416,20200414,7864
20200411,9,송파나루,2498,2575,20200414,5073
20200411,9,한성백제,1392,1094,20200414,2486
20200411,9,올림픽공원,2775,2833,20200414,5608
20200411,9,둔촌오륜,378,385,20200414,763
20200411,9,중앙보훈병원,3068,2904,20200414,5972
20200412,9,언주,2000,2038,20200415,4038
20200412,9,선정릉,2083,2412,20200415,4495
20200412,9,삼성중앙,1295,1355,20200415,2650
20200412,9,봉은사,4220,4008,20200415,8228
20200412,9,종합운동장,1425,1400,20200415,2825
20200412,9,삼전,2522,2599,20200415,5121
20200412,9,석촌고분,2107,2044,20200415,4151
20200412,9,석촌,2956,2434,20200415,5390
20200412,9,송파나루,1814,1903,20200415,3717
20200412,9,한성백제,939,829,20200415,1768
20200412,9,올림픽공원,1865,1970,20200415,3835
20200412,9,둔촌오륜,264,269,20200415,533
20200412,9,중앙보훈병원,2145,2120,20200415,4265
20200413,9,언주,8315,8413,20200416,16728
20200413,9,선정릉,8017,8685,20200416,16702
20200413,9,삼성중앙,5633,5779,20200416,11412
20200413,9,봉은사,12323,12517,20200416,24840
20200413,9,종합운동장,3352,3357,20200416,6709
20200413,9,삼전,5417,5195,20200416,10612
20200413,9,석촌고분,4611,4570,20200416,9181
20200413,9,석촌,6165,5372,20200416,11537
20200413,9,송파나루,3355,3517,20200416,6872
20200413,9,한성백제,1917,1702,20200416,3619
20200413,9,올림픽공원,4219,4124,20200416,8343
20200413,9,둔촌오륜,714,646,20200416,1360
20200413,9,중앙보훈병원,8227,7499,20200416,15726
20200414,9,중앙보훈병원,8278,7311,20200417,15589
20200414,9,둔촌오륜,740,638,20200417,1378
20200414,9,올림픽공원,4425,4222,20200417,8647
20200414,9,한성백제,1995,1768,20200417,3763
20200414,9,송파나루,3576,3893,20200417,7469
20200414,9,석촌,6431,5493,20200417,11924
20200414,9,석촌고분,4708,4549,20200417,9257
20200414,9,삼전,5538,5381,20200417,10919
20200414,9,종합운동장,3619,3504,20200417,7123
20200414,9,봉은사,12590,12725,20200417,25315
20200414,9,삼성중앙,5755,5946,20200417,11701
20200414,9,선정릉,8351,8834,20200417,17185
20200414,9,언주,8553,8453,20200417,17006
20200415,9,언주,2868,2880,20200418,5748
20200415,9,선정릉,2701,2901,20200418,5602
20200415,9,삼성중앙,1874,1900,20200418,3774
20200415,9,봉은사,4834,4762,20200418,9596
20200415,9,종합운동장,1947,1724,20200418,3671
20200415,9,삼전,3226,3179,20200418,6405
20200415,9,석촌고분,2677,2627,20200418,5304
20200415,9,석촌,4026,3162,20200418,7188
20200415,9,송파나루,2152,2337,20200418,4489
20200415,9,한성백제,1232,1022,20200418,2254
20200415,9,올림픽공원,2435,2538,20200418,4973
20200415,9,둔촌오륜,384,369,20200418,753
20200415,9,중앙보훈병원,2801,2707,20200418,5508
20200416,9,언주,8417,8516,20200419,16933
20200416,9,선정릉,8239,8858,20200419,17097
20200416,9,삼성중앙,5682,5969,20200419,11651
20200416,9,봉은사,12755,12817,20200419,25572
20200416,9,종합운동장,3484,3521,20200419,7005
20200416,9,삼전,5495,5341,20200419,10836
20200416,9,석촌고분,4683,4578,20200419,9261
20200416,9,석촌,6391,5680,20200419,12071
20200416,9,송파나루,3601,3880,20200419,7481
20200416,9,한성백제,1943,1702,20200419,3645
20200416,9,올림픽공원,4556,4310,20200419,8866
20200416,9,둔촌오륜,733,723,20200419,1456
20200416,9,중앙보훈병원,8236,7395,20200419,15631
20200417,9,언주,8580,8505,20200420,17085
20200417,9,선정릉,8216,8604,20200420,16820
20200417,9,삼성중앙,5721,5909,20200420,11630
20200417,9,봉은사,12672,12766,20200420,25438
20200417,9,종합운동장,3546,3557,20200420,7103
20200417,9,삼전,5581,5419,20200420,11000
20200417,9,석촌고분,4764,4616,20200420,9380
20200417,9,석촌,6274,5475,20200420,11749
20200417,9,송파나루,3732,3863,20200420,7595
20200417,9,한성백제,1852,1660,20200420,3512
20200417,9,올림픽공원,4205,3965,20200420,8170
20200417,9,둔촌오륜,771,718,20200420,1489
20200417,9,중앙보훈병원,7836,6902,20200420,14738
20200418,9,언주,4005,3855,20200421,7860
20200418,9,선정릉,3400,3710,20200421,7110
20200418,9,삼성중앙,2253,2151,20200421,4404
20200418,9,봉은사,6248,6187,20200421,12435
20200418,9,종합운동장,2450,2249,20200421,4699
20200418,9,삼전,3776,3496,20200421,7272
20200418,9,석촌고분,3176,2955,20200421,6131
20200418,9,석촌,4514,3730,20200421,8244
20200418,9,송파나루,2727,2865,20200421,5592
20200418,9,한성백제,1411,1145,20200421,2556
20200418,9,올림픽공원,3071,3121,20200421,6192
20200418,9,둔촌오륜,457,442,20200421,899
20200418,9,중앙보훈병원,3381,3175,20200421,6556
20200419,9,언주,2323,2232,20200422,4555
20200419,9,선정릉,1970,2200,20200422,4170
20200419,9,삼성중앙,1364,1430,20200422,2794
20200419,9,봉은사,4362,4322,20200422,8684
20200419,9,종합운동장,1442,1360,20200422,2802
20200419,9,삼전,2490,2587,20200422,5077
20200419,9,석촌고분,2059,2068,20200422,4127
20200419,9,석촌,2833,2441,20200422,5274
20200419,9,송파나루,1930,1937,20200422,3867
20200419,9,한성백제,863,711,20200422,1574
20200419,9,올림픽공원,1703,1756,20200422,3459
20200419,9,둔촌오륜,246,301,20200422,547
20200419,9,중앙보훈병원,2190,2156,20200422,4346
20200420,9,언주,8515,8647,20200423,17162
20200420,9,선정릉,8371,8989,20200423,17360
20200420,9,삼성중앙,5844,6048,20200423,11892
20200420,9,봉은사,13261,13326,20200423,26587
20200420,9,종합운동장,3563,3492,20200423,7055
20200420,9,삼전,5560,5481,20200423,11041
20200420,9,석촌고분,4668,4756,20200423,9424
20200420,9,석촌,6336,5520,20200423,11856
20200420,9,송파나루,3482,3696,20200423,7178
20200420,9,한성백제,1956,1759,20200423,3715
20200420,9,올림픽공원,4184,4060,20200423,8244
20200420,9,둔촌오륜,725,684,20200423,1409
20200420,9,중앙보훈병원,8642,7895,20200423,16537
20200421,9,언주,8848,8825,20200424,17673
20200421,9,선정릉,8336,9140,20200424,17476
20200421,9,삼성중앙,6083,6300,20200424,12383
20200421,9,봉은사,13562,13623,20200424,27185
20200421,9,종합운동장,3772,3543,20200424,7315
20200421,9,삼전,5720,5816,20200424,11536
20200421,9,석촌고분,4923,4895,20200424,9818
20200421,9,석촌,6562,5623,20200424,12185
20200421,9,송파나루,3620,3817,20200424,7437
20200421,9,한성백제,2048,1844,20200424,3892
20200421,9,올림픽공원,4368,4261,20200424,8629
20200421,9,둔촌오륜,773,734,20200424,1507
20200421,9,중앙보훈병원,8804,7971,20200424,16775
20200422,9,언주,8910,8790,20200425,17700
20200422,9,선정릉,8363,9175,20200425,17538
20200422,9,삼성중앙,6040,6298,20200425,12338
20200422,9,봉은사,13471,13505,20200425,26976
20200422,9,종합운동장,3801,3639,20200425,7440
20200422,9,삼전,5743,5753,20200425,11496
20200422,9,석촌고분,5005,4888,20200425,9893
20200422,9,석촌,6553,5591,20200425,12144
20200422,9,송파나루,3736,4046,20200425,7782
20200422,9,한성백제,1984,1773,20200425,3757
20200422,9,올림픽공원,4426,4232,20200425,8658
20200422,9,둔촌오륜,716,711,20200425,1427
20200422,9,중앙보훈병원,8762,7886,20200425,16648
20200423,9,언주,8833,9086,20200426,17919
20200423,9,선정릉,8556,9225,20200426,17781
20200423,9,삼성중앙,6006,6255,20200426,12261
20200423,9,봉은사,13900,14061,20200426,27961
20200423,9,종합운동장,3921,3657,20200426,7578
20200423,9,삼전,5755,5650,20200426,11405
20200423,9,석촌고분,4930,4917,20200426,9847
20200423,9,석촌,6642,5767,20200426,12409
20200423,9,송파나루,3830,3972,20200426,7802
20200423,9,한성백제,2004,1766,20200426,3770
20200423,9,올림픽공원,4487,4348,20200426,8835
20200423,9,둔촌오륜,776,690,20200426,1466
20200423,9,중앙보훈병원,8788,7906,20200426,16694
20200424,9,언주,9009,9035,20200427,18044
20200424,9,선정릉,8766,9405,20200427,18171
20200424,9,삼성중앙,6192,6360,20200427,12552
20200424,9,봉은사,14092,14191,20200427,28283
20200424,9,종합운동장,3897,3833,20200427,7730
20200424,9,삼전,6003,5715,20200427,11718
20200424,9,석촌고분,5112,5023,20200427,10135
20200424,9,석촌,6909,5830,20200427,12739
20200424,9,송파나루,3931,4123,20200427,8054
20200424,9,한성백제,2122,1848,20200427,3970
20200424,9,올림픽공원,4708,4627,20200427,9335
20200424,9,둔촌오륜,895,796,20200427,1691
20200424,9,중앙보훈병원,8966,7874,20200427,16840
20200425,9,언주,4220,4102,20200428,8322
20200425,9,선정릉,3893,4256,20200428,8149
20200425,9,삼성중앙,2463,2357,20200428,4820
20200425,9,봉은사,7275,7257,20200428,14532
20200425,9,종합운동장,2504,2266,20200428,4770
20200425,9,삼전,3907,3696,20200428,7603
20200425,9,석촌고분,3309,3034,20200428,6343
20200425,9,석촌,4911,3938,20200428,8849
20200425,9,송파나루,2972,2963,20200428,5935
20200425,9,한성백제,1395,1175,20200428,2570
20200425,9,올림픽공원,3156,3060,20200428,6216
20200425,9,둔촌오륜,511,490,20200428,1001
20200425,9,중앙보훈병원,3619,3441,20200428,7060
20200426,9,언주,2418,2322,20200429,4740
20200426,9,선정릉,2329,2541,20200429,4870
20200426,9,삼성중앙,1546,1583,20200429,3129
20200426,9,봉은사,4973,4956,20200429,9929
20200426,9,종합운동장,1676,1513,20200429,3189
20200426,9,삼전,2777,2719,20200429,5496
20200426,9,석촌고분,2257,2276,20200429,4533
20200426,9,석촌,3406,2916,20200429,6322
20200426,9,송파나루,2032,2154,20200429,4186
20200426,9,한성백제,1152,974,20200429,2126
20200426,9,올림픽공원,2369,2444,20200429,4813
20200426,9,둔촌오륜,347,384,20200429,731
20200426,9,중앙보훈병원,2756,2609,20200429,5365
20200427,9,언주,8842,9000,20200430,17842
20200427,9,선정릉,8728,9450,20200430,18178
20200427,9,삼성중앙,6003,6306,20200430,12309
20200427,9,봉은사,13909,14045,20200430,27954
20200427,9,종합운동장,3755,3671,20200430,7426
20200427,9,삼전,5672,5646,20200430,11318
20200427,9,석촌고분,5048,4943,20200430,9991
20200427,9,석촌,6633,5788,20200430,12421
20200427,9,송파나루,3692,3877,20200430,7569
20200427,9,한성백제,2055,1828,20200430,3883
20200427,9,올림픽공원,4631,4596,20200430,9227
20200427,9,둔촌오륜,789,707,20200430,1496
20200427,9,중앙보훈병원,8756,7953,20200430,16709
20200428,9,언주,8988,9279,20200501,18267
20200428,9,선정릉,8942,9708,20200501,18650
20200428,9,삼성중앙,6171,6477,20200501,12648
20200428,9,봉은사,14184,14652,20200501,28836
20200428,9,종합운동장,3812,3777,20200501,7589
20200428,9,삼전,5889,5775,20200501,11664
20200428,9,석촌고분,4977,4807,20200501,9784
20200428,9,석촌,6939,5903,20200501,12842
20200428,9,송파나루,3670,3928,20200501,7598
20200428,9,한성백제,2146,1951,20200501,4097
20200428,9,올림픽공원,4918,4658,20200501,9576
20200428,9,둔촌오륜,799,718,20200501,1517
20200428,9,중앙보훈병원,9176,8187,20200501,17363
20200429,9,언주,9339,9365,20200502,18704
20200429,9,선정릉,9109,9936,20200502,19045
20200429,9,삼성중앙,6409,6584,20200502,12993
20200429,9,봉은사,15412,15584,20200502,30996
20200429,9,종합운동장,4124,3964,20200502,8088
20200429,9,삼전,6140,5804,20200502,11944
20200429,9,석촌고분,5299,4995,20200502,10294
20200429,9,석촌,7165,6001,20200502,13166
20200429,9,송파나루,3913,4094,20200502,8007
20200429,9,한성백제,2222,1894,20200502,4116
20200429,9,올림픽공원,4990,4750,20200502,9740
20200429,9,둔촌오륜,836,755,20200502,1591
20200429,9,중앙보훈병원,9362,8263,20200502,17625
20200430,9,언주,3035,2960,20200503,5995
20200430,9,선정릉,3081,3335,20200503,6416
20200430,9,삼성중앙,2165,1985,20200503,4150
20200430,9,봉은사,9174,9580,20200503,18754
20200430,9,종합운동장,2223,2001,20200503,4224
20200430,9,삼전,3682,3266,20200503,6948
20200430,9,석촌고분,3108,2787,20200503,5895
20200430,9,석촌,4557,3578,20200503,8135
20200430,9,송파나루,2616,2741,20200503,5357
20200430,9,한성백제,1375,1111,20200503,2486
20200430,9,올림픽공원,2994,3025,20200503,6019
20200430,9,둔촌오륜,452,459,20200503,911
20200430,9,중앙보훈병원,3687,3346,20200503,7033
20200501,9,중앙보훈병원,3641,3346,20200504,6987
20200501,9,둔촌오륜,414,431,20200504,845
20200501,9,올림픽공원,3114,3146,20200504,6260
20200501,9,한성백제,1376,1127,20200504,2503
20200501,9,송파나루,2779,3054,20200504,5833
20200501,9,석촌,4650,3725,20200504,8375
20200501,9,석촌고분,3237,3085,20200504,6322
20200501,9,삼전,3871,3632,20200504,7503
20200501,9,종합운동장,2525,2204,20200504,4729
20200501,9,봉은사,6756,6726,20200504,13482
20200501,9,삼성중앙,2441,2395,20200504,4836
20200501,9,선정릉,3414,3706,20200504,7120
20200501,9,언주,3548,3532,20200504,7080
20200502,9,언주,3817,3705,20200505,7522
20200502,9,선정릉,3409,3598,20200505,7007
20200502,9,삼성중앙,2149,2082,20200505,4231
20200502,9,봉은사,6746,6707,20200505,13453
20200502,9,종합운동장,2172,2076,20200505,4248
20200502,9,삼전,3531,3234,20200505,6765
20200502,9,석촌고분,2946,2837,20200505,5783
20200502,9,석촌,4372,3476,20200505,7848
20200502,9,송파나루,2551,2714,20200505,5265
20200502,9,한성백제,1251,1097,20200505,2348
20200502,9,올림픽공원,2889,2803,20200505,5692
20200502,9,둔촌오륜,372,399,20200505,771
20200502,9,중앙보훈병원,3359,3142,20200505,6501
20200503,9,중앙보훈병원,2748,2785,20200506,5533
20200503,9,둔촌오륜,349,374,20200506,723
20200503,9,올림픽공원,2400,2491,20200506,4891
20200503,9,한성백제,1064,964,20200506,2028
20200503,9,송파나루,1985,2229,20200506,4214
20200503,9,석촌,3305,2911,20200506,6216
20200503,9,석촌고분,2318,2247,20200506,4565
20200503,9,삼전,2701,2741,20200506,5442
20200503,9,종합운동장,1545,1491,20200506,3036
20200503,9,봉은사,4834,4854,20200506,9688
20200503,9,삼성중앙,1498,1549,20200506,3047
20200503,9,선정릉,2315,2601,20200506,4916
20200503,9,언주,2352,2288,20200506,4640
20200504,9,중앙보훈병원,7196,6643,20200507,13839
20200504,9,둔촌오륜,680,636,20200507,1316
20200504,9,올림픽공원,4003,4075,20200507,8078
20200504,9,한성백제,1767,1577,20200507,3344
20200504,9,송파나루,3340,3611,20200507,6951
20200504,9,석촌,5899,4974,20200507,10873
20200504,9,석촌고분,4223,4203,20200507,8426
20200504,9,삼전,5046,4929,20200507,9975
20200504,9,종합운동장,3212,3226,20200507,6438
20200504,9,봉은사,10358,10470,20200507,20828
20200504,9,삼성중앙,4394,4550,20200507,8944
20200504,9,선정릉,6315,6629,20200507,12944
20200504,9,언주,6555,6765,20200507,13320
20200505,9,언주,2712,2605,20200508,5317
20200505,9,선정릉,2503,2727,20200508,5230
20200505,9,삼성중앙,1798,1858,20200508,3656
20200505,9,봉은사,5713,5793,20200508,11506
20200505,9,종합운동장,1759,1690,20200508,3449
20200505,9,삼전,3176,3118,20200508,6294
20200505,9,석촌고분,2576,2563,20200508,5139
20200505,9,석촌,3687,3227,20200508,6914
20200505,9,송파나루,2233,2539,20200508,4772
20200505,9,한성백제,1079,971,20200508,2050
20200505,9,올림픽공원,2345,2396,20200508,4741
20200505,9,둔촌오륜,395,382,20200508,777
20200505,9,중앙보훈병원,3026,2909,20200508,5935
20200506,9,중앙보훈병원,9716,8729,20200509,18445
20200506,9,둔촌오륜,813,776,20200509,1589
20200506,9,올림픽공원,5052,5042,20200509,10094
20200506,9,한성백제,2207,2075,20200509,4282
20200506,9,송파나루,3781,4111,20200509,7892
20200506,9,석촌,6988,6254,20200509,13242
20200506,9,석촌고분,5139,5060,20200509,10199
20200506,9,삼전,6081,5935,20200509,12016
20200506,9,종합운동장,3994,3881,20200509,7875
20200506,9,봉은사,14909,14951,20200509,29860
20200506,9,삼성중앙,6313,6582,20200509,12895
20200506,9,선정릉,9338,10161,20200509,19499
20200506,9,언주,9173,9424,20200509,18597
20200507,9,중앙보훈병원,9658,8819,20200510,18477
20200507,9,둔촌오륜,844,755,20200510,1599
20200507,9,올림픽공원,5157,4981,20200510,10138
20200507,9,한성백제,2279,1978,20200510,4257
20200507,9,송파나루,3908,4146,20200510,8054
20200507,9,석촌,7171,6227,20200510,13398
20200507,9,석촌고분,5233,5085,20200510,10318
20200507,9,삼전,6043,5856,20200510,11899
20200507,9,종합운동장,4054,3885,20200510,7939
20200507,9,봉은사,15143,15452,20200510,30595
20200507,9,삼성중앙,6334,6555,20200510,12889
20200507,9,선정릉,9343,10058,20200510,19401
20200507,9,언주,9434,9432,20200510,18866
20200508,9,언주,10140,9716,20200511,19856
20200508,9,선정릉,9618,10034,20200511,19652
20200508,9,삼성중앙,6961,6844,20200511,13805
20200508,9,봉은사,16134,15654,20200511,31788
20200508,9,종합운동장,4193,4076,20200511,8269
20200508,9,삼전,6266,6198,20200511,12464
20200508,9,석촌고분,5284,5240,20200511,10524
20200508,9,석촌,7351,6286,20200511,13637
20200508,9,송파나루,4037,4254,20200511,8291
20200508,9,한성백제,2277,2081,20200511,4358
20200508,9,올림픽공원,5107,4982,20200511,10089
20200508,9,둔촌오륜,896,817,20200511,1713
20200508,9,중앙보훈병원,9532,8696,20200511,18228
20200509,9,언주,4807,4432,20200512,9239
20200509,9,선정릉,4060,4371,20200512,8431
20200509,9,삼성중앙,2540,2512,20200512,5052
20200509,9,봉은사,8225,8556,20200512,16781
20200509,9,종합운동장,2504,2289,20200512,4793
20200509,9,삼전,3878,3584,20200512,7462
20200509,9,석촌고분,3321,3104,20200512,6425
20200509,9,석촌,4600,3692,20200512,8292
20200509,9,송파나루,2768,2844,20200512,5612
20200509,9,한성백제,1231,1046,20200512,2277
20200509,9,올림픽공원,2673,2540,20200512,5213
20200509,9,둔촌오륜,438,429,20200512,867
20200509,9,중앙보훈병원,3498,3161,20200512,6659
20200510,9,언주,2460,2572,20200513,5032
20200510,9,선정릉,2861,3015,20200513,5876
20200510,9,삼성중앙,1562,1667,20200513,3229
20200510,9,봉은사,5670,5619,20200513,11289
20200510,9,종합운동장,1906,1752,20200513,3658
20200510,9,삼전,2910,2901,20200513,5811
20200510,9,석촌고분,2465,2455,20200513,4920
20200510,9,석촌,3543,3091,20200513,6634
20200510,9,송파나루,2099,2358,20200513,4457
20200510,9,한성백제,1147,989,20200513,2136
20200510,9,올림픽공원,2440,2582,20200513,5022
20200510,9,둔촌오륜,355,397,20200513,752
20200510,9,중앙보훈병원,2759,2610,20200513,5369
20200511,9,중앙보훈병원,9579,8662,20200514,18241
20200511,9,둔촌오륜,822,752,20200514,1574
20200511,9,올림픽공원,4856,4774,20200514,9630
20200511,9,한성백제,2149,1954,20200514,4103
20200511,9,송파나루,3833,3994,20200514,7827
20200511,9,석촌,6831,6034,20200514,12865
20200511,9,석촌고분,5099,5085,20200514,10184
20200511,9,삼전,5965,5890,20200514,11855
20200511,9,종합운동장,3947,3843,20200514,7790
20200511,9,봉은사,14467,14653,20200514,29120
20200511,9,삼성중앙,6342,6579,20200514,12921
20200511,9,선정릉,9161,9757,20200514,18918
20200511,9,언주,9117,9223,20200514,18340
20200512,9,언주,9189,9207,20200515,18396
20200512,9,선정릉,9026,9756,20200515,18782
20200512,9,삼성중앙,6373,6572,20200515,12945
20200512,9,봉은사,14714,14732,20200515,29446
20200512,9,종합운동장,3799,3754,20200515,7553
20200512,9,삼전,6044,5863,20200515,11907
20200512,9,석촌고분,5080,5071,20200515,10151
20200512,9,석촌,6982,6015,20200515,12997
20200512,9,송파나루,3805,4035,20200515,7840
20200512,9,한성백제,2242,2032,20200515,4274
20200512,9,올림픽공원,4997,4946,20200515,9943
20200512,9,둔촌오륜,846,749,20200515,1595
20200512,9,중앙보훈병원,9388,8510,20200515,17898
20200513,9,언주,9205,9268,20200516,18473
20200513,9,선정릉,9242,9815,20200516,19057
20200513,9,삼성중앙,6474,6590,20200516,13064
20200513,9,봉은사,14849,14872,20200516,29721
20200513,9,종합운동장,4030,3943,20200516,7973
20200513,9,삼전,5990,6011,20200516,12001
20200513,9,석촌고분,5163,5083,20200516,10246
20200513,9,석촌,7035,6228,20200516,13263
20200513,9,송파나루,3814,4150,20200516,7964
20200513,9,한성백제,2195,1986,20200516,4181
20200513,9,올림픽공원,5087,4901,20200516,9988
20200513,9,둔촌오륜,814,764,20200516,1578
20200513,9,중앙보훈병원,9406,8479,20200516,17885
20200514,9,언주,9112,9245,20200517,18357
20200514,9,선정릉,9030,9785,20200517,18815
20200514,9,삼성중앙,6266,6600,20200517,12866
20200514,9,봉은사,14472,14584,20200517,29056
20200514,9,종합운동장,3955,3718,20200517,7673
20200514,9,삼전,6084,5833,20200517,11917
20200514,9,석촌고분,5153,5060,20200517,10213
20200514,9,석촌,6987,6098,20200517,13085
20200514,9,송파나루,3814,4146,20200517,7960
20200514,9,한성백제,2252,1945,20200517,4197
20200514,9,올림픽공원,5025,4882,20200517,9907
20200514,9,둔촌오륜,795,752,20200517,1547
20200514,9,중앙보훈병원,9392,8417,20200517,17809
20200515,9,중앙보훈병원,9135,8018,20200518,17153
20200515,9,둔촌오륜,756,745,20200518,1501
20200515,9,올림픽공원,4611,4423,20200518,9034
20200515,9,한성백제,2120,1872,20200518,3992
20200515,9,송파나루,3987,4262,20200518,8249
20200515,9,석촌,6945,5992,20200518,12937
20200515,9,석촌고분,5215,5097,20200518,10312
20200515,9,삼전,6094,5886,20200518,11980
20200515,9,종합운동장,4000,3984,20200518,7984
20200515,9,봉은사,14768,14715,20200518,29483
20200515,9,삼성중앙,6662,6773,20200518,13435
20200515,9,선정릉,8835,9482,20200518,18317
20200515,9,언주,9483,9407,20200518,18890
20200516,9,중앙보훈병원,3701,3510,20200519,7211
20200516,9,둔촌오륜,459,494,20200519,953
20200516,9,올림픽공원,3308,3246,20200519,6554
20200516,9,한성백제,1485,1174,20200519,2659
20200516,9,송파나루,2793,3028,20200519,5821
20200516,9,석촌,4970,4063,20200519,9033
20200516,9,석촌고분,3540,3303,20200519,6843
20200516,9,삼전,3912,3655,20200519,7567
20200516,9,종합운동장,2723,2462,20200519,5185
20200516,9,봉은사,7929,8185,20200519,16114
20200516,9,삼성중앙,2656,2655,20200519,5311
20200516,9,선정릉,4033,4314,20200519,8347
20200516,9,언주,4372,4269,20200519,8641
20200517,9,중앙보훈병원,3169,3078,20200520,6247
20200517,9,둔촌오륜,366,424,20200520,790
20200517,9,올림픽공원,2661,2727,20200520,5388
20200517,9,한성백제,1139,948,20200520,2087
20200517,9,송파나루,2034,2170,20200520,4204
20200517,9,석촌,3474,2974,20200520,6448
20200517,9,석촌고분,2470,2408,20200520,4878
20200517,9,삼전,2845,2853,20200520,5698
20200517,9,종합운동장,1961,1796,20200520,3757
20200517,9,봉은사,5744,5656,20200520,11400
20200517,9,삼성중앙,1596,1621,20200520,3217
20200517,9,선정릉,2752,3053,20200520,5805
20200517,9,언주,2497,2533,20200520,5030
20200518,9,언주,9254,9156,20200521,18410
20200518,9,선정릉,8764,9601,20200521,18365
20200518,9,삼성중앙,6586,6691,20200521,13277
20200518,9,봉은사,14319,14023,20200521,28342
20200518,9,종합운동장,3956,3680,20200521,7636
20200518,9,삼전,5872,5990,20200521,11862
20200518,9,석촌고분,4945,5201,20200521,10146
20200518,9,석촌,6620,5661,20200521,12281
20200518,9,송파나루,3769,4042,20200521,7811
20200518,9,한성백제,2145,1974,20200521,4119
20200518,9,올림픽공원,4647,4532,20200521,9179
20200518,9,둔촌오륜,715,746,20200521,1461
20200518,9,중앙보훈병원,9358,8201,20200521,17559
20200519,9,중앙보훈병원,9005,8088,20200522,17093
20200519,9,둔촌오륜,759,751,20200522,1510
20200519,9,올림픽공원,4779,4660,20200522,9439
20200519,9,한성백제,2181,1975,20200522,4156
20200519,9,송파나루,3858,4061,20200522,7919
20200519,9,석촌,6817,5913,20200522,12730
20200519,9,석촌고분,5155,5080,20200522,10235
20200519,9,삼전,5900,5798,20200522,11698
20200519,9,종합운동장,3946,3855,20200522,7801
20200519,9,봉은사,14211,14459,20200522,28670
20200519,9,삼성중앙,6410,6751,20200522,13161
20200519,9,선정릉,8950,9507,20200522,18457
20200519,9,언주,9061,9256,20200522,18317
20200520,9,중앙보훈병원,9710,8624,20200523,18334
20200520,9,둔촌오륜,879,838,20200523,1717
20200520,9,올림픽공원,5354,5278,20200523,10632
20200520,9,한성백제,2356,2087,20200523,4443
20200520,9,송파나루,3937,4343,20200523,8280
20200520,9,석촌,7227,6294,20200523,13521
20200520,9,석촌고분,5363,5221,20200523,10584
20200520,9,삼전,6120,5997,20200523,12117
20200520,9,종합운동장,4154,3926,20200523,8080
20200520,9,봉은사,14688,14871,20200523,29559
20200520,9,삼성중앙,6560,6739,20200523,13299
20200520,9,선정릉,9295,10032,20200523,19327
20200520,9,언주,9137,9357,20200523,18494
20200521,9,중앙보훈병원,9772,8772,20200524,18544
20200521,9,둔촌오륜,907,791,20200524,1698
20200521,9,올림픽공원,5456,5219,20200524,10675
20200521,9,한성백제,2257,2022,20200524,4279
20200521,9,송파나루,3945,4219,20200524,8164
20200521,9,석촌,7284,6322,20200524,13606
20200521,9,석촌고분,5251,5199,20200524,10450
20200521,9,삼전,6018,5967,20200524,11985
20200521,9,종합운동장,4112,3986,20200524,8098
20200521,9,봉은사,14622,15020,20200524,29642
20200521,9,삼성중앙,6436,6619,20200524,13055
20200521,9,선정릉,9196,9976,20200524,19172
20200521,9,언주,9281,9388,20200524,18669
20200522,9,언주,9411,9415,20200525,18826
20200522,9,선정릉,9225,9970,20200525,19195
20200522,9,삼성중앙,6579,6685,20200525,13264
20200522,9,봉은사,15434,15461,20200525,30895
20200522,9,종합운동장,4126,4027,20200525,8153
20200522,9,삼전,6173,6075,20200525,12248
20200522,9,석촌고분,5334,5184,20200525,10518
20200522,9,석촌,7457,6476,20200525,13933
20200522,9,송파나루,4136,4485,20200525,8621
20200522,9,한성백제,2377,2006,20200525,4383
20200522,9,올림픽공원,5415,5293,20200525,10708
20200522,9,둔촌오륜,903,821,20200525,1724
20200522,9,중앙보훈병원,9648,8404,20200525,18052
20200523,9,언주,4770,4651,20200526,9421
20200523,9,선정릉,4468,4944,20200526,9412
20200523,9,삼성중앙,2865,2843,20200526,5708
20200523,9,봉은사,9300,9434,20200526,18734
20200523,9,종합운동장,3205,2862,20200526,6067
20200523,9,삼전,4385,4134,20200526,8519
20200523,9,석촌고분,3566,3362,20200526,6928
20200523,9,석촌,5533,4443,20200526,9976
20200523,9,송파나루,3203,3582,20200526,6785
20200523,9,한성백제,1836,1528,20200526,3364
20200523,9,올림픽공원,3842,3944,20200526,7786
20200523,9,둔촌오륜,544,522,20200526,1066
20200523,9,중앙보훈병원,4374,4068,20200526,8442
20200524,9,중앙보훈병원,2945,2882,20200527,5827
20200524,9,둔촌오륜,335,352,20200527,687
20200524,9,올림픽공원,2616,2728,20200527,5344
20200524,9,한성백제,1177,1027,20200527,2204
20200524,9,송파나루,2191,2321,20200527,4512
20200524,9,석촌,3522,3046,20200527,6568
20200524,9,석촌고분,2423,2491,20200527,4914
20200524,9,삼전,2853,2852,20200527,5705
20200524,9,종합운동장,1927,1671,20200527,3598
20200524,9,봉은사,5844,5832,20200527,11676
20200524,9,삼성중앙,1627,1580,20200527,3207
20200524,9,선정릉,2647,2896,20200527,5543
20200524,9,언주,2663,2616,20200527,5279
20200525,9,중앙보훈병원,9533,8597,20200528,18130
20200525,9,둔촌오륜,888,798,20200528,1686
20200525,9,올림픽공원,5224,5157,20200528,10381
20200525,9,한성백제,2255,1988,20200528,4243
20200525,9,송파나루,3847,4071,20200528,7918
20200525,9,석촌,7114,6359,20200528,13473
20200525,9,석촌고분,5144,5150,20200528,10294
20200525,9,삼전,6020,5876,20200528,11896
20200525,9,종합운동장,3905,3882,20200528,7787
20200525,9,봉은사,14917,15090,20200528,30007
20200525,9,삼성중앙,6331,6601,20200528,12932
20200525,9,선정릉,9061,9778,20200528,18839
20200525,9,언주,9122,9222,20200528,18344
20200526,9,중앙보훈병원,9748,8655,20200529,18403
20200526,9,둔촌오륜,932,804,20200529,1736
20200526,9,올림픽공원,5344,5135,20200529,10479
20200526,9,한성백제,2238,2068,20200529,4306
20200526,9,송파나루,3898,4215,20200529,8113
20200526,9,석촌,7197,6288,20200529,13485
20200526,9,석촌고분,5218,5317,20200529,10535
20200526,9,삼전,6012,5930,20200529,11942
20200526,9,종합운동장,4111,3873,20200529,7984
20200526,9,봉은사,15132,15227,20200529,30359
20200526,9,삼성중앙,6580,6894,20200529,13474
20200526,9,선정릉,9109,9899,20200529,19008
20200526,9,언주,9502,9541,20200529,19043
20200527,9,중앙보훈병원,9923,8743,20200530,18666
20200527,9,둔촌오륜,1048,956,20200530,2004
20200527,9,올림픽공원,5575,5466,20200530,11041
20200527,9,한성백제,2327,2131,20200530,4458
20200527,9,송파나루,4060,4426,20200530,8486
20200527,9,석촌,7476,6478,20200530,13954
20200527,9,석촌고분,5410,5185,20200530,10595
20200527,9,삼전,6083,5991,20200530,12074
20200527,9,종합운동장,4173,3969,20200530,8142
20200527,9,봉은사,15308,15406,20200530,30714
20200527,9,삼성중앙,6519,6815,20200530,13334
20200527,9,선정릉,9343,10165,20200530,19508
20200527,9,언주,9323,9469,20200530,18792
20200528,9,중앙보훈병원,9561,8621,20200531,18182
20200528,9,둔촌오륜,1047,921,20200531,1968
20200528,9,올림픽공원,5386,5380,20200531,10766
20200528,9,한성백제,2354,2123,20200531,4477
20200528,9,송파나루,3918,4263,20200531,8181
20200528,9,석촌,7178,6240,20200531,13418
20200528,9,석촌고분,5225,5086,20200531,10311
20200528,9,삼전,5927,5793,20200531,11720
20200528,9,종합운동장,4091,3952,20200531,8043
20200528,9,봉은사,15077,15286,20200531,30363
20200528,9,삼성중앙,6443,6698,20200531,13141
20200528,9,선정릉,9161,10070,20200531,19231
20200528,9,언주,9218,9280,20200531,18498
20200529,9,언주,9432,9356,20200601,18788
20200529,9,선정릉,9362,10002,20200601,19364
20200529,9,삼성중앙,6526,6673,20200601,13199
20200529,9,봉은사,15601,15666,20200601,31267
20200529,9,종합운동장,4105,4002,20200601,8107
20200529,9,삼전,6166,5881,20200601,12047
20200529,9,석촌고분,5328,5242,20200601,10570
20200529,9,석촌,7457,6442,20200601,13899
20200529,9,송파나루,4164,4546,20200601,8710
20200529,9,한성백제,2366,2069,20200601,4435
20200529,9,올림픽공원,5424,5368,20200601,10792
20200529,9,둔촌오륜,1158,938,20200601,2096
20200529,9,중앙보훈병원,9707,8453,20200601,18160
20200530,9,언주,4619,4394,20200602,9013
20200530,9,선정릉,4217,4775,20200602,8992
20200530,9,삼성중앙,2751,2670,20200602,5421
20200530,9,봉은사,10717,10752,20200602,21469
20200530,9,종합운동장,2743,2545,20200602,5288
20200530,9,삼전,4187,3895,20200602,8082
20200530,9,석촌고분,3621,3388,20200602,7009
20200530,9,석촌,5487,4555,20200602,10042
20200530,9,송파나루,3116,3322,20200602,6438
20200530,9,한성백제,1636,1361,20200602,2997
20200530,9,올림픽공원,3768,3850,20200602,7618
20200530,9,둔촌오륜,510,504,20200602,1014
20200530,9,중앙보훈병원,4174,3872,20200602,8046
20200531,9,중앙보훈병원,3048,2925,20200603,5973
20200531,9,둔촌오륜,376,353,20200603,729
20200531,9,올림픽공원,2699,2984,20200603,5683
20200531,9,한성백제,1144,956,20200603,2100
20200531,9,송파나루,2123,2348,20200603,4471
20200531,9,석촌,3646,2989,20200603,6635
20200531,9,석촌고분,2424,2457,20200603,4881
20200531,9,삼전,2941,2969,20200603,5910
20200531,9,종합운동장,1868,1642,20200603,3510
20200531,9,봉은사,5543,5547,20200603,11090
20200531,9,삼성중앙,1585,1683,20200603,3268
20200531,9,선정릉,2598,2821,20200603,5419
20200531,9,언주,2580,2670,20200603,5250
20200101,KK,여주,1631,1419,20200104,3050
20200101,KK,세종대왕릉,218,217,20200104,435
20200101,KK,부발,981,1539,20200104,2520
20200101,KK,이천,1824,1940,20200104,3764
20200101,KK,신둔도예촌,618,669,20200104,1287
20200101,KK,곤지암,1128,1242,20200104,2370
20200101,KK,초월,1214,1340,20200104,2554
20200101,KK,경기광주,3077,3099,20200104,6176
20200101,KK,삼동,729,752,20200104,1481
20200101,KK,이매,545,382,20200104,927
20200101,KK,판교,1405,1344,20200104,2749
20200102,KK,판교,4966,4843,20200105,9809
20200102,KK,이매,1200,1021,20200105,2221
20200102,KK,삼동,2473,2170,20200105,4643
20200102,KK,경기광주,7612,7113,20200105,14725
20200102,KK,초월,2848,2769,20200105,5617
20200102,KK,곤지암,2060,2156,20200105,4216
20200102,KK,신둔도예촌,1266,1120,20200105,2386
20200102,KK,이천,2690,3004,20200105,5694
20200102,KK,부발,1821,1652,20200105,3473
20200102,KK,세종대왕릉,319,279,20200105,598
20200102,KK,여주,1880,1747,20200105,3627
20200103,KK,판교,5245,5144,20200106,10389
20200103,KK,이매,1283,1113,20200106,2396
20200103,KK,삼동,2595,2197,20200106,4792
20200103,KK,경기광주,8194,7612,20200106,15806
20200103,KK,초월,3209,2860,20200106,6069
20200103,KK,곤지암,2352,2202,20200106,4554
20200103,KK,신둔도예촌,1412,1196,20200106,2608
20200103,KK,이천,3122,3142,20200106,6264
20200103,KK,부발,2365,1731,20200106,4096
20200103,KK,세종대왕릉,316,309,20200106,625
20200103,KK,여주,2015,1999,20200106,4014
20200104,KK,판교,2936,2931,20200107,5867
20200104,KK,이매,894,669,20200107,1563
20200104,KK,삼동,1584,1378,20200107,2962
20200104,KK,경기광주,5762,5289,20200107,11051
20200104,KK,초월,2287,2012,20200107,4299
20200104,KK,곤지암,2048,1730,20200107,3778
20200104,KK,신둔도예촌,1141,1074,20200107,2215
20200104,KK,이천,2787,2830,20200107,5617
20200104,KK,부발,1929,1588,20200107,3517
20200104,KK,세종대왕릉,342,321,20200107,663
20200104,KK,여주,2048,2090,20200107,4138
20200105,KK,판교,2401,2254,20200108,4655
20200105,KK,이매,980,640,20200108,1620
20200105,KK,삼동,1127,1079,20200108,2206
20200105,KK,경기광주,4122,4099,20200108,8221
20200105,KK,초월,1613,1594,20200108,3207
20200105,KK,곤지암,1512,1536,20200108,3048
20200105,KK,신둔도예촌,834,900,20200108,1734
20200105,KK,이천,2125,2306,20200108,4431
20200105,KK,부발,1264,1743,20200108,3007
20200105,KK,세종대왕릉,254,254,20200108,508
20200105,KK,여주,1881,1680,20200108,3561
20200106,KK,판교,5020,4879,20200109,9899
20200106,KK,이매,1206,1024,20200109,2230
20200106,KK,삼동,2595,2240,20200109,4835
20200106,KK,경기광주,7858,7433,20200109,15291
20200106,KK,초월,3028,2880,20200109,5908
20200106,KK,곤지암,2087,2043,20200109,4130
20200106,KK,신둔도예촌,1243,1144,20200109,2387
20200106,KK,이천,2747,2941,20200109,5688
20200106,KK,부발,1724,1711,20200109,3435
20200106,KK,세종대왕릉,270,252,20200109,522
20200106,KK,여주,1938,1900,20200109,3838
20200107,KK,판교,4927,4836,20200110,9763
20200107,KK,이매,1129,1045,20200110,2174
20200107,KK,삼동,2482,2080,20200110,4562
20200107,KK,경기광주,7502,7074,20200110,14576
20200107,KK,초월,2828,2716,20200110,5544
20200107,KK,곤지암,1846,1808,20200110,3654
20200107,KK,신둔도예촌,1160,1055,20200110,2215
20200107,KK,이천,2602,2639,20200110,5241
20200107,KK,부발,1712,1532,20200110,3244
20200107,KK,세종대왕릉,260,236,20200110,496
20200107,KK,여주,1755,1706,20200110,3461
20200108,KK,판교,5206,5098,20200111,10304
20200108,KK,이매,1261,1039,20200111,2300
20200108,KK,삼동,2539,2292,20200111,4831
20200108,KK,경기광주,7825,7212,20200111,15037
20200108,KK,초월,2948,2866,20200111,5814
20200108,KK,곤지암,2004,1935,20200111,3939
20200108,KK,신둔도예촌,1189,1162,20200111,2351
20200108,KK,이천,2653,2886,20200111,5539
20200108,KK,부발,1815,1658,20200111,3473
20200108,KK,세종대왕릉,308,287,20200111,595
20200108,KK,여주,1881,1834,20200111,3715
20200109,KK,판교,4997,5099,20200112,10096
20200109,KK,이매,1238,1023,20200112,2261
20200109,KK,삼동,2636,2251,20200112,4887
20200109,KK,경기광주,7975,7452,20200112,15427
20200109,KK,초월,3012,2830,20200112,5842
20200109,KK,곤지암,2135,2023,20200112,4158
20200109,KK,신둔도예촌,1281,1197,20200112,2478
20200109,KK,이천,2879,2895,20200112,5774
20200109,KK,부발,1903,1771,20200112,3674
20200109,KK,세종대왕릉,302,286,20200112,588
20200109,KK,여주,1968,1901,20200112,3869
20200110,KK,판교,5323,5404,20200113,10727
20200110,KK,이매,1307,1110,20200113,2417
20200110,KK,삼동,2678,2231,20200113,4909
20200110,KK,경기광주,8291,7578,20200113,15869
20200110,KK,초월,3170,2857,20200113,6027
20200110,KK,곤지암,2354,2166,20200113,4520
20200110,KK,신둔도예촌,1497,1270,20200113,2767
20200110,KK,이천,3100,3190,20200113,6290
20200110,KK,부발,2534,1857,20200113,4391
20200110,KK,세종대왕릉,327,312,20200113,639
20200110,KK,여주,2163,2169,20200113,4332
20200111,KK,판교,3061,2948,20200114,6009
20200111,KK,이매,937,699,20200114,1636
20200111,KK,삼동,1706,1440,20200114,3146
20200111,KK,경기광주,6111,5671,20200114,11782
20200111,KK,초월,2420,2145,20200114,4565
20200111,KK,곤지암,1946,1825,20200114,3771
20200111,KK,신둔도예촌,1237,1133,20200114,2370
20200111,KK,이천,3106,3177,20200114,6283
20200111,KK,부발,2070,1707,20200114,3777
20200111,KK,세종대왕릉,335,328,20200114,663
20200111,KK,여주,2317,2284,20200114,4601
20200112,KK,판교,2444,2358,20200115,4802
20200112,KK,이매,908,617,20200115,1525
20200112,KK,삼동,1129,1088,20200115,2217
20200112,KK,경기광주,4283,4351,20200115,8634
20200112,KK,초월,1757,1723,20200115,3480
20200112,KK,곤지암,1570,1529,20200115,3099
20200112,KK,신둔도예촌,913,912,20200115,1825
20200112,KK,이천,2248,2641,20200115,4889
20200112,KK,부발,1329,1901,20200115,3230
20200112,KK,세종대왕릉,257,265,20200115,522
20200112,KK,여주,1988,1830,20200115,3818
20200113,KK,판교,5124,4924,20200116,10048
20200113,KK,이매,1245,1058,20200116,2303
20200113,KK,삼동,2566,2262,20200116,4828
20200113,KK,경기광주,7869,7335,20200116,15204
20200113,KK,초월,2990,2958,20200116,5948
20200113,KK,곤지암,2028,1977,20200116,4005
20200113,KK,신둔도예촌,1227,1144,20200116,2371
20200113,KK,이천,2702,2912,20200116,5614
20200113,KK,부발,1877,1786,20200116,3663
20200113,KK,세종대왕릉,344,298,20200116,642
20200113,KK,여주,1992,1940,20200116,3932
20200114,KK,여주,1969,1850,20200117,3819
20200114,KK,세종대왕릉,293,276,20200117,569
20200114,KK,부발,1832,1730,20200117,3562
20200114,KK,이천,2828,3053,20200117,5881
20200114,KK,신둔도예촌,1273,1188,20200117,2461
20200114,KK,곤지암,2179,2085,20200117,4264
20200114,KK,초월,2952,2774,20200117,5726
20200114,KK,경기광주,7878,7453,20200117,15331
20200114,KK,삼동,2656,2289,20200117,4945
20200114,KK,이매,1211,1049,20200117,2260
20200114,KK,판교,5338,5223,20200117,10561
20200115,KK,판교,5236,5117,20200118,10353
20200115,KK,이매,1244,1032,20200118,2276
20200115,KK,삼동,2549,2330,20200118,4879
20200115,KK,경기광주,7882,7335,20200118,15217
20200115,KK,초월,3016,2905,20200118,5921
20200115,KK,곤지암,2126,1998,20200118,4124
20200115,KK,신둔도예촌,1232,1135,20200118,2367
20200115,KK,이천,2754,2919,20200118,5673
20200115,KK,부발,1852,1760,20200118,3612
20200115,KK,세종대왕릉,299,294,20200118,593
20200115,KK,여주,1993,1961,20200118,3954
20200116,KK,여주,1975,1919,20200119,3894
20200116,KK,세종대왕릉,293,286,20200119,579
20200116,KK,부발,1941,1769,20200119,3710
20200116,KK,이천,2812,2965,20200119,5777
20200116,KK,신둔도예촌,1232,1161,20200119,2393
20200116,KK,곤지암,2103,2071,20200119,4174
20200116,KK,초월,2910,2741,20200119,5651
20200116,KK,경기광주,7937,7375,20200119,15312
20200116,KK,삼동,2550,2280,20200119,4830
20200116,KK,이매,1224,1075,20200119,2299
20200116,KK,판교,5029,5126,20200119,10155
20200117,KK,판교,5300,5276,20200120,10576
20200117,KK,이매,1282,1098,20200120,2380
20200117,KK,삼동,2804,2245,20200120,5049
20200117,KK,경기광주,8295,7391,20200120,15686
20200117,KK,초월,3175,2873,20200120,6048
20200117,KK,곤지암,2338,2147,20200120,4485
20200117,KK,신둔도예촌,1402,1194,20200120,2596
20200117,KK,이천,3167,3290,20200120,6457
20200117,KK,부발,2521,1846,20200120,4367
20200117,KK,세종대왕릉,311,296,20200120,607
20200117,KK,여주,2278,2181,20200120,4459
20200118,KK,판교,3022,3049,20200121,6071
20200118,KK,이매,844,667,20200121,1511
20200118,KK,삼동,1668,1392,20200121,3060
20200118,KK,경기광주,6116,5522,20200121,11638
20200118,KK,초월,2314,2044,20200121,4358
20200118,KK,곤지암,2032,1819,20200121,3851
20200118,KK,신둔도예촌,1230,1087,20200121,2317
20200118,KK,이천,3044,3042,20200121,6086
20200118,KK,부발,1998,1611,20200121,3609
20200118,KK,세종대왕릉,329,322,20200121,651
20200118,KK,여주,2405,2331,20200121,4736
20200119,KK,판교,2380,2377,20200122,4757
20200119,KK,이매,885,613,20200122,1498
20200119,KK,삼동,1175,1102,20200122,2277
20200119,KK,경기광주,4246,4267,20200122,8513
20200119,KK,초월,1634,1655,20200122,3289
20200119,KK,곤지암,1559,1607,20200122,3166
20200119,KK,신둔도예촌,814,844,20200122,1658
20200119,KK,이천,2175,2383,20200122,4558
20200119,KK,부발,1236,1915,20200122,3151
20200119,KK,세종대왕릉,245,264,20200122,509
20200119,KK,여주,1804,1666,20200122,3470
20200120,KK,여주,2054,2053,20200123,4107
20200120,KK,세종대왕릉,339,301,20200123,640
20200120,KK,부발,1855,1682,20200123,3537
20200120,KK,이천,2862,3019,20200123,5881
20200120,KK,신둔도예촌,1244,1174,20200123,2418
20200120,KK,곤지암,2122,2014,20200123,4136
20200120,KK,초월,2959,2868,20200123,5827
20200120,KK,경기광주,7877,7410,20200123,15287
20200120,KK,삼동,2566,2274,20200123,4840
20200120,KK,이매,1193,1036,20200123,2229
20200120,KK,판교,5153,5060,20200123,10213
20200121,KK,여주,1977,1995,20200124,3972
20200121,KK,판교,5139,5087,20200124,10226
20200121,KK,이매,1216,1090,20200124,2306
20200121,KK,삼동,2592,2292,20200124,4884
20200121,KK,경기광주,7749,7267,20200124,15016
20200121,KK,초월,2984,2832,20200124,5816
20200121,KK,곤지암,2085,1916,20200124,4001
20200121,KK,신둔도예촌,1222,1086,20200124,2308
20200121,KK,이천,2695,2791,20200124,5486
20200121,KK,부발,1769,1634,20200124,3403
20200121,KK,세종대왕릉,299,280,20200124,579
20200122,KK,판교,5087,5165,20200125,10252
20200122,KK,이매,1198,1017,20200125,2215
20200122,KK,삼동,2627,2202,20200125,4829
20200122,KK,경기광주,7797,7248,20200125,15045
20200122,KK,초월,2922,2794,20200125,5716
20200122,KK,곤지암,2082,1930,20200125,4012
20200122,KK,신둔도예촌,1205,1121,20200125,2326
20200122,KK,이천,2790,2966,20200125,5756
20200122,KK,부발,2113,1705,20200125,3818
20200122,KK,세종대왕릉,304,286,20200125,590
20200122,KK,여주,1956,1902,20200125,3858
20200123,KK,판교,5062,4951,20200126,10013
20200123,KK,이매,1185,971,20200126,2156
20200123,KK,삼동,2397,2003,20200126,4400
20200123,KK,경기광주,7800,7608,20200126,15408
20200123,KK,초월,2974,2659,20200126,5633
20200123,KK,곤지암,2324,2120,20200126,4444
20200123,KK,신둔도예촌,1309,1198,20200126,2507
20200123,KK,이천,3092,3491,20200126,6583
20200123,KK,부발,3019,2027,20200126,5046
20200123,KK,세종대왕릉,338,364,20200126,702
20200123,KK,여주,2039,2664,20200126,4703
20200124,KK,여주,1553,2891,20200127,4444
20200124,KK,세종대왕릉,214,464,20200127,678
20200124,KK,부발,1138,1283,20200127,2421
20200124,KK,이천,2356,3070,20200127,5426
20200124,KK,신둔도예촌,610,879,20200127,1489
20200124,KK,곤지암,1607,1812,20200127,3419
20200124,KK,초월,1425,1491,20200127,2916
20200124,KK,경기광주,3609,3905,20200127,7514
20200124,KK,삼동,820,836,20200127,1656
20200124,KK,이매,681,373,20200127,1054
20200124,KK,판교,1618,1262,20200127,2880
20200125,KK,판교,1165,1007,20200128,2172
20200125,KK,이매,626,374,20200128,1000
20200125,KK,삼동,718,598,20200128,1316
20200125,KK,경기광주,3405,3325,20200128,6730
20200125,KK,초월,1405,1241,20200128,2646
20200125,KK,곤지암,1874,1592,20200128,3466
20200125,KK,신둔도예촌,795,685,20200128,1480
20200125,KK,이천,2678,2596,20200128,5274
20200125,KK,부발,1236,1003,20200128,2239
20200125,KK,세종대왕릉,451,342,20200128,793
20200125,KK,여주,2451,1918,20200128,4369
20200126,KK,판교,2293,2309,20200129,4602
20200126,KK,이매,844,564,20200129,1408
20200126,KK,삼동,938,833,20200129,1771
20200126,KK,경기광주,4209,3898,20200129,8107
20200126,KK,초월,1633,1459,20200129,3092
20200126,KK,곤지암,1789,1715,20200129,3504
20200126,KK,신둔도예촌,846,665,20200129,1511
20200126,KK,이천,2619,2523,20200129,5142
20200126,KK,부발,1130,979,20200129,2109
20200126,KK,세종대왕릉,348,258,20200129,606
20200126,KK,여주,2626,1853,20200129,4479
20200127,KK,판교,2280,2234,20200130,4514
20200127,KK,이매,619,452,20200130,1071
20200127,KK,삼동,924,918,20200130,1842
20200127,KK,경기광주,4166,4002,20200130,8168
20200127,KK,초월,1581,1484,20200130,3065
20200127,KK,곤지암,1422,1496,20200130,2918
20200127,KK,신둔도예촌,804,721,20200130,1525
20200127,KK,이천,2277,2353,20200130,4630
20200127,KK,부발,1140,1668,20200130,2808
20200127,KK,세종대왕릉,261,196,20200130,457
20200127,KK,여주,2236,1622,20200130,3858
20200128,KK,판교,4639,4525,20200131,9164
20200128,KK,이매,1114,995,20200131,2109
20200128,KK,삼동,2303,2046,20200131,4349
20200128,KK,경기광주,7034,6731,20200131,13765
20200128,KK,초월,2669,2649,20200131,5318
20200128,KK,곤지암,1877,1859,20200131,3736
20200128,KK,신둔도예촌,1115,1053,20200131,2168
20200128,KK,이천,2544,2663,20200131,5207
20200128,KK,부발,1685,1663,20200131,3348
20200128,KK,세종대왕릉,287,260,20200131,547
20200128,KK,여주,1852,1789,20200131,3641
20200129,KK,판교,4854,4888,20200201,9742
20200129,KK,이매,1149,941,20200201,2090
20200129,KK,삼동,2401,2146,20200201,4547
20200129,KK,경기광주,7302,6963,20200201,14265
20200129,KK,초월,2833,2717,20200201,5550
20200129,KK,곤지암,1988,1844,20200201,3832
20200129,KK,신둔도예촌,1096,1014,20200201,2110
20200129,KK,이천,2630,2741,20200201,5371
20200129,KK,부발,1724,1553,20200201,3277
20200129,KK,세종대왕릉,289,274,20200201,563
20200129,KK,여주,1779,1698,20200201,3477
20200130,KK,여주,1783,1703,20200202,3486
20200130,KK,세종대왕릉,247,279,20200202,526
20200130,KK,부발,1721,1543,20200202,3264
20200130,KK,이천,2473,2670,20200202,5143
20200130,KK,신둔도예촌,1140,1019,20200202,2159
20200130,KK,곤지암,1925,1883,20200202,3808
20200130,KK,초월,2759,2649,20200202,5408
20200130,KK,경기광주,7424,6954,20200202,14378
20200130,KK,삼동,2504,2209,20200202,4713
20200130,KK,이매,1101,999,20200202,2100
20200130,KK,판교,4940,4835,20200202,9775
20200131,KK,판교,4937,4952,20200203,9889
20200131,KK,이매,1114,1008,20200203,2122
20200131,KK,삼동,2504,2127,20200203,4631
20200131,KK,경기광주,7541,6982,20200203,14523
20200131,KK,초월,2902,2609,20200203,5511
20200131,KK,곤지암,2111,1996,20200203,4107
20200131,KK,신둔도예촌,1336,1060,20200203,2396
20200131,KK,이천,2667,2808,20200203,5475
20200131,KK,부발,2271,1699,20200203,3970
20200131,KK,세종대왕릉,274,256,20200203,530
20200131,KK,여주,1776,1714,20200203,3490
20200201,KK,판교,2417,2387,20200204,4804
20200201,KK,이매,746,545,20200204,1291
20200201,KK,삼동,1336,1148,20200204,2484
20200201,KK,경기광주,4803,4493,20200204,9296
20200201,KK,초월,1808,1606,20200204,3414
20200201,KK,곤지암,1549,1437,20200204,2986
20200201,KK,신둔도예촌,899,871,20200204,1770
20200201,KK,이천,2143,2290,20200204,4433
20200201,KK,부발,1663,1329,20200204,2992
20200201,KK,세종대왕릉,231,226,20200204,457
20200201,KK,여주,1582,1649,20200204,3231
20200202,KK,판교,1833,1765,20200205,3598
20200202,KK,이매,702,492,20200205,1194
20200202,KK,삼동,893,837,20200205,1730
20200202,KK,경기광주,3382,3336,20200205,6718
20200202,KK,초월,1266,1314,20200205,2580
20200202,KK,곤지암,1214,1253,20200205,2467
20200202,KK,신둔도예촌,633,675,20200205,1308
20200202,KK,이천,1662,1926,20200205,3588
20200202,KK,부발,931,1498,20200205,2429
20200202,KK,세종대왕릉,183,184,20200205,367
20200202,KK,여주,1350,1265,20200205,2615
20200203,KK,판교,4723,4564,20200206,9287
20200203,KK,이매,1114,917,20200206,2031
20200203,KK,삼동,2379,2088,20200206,4467
20200203,KK,경기광주,6938,6720,20200206,13658
20200203,KK,초월,2609,2588,20200206,5197
20200203,KK,곤지암,1854,1797,20200206,3651
20200203,KK,신둔도예촌,1066,982,20200206,2048
20200203,KK,이천,2339,2515,20200206,4854
20200203,KK,부발,1527,1465,20200206,2992
20200203,KK,세종대왕릉,227,208,20200206,435
20200203,KK,여주,1618,1644,20200206,3262
20200204,KK,판교,4689,4562,20200207,9251
20200204,KK,이매,1078,928,20200207,2006
20200204,KK,삼동,2441,2141,20200207,4582
20200204,KK,경기광주,6946,6662,20200207,13608
20200204,KK,초월,2637,2549,20200207,5186
20200204,KK,곤지암,1759,1653,20200207,3412
20200204,KK,신둔도예촌,1072,971,20200207,2043
20200204,KK,이천,2246,2436,20200207,4682
20200204,KK,부발,1567,1479,20200207,3046
20200204,KK,세종대왕릉,254,231,20200207,485
20200204,KK,여주,1566,1572,20200207,3138
20200205,KK,판교,4753,4683,20200208,9436
20200205,KK,이매,1013,887,20200208,1900
20200205,KK,삼동,2357,2097,20200208,4454
20200205,KK,경기광주,6939,6505,20200208,13444
20200205,KK,초월,2633,2510,20200208,5143
20200205,KK,곤지암,1660,1602,20200208,3262
20200205,KK,신둔도예촌,1034,981,20200208,2015
20200205,KK,이천,2239,2429,20200208,4668
20200205,KK,부발,1575,1453,20200208,3028
20200205,KK,세종대왕릉,245,214,20200208,459
20200205,KK,여주,1580,1638,20200208,3218
20200206,KK,판교,4562,4557,20200209,9119
20200206,KK,이매,1069,935,20200209,2004
20200206,KK,삼동,2276,2040,20200209,4316
20200206,KK,경기광주,6802,6400,20200209,13202
20200206,KK,초월,2533,2488,20200209,5021
20200206,KK,곤지암,1643,1617,20200209,3260
20200206,KK,신둔도예촌,978,883,20200209,1861
20200206,KK,이천,2223,2315,20200209,4538
20200206,KK,부발,1561,1472,20200209,3033
20200206,KK,세종대왕릉,237,211,20200209,448
20200206,KK,여주,1572,1541,20200209,3113
20200207,KK,판교,4785,4722,20200210,9507
20200207,KK,이매,1071,966,20200210,2037
20200207,KK,삼동,2366,2041,20200210,4407
20200207,KK,경기광주,7178,6654,20200210,13832
20200207,KK,초월,2740,2484,20200210,5224
20200207,KK,곤지암,1896,1788,20200210,3684
20200207,KK,신둔도예촌,1222,1020,20200210,2242
20200207,KK,이천,2532,2674,20200210,5206
20200207,KK,부발,2176,1628,20200210,3804
20200207,KK,세종대왕릉,242,231,20200210,473
20200207,KK,여주,1662,1861,20200210,3523
20200208,KK,판교,2270,2329,20200211,4599
20200208,KK,이매,664,545,20200211,1209
20200208,KK,삼동,1285,1153,20200211,2438
20200208,KK,경기광주,4332,4127,20200211,8459
20200208,KK,초월,1719,1579,20200211,3298
20200208,KK,곤지암,1403,1286,20200211,2689
20200208,KK,신둔도예촌,867,788,20200211,1655
20200208,KK,이천,2203,2203,20200211,4406
20200208,KK,부발,1542,1228,20200211,2770
20200208,KK,세종대왕릉,217,235,20200211,452
20200208,KK,여주,1680,1550,20200211,3230
20200209,KK,판교,1838,1791,20200212,3629
20200209,KK,이매,708,450,20200212,1158
20200209,KK,삼동,884,829,20200212,1713
20200209,KK,경기광주,3391,3337,20200212,6728
20200209,KK,초월,1319,1309,20200212,2628
20200209,KK,곤지암,1179,1287,20200212,2466
20200209,KK,신둔도예촌,636,629,20200212,1265
20200209,KK,이천,1654,1865,20200212,3519
20200209,KK,부발,972,1577,20200212,2549
20200209,KK,세종대왕릉,187,198,20200212,385
20200209,KK,여주,1334,1219,20200212,2553
20200210,KK,판교,4290,4098,20200213,8388
20200210,KK,이매,1091,969,20200213,2060
20200210,KK,삼동,2308,2104,20200213,4412
20200210,KK,경기광주,6802,6552,20200213,13354
20200210,KK,초월,2631,2596,20200213,5227
20200210,KK,곤지암,1773,1826,20200213,3599
20200210,KK,신둔도예촌,1078,977,20200213,2055
20200210,KK,이천,2333,2490,20200213,4823
20200210,KK,부발,1540,1530,20200213,3070
20200210,KK,세종대왕릉,259,244,20200213,503
20200210,KK,여주,1778,1667,20200213,3445
20200211,KK,판교,4792,4737,20200214,9529
20200211,KK,이매,1130,971,20200214,2101
20200211,KK,삼동,2425,2128,20200214,4553
20200211,KK,경기광주,7248,6901,20200214,14149
20200211,KK,초월,2664,2587,20200214,5251
20200211,KK,곤지암,1844,1850,20200214,3694
20200211,KK,신둔도예촌,1119,1074,20200214,2193
20200211,KK,이천,2439,2556,20200214,4995
20200211,KK,부발,1562,1531,20200214,3093
20200211,KK,세종대왕릉,290,260,20200214,550
20200211,KK,여주,1655,1648,20200214,3303
20200212,KK,판교,4791,4740,20200215,9531
20200212,KK,이매,1045,893,20200215,1938
20200212,KK,삼동,2335,2150,20200215,4485
20200212,KK,경기광주,6899,6512,20200215,13411
20200212,KK,초월,2556,2447,20200215,5003
20200212,KK,곤지암,1675,1591,20200215,3266
20200212,KK,신둔도예촌,1031,954,20200215,1985
20200212,KK,이천,2312,2446,20200215,4758
20200212,KK,부발,1564,1473,20200215,3037
20200212,KK,세종대왕릉,224,220,20200215,444
20200212,KK,여주,1561,1504,20200215,3065
20200213,KK,판교,4908,4854,20200216,9762
20200213,KK,이매,1126,966,20200216,2092
20200213,KK,삼동,2472,2154,20200216,4626
20200213,KK,경기광주,7323,6752,20200216,14075
20200213,KK,초월,2767,2666,20200216,5433
20200213,KK,곤지암,1873,1809,20200216,3682
20200213,KK,신둔도예촌,1160,1087,20200216,2247
20200213,KK,이천,2539,2644,20200216,5183
20200213,KK,부발,1644,1539,20200216,3183
20200213,KK,세종대왕릉,253,245,20200216,498
20200213,KK,여주,1839,1804,20200216,3643
20200214,KK,판교,5065,5058,20200217,10123
20200214,KK,이매,1127,1011,20200217,2138
20200214,KK,삼동,2609,2140,20200217,4749
20200214,KK,경기광주,7748,7135,20200217,14883
20200214,KK,초월,2935,2645,20200217,5580
20200214,KK,곤지암,2095,1939,20200217,4034
20200214,KK,신둔도예촌,1336,1190,20200217,2526
20200214,KK,이천,2925,3007,20200217,5932
20200214,KK,부발,2293,1722,20200217,4015
20200214,KK,세종대왕릉,317,303,20200217,620
20200214,KK,여주,1907,1939,20200217,3846
20200215,KK,판교,2652,2508,20200218,5160
20200215,KK,이매,753,620,20200218,1373
20200215,KK,삼동,1425,1235,20200218,2660
20200215,KK,경기광주,5180,4804,20200218,9984
20200215,KK,초월,2001,1778,20200218,3779
20200215,KK,곤지암,1728,1603,20200218,3331
20200215,KK,신둔도예촌,975,888,20200218,1863
20200215,KK,이천,2447,2555,20200218,5002
20200215,KK,부발,1798,1440,20200218,3238
20200215,KK,세종대왕릉,287,291,20200218,578
20200215,KK,여주,1914,2034,20200218,3948
20200216,KK,판교,1944,1923,20200219,3867
20200216,KK,이매,737,488,20200219,1225
20200216,KK,삼동,948,842,20200219,1790
20200216,KK,경기광주,3462,3468,20200219,6930
20200216,KK,초월,1424,1405,20200219,2829
20200216,KK,곤지암,1123,1274,20200219,2397
20200216,KK,신둔도예촌,641,715,20200219,1356
20200216,KK,이천,1736,1984,20200219,3720
20200216,KK,부발,1022,1640,20200219,2662
20200216,KK,세종대왕릉,246,212,20200219,458
20200216,KK,여주,1559,1404,20200219,2963
20200217,KK,판교,5164,4987,20200220,10151
20200217,KK,이매,1254,1109,20200220,2363
20200217,KK,삼동,2748,2354,20200220,5102
20200217,KK,경기광주,7863,7349,20200220,15212
20200217,KK,초월,2986,2924,20200220,5910
20200217,KK,곤지암,1897,1893,20200220,3790
20200217,KK,신둔도예촌,1184,1070,20200220,2254
20200217,KK,이천,2592,2743,20200220,5335
20200217,KK,부발,1617,1674,20200220,3291
20200217,KK,세종대왕릉,258,233,20200220,491
20200217,KK,여주,1930,1840,20200220,3770
20200218,KK,판교,4803,4776,20200221,9579
20200218,KK,이매,1138,982,20200221,2120
20200218,KK,삼동,2445,2253,20200221,4698
20200218,KK,경기광주,7324,6910,20200221,14234
20200218,KK,초월,2762,2632,20200221,5394
20200218,KK,곤지암,1819,1756,20200221,3575
20200218,KK,신둔도예촌,1148,1032,20200221,2180
20200218,KK,이천,2439,2571,20200221,5010
20200218,KK,부발,1647,1530,20200221,3177
20200218,KK,세종대왕릉,255,235,20200221,490
20200218,KK,여주,1723,1713,20200221,3436
20200219,KK,판교,4820,4795,20200222,9615
20200219,KK,이매,1148,986,20200222,2134
20200219,KK,삼동,2466,2215,20200222,4681
20200219,KK,경기광주,7286,6923,20200222,14209
20200219,KK,초월,2877,2734,20200222,5611
20200219,KK,곤지암,1850,1814,20200222,3664
20200219,KK,신둔도예촌,1108,1021,20200222,2129
20200219,KK,이천,2563,2719,20200222,5282
20200219,KK,부발,1777,1613,20200222,3390
20200219,KK,세종대왕릉,250,255,20200222,505
20200219,KK,여주,1675,1675,20200222,3350
20200220,KK,판교,4695,4654,20200223,9349
20200220,KK,이매,1116,1005,20200223,2121
20200220,KK,삼동,2398,2152,20200223,4550
20200220,KK,경기광주,7153,6883,20200223,14036
20200220,KK,초월,2746,2684,20200223,5430
20200220,KK,곤지암,1774,1692,20200223,3466
20200220,KK,신둔도예촌,1105,1022,20200223,2127
20200220,KK,이천,2357,2534,20200223,4891
20200220,KK,부발,1596,1480,20200223,3076
20200220,KK,세종대왕릉,245,231,20200223,476
20200220,KK,여주,1736,1845,20200223,3581
20200221,KK,판교,4622,4569,20200224,9191
20200221,KK,이매,1065,988,20200224,2053
20200221,KK,삼동,2384,2101,20200224,4485
20200221,KK,경기광주,7085,6632,20200224,13717
20200221,KK,초월,2787,2528,20200224,5315
20200221,KK,곤지암,1906,1755,20200224,3661
20200221,KK,신둔도예촌,1151,1040,20200224,2191
20200221,KK,이천,2501,2634,20200224,5135
20200221,KK,부발,2034,1535,20200224,3569
20200221,KK,세종대왕릉,244,252,20200224,496
20200221,KK,여주,1873,1807,20200224,3680
20200222,KK,판교,2079,2085,20200225,4164
20200222,KK,이매,562,424,20200225,986
20200222,KK,삼동,1185,1047,20200225,2232
20200222,KK,경기광주,4121,3756,20200225,7877
20200222,KK,초월,1530,1418,20200225,2948
20200222,KK,곤지암,1340,1278,20200225,2618
20200222,KK,신둔도예촌,728,682,20200225,1410
20200222,KK,이천,1784,1966,20200225,3750
20200222,KK,부발,1255,1053,20200225,2308
20200222,KK,세종대왕릉,192,196,20200225,388
20200222,KK,여주,1257,1347,20200225,2604
20200223,KK,판교,1493,1417,20200226,2910
20200223,KK,이매,417,301,20200226,718
20200223,KK,삼동,746,677,20200226,1423
20200223,KK,경기광주,2629,2531,20200226,5160
20200223,KK,초월,1036,1092,20200226,2128
20200223,KK,곤지암,859,1028,20200226,1887
20200223,KK,신둔도예촌,493,459,20200226,952
20200223,KK,이천,1190,1367,20200226,2557
20200223,KK,부발,756,1228,20200226,1984
20200223,KK,세종대왕릉,157,135,20200226,292
20200223,KK,여주,1010,923,20200226,1933
20200224,KK,판교,4146,4040,20200227,8186
20200224,KK,이매,877,780,20200227,1657
20200224,KK,삼동,2072,1893,20200227,3965
20200224,KK,경기광주,5867,5707,20200227,11574
20200224,KK,초월,2314,2327,20200227,4641
20200224,KK,곤지암,1527,1486,20200227,3013
20200224,KK,신둔도예촌,893,833,20200227,1726
20200224,KK,이천,1950,2077,20200227,4027
20200224,KK,부발,1284,1330,20200227,2614
20200224,KK,세종대왕릉,219,203,20200227,422
20200224,KK,여주,1299,1254,20200227,2553
20200225,KK,판교,3822,3743,20200228,7565
20200225,KK,이매,755,670,20200228,1425
20200225,KK,삼동,1926,1769,20200228,3695
20200225,KK,경기광주,5209,5002,20200228,10211
20200225,KK,초월,2007,1997,20200228,4004
20200225,KK,곤지암,1332,1254,20200228,2586
20200225,KK,신둔도예촌,765,730,20200228,1495
20200225,KK,이천,1593,1717,20200228,3310
20200225,KK,부발,1110,1063,20200228,2173
20200225,KK,세종대왕릉,149,150,20200228,299
20200225,KK,여주,1104,1106,20200228,2210
20200226,KK,판교,3652,3543,20200229,7195
20200226,KK,이매,657,593,20200229,1250
20200226,KK,삼동,1917,1750,20200229,3667
20200226,KK,경기광주,5199,4981,20200229,10180
20200226,KK,초월,2012,1952,20200229,3964
20200226,KK,곤지암,1347,1321,20200229,2668
20200226,KK,신둔도예촌,772,752,20200229,1524
20200226,KK,이천,1637,1742,20200229,3379
20200226,KK,부발,1119,1063,20200229,2182
20200226,KK,세종대왕릉,171,154,20200229,325
20200226,KK,여주,1053,1088,20200229,2141
20200227,KK,판교,3328,3142,20200301,6470
20200227,KK,이매,726,609,20200301,1335
20200227,KK,삼동,1812,1640,20200301,3452
20200227,KK,경기광주,5084,4864,20200301,9948
20200227,KK,초월,1876,1874,20200301,3750
20200227,KK,곤지암,1287,1262,20200301,2549
20200227,KK,신둔도예촌,715,724,20200301,1439
20200227,KK,이천,1538,1618,20200301,3156
20200227,KK,부발,1134,1034,20200301,2168
20200227,KK,세종대왕릉,164,167,20200301,331
20200227,KK,여주,1079,1088,20200301,2167
20200228,KK,판교,3140,3000,20200302,6140
20200228,KK,이매,675,587,20200302,1262
20200228,KK,삼동,1734,1556,20200302,3290
20200228,KK,경기광주,4832,4753,20200302,9585
20200228,KK,초월,1894,1760,20200302,3654
20200228,KK,곤지암,1264,1244,20200302,2508
20200228,KK,신둔도예촌,728,705,20200302,1433
20200228,KK,이천,1652,1691,20200302,3343
20200228,KK,부발,1420,1055,20200302,2475
20200228,KK,세종대왕릉,159,176,20200302,335
20200228,KK,여주,990,1080,20200302,2070
20200229,KK,판교,1580,1532,20200303,3112
20200229,KK,이매,431,294,20200303,725
20200229,KK,삼동,824,734,20200303,1558
20200229,KK,경기광주,2641,2572,20200303,5213
20200229,KK,초월,1036,1020,20200303,2056
20200229,KK,곤지암,859,873,20200303,1732
20200229,KK,신둔도예촌,460,432,20200303,892
20200229,KK,이천,1057,1114,20200303,2171
20200229,KK,부발,870,695,20200303,1565
20200229,KK,세종대왕릉,140,132,20200303,272
20200229,KK,여주,858,947,20200303,1805
20200301,KK,판교,1199,1137,20200304,2336
20200301,KK,이매,309,200,20200304,509
20200301,KK,삼동,511,480,20200304,991
20200301,KK,경기광주,1677,1677,20200304,3354
20200301,KK,초월,694,677,20200304,1371
20200301,KK,곤지암,578,677,20200304,1255
20200301,KK,신둔도예촌,325,333,20200304,658
20200301,KK,이천,760,861,20200304,1621
20200301,KK,부발,490,928,20200304,1418
20200301,KK,세종대왕릉,98,98,20200304,196
20200301,KK,여주,761,687,20200304,1448
20200302,KK,판교,3134,2931,20200305,6065
20200302,KK,이매,671,579,20200305,1250
20200302,KK,삼동,1662,1579,20200305,3241
20200302,KK,경기광주,4863,4664,20200305,9527
20200302,KK,초월,1847,1904,20200305,3751
20200302,KK,곤지암,1239,1256,20200305,2495
20200302,KK,신둔도예촌,728,673,20200305,1401
20200302,KK,이천,1487,1615,20200305,3102
20200302,KK,부발,1018,1022,20200305,2040
20200302,KK,세종대왕릉,165,147,20200305,312
20200302,KK,여주,1086,1030,20200305,2116
20200303,KK,판교,3071,2969,20200306,6040
20200303,KK,이매,710,611,20200306,1321
20200303,KK,삼동,1733,1565,20200306,3298
20200303,KK,경기광주,4828,4651,20200306,9479
20200303,KK,초월,1744,1788,20200306,3532
20200303,KK,곤지암,1255,1215,20200306,2470
20200303,KK,신둔도예촌,703,673,20200306,1376
20200303,KK,이천,1483,1554,20200306,3037
20200303,KK,부발,1051,982,20200306,2033
20200303,KK,세종대왕릉,168,160,20200306,328
20200303,KK,여주,992,965,20200306,1957
20200304,KK,판교,3002,2955,20200307,5957
20200304,KK,이매,670,582,20200307,1252
20200304,KK,삼동,1665,1500,20200307,3165
20200304,KK,경기광주,4822,4623,20200307,9445
20200304,KK,초월,1863,1816,20200307,3679
20200304,KK,곤지암,1250,1242,20200307,2492
20200304,KK,신둔도예촌,723,683,20200307,1406
20200304,KK,이천,1472,1563,20200307,3035
20200304,KK,부발,1007,1026,20200307,2033
20200304,KK,세종대왕릉,164,154,20200307,318
20200304,KK,여주,930,961,20200307,1891
20200305,KK,곤지암,1257,1264,20200308,2521
20200305,KK,판교,3122,2982,20200308,6104
20200305,KK,이매,699,595,20200308,1294
20200305,KK,삼동,1672,1560,20200308,3232
20200305,KK,경기광주,4893,4641,20200308,9534
20200305,KK,초월,1884,1825,20200308,3709
20200305,KK,신둔도예촌,740,691,20200308,1431
20200305,KK,이천,1505,1608,20200308,3113
20200305,KK,부발,1072,990,20200308,2062
20200305,KK,세종대왕릉,170,160,20200308,330
20200305,KK,여주,1004,1000,20200308,2004
20200306,KK,판교,3160,3102,20200309,6262
20200306,KK,이매,717,561,20200309,1278
20200306,KK,삼동,1734,1536,20200309,3270
20200306,KK,경기광주,5056,4828,20200309,9884
20200306,KK,초월,1958,1925,20200309,3883
20200306,KK,곤지암,1369,1320,20200309,2689
20200306,KK,신둔도예촌,805,733,20200309,1538
20200306,KK,이천,1730,1810,20200309,3540
20200306,KK,부발,1494,1127,20200309,2621
20200306,KK,세종대왕릉,177,177,20200309,354
20200306,KK,여주,1126,1265,20200309,2391
20200307,KK,판교,1635,1625,20200310,3260
20200307,KK,이매,440,334,20200310,774
20200307,KK,삼동,892,811,20200310,1703
20200307,KK,경기광주,2729,2655,20200310,5384
20200307,KK,초월,1198,1112,20200310,2310
20200307,KK,곤지암,927,952,20200310,1879
20200307,KK,신둔도예촌,500,484,20200310,984
20200307,KK,이천,1221,1261,20200310,2482
20200307,KK,부발,962,791,20200310,1753
20200307,KK,세종대왕릉,151,145,20200310,296
20200307,KK,여주,871,1000,20200310,1871
20200308,KK,판교,1286,1193,20200311,2479
20200308,KK,이매,317,228,20200311,545
20200308,KK,삼동,562,584,20200311,1146
20200308,KK,경기광주,1867,1770,20200311,3637
20200308,KK,초월,816,839,20200311,1655
20200308,KK,곤지암,659,785,20200311,1444
20200308,KK,신둔도예촌,377,349,20200311,726
20200308,KK,이천,958,1036,20200311,1994
20200308,KK,부발,629,1101,20200311,1730
20200308,KK,세종대왕릉,145,132,20200311,277
20200308,KK,여주,914,813,20200311,1727
20200309,KK,판교,3423,3214,20200312,6637
20200309,KK,이매,715,640,20200312,1355
20200309,KK,삼동,1726,1594,20200312,3320
20200309,KK,경기광주,5072,4836,20200312,9908
20200309,KK,초월,1951,1945,20200312,3896
20200309,KK,곤지암,1273,1294,20200312,2567
20200309,KK,신둔도예촌,783,744,20200312,1527
20200309,KK,이천,1714,1845,20200312,3559
20200309,KK,부발,1146,1129,20200312,2275
20200309,KK,세종대왕릉,209,169,20200312,378
20200309,KK,여주,1157,1134,20200312,2291
20200310,KK,판교,3190,3065,20200313,6255
20200310,KK,이매,679,599,20200313,1278
20200310,KK,삼동,1706,1543,20200313,3249
20200310,KK,경기광주,4769,4533,20200313,9302
20200310,KK,초월,1780,1875,20200313,3655
20200310,KK,곤지암,1187,1222,20200313,2409
20200310,KK,신둔도예촌,712,686,20200313,1398
20200310,KK,이천,1512,1564,20200313,3076
20200310,KK,부발,1032,1037,20200313,2069
20200310,KK,세종대왕릉,145,134,20200313,279
20200310,KK,여주,1042,1001,20200313,2043
20200311,KK,판교,3277,3149,20200314,6426
20200311,KK,이매,741,625,20200314,1366
20200311,KK,삼동,1738,1643,20200314,3381
20200311,KK,경기광주,4952,4692,20200314,9644
20200311,KK,초월,1978,1988,20200314,3966
20200311,KK,곤지암,1269,1299,20200314,2568
20200311,KK,신둔도예촌,831,737,20200314,1568
20200311,KK,이천,1654,1735,20200314,3389
20200311,KK,부발,1189,1140,20200314,2329
20200311,KK,세종대왕릉,199,183,20200314,382
20200311,KK,여주,1099,1076,20200314,2175
20200312,KK,판교,3219,3083,20200315,6302
20200312,KK,이매,701,607,20200315,1308
20200312,KK,삼동,1736,1594,20200315,3330
20200312,KK,경기광주,4996,4690,20200315,9686
20200312,KK,초월,1895,1920,20200315,3815
20200312,KK,곤지암,1273,1255,20200315,2528
20200312,KK,신둔도예촌,771,737,20200315,1508
20200312,KK,이천,1637,1687,20200315,3324
20200312,KK,부발,1170,1121,20200315,2291
20200312,KK,세종대왕릉,186,184,20200315,370
20200312,KK,여주,1049,1043,20200315,2092
20200313,KK,판교,3271,3211,20200316,6482
20200313,KK,이매,721,615,20200316,1336
20200313,KK,삼동,1769,1572,20200316,3341
20200313,KK,경기광주,5170,4824,20200316,9994
20200313,KK,초월,1985,1887,20200316,3872
20200313,KK,곤지암,1347,1297,20200316,2644
20200313,KK,신둔도예촌,832,763,20200316,1595
20200313,KK,이천,1764,1937,20200316,3701
20200313,KK,부발,1585,1202,20200316,2787
20200313,KK,세종대왕릉,190,197,20200316,387
20200313,KK,여주,1146,1180,20200316,2326
20200314,KK,판교,1778,1775,20200317,3553
20200314,KK,이매,454,332,20200317,786
20200314,KK,삼동,910,849,20200317,1759
20200314,KK,경기광주,2921,2903,20200317,5824
20200314,KK,초월,1224,1162,20200317,2386
20200314,KK,곤지암,922,1007,20200317,1929
20200314,KK,신둔도예촌,541,532,20200317,1073
20200314,KK,이천,1338,1476,20200317,2814
20200314,KK,부발,1102,897,20200317,1999
20200314,KK,세종대왕릉,184,199,20200317,383
20200314,KK,여주,999,1125,20200317,2124
20200315,KK,판교,1236,1165,20200318,2401
20200315,KK,이매,335,230,20200318,565
20200315,KK,삼동,550,542,20200318,1092
20200315,KK,경기광주,1979,1946,20200318,3925
20200315,KK,초월,825,821,20200318,1646
20200315,KK,곤지암,658,832,20200318,1490
20200315,KK,신둔도예촌,426,399,20200318,825
20200315,KK,이천,1074,1116,20200318,2190
20200315,KK,부발,662,1143,20200318,1805
20200315,KK,세종대왕릉,126,100,20200318,226
20200315,KK,여주,954,904,20200318,1858
20200316,KK,판교,2917,2761,20200319,5678
20200316,KK,이매,703,613,20200319,1316
20200316,KK,삼동,1670,1550,20200319,3220
20200316,KK,경기광주,4996,4768,20200319,9764
20200316,KK,초월,1915,1944,20200319,3859
20200316,KK,곤지암,1259,1241,20200319,2500
20200316,KK,신둔도예촌,789,777,20200319,1566
20200316,KK,이천,1696,1870,20200319,3566
20200316,KK,부발,1171,1119,20200319,2290
20200316,KK,세종대왕릉,195,183,20200319,378
20200316,KK,여주,1188,1146,20200319,2334
20200317,KK,판교,3148,3049,20200320,6197
20200317,KK,이매,738,623,20200320,1361
20200317,KK,삼동,1700,1568,20200320,3268
20200317,KK,경기광주,5034,4808,20200320,9842
20200317,KK,초월,1884,1895,20200320,3779
20200317,KK,곤지암,1253,1257,20200320,2510
20200317,KK,신둔도예촌,748,703,20200320,1451
20200317,KK,이천,1570,1726,20200320,3296
20200317,KK,부발,1147,1086,20200320,2233
20200317,KK,세종대왕릉,192,174,20200320,366
20200317,KK,여주,1067,1079,20200320,2146
20200318,KK,판교,3222,3100,20200321,6322
20200318,KK,이매,774,636,20200321,1410
20200318,KK,삼동,1745,1578,20200321,3323
20200318,KK,경기광주,5151,4920,20200321,10071
20200318,KK,초월,2006,2001,20200321,4007
20200318,KK,곤지암,1307,1306,20200321,2613
20200318,KK,신둔도예촌,776,703,20200321,1479
20200318,KK,이천,1665,1802,20200321,3467
20200318,KK,부발,1212,1178,20200321,2390
20200318,KK,세종대왕릉,211,193,20200321,404
20200318,KK,여주,1174,1161,20200321,2335
20200319,KK,판교,3126,3002,20200322,6128
20200319,KK,이매,673,606,20200322,1279
20200319,KK,삼동,1657,1541,20200322,3198
20200319,KK,경기광주,4906,4687,20200322,9593
20200319,KK,초월,1889,1937,20200322,3826
20200319,KK,곤지암,1260,1229,20200322,2489
20200319,KK,신둔도예촌,707,703,20200322,1410
20200319,KK,이천,1538,1588,20200322,3126
20200319,KK,부발,1201,1139,20200322,2340
20200319,KK,세종대왕릉,179,177,20200322,356
20200319,KK,여주,1034,1026,20200322,2060
20200320,KK,판교,3319,3261,20200323,6580
20200320,KK,이매,780,624,20200323,1404
20200320,KK,삼동,1773,1592,20200323,3365
20200320,KK,경기광주,5434,5041,20200323,10475
20200320,KK,초월,2137,1967,20200323,4104
20200320,KK,곤지암,1441,1393,20200323,2834
20200320,KK,신둔도예촌,869,808,20200323,1677
20200320,KK,이천,1919,2074,20200323,3993
20200320,KK,부발,1740,1266,20200323,3006
20200320,KK,세종대왕릉,205,222,20200323,427
20200320,KK,여주,1308,1377,20200323,2685
20200321,KK,판교,1713,1619,20200324,3332
20200321,KK,이매,507,354,20200324,861
20200321,KK,삼동,891,809,20200324,1700
20200321,KK,경기광주,3102,2930,20200324,6032
20200321,KK,초월,1222,1168,20200324,2390
20200321,KK,곤지암,972,1072,20200324,2044
20200321,KK,신둔도예촌,613,629,20200324,1242
20200321,KK,이천,1511,1572,20200324,3083
20200321,KK,부발,1186,991,20200324,2177
20200321,KK,세종대왕릉,180,180,20200324,360
20200321,KK,여주,1184,1409,20200324,2593
20200322,KK,판교,1307,1214,20200325,2521
20200322,KK,이매,407,264,20200325,671
20200322,KK,삼동,601,578,20200325,1179
20200322,KK,경기광주,2237,2137,20200325,4374
20200322,KK,초월,873,909,20200325,1782
20200322,KK,곤지암,749,953,20200325,1702
20200322,KK,신둔도예촌,483,473,20200325,956
20200322,KK,이천,1181,1358,20200325,2539
20200322,KK,부발,749,1361,20200325,2110
20200322,KK,세종대왕릉,148,158,20200325,306
20200322,KK,여주,1188,1022,20200325,2210
20200323,KK,판교,3326,3162,20200326,6488
20200323,KK,이매,735,667,20200326,1402
20200323,KK,삼동,1810,1625,20200326,3435
20200323,KK,경기광주,5294,5067,20200326,10361
20200323,KK,초월,2046,2088,20200326,4134
20200323,KK,곤지암,1355,1325,20200326,2680
20200323,KK,신둔도예촌,807,738,20200326,1545
20200323,KK,이천,1756,1834,20200326,3590
20200323,KK,부발,1195,1226,20200326,2421
20200323,KK,세종대왕릉,203,186,20200326,389
20200323,KK,여주,1270,1249,20200326,2519
20200324,KK,판교,3372,3219,20200327,6591
20200324,KK,이매,774,652,20200327,1426
20200324,KK,삼동,1740,1640,20200327,3380
20200324,KK,경기광주,5303,5095,20200327,10398
20200324,KK,초월,2010,1994,20200327,4004
20200324,KK,곤지암,1336,1316,20200327,2652
20200324,KK,신둔도예촌,780,751,20200327,1531
20200324,KK,이천,1738,1811,20200327,3549
20200324,KK,부발,1261,1147,20200327,2408
20200324,KK,세종대왕릉,220,212,20200327,432
20200324,KK,여주,1193,1179,20200327,2372
20200325,KK,판교,3369,3228,20200328,6597
20200325,KK,이매,763,638,20200328,1401
20200325,KK,삼동,1794,1697,20200328,3491
20200325,KK,경기광주,5379,5131,20200328,10510
20200325,KK,초월,2093,2091,20200328,4184
20200325,KK,곤지암,1380,1375,20200328,2755
20200325,KK,신둔도예촌,792,733,20200328,1525
20200325,KK,이천,1731,1840,20200328,3571
20200325,KK,부발,1296,1186,20200328,2482
20200325,KK,세종대왕릉,199,201,20200328,400
20200325,KK,여주,1198,1202,20200328,2400
20200326,KK,판교,3306,3177,20200329,6483
20200326,KK,이매,729,626,20200329,1355
20200326,KK,삼동,1764,1626,20200329,3390
20200326,KK,경기광주,5090,4866,20200329,9956
20200326,KK,초월,2011,1980,20200329,3991
20200326,KK,곤지암,1306,1314,20200329,2620
20200326,KK,신둔도예촌,777,749,20200329,1526
20200326,KK,이천,1737,1778,20200329,3515
20200326,KK,부발,1228,1176,20200329,2404
20200326,KK,세종대왕릉,200,188,20200329,388
20200326,KK,여주,1225,1267,20200329,2492
20200327,KK,판교,3351,3238,20200330,6589
20200327,KK,이매,749,597,20200330,1346
20200327,KK,삼동,1804,1573,20200330,3377
20200327,KK,경기광주,5403,5084,20200330,10487
20200327,KK,초월,2139,2015,20200330,4154
20200327,KK,곤지암,1411,1340,20200330,2751
20200327,KK,신둔도예촌,855,815,20200330,1670
20200327,KK,이천,1968,2052,20200330,4020
20200327,KK,부발,1652,1260,20200330,2912
20200327,KK,세종대왕릉,180,209,20200330,389
20200327,KK,여주,1273,1328,20200330,2601
20200328,KK,판교,1789,1625,20200331,3414
20200328,KK,이매,448,367,20200331,815
20200328,KK,삼동,958,871,20200331,1829
20200328,KK,경기광주,3140,3022,20200331,6162
20200328,KK,초월,1301,1199,20200331,2500
20200328,KK,곤지암,983,1153,20200331,2136
20200328,KK,신둔도예촌,606,594,20200331,1200
20200328,KK,이천,1473,1607,20200331,3080
20200328,KK,부발,1304,1095,20200331,2399
20200328,KK,세종대왕릉,187,188,20200331,375
20200328,KK,여주,1212,1446,20200331,2658
20200329,KK,판교,1373,1315,20200401,2688
20200329,KK,이매,404,262,20200401,666
20200329,KK,삼동,623,586,20200401,1209
20200329,KK,경기광주,2263,2199,20200401,4462
20200329,KK,초월,915,902,20200401,1817
20200329,KK,곤지암,793,983,20200401,1776
20200329,KK,신둔도예촌,511,490,20200401,1001
20200329,KK,이천,1138,1316,20200401,2454
20200329,KK,부발,742,1387,20200401,2129
20200329,KK,세종대왕릉,193,175,20200401,368
20200329,KK,여주,1175,995,20200401,2170
20200330,KK,판교,3429,3253,20200402,6682
20200330,KK,이매,772,634,20200402,1406
20200330,KK,삼동,1799,1670,20200402,3469
20200330,KK,경기광주,5383,5131,20200402,10514
20200330,KK,초월,2075,2108,20200402,4183
20200330,KK,곤지암,1376,1394,20200402,2770
20200330,KK,신둔도예촌,848,800,20200402,1648
20200330,KK,이천,1737,1873,20200402,3610
20200330,KK,부발,1203,1298,20200402,2501
20200330,KK,세종대왕릉,214,203,20200402,417
20200330,KK,여주,1291,1305,20200402,2596
20200331,KK,판교,3361,3273,20200403,6634
20200331,KK,이매,778,657,20200403,1435
20200331,KK,삼동,1851,1658,20200403,3509
20200331,KK,경기광주,5357,5100,20200403,10457
20200331,KK,초월,2068,2072,20200403,4140
20200331,KK,곤지암,1354,1369,20200403,2723
20200331,KK,신둔도예촌,777,748,20200403,1525
20200331,KK,이천,1724,1785,20200403,3509
20200331,KK,부발,1243,1154,20200403,2397
20200331,KK,세종대왕릉,224,213,20200403,437
20200331,KK,여주,1175,1197,20200403,2372
20200401,KK,판교,3416,3263,20200404,6679
20200401,KK,이매,720,636,20200404,1356
20200401,KK,삼동,1819,1659,20200404,3478
20200401,KK,경기광주,5333,5085,20200404,10418
20200401,KK,초월,2130,2127,20200404,4257
20200401,KK,곤지암,1343,1369,20200404,2712
20200401,KK,신둔도예촌,799,764,20200404,1563
20200401,KK,이천,1723,1829,20200404,3552
20200401,KK,부발,1299,1211,20200404,2510
20200401,KK,세종대왕릉,211,216,20200404,427
20200401,KK,여주,1227,1238,20200404,2465
20200402,KK,판교,3330,3221,20200405,6551
20200402,KK,이매,741,640,20200405,1381
20200402,KK,삼동,1797,1644,20200405,3441
20200402,KK,경기광주,5362,5106,20200405,10468
20200402,KK,초월,2072,2058,20200405,4130
20200402,KK,곤지암,1374,1332,20200405,2706
20200402,KK,신둔도예촌,787,704,20200405,1491
20200402,KK,이천,1691,1886,20200405,3577
20200402,KK,부발,1315,1214,20200405,2529
20200402,KK,세종대왕릉,223,212,20200405,435
20200402,KK,여주,1179,1175,20200405,2354
20200403,KK,판교,3419,3386,20200406,6805
20200403,KK,이매,822,676,20200406,1498
20200403,KK,삼동,1918,1663,20200406,3581
20200403,KK,경기광주,5711,5266,20200406,10977
20200403,KK,초월,2280,2177,20200406,4457
20200403,KK,곤지암,1552,1481,20200406,3033
20200403,KK,신둔도예촌,895,882,20200406,1777
20200403,KK,이천,2012,2209,20200406,4221
20200403,KK,부발,1733,1363,20200406,3096
20200403,KK,세종대왕릉,243,247,20200406,490
20200403,KK,여주,1389,1519,20200406,2908
20200404,KK,판교,1810,1723,20200407,3533
20200404,KK,이매,545,376,20200407,921
20200404,KK,삼동,1013,930,20200407,1943
20200404,KK,경기광주,3373,3255,20200407,6628
20200404,KK,초월,1452,1300,20200407,2752
20200404,KK,곤지암,1171,1214,20200407,2385
20200404,KK,신둔도예촌,675,585,20200407,1260
20200404,KK,이천,1589,1664,20200407,3253
20200404,KK,부발,1265,1039,20200407,2304
20200404,KK,세종대왕릉,206,187,20200407,393
20200404,KK,여주,1327,1470,20200407,2797
20200405,KK,판교,1415,1337,20200408,2752
20200405,KK,이매,420,284,20200408,704
20200405,KK,삼동,662,661,20200408,1323
20200405,KK,경기광주,2343,2318,20200408,4661
20200405,KK,초월,1018,1062,20200408,2080
20200405,KK,곤지암,901,1001,20200408,1902
20200405,KK,신둔도예촌,511,514,20200408,1025
20200405,KK,이천,1232,1378,20200408,2610
20200405,KK,부발,806,1425,20200408,2231
20200405,KK,세종대왕릉,179,176,20200408,355
20200405,KK,여주,1346,1266,20200408,2612
20200406,KK,판교,3626,3430,20200409,7056
20200406,KK,이매,789,719,20200409,1508
20200406,KK,삼동,1877,1727,20200409,3604
20200406,KK,경기광주,5660,5307,20200409,10967
20200406,KK,초월,2241,2251,20200409,4492
20200406,KK,곤지암,1433,1385,20200409,2818
20200406,KK,신둔도예촌,875,828,20200409,1703
20200406,KK,이천,1900,1972,20200409,3872
20200406,KK,부발,1285,1318,20200409,2603
20200406,KK,세종대왕릉,216,197,20200409,413
20200406,KK,여주,1341,1292,20200409,2633
20200407,KK,판교,3492,3418,20200410,6910
20200407,KK,이매,846,706,20200410,1552
20200407,KK,삼동,1851,1618,20200410,3469
20200407,KK,경기광주,5665,5389,20200410,11054
20200407,KK,초월,2197,2165,20200410,4362
20200407,KK,곤지암,1383,1384,20200410,2767
20200407,KK,신둔도예촌,866,788,20200410,1654
20200407,KK,이천,1814,1894,20200410,3708
20200407,KK,부발,1308,1258,20200410,2566
20200407,KK,세종대왕릉,210,214,20200410,424
20200407,KK,여주,1275,1300,20200410,2575
20200408,KK,판교,3540,3445,20200411,6985
20200408,KK,이매,769,685,20200411,1454
20200408,KK,삼동,1908,1702,20200411,3610
20200408,KK,경기광주,5647,5402,20200411,11049
20200408,KK,초월,2176,2113,20200411,4289
20200408,KK,곤지암,1433,1418,20200411,2851
20200408,KK,신둔도예촌,863,807,20200411,1670
20200408,KK,이천,1775,1911,20200411,3686
20200408,KK,부발,1316,1257,20200411,2573
20200408,KK,세종대왕릉,204,203,20200411,407
20200408,KK,여주,1367,1353,20200411,2720
20200409,KK,판교,3597,3529,20200412,7126
20200409,KK,이매,834,712,20200412,1546
20200409,KK,삼동,1877,1684,20200412,3561
20200409,KK,경기광주,5636,5363,20200412,10999
20200409,KK,초월,2238,2181,20200412,4419
20200409,KK,곤지암,1470,1423,20200412,2893
20200409,KK,신둔도예촌,846,807,20200412,1653
20200409,KK,이천,1848,1966,20200412,3814
20200409,KK,부발,1343,1255,20200412,2598
20200409,KK,세종대왕릉,224,224,20200412,448
20200409,KK,여주,1285,1272,20200412,2557
20200410,KK,판교,3705,3565,20200413,7270
20200410,KK,이매,868,710,20200413,1578
20200410,KK,삼동,1907,1721,20200413,3628
20200410,KK,경기광주,6006,5597,20200413,11603
20200410,KK,초월,2363,2168,20200413,4531
20200410,KK,곤지암,1602,1552,20200413,3154
20200410,KK,신둔도예촌,978,830,20200413,1808
20200410,KK,이천,2037,2210,20200413,4247
20200410,KK,부발,1884,1411,20200413,3295
20200410,KK,세종대왕릉,225,236,20200413,461
20200410,KK,여주,1448,1647,20200413,3095
20200411,KK,판교,1905,1822,20200414,3727
20200411,KK,이매,551,413,20200414,964
20200411,KK,삼동,1003,970,20200414,1973
20200411,KK,경기광주,3605,3469,20200414,7074
20200411,KK,초월,1448,1387,20200414,2835
20200411,KK,곤지암,1239,1285,20200414,2524
20200411,KK,신둔도예촌,711,752,20200414,1463
20200411,KK,이천,1699,1787,20200414,3486
20200411,KK,부발,1392,1146,20200414,2538
20200411,KK,세종대왕릉,218,229,20200414,447
20200411,KK,여주,1372,1633,20200414,3005
20200412,KK,판교,1485,1351,20200415,2836
20200412,KK,이매,405,286,20200415,691
20200412,KK,삼동,670,662,20200415,1332
20200412,KK,경기광주,2395,2430,20200415,4825
20200412,KK,초월,1023,1057,20200415,2080
20200412,KK,곤지암,868,1049,20200415,1917
20200412,KK,신둔도예촌,479,478,20200415,957
20200412,KK,이천,1280,1509,20200415,2789
20200412,KK,부발,836,1484,20200415,2320
20200412,KK,세종대왕릉,194,178,20200415,372
20200412,KK,여주,1226,1130,20200415,2356
20200413,KK,판교,3647,3548,20200416,7195
20200413,KK,이매,815,696,20200416,1511
20200413,KK,삼동,1898,1759,20200416,3657
20200413,KK,경기광주,5795,5555,20200416,11350
20200413,KK,초월,2303,2250,20200416,4553
20200413,KK,곤지암,1508,1473,20200416,2981
20200413,KK,신둔도예촌,885,832,20200416,1717
20200413,KK,이천,1879,2035,20200416,3914
20200413,KK,부발,1370,1353,20200416,2723
20200413,KK,세종대왕릉,212,210,20200416,422
20200413,KK,여주,1428,1393,20200416,2821
20200414,KK,판교,3716,3587,20200417,7303
20200414,KK,이매,882,747,20200417,1629
20200414,KK,삼동,2070,1727,20200417,3797
20200414,KK,경기광주,5951,5546,20200417,11497
20200414,KK,초월,2352,2226,20200417,4578
20200414,KK,곤지암,1546,1540,20200417,3086
20200414,KK,신둔도예촌,947,822,20200417,1769
20200414,KK,이천,2016,2105,20200417,4121
20200414,KK,부발,1622,1374,20200417,2996
20200414,KK,세종대왕릉,266,270,20200417,536
20200414,KK,여주,1389,1435,20200417,2824
20200415,KK,판교,1661,1587,20200418,3248
20200415,KK,이매,515,396,20200418,911
20200415,KK,삼동,990,916,20200418,1906
20200415,KK,경기광주,3168,3027,20200418,6195
20200415,KK,초월,1313,1309,20200418,2622
20200415,KK,곤지암,1093,1180,20200418,2273
20200415,KK,신둔도예촌,532,537,20200418,1069
20200415,KK,이천,1322,1444,20200418,2766
20200415,KK,부발,1001,1282,20200418,2283
20200415,KK,세종대왕릉,195,223,20200418,418
20200415,KK,여주,1254,1283,20200418,2537
20200416,KK,판교,3677,3559,20200419,7236
20200416,KK,이매,878,725,20200419,1603
20200416,KK,삼동,1957,1699,20200419,3656
20200416,KK,경기광주,5807,5526,20200419,11333
20200416,KK,초월,2354,2267,20200419,4621
20200416,KK,곤지암,1548,1509,20200419,3057
20200416,KK,신둔도예촌,920,863,20200419,1783
20200416,KK,이천,1955,2049,20200419,4004
20200416,KK,부발,1404,1383,20200419,2787
20200416,KK,세종대왕릉,247,235,20200419,482
20200416,KK,여주,1394,1382,20200419,2776
20200417,KK,판교,3697,3623,20200420,7320
20200417,KK,이매,809,708,20200420,1517
20200417,KK,삼동,1942,1683,20200420,3625
20200417,KK,경기광주,5812,5475,20200420,11287
20200417,KK,초월,2329,2211,20200420,4540
20200417,KK,곤지암,1570,1465,20200420,3035
20200417,KK,신둔도예촌,937,833,20200420,1770
20200417,KK,이천,2057,2182,20200420,4239
20200417,KK,부발,1846,1308,20200420,3154
20200417,KK,세종대왕릉,216,204,20200420,420
20200417,KK,여주,1422,1579,20200420,3001
20200418,KK,판교,1961,1947,20200421,3908
20200418,KK,이매,567,464,20200421,1031
20200418,KK,삼동,1159,1044,20200421,2203
20200418,KK,경기광주,3901,3696,20200421,7597
20200418,KK,초월,1588,1519,20200421,3107
20200418,KK,곤지암,1354,1447,20200421,2801
20200418,KK,신둔도예촌,786,711,20200421,1497
20200418,KK,이천,1928,1977,20200421,3905
20200418,KK,부발,1420,1165,20200421,2585
20200418,KK,세종대왕릉,251,262,20200421,513
20200418,KK,여주,1524,1703,20200421,3227
20200419,KK,판교,1556,1420,20200422,2976
20200419,KK,이매,442,294,20200422,736
20200419,KK,삼동,725,671,20200422,1396
20200419,KK,경기광주,2559,2510,20200422,5069
20200419,KK,초월,1024,1139,20200422,2163
20200419,KK,곤지암,888,1142,20200422,2030
20200419,KK,신둔도예촌,580,548,20200422,1128
20200419,KK,이천,1347,1538,20200422,2885
20200419,KK,부발,828,1505,20200422,2333
20200419,KK,세종대왕릉,178,203,20200422,381
20200419,KK,여주,1262,1174,20200422,2436
20200420,KK,판교,3812,3680,20200423,7492
20200420,KK,이매,930,793,20200423,1723
20200420,KK,삼동,1913,1775,20200423,3688
20200420,KK,경기광주,5892,5584,20200423,11476
20200420,KK,초월,2291,2293,20200423,4584
20200420,KK,곤지암,1581,1549,20200423,3130
20200420,KK,신둔도예촌,919,909,20200423,1828
20200420,KK,이천,1987,2079,20200423,4066
20200420,KK,부발,1353,1351,20200423,2704
20200420,KK,세종대왕릉,242,247,20200423,489
20200420,KK,여주,1497,1531,20200423,3028
20200421,KK,판교,3840,3663,20200424,7503
20200421,KK,이매,944,796,20200424,1740
20200421,KK,삼동,2007,1814,20200424,3821
20200421,KK,경기광주,6020,5750,20200424,11770
20200421,KK,초월,2270,2226,20200424,4496
20200421,KK,곤지암,1574,1604,20200424,3178
20200421,KK,신둔도예촌,915,853,20200424,1768
20200421,KK,이천,1910,2056,20200424,3966
20200421,KK,부발,1416,1370,20200424,2786
20200421,KK,세종대왕릉,238,239,20200424,477
20200421,KK,여주,1486,1429,20200424,2915
20200422,KK,판교,3714,3663,20200425,7377
20200422,KK,이매,925,794,20200425,1719
20200422,KK,삼동,1990,1743,20200425,3733
20200422,KK,경기광주,5858,5559,20200425,11417
20200422,KK,초월,2348,2290,20200425,4638
20200422,KK,곤지암,1507,1467,20200425,2974
20200422,KK,신둔도예촌,887,830,20200425,1717
20200422,KK,이천,1954,1997,20200425,3951
20200422,KK,부발,1374,1286,20200425,2660
20200422,KK,세종대왕릉,219,221,20200425,440
20200422,KK,여주,1422,1421,20200425,2843
20200423,KK,판교,3801,3785,20200426,7586
20200423,KK,이매,938,839,20200426,1777
20200423,KK,삼동,2029,1765,20200426,3794
20200423,KK,경기광주,6069,5664,20200426,11733
20200423,KK,초월,2369,2257,20200426,4626
20200423,KK,곤지암,1537,1491,20200426,3028
20200423,KK,신둔도예촌,941,854,20200426,1795
20200423,KK,이천,1942,2073,20200426,4015
20200423,KK,부발,1430,1323,20200426,2753
20200423,KK,세종대왕릉,227,212,20200426,439
20200423,KK,여주,1422,1411,20200426,2833
20200424,KK,판교,4047,3962,20200427,8009
20200424,KK,이매,1006,830,20200427,1836
20200424,KK,삼동,2104,1809,20200427,3913
20200424,KK,경기광주,6448,6027,20200427,12475
20200424,KK,초월,2611,2370,20200427,4981
20200424,KK,곤지암,1795,1767,20200427,3562
20200424,KK,신둔도예촌,1018,945,20200427,1963
20200424,KK,이천,2250,2393,20200427,4643
20200424,KK,부발,1950,1448,20200427,3398
20200424,KK,세종대왕릉,268,256,20200427,524
20200424,KK,여주,1642,1810,20200427,3452
20200425,KK,판교,2173,2072,20200428,4245
20200425,KK,이매,663,506,20200428,1169
20200425,KK,삼동,1180,1067,20200428,2247
20200425,KK,경기광주,4082,3856,20200428,7938
20200425,KK,초월,1754,1521,20200428,3275
20200425,KK,곤지암,1385,1574,20200428,2959
20200425,KK,신둔도예촌,771,754,20200428,1525
20200425,KK,이천,1942,2124,20200428,4066
20200425,KK,부발,1527,1200,20200428,2727
20200425,KK,세종대왕릉,244,235,20200428,479
20200425,KK,여주,1653,1877,20200428,3530
20200426,KK,판교,1716,1578,20200429,3294
20200426,KK,이매,484,367,20200429,851
20200426,KK,삼동,753,771,20200429,1524
20200426,KK,경기광주,2962,2816,20200429,5778
20200426,KK,초월,1130,1161,20200429,2291
20200426,KK,곤지암,1075,1227,20200429,2302
20200426,KK,신둔도예촌,598,630,20200429,1228
20200426,KK,이천,1557,1715,20200429,3272
20200426,KK,부발,896,1613,20200429,2509
20200426,KK,세종대왕릉,235,228,20200429,463
20200426,KK,여주,1582,1461,20200429,3043
20200427,KK,판교,3964,3836,20200430,7800
20200427,KK,이매,989,830,20200430,1819
20200427,KK,삼동,2029,1885,20200430,3914
20200427,KK,경기광주,6169,5801,20200430,11970
20200427,KK,초월,2453,2458,20200430,4911
20200427,KK,곤지암,1593,1643,20200430,3236
20200427,KK,신둔도예촌,1000,921,20200430,1921
20200427,KK,이천,2096,2227,20200430,4323
20200427,KK,부발,1424,1438,20200430,2862
20200427,KK,세종대왕릉,271,270,20200430,541
20200427,KK,여주,1596,1545,20200430,3141
20200428,KK,판교,4006,3871,20200501,7877
20200428,KK,이매,949,831,20200501,1780
20200428,KK,삼동,2102,1887,20200501,3989
20200428,KK,경기광주,6343,5958,20200501,12301
20200428,KK,초월,2442,2342,20200501,4784
20200428,KK,곤지암,1643,1596,20200501,3239
20200428,KK,신둔도예촌,971,923,20200501,1894
20200428,KK,이천,2082,2190,20200501,4272
20200428,KK,부발,1502,1429,20200501,2931
20200428,KK,세종대왕릉,283,263,20200501,546
20200428,KK,여주,1527,1543,20200501,3070
20200429,KK,판교,4017,4015,20200502,8032
20200429,KK,이매,1046,886,20200502,1932
20200429,KK,삼동,2228,1879,20200502,4107
20200429,KK,경기광주,6674,6214,20200502,12888
20200429,KK,초월,2646,2412,20200502,5058
20200429,KK,곤지암,1858,1798,20200502,3656
20200429,KK,신둔도예촌,1078,984,20200502,2062
20200429,KK,이천,2303,2553,20200502,4856
20200429,KK,부발,2023,1516,20200502,3539
20200429,KK,세종대왕릉,252,265,20200502,517
20200429,KK,여주,1687,1872,20200502,3559
20200430,KK,판교,2127,1968,20200503,4095
20200430,KK,이매,742,546,20200503,1288
20200430,KK,삼동,1346,1132,20200503,2478
20200430,KK,경기광주,4239,3981,20200503,8220
20200430,KK,초월,1679,1544,20200503,3223
20200430,KK,곤지암,1505,1609,20200503,3114
20200430,KK,신둔도예촌,721,722,20200503,1443
20200430,KK,이천,1853,2051,20200503,3904
20200430,KK,부발,1611,1139,20200503,2750
20200430,KK,세종대왕릉,277,309,20200503,586
20200430,KK,여주,1872,2294,20200503,4166
20200501,KK,여주,1832,1904,20200504,3736
20200501,KK,세종대왕릉,270,294,20200504,564
20200501,KK,부발,1260,1227,20200504,2487
20200501,KK,이천,1986,2148,20200504,4134
20200501,KK,신둔도예촌,829,807,20200504,1636
20200501,KK,곤지암,1443,1549,20200504,2992
20200501,KK,초월,1684,1592,20200504,3276
20200501,KK,경기광주,4377,4128,20200504,8505
20200501,KK,삼동,1188,1080,20200504,2268
20200501,KK,이매,689,522,20200504,1211
20200501,KK,판교,2149,2060,20200504,4209
20200502,KK,판교,2097,2059,20200505,4156
20200502,KK,이매,682,512,20200505,1194
20200502,KK,삼동,1133,1026,20200505,2159
20200502,KK,경기광주,3976,3898,20200505,7874
20200502,KK,초월,1677,1596,20200505,3273
20200502,KK,곤지암,1531,1562,20200505,3093
20200502,KK,신둔도예촌,866,786,20200505,1652
20200502,KK,이천,2076,2243,20200505,4319
20200502,KK,부발,1118,1116,20200505,2234
20200502,KK,세종대왕릉,256,280,20200505,536
20200502,KK,여주,1817,1873,20200505,3690
20200503,KK,여주,1758,1488,20200506,3246
20200503,KK,세종대왕릉,246,214,20200506,460
20200503,KK,부발,909,1519,20200506,2428
20200503,KK,이천,1738,1915,20200506,3653
20200503,KK,신둔도예촌,643,631,20200506,1274
20200503,KK,곤지암,1296,1430,20200506,2726
20200503,KK,초월,1303,1330,20200506,2633
20200503,KK,경기광주,3184,3063,20200506,6247
20200503,KK,삼동,827,819,20200506,1646
20200503,KK,이매,541,380,20200506,921
20200503,KK,판교,1708,1610,20200506,3318
20200504,KK,여주,1705,1727,20200507,3432
20200504,KK,세종대왕릉,282,263,20200507,545
20200504,KK,부발,1455,1413,20200507,2868
20200504,KK,이천,2211,2355,20200507,4566
20200504,KK,신둔도예촌,848,809,20200507,1657
20200504,KK,곤지암,1649,1700,20200507,3349
20200504,KK,초월,2303,2170,20200507,4473
20200504,KK,경기광주,5700,5276,20200507,10976
20200504,KK,삼동,1791,1542,20200507,3333
20200504,KK,이매,937,758,20200507,1695
20200504,KK,판교,3016,3019,20200507,6035
20200505,KK,판교,1887,1833,20200508,3720
20200505,KK,이매,537,415,20200508,952
20200505,KK,삼동,973,885,20200508,1858
20200505,KK,경기광주,3351,3209,20200508,6560
20200505,KK,초월,1302,1285,20200508,2587
20200505,KK,곤지암,1185,1255,20200508,2440
20200505,KK,신둔도예촌,604,546,20200508,1150
20200505,KK,이천,1587,1687,20200508,3274
20200505,KK,부발,1000,1244,20200508,2244
20200505,KK,세종대왕릉,234,231,20200508,465
20200505,KK,여주,1695,1555,20200508,3250
20200506,KK,여주,1778,1726,20200509,3504
20200506,KK,세종대왕릉,279,288,20200509,567
20200506,KK,부발,1509,1510,20200509,3019
20200506,KK,이천,2388,2361,20200509,4749
20200506,KK,신둔도예촌,1055,958,20200509,2013
20200506,KK,곤지암,1796,1749,20200509,3545
20200506,KK,초월,2588,2517,20200509,5105
20200506,KK,경기광주,6673,6361,20200509,13034
20200506,KK,삼동,2156,1994,20200509,4150
20200506,KK,이매,1074,932,20200509,2006
20200506,KK,판교,4233,4173,20200509,8406
20200507,KK,여주,1675,1663,20200510,3338
20200507,KK,세종대왕릉,286,290,20200510,576
20200507,KK,부발,1585,1511,20200510,3096
20200507,KK,이천,2302,2459,20200510,4761
20200507,KK,신둔도예촌,1031,948,20200510,1979
20200507,KK,곤지암,1786,1833,20200510,3619
20200507,KK,초월,2718,2547,20200510,5265
20200507,KK,경기광주,6857,6487,20200510,13344
20200507,KK,삼동,2218,1961,20200510,4179
20200507,KK,이매,1042,907,20200510,1949
20200507,KK,판교,4322,4213,20200510,8535
20200508,KK,판교,4568,4256,20200511,8824
20200508,KK,이매,1104,918,20200511,2022
20200508,KK,삼동,2268,2091,20200511,4359
20200508,KK,경기광주,7043,6827,20200511,13870
20200508,KK,초월,2759,2644,20200511,5403
20200508,KK,곤지암,2026,1981,20200511,4007
20200508,KK,신둔도예촌,1223,1105,20200511,2328
20200508,KK,이천,2504,2779,20200511,5283
20200508,KK,부발,2165,1678,20200511,3843
20200508,KK,세종대왕릉,317,291,20200511,608
20200508,KK,여주,1855,2048,20200511,3903
20200509,KK,판교,1899,1874,20200512,3773
20200509,KK,이매,645,453,20200512,1098
20200509,KK,삼동,1106,1019,20200512,2125
20200509,KK,경기광주,3816,3603,20200512,7419
20200509,KK,초월,1593,1470,20200512,3063
20200509,KK,곤지암,1248,1163,20200512,2411
20200509,KK,신둔도예촌,761,708,20200512,1469
20200509,KK,이천,1900,1989,20200512,3889
20200509,KK,부발,1462,1158,20200512,2620
20200509,KK,세종대왕릉,201,234,20200512,435
20200509,KK,여주,1455,1595,20200512,3050
20200510,KK,판교,1788,1700,20200513,3488
20200510,KK,이매,526,382,20200513,908
20200510,KK,삼동,863,776,20200513,1639
20200510,KK,경기광주,3292,3107,20200513,6399
20200510,KK,초월,1322,1373,20200513,2695
20200510,KK,곤지암,1140,1382,20200513,2522
20200510,KK,신둔도예촌,711,689,20200513,1400
20200510,KK,이천,1659,1845,20200513,3504
20200510,KK,부발,1072,1676,20200513,2748
20200510,KK,세종대왕릉,239,198,20200513,437
20200510,KK,여주,1637,1672,20200513,3309
20200511,KK,여주,2030,1983,20200514,4013
20200511,KK,세종대왕릉,280,263,20200514,543
20200511,KK,부발,1527,1553,20200514,3080
20200511,KK,이천,2324,2353,20200514,4677
20200511,KK,신둔도예촌,1047,976,20200514,2023
20200511,KK,곤지암,1843,1860,20200514,3703
20200511,KK,초월,2571,2539,20200514,5110
20200511,KK,경기광주,6711,6450,20200514,13161
20200511,KK,삼동,2202,1988,20200514,4190
20200511,KK,이매,1044,911,20200514,1955
20200511,KK,판교,4214,4043,20200514,8257
20200512,KK,판교,4040,4016,20200515,8056
20200512,KK,이매,1036,856,20200515,1892
20200512,KK,삼동,2201,1939,20200515,4140
20200512,KK,경기광주,6649,6256,20200515,12905
20200512,KK,초월,2569,2482,20200515,5051
20200512,KK,곤지암,1768,1721,20200515,3489
20200512,KK,신둔도예촌,999,955,20200515,1954
20200512,KK,이천,2302,2353,20200515,4655
20200512,KK,부발,1509,1470,20200515,2979
20200512,KK,세종대왕릉,289,271,20200515,560
20200512,KK,여주,1765,1763,20200515,3528
20200513,KK,판교,4186,3970,20200516,8156
20200513,KK,이매,1086,875,20200516,1961
20200513,KK,삼동,2178,1964,20200516,4142
20200513,KK,경기광주,6718,6348,20200516,13066
20200513,KK,초월,2610,2522,20200516,5132
20200513,KK,곤지암,1776,1793,20200516,3569
20200513,KK,신둔도예촌,1037,957,20200516,1994
20200513,KK,이천,2199,2352,20200516,4551
20200513,KK,부발,1572,1498,20200516,3070
20200513,KK,세종대왕릉,249,280,20200516,529
20200513,KK,여주,1888,1859,20200516,3747
20200514,KK,판교,4164,3997,20200517,8161
20200514,KK,이매,1074,859,20200517,1933
20200514,KK,삼동,2231,2034,20200517,4265
20200514,KK,경기광주,6628,6442,20200517,13070
20200514,KK,초월,2590,2548,20200517,5138
20200514,KK,곤지암,1809,1762,20200517,3571
20200514,KK,신둔도예촌,1050,962,20200517,2012
20200514,KK,이천,2264,2327,20200517,4591
20200514,KK,부발,1634,1535,20200517,3169
20200514,KK,세종대왕릉,253,236,20200517,489
20200514,KK,여주,1930,1829,20200517,3759
20200515,KK,판교,4097,4025,20200518,8122
20200515,KK,여주,1750,1729,20200518,3479
20200515,KK,세종대왕릉,239,243,20200518,482
20200515,KK,부발,2112,1500,20200518,3612
20200515,KK,이천,2298,2493,20200518,4791
20200515,KK,신둔도예촌,1055,919,20200518,1974
20200515,KK,곤지암,1816,1621,20200518,3437
20200515,KK,초월,2647,2395,20200518,5042
20200515,KK,경기광주,6421,6010,20200518,12431
20200515,KK,삼동,2127,1863,20200518,3990
20200515,KK,이매,958,842,20200518,1800
20200516,KK,여주,1518,1823,20200519,3341
20200516,KK,세종대왕릉,275,275,20200519,550
20200516,KK,부발,1507,1204,20200519,2711
20200516,KK,이천,2113,2314,20200519,4427
20200516,KK,신둔도예촌,777,748,20200519,1525
20200516,KK,곤지암,1444,1576,20200519,3020
20200516,KK,초월,1773,1600,20200519,3373
20200516,KK,경기광주,4172,4017,20200519,8189
20200516,KK,삼동,1248,1134,20200519,2382
20200516,KK,이매,724,458,20200519,1182
20200516,KK,판교,2197,2074,20200519,4271
20200517,KK,여주,1684,1589,20200520,3273
20200517,KK,세종대왕릉,257,262,20200520,519
20200517,KK,부발,988,1745,20200520,2733
20200517,KK,이천,1660,1910,20200520,3570
20200517,KK,신둔도예촌,614,651,20200520,1265
20200517,KK,곤지암,1163,1409,20200520,2572
20200517,KK,초월,1296,1339,20200520,2635
20200517,KK,경기광주,3225,3193,20200520,6418
20200517,KK,삼동,820,822,20200520,1642
20200517,KK,이매,610,403,20200520,1013
20200517,KK,판교,1833,1667,20200520,3500
20200518,KK,판교,4010,3857,20200521,7867
20200518,KK,이매,1004,859,20200521,1863
20200518,KK,삼동,2054,1902,20200521,3956
20200518,KK,경기광주,6433,6149,20200521,12582
20200518,KK,초월,2521,2511,20200521,5032
20200518,KK,곤지암,1737,1694,20200521,3431
20200518,KK,신둔도예촌,957,882,20200521,1839
20200518,KK,이천,2108,2226,20200521,4334
20200518,KK,부발,1425,1461,20200521,2886
20200518,KK,세종대왕릉,242,244,20200521,486
20200518,KK,여주,1668,1594,20200521,3262
20200519,KK,여주,1446,1466,20200522,2912
20200519,KK,세종대왕릉,235,226,20200522,461
20200519,KK,부발,1435,1371,20200522,2806
20200519,KK,이천,1947,2122,20200522,4069
20200519,KK,신둔도예촌,908,877,20200522,1785
20200519,KK,곤지암,1627,1580,20200522,3207
20200519,KK,초월,2484,2369,20200522,4853
20200519,KK,경기광주,6312,5999,20200522,12311
20200519,KK,삼동,2099,1922,20200522,4021
20200519,KK,이매,1028,829,20200522,1857
20200519,KK,판교,4007,3885,20200522,7892
20200520,KK,여주,1782,1762,20200523,3544
20200520,KK,세종대왕릉,270,295,20200523,565
20200520,KK,부발,1497,1474,20200523,2971
20200520,KK,이천,2245,2372,20200523,4617
20200520,KK,신둔도예촌,1025,950,20200523,1975
20200520,KK,곤지암,1821,1777,20200523,3598
20200520,KK,초월,2661,2558,20200523,5219
20200520,KK,경기광주,6769,6448,20200523,13217
20200520,KK,삼동,2194,2005,20200523,4199
20200520,KK,이매,1075,895,20200523,1970
20200520,KK,판교,4039,3917,20200523,7956
20200521,KK,여주,1681,1685,20200524,3366
20200521,KK,세종대왕릉,252,260,20200524,512
20200521,KK,부발,1587,1467,20200524,3054
20200521,KK,이천,2254,2407,20200524,4661
20200521,KK,신둔도예촌,1053,949,20200524,2002
20200521,KK,곤지암,1774,1803,20200524,3577
20200521,KK,초월,2630,2486,20200524,5116
20200521,KK,경기광주,6767,6429,20200524,13196
20200521,KK,삼동,2179,1994,20200524,4173
20200521,KK,이매,1055,867,20200524,1922
20200521,KK,판교,4141,4022,20200524,8163
20200522,KK,판교,4313,4166,20200525,8479
20200522,KK,이매,1095,903,20200525,1998
20200522,KK,삼동,2232,1980,20200525,4212
20200522,KK,경기광주,7030,6632,20200525,13662
20200522,KK,초월,2838,2543,20200525,5381
20200522,KK,곤지암,2066,1973,20200525,4039
20200522,KK,신둔도예촌,1154,1018,20200525,2172
20200522,KK,이천,2589,2634,20200525,5223
20200522,KK,부발,2208,1633,20200525,3841
20200522,KK,세종대왕릉,296,310,20200525,606
20200522,KK,여주,1942,2017,20200525,3959
20200523,KK,판교,2401,2297,20200526,4698
20200523,KK,이매,800,589,20200526,1389
20200523,KK,삼동,1354,1241,20200526,2595
20200523,KK,경기광주,4717,4272,20200526,8989
20200523,KK,초월,1880,1744,20200526,3624
20200523,KK,곤지암,1614,1787,20200526,3401
20200523,KK,신둔도예촌,865,859,20200526,1724
20200523,KK,이천,2172,2394,20200526,4566
20200523,KK,부발,1643,1342,20200526,2985
20200523,KK,세종대왕릉,299,295,20200526,594
20200523,KK,여주,1951,2172,20200526,4123
20200524,KK,여주,1458,1448,20200527,2906
20200524,KK,세종대왕릉,211,208,20200527,419
20200524,KK,부발,874,1670,20200527,2544
20200524,KK,이천,1493,1723,20200527,3216
20200524,KK,신둔도예촌,611,613,20200527,1224
20200524,KK,곤지암,1102,1392,20200527,2494
20200524,KK,초월,1176,1247,20200527,2423
20200524,KK,경기광주,2927,2982,20200527,5909
20200524,KK,삼동,869,830,20200527,1699
20200524,KK,이매,560,306,20200527,866
20200524,KK,판교,1748,1584,20200527,3332
20200525,KK,여주,1724,1761,20200528,3485
20200525,KK,세종대왕릉,281,277,20200528,558
20200525,KK,부발,1540,1590,20200528,3130
20200525,KK,이천,2211,2433,20200528,4644
20200525,KK,신둔도예촌,1081,1032,20200528,2113
20200525,KK,곤지암,1944,1940,20200528,3884
20200525,KK,초월,2695,2641,20200528,5336
20200525,KK,경기광주,6759,6393,20200528,13152
20200525,KK,삼동,2226,2061,20200528,4287
20200525,KK,이매,1079,905,20200528,1984
20200525,KK,판교,4294,4090,20200528,8384
20200526,KK,여주,1678,1651,20200529,3329
20200526,KK,세종대왕릉,256,237,20200529,493
20200526,KK,부발,1472,1491,20200529,2963
20200526,KK,이천,2150,2303,20200529,4453
20200526,KK,신둔도예촌,1083,1002,20200529,2085
20200526,KK,곤지암,1847,1833,20200529,3680
20200526,KK,초월,2622,2550,20200529,5172
20200526,KK,경기광주,6709,6445,20200529,13154
20200526,KK,삼동,2245,2012,20200529,4257
20200526,KK,이매,1082,888,20200529,1970
20200526,KK,판교,4208,4108,20200529,8316
20200527,KK,여주,1700,1755,20200530,3455
20200527,KK,세종대왕릉,245,259,20200530,504
20200527,KK,부발,1554,1441,20200530,2995
20200527,KK,이천,2259,2389,20200530,4648
20200527,KK,신둔도예촌,1014,970,20200530,1984
20200527,KK,곤지암,1938,1913,20200530,3851
20200527,KK,초월,2745,2613,20200530,5358
20200527,KK,경기광주,6935,6569,20200530,13504
20200527,KK,삼동,2208,1992,20200530,4200
20200527,KK,이매,1101,956,20200530,2057
20200527,KK,판교,4233,4059,20200530,8292
20200528,KK,여주,1701,1713,20200531,3414
20200528,KK,세종대왕릉,273,264,20200531,537
20200528,KK,부발,1547,1498,20200531,3045
20200528,KK,이천,2217,2334,20200531,4551
20200528,KK,신둔도예촌,1067,976,20200531,2043
20200528,KK,곤지암,1960,1948,20200531,3908
20200528,KK,초월,2632,2596,20200531,5228
20200528,KK,경기광주,6803,6446,20200531,13249
20200528,KK,삼동,2230,1992,20200531,4222
20200528,KK,이매,1082,905,20200531,1987
20200528,KK,판교,4285,4151,20200531,8436
20200529,KK,판교,4250,4240,20200601,8490
20200529,KK,이매,1133,971,20200601,2104
20200529,KK,삼동,2283,2005,20200601,4288
20200529,KK,경기광주,7001,6696,20200601,13697
20200529,KK,초월,2801,2583,20200601,5384
20200529,KK,곤지암,2146,2003,20200601,4149
20200529,KK,신둔도예촌,1183,1047,20200601,2230
20200529,KK,이천,2553,2716,20200601,5269
20200529,KK,부발,2234,1645,20200601,3879
20200529,KK,세종대왕릉,300,276,20200601,576
20200529,KK,여주,1942,2003,20200601,3945
20200530,KK,판교,2191,2148,20200602,4339
20200530,KK,이매,830,596,20200602,1426
20200530,KK,삼동,1294,1124,20200602,2418
20200530,KK,경기광주,4340,4169,20200602,8509
20200530,KK,초월,1792,1659,20200602,3451
20200530,KK,곤지암,1479,1623,20200602,3102
20200530,KK,신둔도예촌,861,815,20200602,1676
20200530,KK,이천,2041,2183,20200602,4224
20200530,KK,부발,1606,1277,20200602,2883
20200530,KK,세종대왕릉,292,272,20200602,564
20200530,KK,여주,1842,2117,20200602,3959
20200531,KK,여주,1623,1611,20200603,3234
20200531,KK,세종대왕릉,253,261,20200603,514
20200531,KK,부발,965,1669,20200603,2634
20200531,KK,이천,1619,1759,20200603,3378
20200531,KK,신둔도예촌,668,677,20200603,1345
20200531,KK,곤지암,1103,1355,20200603,2458
20200531,KK,초월,1229,1210,20200603,2439
20200531,KK,경기광주,3068,3081,20200603,6149
20200531,KK,삼동,814,818,20200603,1632
20200531,KK,이매,577,353,20200603,930
20200531,KK,판교,1743,1616,20200603,3359
20200101,경부선,광명,2122,1191,20200104,3313
20200101,경부선,서동탄,866,827,20200104,1693
20200101,1,당정,2742,2921,20200104,5663
20200101,1,천안,5507,5236,20200104,10743
20200101,1,두정,3594,3868,20200104,7462
20200101,1,직산,606,647,20200104,1253
20200101,1,성환,2437,2892,20200104,5329
20200101,1,평택,10071,11332,20200104,21403
20200101,1,지제,1554,1597,20200104,3151
20200101,1,서정리,3214,4978,20200104,8192
20200101,1,송탄,3250,4020,20200104,7270
20200101,1,진위,659,719,20200104,1378
20200101,1,오산,7143,8176,20200104,15319
20200101,1,오산대,1632,1598,20200104,3230
20200101,1,세마,1635,1548,20200104,3183
20200101,1,병점,8178,10037,20200104,18215
20200101,1,세류,2234,2399,20200104,4633
20200101,1,독산,5557,5667,20200104,11224
20200101,1,수원,33590,32542,20200104,66132
20200101,1,화서,3607,3579,20200104,7186
20200101,1,성균관대,7253,7836,20200104,15089
20200101,1,의왕,3871,4074,20200104,7945
20200101,1,군포,3133,2945,20200104,6078
20200101,4,금정,12169,13152,20200104,25321
20200101,1,명학,2839,2798,20200104,5637
20200101,1,안양,14028,13752,20200104,27780
20200101,1,관악,4263,4052,20200104,8315
20200101,1,석수,4711,4579,20200104,9290
20200101,1,금천구청,5733,5705,20200104,11438
20200101,1,가산디지털단지,4474,6236,20200104,10710
20200101,1,구로,9338,9455,20200104,18793
20200101,1,신길,4573,4125,20200104,8698
20200101,경부선,신도림,1651,1830,20200104,3481
20200101,1,영등포,35405,33938,20200104,69343
20200101,1,대방,5943,6316,20200104,12259
20200101,1,노량진,7177,6531,20200104,13708
20200101,1,용산,32456,29286,20200104,61742
20200101,1,남영,4040,4234,20200104,8274
20200101,경부선,서울역,6620,1051,20200104,7671
20200102,경부선,서울역,7265,1645,20200105,8910
20200102,1,남영,11022,11581,20200105,22603
20200102,1,용산,40437,40425,20200105,80862
20200102,1,노량진,11087,10685,20200105,21772
20200102,1,대방,15292,15526,20200105,30818
20200102,1,영등포,47585,49366,20200105,96951
20200102,경부선,신도림,4288,4214,20200105,8502
20200102,1,신길,10044,8441,20200105,18485
20200102,1,구로,20219,20273,20200105,40492
20200102,1,가산디지털단지,20409,23292,20200105,43701
20200102,1,금천구청,13145,12489,20200105,25634
20200102,1,석수,11569,10038,20200105,21607
20200102,1,관악,8546,7805,20200105,16351
20200102,1,안양,25168,24644,20200105,49812
20200102,1,명학,10069,9608,20200105,19677
20200102,4,금정,28128,29071,20200105,57199
20200102,1,군포,8061,7923,20200105,15984
20200102,1,의왕,9246,8971,20200105,18217
20200102,1,성균관대,15053,15477,20200105,30530
20200102,1,화서,8403,8074,20200105,16477
20200102,1,수원,40958,42994,20200105,83952
20200102,1,독산,18320,19032,20200105,37352
20200102,1,세류,3723,3464,20200105,7187
20200102,1,병점,15084,15269,20200105,30353
20200102,1,세마,2886,2549,20200105,5435
20200102,1,오산대,3132,2673,20200105,5805
20200102,1,오산,9614,9676,20200105,19290
20200102,1,진위,1639,1382,20200105,3021
20200102,1,송탄,4557,4523,20200105,9080
20200102,1,서정리,5307,5696,20200105,11003
20200102,1,지제,2735,2314,20200105,5049
20200102,1,평택,12286,12563,20200105,24849
20200102,1,성환,3315,3413,20200105,6728
20200102,1,직산,836,831,20200105,1667
20200102,1,두정,4520,4818,20200105,9338
20200102,1,천안,5621,5833,20200105,11454
20200102,1,당정,7070,6670,20200105,13740
20200102,경부선,서동탄,1950,1508,20200105,3458
20200102,경부선,광명,3332,2593,20200105,5925
20200103,경부선,서울역,8504,1846,20200106,10350
20200103,1,남영,11459,11970,20200106,23429
20200103,1,용산,44974,45216,20200106,90190
20200103,1,노량진,12152,11559,20200106,23711
20200103,1,대방,15893,16125,20200106,32018
20200103,1,영등포,53778,56902,20200106,110680
20200103,경부선,신도림,4340,4496,20200106,8836
20200103,1,신길,10669,8765,20200106,19434
20200103,1,구로,20860,21262,20200106,42122
20200103,1,가산디지털단지,20529,23685,20200106,44214
20200103,1,금천구청,13725,13086,20200106,26811
20200103,1,석수,12188,10242,20200106,22430
20200103,1,관악,8890,8054,20200106,16944
20200103,1,안양,26554,26893,20200106,53447
20200103,1,명학,10258,9697,20200106,19955
20200103,4,금정,30084,30685,20200106,60769
20200103,1,군포,8393,8095,20200106,16488
20200103,1,의왕,10162,9791,20200106,19953
20200103,1,성균관대,16337,16032,20200106,32369
20200103,1,화서,8820,8162,20200106,16982
20200103,1,수원,44456,47848,20200106,92304
20200103,1,독산,18775,19390,20200106,38165
20200103,1,세류,4031,3626,20200106,7657
20200103,1,병점,16956,16270,20200106,33226
20200103,1,세마,3015,2604,20200106,5619
20200103,1,오산대,3421,2919,20200106,6340
20200103,1,오산,11168,10731,20200106,21899
20200103,1,진위,1916,1467,20200106,3383
20200103,1,송탄,5032,4580,20200106,9612
20200103,1,서정리,6140,5714,20200106,11854
20200103,1,지제,2942,2546,20200106,5488
20200103,1,평택,14404,13489,20200106,27893
20200103,1,성환,4074,3608,20200106,7682
20200103,1,직산,1005,842,20200106,1847
20200103,1,두정,5702,5748,20200106,11450
20200103,1,천안,6174,6510,20200106,12684
20200103,1,당정,7618,7071,20200106,14689
20200103,경부선,서동탄,1984,1594,20200106,3578
20200103,경부선,광명,3720,2817,20200106,6537
20200104,경부선,서울역,8218,1538,20200107,9756
20200104,1,남영,7395,7314,20200107,14709
20200104,1,용산,42929,43628,20200107,86557
20200104,1,노량진,12218,10668,20200107,22886
20200104,1,대방,10649,10445,20200107,21094
20200104,1,영등포,54846,58246,20200107,113092
20200104,경부선,신도림,3296,3756,20200107,7052
20200104,1,신길,7409,5944,20200107,13353
20200104,1,구로,15632,16373,20200107,32005
20200104,1,가산디지털단지,6932,9446,20200107,16378
20200104,1,금천구청,9738,9448,20200107,19186
20200104,1,석수,8813,7951,20200107,16764
20200104,1,관악,7026,6600,20200107,13626
20200104,1,안양,22657,23195,20200107,45852
20200104,1,명학,6430,6108,20200107,12538
20200104,4,금정,21452,22032,20200107,43484
20200104,1,군포,5018,4512,20200107,9530
20200104,1,의왕,7036,6744,20200107,13780
20200104,1,성균관대,12514,12254,20200107,24768
20200104,1,화서,6389,6282,20200107,12671
20200104,1,수원,46080,49620,20200107,95700
20200104,1,독산,10167,9823,20200107,19990
20200104,1,세류,3488,3343,20200107,6831
20200104,1,병점,14087,13452,20200107,27539
20200104,1,세마,2730,2264,20200107,4994
20200104,1,오산대,2729,2386,20200107,5115
20200104,1,오산,10297,9705,20200107,20002
20200104,1,진위,1203,986,20200107,2189
20200104,1,송탄,5044,4638,20200107,9682
20200104,1,서정리,6194,5180,20200107,11374
20200104,1,지제,2605,2207,20200107,4812
20200104,1,평택,14851,14173,20200107,29024
20200104,1,성환,3545,3220,20200107,6765
20200104,1,직산,794,720,20200107,1514
20200104,1,두정,5456,5531,20200107,10987
20200104,1,천안,7489,7160,20200107,14649
20200104,1,당정,5083,4643,20200107,9726
20200104,경부선,서동탄,1466,1459,20200107,2925
20200104,경부선,광명,2865,2192,20200107,5057
20200105,경부선,서울역,7353,1255,20200108,8608
20200105,1,남영,5633,5900,20200108,11533
20200105,1,용산,36380,34012,20200108,70392
20200105,1,노량진,8623,7612,20200108,16235
20200105,1,대방,8175,8638,20200108,16813
20200105,1,영등포,44464,43378,20200108,87842
20200105,경부선,신도림,2462,2530,20200108,4992
20200105,1,신길,5611,4907,20200108,10518
20200105,1,구로,11645,11520,20200108,23165
20200105,1,가산디지털단지,5490,7663,20200108,13153
20200105,1,금천구청,7373,6979,20200108,14352
20200105,1,석수,6454,5986,20200108,12440
20200105,1,관악,5994,5479,20200108,11473
20200105,1,안양,16843,16892,20200108,33735
20200105,1,명학,4211,4032,20200108,8243
20200105,4,금정,16148,16885,20200108,33033
20200105,1,군포,3857,3363,20200108,7220
20200105,1,의왕,4868,4888,20200108,9756
20200105,1,성균관대,9330,9835,20200108,19165
20200105,1,화서,4784,4548,20200108,9332
20200105,1,수원,39438,39506,20200108,78944
20200105,1,독산,6823,6947,20200108,13770
20200105,1,세류,2700,2761,20200108,5461
20200105,1,병점,10537,11840,20200108,22377
20200105,1,세마,1944,1818,20200108,3762
20200105,1,오산대,2104,1989,20200108,4093
20200105,1,오산,8578,9176,20200108,17754
20200105,1,진위,869,824,20200108,1693
20200105,1,송탄,3939,4341,20200108,8280
20200105,1,서정리,3977,5460,20200108,9437
20200105,1,지제,2049,1945,20200108,3994
20200105,1,평택,12586,13398,20200108,25984
20200105,1,성환,2760,3301,20200108,6061
20200105,1,직산,650,748,20200108,1398
20200105,1,두정,4406,4896,20200108,9302
20200105,1,천안,6529,6361,20200108,12890
20200105,1,당정,3606,3596,20200108,7202
20200105,경부선,서동탄,1084,1099,20200108,2183
20200105,경부선,광명,2556,1633,20200108,4189
20200106,경부선,서울역,6832,1686,20200109,8518
20200106,1,남영,11502,12170,20200109,23672
20200106,1,용산,38773,39991,20200109,78764
20200106,1,노량진,11167,10956,20200109,22123
20200106,1,대방,15476,16117,20200109,31593
20200106,1,영등포,46896,48545,20200109,95441
20200106,경부선,신도림,4210,4294,20200109,8504
20200106,1,신길,10529,8928,20200109,19457
20200106,1,구로,20947,21034,20200109,41981
20200106,1,가산디지털단지,20836,24326,20200109,45162
20200106,1,금천구청,13222,12747,20200109,25969
20200106,1,석수,11790,10286,20200109,22076
20200106,1,관악,8585,7880,20200109,16465
20200106,1,안양,24852,25124,20200109,49976
20200106,1,명학,10353,9945,20200109,20298
20200106,4,금정,28931,29525,20200109,58456
20200106,1,군포,8098,8098,20200109,16196
20200106,1,의왕,10027,9756,20200109,19783
20200106,1,성균관대,15716,15610,20200109,31326
20200106,1,화서,8569,8143,20200109,16712
20200106,1,수원,39128,42215,20200109,81343
20200106,1,독산,18985,19588,20200109,38573
20200106,1,세류,3649,3306,20200109,6955
20200106,1,병점,15444,15381,20200109,30825
20200106,1,세마,2889,2502,20200109,5391
20200106,1,오산대,3040,2594,20200109,5634
20200106,1,오산,9646,9802,20200109,19448
20200106,1,진위,1633,1486,20200109,3119
20200106,1,송탄,4315,3989,20200109,8304
20200106,1,서정리,5344,5536,20200109,10880
20200106,1,지제,2652,2326,20200109,4978
20200106,1,평택,12352,11973,20200109,24325
20200106,1,성환,3420,3674,20200109,7094
20200106,1,직산,822,798,20200109,1620
20200106,1,두정,4757,5022,20200109,9779
20200106,1,천안,5607,5680,20200109,11287
20200106,1,당정,7361,6891,20200109,14252
20200106,경부선,서동탄,1904,1533,20200109,3437
20200106,경부선,광명,3401,2505,20200109,5906
20200107,경부선,서울역,6449,1517,20200110,7966
20200107,1,남영,10990,11844,20200110,22834
20200107,1,용산,37362,38021,20200110,75383
20200107,1,노량진,10652,10347,20200110,20999
20200107,1,대방,15499,16003,20200110,31502
20200107,1,영등포,45646,46872,20200110,92518
20200107,경부선,신도림,3740,3989,20200110,7729
20200107,1,신길,10212,8540,20200110,18752
20200107,1,구로,20055,20091,20200110,40146
20200107,1,가산디지털단지,20052,23445,20200110,43497
20200107,1,금천구청,12657,12297,20200110,24954
20200107,1,석수,11441,9901,20200110,21342
20200107,1,관악,8380,7580,20200110,15960
20200107,1,안양,23896,24327,20200110,48223
20200107,1,명학,10033,9772,20200110,19805
20200107,4,금정,27832,28859,20200110,56691
20200107,1,군포,7967,7653,20200110,15620
20200107,1,의왕,9565,9414,20200110,18979
20200107,1,성균관대,15144,14985,20200110,30129
20200107,1,화서,8099,7629,20200110,15728
20200107,1,수원,37975,40293,20200110,78268
20200107,1,독산,18364,19195,20200110,37559
20200107,1,세류,3441,3152,20200110,6593
20200107,1,병점,14824,14757,20200110,29581
20200107,1,세마,2692,2455,20200110,5147
20200107,1,오산대,2984,2573,20200110,5557
20200107,1,오산,9278,9249,20200110,18527
20200107,1,진위,1623,1393,20200110,3016
20200107,1,송탄,3839,3742,20200110,7581
20200107,1,서정리,5051,5123,20200110,10174
20200107,1,지제,2427,2186,20200110,4613
20200107,1,평택,11308,10930,20200110,22238
20200107,1,성환,3161,3231,20200110,6392
20200107,1,직산,785,743,20200110,1528
20200107,1,두정,4343,4365,20200110,8708
20200107,1,천안,4798,4948,20200110,9746
20200107,1,당정,7160,6821,20200110,13981
20200107,경부선,서동탄,1721,1341,20200110,3062
20200107,경부선,광명,3206,2464,20200110,5670
20200108,경부선,서울역,6301,1509,20200111,7810
20200108,1,남영,11590,12073,20200111,23663
20200108,1,용산,41335,41620,20200111,82955
20200108,1,노량진,11756,11275,20200111,23031
20200108,1,대방,16246,16426,20200111,32672
20200108,1,영등포,48533,50457,20200111,98990
20200108,경부선,신도림,4327,4369,20200111,8696
20200108,1,신길,10537,8896,20200111,19433
20200108,1,구로,20800,21182,20200111,41982
20200108,1,가산디지털단지,20923,24065,20200111,44988
20200108,1,금천구청,13362,12807,20200111,26169
20200108,1,석수,11887,10345,20200111,22232
20200108,1,관악,8689,8032,20200111,16721
20200108,1,안양,25531,25846,20200111,51377
20200108,1,명학,10454,10078,20200111,20532
20200108,4,금정,29409,30167,20200111,59576
20200108,1,군포,8383,8170,20200111,16553
20200108,1,의왕,10225,10023,20200111,20248
20200108,1,성균관대,15749,15582,20200111,31331
20200108,1,화서,8665,8321,20200111,16986
20200108,1,수원,40625,43110,20200111,83735
20200108,1,독산,18797,19680,20200111,38477
20200108,1,세류,3459,3292,20200111,6751
20200108,1,병점,15930,15848,20200111,31778
20200108,1,세마,2866,2580,20200111,5446
20200108,1,오산대,2974,2532,20200111,5506
20200108,1,오산,9985,10127,20200111,20112
20200108,1,진위,1710,1448,20200111,3158
20200108,1,송탄,4404,4079,20200111,8483
20200108,1,서정리,5339,5561,20200111,10900
20200108,1,지제,2571,2293,20200111,4864
20200108,1,평택,11944,11608,20200111,23552
20200108,1,성환,3121,3173,20200111,6294
20200108,1,직산,802,790,20200111,1592
20200108,1,두정,4855,4807,20200111,9662
20200108,1,천안,5112,5171,20200111,10283
20200108,1,당정,7248,6731,20200111,13979
20200108,경부선,서동탄,1879,1549,20200111,3428
20200108,경부선,광명,3221,2605,20200111,5826
20200109,경부선,서울역,6847,1587,20200112,8434
20200109,1,남영,11852,12516,20200112,24368
20200109,1,용산,40784,41838,20200112,82622
20200109,1,노량진,12188,11574,20200112,23762
20200109,1,대방,16247,16560,20200112,32807
20200109,1,영등포,48938,50808,20200112,99746
20200109,경부선,신도림,4296,4403,20200112,8699
20200109,1,신길,10833,9013,20200112,19846
20200109,1,구로,21116,21371,20200112,42487
20200109,1,가산디지털단지,21101,24259,20200112,45360
20200109,1,금천구청,13618,13053,20200112,26671
20200109,1,석수,12330,10705,20200112,23035
20200109,1,관악,8944,8335,20200112,17279
20200109,1,안양,26150,26285,20200112,52435
20200109,1,명학,10311,9972,20200112,20283
20200109,4,금정,29717,30447,20200112,60164
20200109,1,군포,8253,8106,20200112,16359
20200109,1,의왕,10384,10101,20200112,20485
20200109,1,성균관대,16248,15797,20200112,32045
20200109,1,화서,8847,8480,20200112,17327
20200109,1,수원,41907,44311,20200112,86218
20200109,1,독산,18923,19632,20200112,38555
20200109,1,세류,3774,3467,20200112,7241
20200109,1,병점,16082,16210,20200112,32292
20200109,1,세마,3016,2645,20200112,5661
20200109,1,오산대,3119,2698,20200112,5817
20200109,1,오산,9986,9988,20200112,19974
20200109,1,진위,1633,1469,20200112,3102
20200109,1,송탄,4347,4159,20200112,8506
20200109,1,서정리,5423,5545,20200112,10968
20200109,1,지제,2614,2311,20200112,4925
20200109,1,평택,12691,12144,20200112,24835
20200109,1,성환,3461,3397,20200112,6858
20200109,1,직산,795,844,20200112,1639
20200109,1,두정,5134,5068,20200112,10202
20200109,1,천안,5750,5806,20200112,11556
20200109,1,당정,7485,6960,20200112,14445
20200109,경부선,서동탄,1969,1566,20200112,3535
20200109,경부선,광명,3394,2553,20200112,5947
20200110,경부선,서울역,9219,2039,20200113,11258
20200110,1,남영,11877,12401,20200113,24278
20200110,1,용산,47864,48107,20200113,95971
20200110,1,노량진,12987,12198,20200113,25185
20200110,1,대방,16718,16822,20200113,33540
20200110,1,영등포,55546,59370,20200113,114916
20200110,경부선,신도림,4434,4643,20200113,9077
20200110,1,신길,10887,9032,20200113,19919
20200110,1,구로,21599,22058,20200113,43657
20200110,1,가산디지털단지,21493,24648,20200113,46141
20200110,1,금천구청,14051,13641,20200113,27692
20200110,1,석수,12802,10591,20200113,23393
20200110,1,관악,9081,8278,20200113,17359
20200110,1,안양,27438,28163,20200113,55601
20200110,1,명학,10595,10091,20200113,20686
20200110,4,금정,31571,31810,20200113,63381
20200110,1,군포,8681,8370,20200113,17051
20200110,1,의왕,10751,10269,20200113,21020
20200110,1,성균관대,17321,17017,20200113,34338
20200110,1,화서,9176,8528,20200113,17704
20200110,1,수원,46215,50376,20200113,96591
20200110,1,독산,19354,19793,20200113,39147
20200110,1,세류,4242,3670,20200113,7912
20200110,1,병점,18186,17591,20200113,35777
20200110,1,세마,3309,2766,20200113,6075
20200110,1,오산대,3387,2852,20200113,6239
20200110,1,오산,11488,10966,20200113,22454
20200110,1,진위,2123,1548,20200113,3671
20200110,1,송탄,5081,4519,20200113,9600
20200110,1,서정리,6246,5844,20200113,12090
20200110,1,지제,3140,2630,20200113,5770
20200110,1,평택,14721,13806,20200113,28527
20200110,1,성환,3988,3623,20200113,7611
20200110,1,직산,957,868,20200113,1825
20200110,1,두정,6030,5967,20200113,11997
20200110,1,천안,6452,6681,20200113,13133
20200110,1,당정,8009,7358,20200113,15367
20200110,경부선,서동탄,2080,1702,20200113,3782
20200110,경부선,광명,3985,3176,20200113,7161
20200111,경부선,서울역,9112,1717,20200114,10829
20200111,1,남영,7726,7659,20200114,15385
20200111,1,용산,46954,48938,20200114,95892
20200111,1,노량진,13099,11447,20200114,24546
20200111,1,대방,12180,12076,20200114,24256
20200111,1,영등포,59430,62781,20200114,122211
20200111,경부선,신도림,3418,3930,20200114,7348
20200111,1,신길,7882,6449,20200114,14331
20200111,1,구로,16579,17255,20200114,33834
20200111,1,가산디지털단지,7421,10119,20200114,17540
20200111,1,금천구청,10393,10135,20200114,20528
20200111,1,석수,9342,8310,20200114,17652
20200111,1,관악,7369,6870,20200114,14239
20200111,1,안양,24392,24817,20200114,49209
20200111,1,명학,6813,6366,20200114,13179
20200111,4,금정,23338,23608,20200114,46946
20200111,1,군포,5516,4744,20200114,10260
20200111,1,의왕,7035,6707,20200114,13742
20200111,1,성균관대,13442,13029,20200114,26471
20200111,1,화서,6952,6527,20200114,13479
20200111,1,수원,48949,53420,20200114,102369
20200111,1,독산,10721,10589,20200114,21310
20200111,1,세류,3722,3470,20200114,7192
20200111,1,병점,15308,14506,20200114,29814
20200111,1,세마,2732,2314,20200114,5046
20200111,1,오산대,2970,2445,20200114,5415
20200111,1,오산,11020,10348,20200114,21368
20200111,1,진위,1256,1054,20200114,2310
20200111,1,송탄,5226,4682,20200114,9908
20200111,1,서정리,6666,5492,20200114,12158
20200111,1,지제,2825,2341,20200114,5166
20200111,1,평택,15816,14993,20200114,30809
20200111,1,성환,3913,3470,20200114,7383
20200111,1,직산,863,771,20200114,1634
20200111,1,두정,5684,5869,20200114,11553
20200111,1,천안,7902,7861,20200114,15763
20200111,1,당정,5157,4848,20200114,10005
20200111,경부선,서동탄,1556,1557,20200114,3113
20200111,경부선,광명,3141,2374,20200114,5515
20200112,경부선,서울역,7550,1471,20200115,9021
20200112,1,남영,5746,6131,20200115,11877
20200112,1,용산,38255,36896,20200115,75151
20200112,1,노량진,8881,7942,20200115,16823
20200112,1,대방,8055,8300,20200115,16355
20200112,1,영등포,46610,45253,20200115,91863
20200112,경부선,신도림,2449,2609,20200115,5058
20200112,1,신길,5861,5072,20200115,10933
20200112,1,구로,12378,12526,20200115,24904
20200112,1,가산디지털단지,5645,7792,20200115,13437
20200112,1,금천구청,7511,7078,20200115,14589
20200112,1,석수,6665,6254,20200115,12919
20200112,1,관악,5767,5248,20200115,11015
20200112,1,안양,18305,18079,20200115,36384
20200112,1,명학,4241,4117,20200115,8358
20200112,4,금정,17151,17975,20200115,35126
20200112,1,군포,3953,3617,20200115,7570
20200112,1,의왕,5115,5173,20200115,10288
20200112,1,성균관대,9646,10182,20200115,19828
20200112,1,화서,4847,4816,20200115,9663
20200112,1,수원,42249,42159,20200115,84408
20200112,1,독산,7337,7458,20200115,14795
20200112,1,세류,2966,2963,20200115,5929
20200112,1,병점,11076,12307,20200115,23383
20200112,1,세마,2158,1972,20200115,4130
20200112,1,오산대,2195,1987,20200115,4182
20200112,1,오산,9178,9889,20200115,19067
20200112,1,진위,883,858,20200115,1741
20200112,1,송탄,4105,4554,20200115,8659
20200112,1,서정리,4513,6065,20200115,10578
20200112,1,지제,2089,2020,20200115,4109
20200112,1,평택,13441,14703,20200115,28144
20200112,1,성환,3196,3657,20200115,6853
20200112,1,직산,730,819,20200115,1549
20200112,1,두정,4709,4998,20200115,9707
20200112,1,천안,6883,6886,20200115,13769
20200112,1,당정,3630,3597,20200115,7227
20200112,경부선,서동탄,1189,1112,20200115,2301
20200112,경부선,광명,2773,1779,20200115,4552
20200113,경부선,서울역,6940,1696,20200116,8636
20200113,1,남영,11233,11852,20200116,23085
20200113,1,용산,39755,41741,20200116,81496
20200113,1,노량진,11407,10953,20200116,22360
20200113,1,대방,15840,16175,20200116,32015
20200113,1,영등포,47711,49383,20200116,97094
20200113,경부선,신도림,4221,4340,20200116,8561
20200113,1,신길,10770,9048,20200116,19818
20200113,1,구로,21096,21068,20200116,42164
20200113,1,가산디지털단지,20921,24134,20200116,45055
20200113,1,금천구청,13478,13075,20200116,26553
20200113,1,석수,12320,10166,20200116,22486
20200113,1,관악,8571,7882,20200116,16453
20200113,1,안양,25511,25699,20200116,51210
20200113,1,명학,10528,10134,20200116,20662
20200113,4,금정,29410,30570,20200116,59980
20200113,1,군포,8226,8301,20200116,16527
20200113,1,의왕,10136,9827,20200116,19963
20200113,1,성균관대,15929,15830,20200116,31759
20200113,1,화서,8733,8270,20200116,17003
20200113,1,수원,40531,43755,20200116,84286
20200113,1,독산,19132,19832,20200116,38964
20200113,1,세류,3771,3352,20200116,7123
20200113,1,병점,15801,15985,20200116,31786
20200113,1,세마,2919,2548,20200116,5467
20200113,1,오산대,3003,2566,20200116,5569
20200113,1,오산,10380,10617,20200116,20997
20200113,1,진위,1600,1464,20200116,3064
20200113,1,송탄,4359,4088,20200116,8447
20200113,1,서정리,5412,5605,20200116,11017
20200113,1,지제,2642,2339,20200116,4981
20200113,1,평택,12746,12354,20200116,25100
20200113,1,성환,3287,3509,20200116,6796
20200113,1,직산,822,828,20200116,1650
20200113,1,두정,4828,5081,20200116,9909
20200113,1,천안,5739,5960,20200116,11699
20200113,1,당정,7282,6777,20200116,14059
20200113,경부선,서동탄,1911,1468,20200116,3379
20200113,경부선,광명,3351,2664,20200116,6015
20200114,경부선,광명,3180,2453,20200117,5633
20200114,경부선,서동탄,1897,1545,20200117,3442
20200114,1,당정,7279,6885,20200117,14164
20200114,1,천안,5840,5730,20200117,11570
20200114,1,두정,5003,5015,20200117,10018
20200114,1,직산,806,781,20200117,1587
20200114,1,성환,3441,3425,20200117,6866
20200114,1,평택,12084,11741,20200117,23825
20200114,1,지제,2539,2260,20200117,4799
20200114,1,서정리,5265,5360,20200117,10625
20200114,1,송탄,4222,3954,20200117,8176
20200114,1,진위,1625,1414,20200117,3039
20200114,1,오산,9971,9925,20200117,19896
20200114,1,오산대,2970,2515,20200117,5485
20200114,1,세마,2795,2569,20200117,5364
20200114,1,병점,15843,15682,20200117,31525
20200114,1,세류,3672,3382,20200117,7054
20200114,1,독산,19122,19973,20200117,39095
20200114,1,수원,40225,42814,20200117,83039
20200114,1,화서,8703,8308,20200117,17011
20200114,1,성균관대,15872,15966,20200117,31838
20200114,1,의왕,10258,9964,20200117,20222
20200114,1,군포,8246,8126,20200117,16372
20200114,4,금정,29557,30241,20200117,59798
20200114,1,명학,10499,10091,20200117,20590
20200114,1,안양,25894,26129,20200117,52023
20200114,1,관악,8836,8109,20200117,16945
20200114,1,석수,12142,10458,20200117,22600
20200114,1,금천구청,13429,12988,20200117,26417
20200114,1,가산디지털단지,20917,24164,20200117,45081
20200114,1,구로,21068,21444,20200117,42512
20200114,1,신길,10662,9152,20200117,19814
20200114,경부선,신도림,4224,4293,20200117,8517
20200114,1,영등포,48332,50032,20200117,98364
20200114,1,대방,15968,16407,20200117,32375
20200114,1,노량진,11829,11270,20200117,23099
20200114,1,용산,39054,40246,20200117,79300
20200114,1,남영,11271,11831,20200117,23102
20200114,경부선,서울역,6363,1583,20200117,7946
20200115,경부선,서울역,6827,1719,20200118,8546
20200115,1,남영,11401,11878,20200118,23279
20200115,1,용산,40236,41363,20200118,81599
20200115,1,노량진,11909,11536,20200118,23445
20200115,1,대방,16121,16424,20200118,32545
20200115,1,영등포,49207,50733,20200118,99940
20200115,경부선,신도림,4427,4540,20200118,8967
20200115,1,신길,10767,9171,20200118,19938
20200115,1,구로,21158,21381,20200118,42539
20200115,1,가산디지털단지,20873,24391,20200118,45264
20200115,1,금천구청,13434,13217,20200118,26651
20200115,1,석수,12080,10360,20200118,22440
20200115,1,관악,8679,7894,20200118,16573
20200115,1,안양,25721,26044,20200118,51765
20200115,1,명학,10517,10239,20200118,20756
20200115,4,금정,30163,30905,20200118,61068
20200115,1,군포,8388,8218,20200118,16606
20200115,1,의왕,10229,9902,20200118,20131
20200115,1,성균관대,16197,16035,20200118,32232
20200115,1,화서,8709,8251,20200118,16960
20200115,1,수원,40785,43480,20200118,84265
20200115,1,독산,19230,19982,20200118,39212
20200115,1,세류,3660,3283,20200118,6943
20200115,1,병점,16033,16019,20200118,32052
20200115,1,세마,2907,2566,20200118,5473
20200115,1,오산대,3025,2638,20200118,5663
20200115,1,오산,10097,10029,20200118,20126
20200115,1,진위,1637,1429,20200118,3066
20200115,1,송탄,4246,4136,20200118,8382
20200115,1,서정리,5508,5536,20200118,11044
20200115,1,지제,2594,2332,20200118,4926
20200115,1,평택,12458,12063,20200118,24521
20200115,1,성환,3285,3301,20200118,6586
20200115,1,직산,827,803,20200118,1630
20200115,1,두정,5021,5052,20200118,10073
20200115,1,천안,5543,5670,20200118,11213
20200115,1,당정,7441,6928,20200118,14369
20200115,경부선,서동탄,1902,1565,20200118,3467
20200115,경부선,광명,3208,2528,20200118,5736
20200116,경부선,광명,3420,2558,20200119,5978
20200116,경부선,서동탄,1955,1561,20200119,3516
20200116,1,당정,7370,6934,20200119,14304
20200116,1,천안,5572,5485,20200119,11057
20200116,1,두정,4945,4930,20200119,9875
20200116,1,직산,751,788,20200119,1539
20200116,1,성환,3227,3293,20200119,6520
20200116,1,평택,12800,11999,20200119,24799
20200116,1,지제,2532,2316,20200119,4848
20200116,1,서정리,5445,5420,20200119,10865
20200116,1,송탄,4280,4193,20200119,8473
20200116,1,진위,1669,1406,20200119,3075
20200116,1,오산,9699,9622,20200119,19321
20200116,1,오산대,2986,2659,20200119,5645
20200116,1,세마,2821,2561,20200119,5382
20200116,1,병점,15797,15716,20200119,31513
20200116,1,세류,3775,3467,20200119,7242
20200116,1,독산,19202,19937,20200119,39139
20200116,1,수원,40699,43559,20200119,84258
20200116,1,화서,8728,8340,20200119,17068
20200116,1,성균관대,16158,15912,20200119,32070
20200116,1,의왕,10376,9939,20200119,20315
20200116,1,군포,8171,8087,20200119,16258
20200116,4,금정,29975,30753,20200119,60728
20200116,1,명학,10447,10029,20200119,20476
20200116,1,안양,26244,26350,20200119,52594
20200116,1,관악,8850,7978,20200119,16828
20200116,1,석수,12248,10400,20200119,22648
20200116,1,금천구청,13469,13089,20200119,26558
20200116,1,가산디지털단지,20789,24301,20200119,45090
20200116,1,구로,20944,21271,20200119,42215
20200116,1,신길,10901,8905,20200119,19806
20200116,경부선,신도림,4422,4348,20200119,8770
20200116,1,영등포,49601,51110,20200119,100711
20200116,1,대방,15980,16503,20200119,32483
20200116,1,노량진,12124,11618,20200119,23742
20200116,1,용산,41784,42155,20200119,83939
20200116,1,남영,11423,12052,20200119,23475
20200116,경부선,서울역,7286,1694,20200119,8980
20200117,경부선,서울역,9335,2114,20200120,11449
20200117,1,남영,11438,12135,20200120,23573
20200117,1,용산,47104,47111,20200120,94215
20200117,1,노량진,12892,12148,20200120,25040
20200117,1,대방,16267,16256,20200120,32523
20200117,1,영등포,55127,58588,20200120,113715
20200117,경부선,신도림,4507,4595,20200120,9102
20200117,1,신길,10957,9081,20200120,20038
20200117,1,구로,21185,21948,20200120,43133
20200117,1,가산디지털단지,21572,24614,20200120,46186
20200117,1,금천구청,14033,13472,20200120,27505
20200117,1,석수,12533,10517,20200120,23050
20200117,1,관악,9019,8055,20200120,17074
20200117,1,안양,27114,27786,20200120,54900
20200117,1,명학,10578,9933,20200120,20511
20200117,4,금정,31344,32005,20200120,63349
20200117,1,군포,8486,8321,20200120,16807
20200117,1,의왕,10642,10134,20200120,20776
20200117,1,성균관대,16919,16457,20200120,33376
20200117,1,화서,8962,8389,20200120,17351
20200117,1,수원,44738,48875,20200120,93613
20200117,1,독산,19649,20326,20200120,39975
20200117,1,세류,4017,3753,20200120,7770
20200117,1,병점,17615,16820,20200120,34435
20200117,1,세마,3165,2691,20200120,5856
20200117,1,오산대,3305,2830,20200120,6135
20200117,1,오산,11106,10592,20200120,21698
20200117,1,진위,1959,1475,20200120,3434
20200117,1,송탄,5183,4658,20200120,9841
20200117,1,서정리,6326,5845,20200120,12171
20200117,1,지제,2945,2516,20200120,5461
20200117,1,평택,14137,13459,20200120,27596
20200117,1,성환,3929,3429,20200120,7358
20200117,1,직산,958,864,20200120,1822
20200117,1,두정,5801,5661,20200120,11462
20200117,1,천안,6115,6126,20200120,12241
20200117,1,당정,7538,6934,20200120,14472
20200117,경부선,서동탄,2061,1618,20200120,3679
20200117,경부선,광명,4046,3052,20200120,7098
20200118,경부선,서울역,8495,1740,20200121,10235
20200118,1,남영,8039,7985,20200121,16024
20200118,1,용산,44413,45685,20200121,90098
20200118,1,노량진,13144,11279,20200121,24423
20200118,1,대방,11574,11575,20200121,23149
20200118,1,영등포,56731,59936,20200121,116667
20200118,경부선,신도림,3553,3903,20200121,7456
20200118,1,신길,7795,6385,20200121,14180
20200118,1,구로,16290,16902,20200121,33192
20200118,1,가산디지털단지,7814,10571,20200121,18385
20200118,1,금천구청,10326,10122,20200121,20448
20200118,1,석수,9150,7978,20200121,17128
20200118,1,관악,7351,6777,20200121,14128
20200118,1,안양,23739,24039,20200121,47778
20200118,1,명학,6308,5881,20200121,12189
20200118,4,금정,23162,23300,20200121,46462
20200118,1,군포,5243,4740,20200121,9983
20200118,1,의왕,7354,6942,20200121,14296
20200118,1,성균관대,13087,13077,20200121,26164
20200118,1,화서,6677,6398,20200121,13075
20200118,1,수원,47709,51389,20200121,99098
20200118,1,독산,11498,11260,20200121,22758
20200118,1,세류,3694,3603,20200121,7297
20200118,1,병점,15090,14580,20200121,29670
20200118,1,세마,2744,2317,20200121,5061
20200118,1,오산대,2805,2407,20200121,5212
20200118,1,오산,11234,10253,20200121,21487
20200118,1,진위,1222,990,20200121,2212
20200118,1,송탄,5203,4664,20200121,9867
20200118,1,서정리,6314,5238,20200121,11552
20200118,1,지제,2619,2169,20200121,4788
20200118,1,평택,15239,14573,20200121,29812
20200118,1,성환,3588,3208,20200121,6796
20200118,1,직산,910,816,20200121,1726
20200118,1,두정,5504,5523,20200121,11027
20200118,1,천안,7465,7489,20200121,14954
20200118,1,당정,5143,4808,20200121,9951
20200118,경부선,서동탄,1550,1598,20200121,3148
20200118,경부선,광명,3219,2439,20200121,5658
20200119,경부선,서울역,7359,1468,20200122,8827
20200119,1,남영,5911,6042,20200122,11953
20200119,1,용산,36074,34964,20200122,71038
20200119,1,노량진,8870,7587,20200122,16457
20200119,1,대방,8102,8433,20200122,16535
20200119,1,영등포,44677,43404,20200122,88081
20200119,경부선,신도림,2255,2652,20200122,4907
20200119,1,신길,5777,4722,20200122,10499
20200119,1,구로,12088,12134,20200122,24222
20200119,1,가산디지털단지,5511,7727,20200122,13238
20200119,1,금천구청,7306,7004,20200122,14310
20200119,1,석수,6328,5950,20200122,12278
20200119,1,관악,6025,5354,20200122,11379
20200119,1,안양,17127,16799,20200122,33926
20200119,1,명학,4133,3882,20200122,8015
20200119,4,금정,16797,17684,20200122,34481
20200119,1,군포,3635,3290,20200122,6925
20200119,1,의왕,4788,4901,20200122,9689
20200119,1,성균관대,9507,9738,20200122,19245
20200119,1,화서,4740,4781,20200122,9521
20200119,1,수원,39092,39499,20200122,78591
20200119,1,독산,7175,7383,20200122,14558
20200119,1,세류,2757,2735,20200122,5492
20200119,1,병점,10350,11618,20200122,21968
20200119,1,세마,2032,1901,20200122,3933
20200119,1,오산대,1953,1875,20200122,3828
20200119,1,오산,8434,9219,20200122,17653
20200119,1,진위,792,761,20200122,1553
20200119,1,송탄,4144,4412,20200122,8556
20200119,1,서정리,4017,5644,20200122,9661
20200119,1,지제,1895,1925,20200122,3820
20200119,1,평택,12691,13370,20200122,26061
20200119,1,성환,2734,3114,20200122,5848
20200119,1,직산,731,771,20200122,1502
20200119,1,두정,4589,5013,20200122,9602
20200119,1,천안,6542,6394,20200122,12936
20200119,1,당정,3589,3604,20200122,7193
20200119,경부선,서동탄,1083,1085,20200122,2168
20200119,경부선,광명,2524,1769,20200122,4293
20200120,경부선,광명,3433,2757,20200123,6190
20200120,경부선,서동탄,1874,1533,20200123,3407
20200120,1,당정,7255,6907,20200123,14162
20200120,1,천안,5629,5798,20200123,11427
20200120,1,두정,4849,4999,20200123,9848
20200120,1,직산,837,835,20200123,1672
20200120,1,성환,3421,3570,20200123,6991
20200120,1,평택,12655,12695,20200123,25350
20200120,1,지제,2625,2446,20200123,5071
20200120,1,서정리,5486,5580,20200123,11066
20200120,1,송탄,4506,4367,20200123,8873
20200120,1,진위,1627,1495,20200123,3122
20200120,1,오산,9985,10152,20200123,20137
20200120,1,오산대,3045,2635,20200123,5680
20200120,1,세마,2867,2461,20200123,5328
20200120,1,병점,15672,15796,20200123,31468
20200120,1,세류,3715,3432,20200123,7147
20200120,1,독산,19588,20056,20200123,39644
20200120,1,수원,40508,43653,20200123,84161
20200120,1,화서,8554,8211,20200123,16765
20200120,1,성균관대,16026,15717,20200123,31743
20200120,1,의왕,10299,9986,20200123,20285
20200120,1,군포,8259,8242,20200123,16501
20200120,4,금정,29850,31023,20200123,60873
20200120,1,명학,10733,10321,20200123,21054
20200120,1,안양,25888,26131,20200123,52019
20200120,1,관악,8521,7737,20200123,16258
20200120,1,석수,11857,10230,20200123,22087
20200120,1,금천구청,13875,13204,20200123,27079
20200120,1,가산디지털단지,21034,24461,20200123,45495
20200120,1,구로,21074,21362,20200123,42436
20200120,경부선,신도림,4405,4435,20200123,8840
20200120,1,영등포,48299,50208,20200123,98507
20200120,1,대방,15780,16121,20200123,31901
20200120,1,노량진,11622,11177,20200123,22799
20200120,1,용산,38804,41186,20200123,79990
20200120,1,남영,11411,12000,20200123,23411
20200120,경부선,서울역,6868,1737,20200123,8605
20200120,1,신길,10845,8976,20200123,19821
20200121,경부선,서울역,6628,1730,20200124,8358
20200121,1,남영,11458,11934,20200124,23392
20200121,1,용산,38918,41868,20200124,80786
20200121,1,노량진,11771,11371,20200124,23142
20200121,1,대방,16024,16289,20200124,32313
20200121,1,영등포,48023,50125,20200124,98148
20200121,경부선,신도림,4291,4315,20200124,8606
20200121,1,신길,10546,8886,20200124,19432
20200121,1,구로,20950,21494,20200124,42444
20200121,1,가산디지털단지,21147,24365,20200124,45512
20200121,1,금천구청,13389,12911,20200124,26300
20200121,1,석수,11999,10300,20200124,22299
20200121,1,관악,8707,7992,20200124,16699
20200121,1,안양,25665,26137,20200124,51802
20200121,1,명학,10216,9812,20200124,20028
20200121,4,금정,29632,30378,20200124,60010
20200121,1,군포,8295,8025,20200124,16320
20200121,1,의왕,10099,9813,20200124,19912
20200121,1,성균관대,16134,15679,20200124,31813
20200121,1,화서,8582,8304,20200124,16886
20200121,1,수원,40054,43167,20200124,83221
20200121,1,독산,19208,20207,20200124,39415
20200121,1,세류,3734,3422,20200124,7156
20200121,1,병점,15535,15440,20200124,30975
20200121,1,세마,2862,2533,20200124,5395
20200121,1,오산대,3026,2634,20200124,5660
20200121,1,오산,9861,9730,20200124,19591
20200121,1,진위,1574,1339,20200124,2913
20200121,1,송탄,4224,3919,20200124,8143
20200121,1,서정리,5360,5375,20200124,10735
20200121,1,지제,2428,2231,20200124,4659
20200121,1,평택,12175,11759,20200124,23934
20200121,1,성환,3448,3380,20200124,6828
20200121,1,직산,859,809,20200124,1668
20200121,1,두정,4926,4787,20200124,9713
20200121,1,천안,5475,5650,20200124,11125
20200121,1,당정,7660,7139,20200124,14799
20200121,경부선,서동탄,1869,1479,20200124,3348
20200121,경부선,광명,3254,2510,20200124,5764
20200122,경부선,서울역,5940,1852,20200125,7792
20200122,1,남영,11201,11764,20200125,22965
20200122,1,용산,39288,46189,20200125,85477
20200122,1,노량진,12357,11441,20200125,23798
20200122,1,대방,16077,16101,20200125,32178
20200122,1,영등포,49457,52723,20200125,102180
20200122,경부선,신도림,4425,4491,20200125,8916
20200122,1,신길,10818,8952,20200125,19770
20200122,1,구로,21574,21919,20200125,43493
20200122,1,가산디지털단지,21353,24584,20200125,45937
20200122,1,금천구청,13495,12963,20200125,26458
20200122,1,석수,11885,10295,20200125,22180
20200122,1,관악,8462,7528,20200125,15990
20200122,1,안양,25877,26218,20200125,52095
20200122,1,명학,10099,9720,20200125,19819
20200122,4,금정,29985,30831,20200125,60816
20200122,1,군포,8273,8020,20200125,16293
20200122,1,의왕,10280,9933,20200125,20213
20200122,1,성균관대,16210,15618,20200125,31828
20200122,1,화서,8779,8135,20200125,16914
20200122,1,수원,41207,45005,20200125,86212
20200122,1,독산,19302,19957,20200125,39259
20200122,1,세류,3559,3312,20200125,6871
20200122,1,병점,15970,15369,20200125,31339
20200122,1,세마,2935,2494,20200125,5429
20200122,1,오산대,3018,2546,20200125,5564
20200122,1,오산,10282,10091,20200125,20373
20200122,1,진위,1623,1400,20200125,3023
20200122,1,송탄,4438,4078,20200125,8516
20200122,1,서정리,5980,5525,20200125,11505
20200122,1,지제,2603,2272,20200125,4875
20200122,1,평택,12539,12166,20200125,24705
20200122,1,성환,3348,3275,20200125,6623
20200122,1,직산,799,758,20200125,1557
20200122,1,두정,4955,4942,20200125,9897
20200122,1,천안,5332,5575,20200125,10907
20200122,1,당정,7362,6891,20200125,14253
20200122,경부선,서동탄,1891,1468,20200125,3359
20200122,경부선,광명,3292,2818,20200125,6110
20200123,경부선,서울역,5854,1898,20200126,7752
20200123,1,남영,10719,10804,20200126,21523
20200123,1,용산,40657,51874,20200126,92531
20200123,1,노량진,12286,10959,20200126,23245
20200123,1,대방,14914,14209,20200126,29123
20200123,1,영등포,51904,55917,20200126,107821
20200123,경부선,신도림,4212,4187,20200126,8399
20200123,1,신길,10136,7868,20200126,18004
20200123,1,구로,20447,20790,20200126,41237
20200123,1,가산디지털단지,18658,21332,20200126,39990
20200123,1,금천구청,13046,12557,20200126,25603
20200123,1,석수,11136,9489,20200126,20625
20200123,1,관악,8025,7223,20200126,15248
20200123,1,안양,25213,26479,20200126,51692
20200123,1,명학,9328,8769,20200126,18097
20200123,4,금정,27849,28679,20200126,56528
20200123,1,군포,7799,7376,20200126,15175
20200123,1,의왕,10262,9203,20200126,19465
20200123,1,성균관대,16069,14818,20200126,30887
20200123,1,화서,8000,7558,20200126,15558
20200123,1,수원,44501,51882,20200126,96383
20200123,1,독산,18245,18430,20200126,36675
20200123,1,세류,4129,4085,20200126,8214
20200123,1,병점,16509,15558,20200126,32067
20200123,1,세마,2987,2575,20200126,5562
20200123,1,오산대,3260,2851,20200126,6111
20200123,1,오산,12068,11524,20200126,23592
20200123,1,진위,1783,1397,20200126,3180
20200123,1,송탄,5286,4629,20200126,9915
20200123,1,서정리,7031,5619,20200126,12650
20200123,1,지제,3339,2786,20200126,6125
20200123,1,평택,15323,15303,20200126,30626
20200123,1,성환,4351,3909,20200126,8260
20200123,1,직산,964,878,20200126,1842
20200123,1,두정,5629,5755,20200126,11384
20200123,1,천안,6460,8122,20200126,14582
20200123,1,당정,7001,6373,20200126,13374
20200123,경부선,서동탄,1788,1512,20200126,3300
20200123,경부선,광명,3387,3159,20200126,6546
20200124,경부선,광명,1759,1690,20200127,3449
20200124,경부선,서동탄,824,881,20200127,1705
20200124,1,당정,2578,2346,20200127,4924
20200124,1,천안,6710,9571,20200127,16281
20200124,1,두정,3905,4045,20200127,7950
20200124,1,직산,738,788,20200127,1526
20200124,1,성환,3264,3669,20200127,6933
20200124,1,평택,11883,13235,20200127,25118
20200124,1,지제,1551,1711,20200127,3262
20200124,1,서정리,4023,3884,20200127,7907
20200124,1,송탄,3639,3464,20200127,7103
20200124,1,진위,848,798,20200127,1646
20200124,1,오산,9053,8484,20200127,17537
20200124,1,오산대,1735,1530,20200127,3265
20200124,1,세마,1532,1298,20200127,2830
20200124,1,병점,8965,8612,20200127,17577
20200124,1,세류,2462,2695,20200127,5157
20200124,1,독산,6259,5510,20200127,11769
20200124,1,수원,33489,40680,20200127,74169
20200124,1,화서,3518,3546,20200127,7064
20200124,1,성균관대,7264,6514,20200127,13778
20200124,1,의왕,3717,3671,20200127,7388
20200124,1,군포,3266,2942,20200127,6208
20200124,4,금정,13059,12957,20200127,26016
20200124,1,명학,3114,2571,20200127,5685
20200124,1,안양,13182,13522,20200127,26704
20200124,1,관악,3547,3669,20200127,7216
20200124,1,석수,4631,4218,20200127,8849
20200124,1,금천구청,5955,5657,20200127,11612
20200124,1,가산디지털단지,5053,6025,20200127,11078
20200124,1,구로,9424,9276,20200127,18700
20200124,1,신길,4621,3342,20200127,7963
20200124,경부선,신도림,1803,1458,20200127,3261
20200124,1,영등포,29232,31913,20200127,61145
20200124,1,대방,5923,4787,20200127,10710
20200124,1,노량진,8363,6451,20200127,14814
20200124,1,용산,29996,42186,20200127,72182
20200124,1,남영,3869,3430,20200127,7299
20200124,경부선,서울역,4284,1264,20200127,5548
20200125,경부선,서울역,6400,1137,20200128,7537
20200125,1,남영,3208,3490,20200128,6698
20200125,1,용산,34288,33132,20200128,67420
20200125,1,노량진,6188,5682,20200128,11870
20200125,1,대방,5081,5151,20200128,10232
20200125,1,영등포,27581,27937,20200128,55518
20200125,경부선,신도림,1475,1508,20200128,2983
20200125,1,신길,4495,3600,20200128,8095
20200125,1,구로,9339,9808,20200128,19147
20200125,1,가산디지털단지,4339,5972,20200128,10311
20200125,1,금천구청,6022,6051,20200128,12073
20200125,1,석수,4821,4163,20200128,8984
20200125,1,관악,4007,3706,20200128,7713
20200125,1,안양,12175,12588,20200128,24763
20200125,1,명학,2877,2819,20200128,5696
20200125,4,금정,12396,12864,20200128,25260
20200125,1,군포,3162,2812,20200128,5974
20200125,1,의왕,3645,3651,20200128,7296
20200125,1,성균관대,6197,6269,20200128,12466
20200125,1,화서,3643,3745,20200128,7388
20200125,1,수원,35129,35800,20200128,70929
20200125,1,독산,5050,5391,20200128,10441
20200125,1,세류,2838,2477,20200128,5315
20200125,1,병점,8170,8261,20200128,16431
20200125,1,세마,1418,1287,20200128,2705
20200125,1,오산대,1637,1467,20200128,3104
20200125,1,오산,7976,8044,20200128,16020
20200125,1,진위,905,721,20200128,1626
20200125,1,송탄,3660,3382,20200128,7042
20200125,1,서정리,3684,3708,20200128,7392
20200125,1,지제,1516,1269,20200128,2785
20200125,1,평택,11665,10968,20200128,22633
20200125,1,성환,3535,3056,20200128,6591
20200125,1,직산,802,693,20200128,1495
20200125,1,두정,3468,3665,20200128,7133
20200125,1,천안,8515,7464,20200128,15979
20200125,1,당정,2461,2438,20200128,4899
20200125,경부선,서동탄,965,819,20200128,1784
20200125,경부선,광명,1967,1297,20200128,3264
20200126,경부선,서울역,7200,946,20200129,8146
20200126,1,남영,4247,4688,20200129,8935
20200126,1,용산,40377,31391,20200129,71768
20200126,1,노량진,7007,6735,20200129,13742
20200126,1,대방,5838,6506,20200129,12344
20200126,1,영등포,41177,40276,20200129,81453
20200126,경부선,신도림,1785,2123,20200129,3908
20200126,1,신길,4451,4113,20200129,8564
20200126,1,구로,9609,10497,20200129,20106
20200126,1,가산디지털단지,4842,7338,20200129,12180
20200126,1,금천구청,6589,6671,20200129,13260
20200126,1,석수,5465,5006,20200129,10471
20200126,1,관악,5097,4748,20200129,9845
20200126,1,안양,15472,15588,20200129,31060
20200126,1,명학,3441,3160,20200129,6601
20200126,4,금정,14632,15275,20200129,29907
20200126,1,군포,3376,3098,20200129,6474
20200126,1,의왕,4434,4239,20200129,8673
20200126,1,성균관대,7519,8385,20200129,15904
20200126,1,화서,4265,3922,20200129,8187
20200126,1,수원,43113,41154,20200129,84267
20200126,1,독산,5556,6016,20200129,11572
20200126,1,세류,2870,2593,20200129,5463
20200126,1,병점,9119,9744,20200129,18863
20200126,1,세마,1696,1517,20200129,3213
20200126,1,오산대,1916,1757,20200129,3673
20200126,1,오산,8837,8876,20200129,17713
20200126,1,진위,902,717,20200129,1619
20200126,1,송탄,3767,3574,20200129,7341
20200126,1,서정리,3746,4122,20200129,7868
20200126,1,지제,1663,1325,20200129,2988
20200126,1,평택,12761,12515,20200129,25276
20200126,1,성환,3066,3105,20200129,6171
20200126,1,직산,699,641,20200129,1340
20200126,1,두정,3633,3933,20200129,7566
20200126,1,천안,7716,6338,20200129,14054
20200126,1,당정,2997,2887,20200129,5884
20200126,경부선,서동탄,1107,995,20200129,2102
20200126,경부선,광명,2583,1347,20200129,3930
20200127,경부선,서울역,8580,1153,20200130,9733
20200127,1,남영,4049,4668,20200130,8717
20200127,1,용산,41092,30589,20200130,71681
20200127,1,노량진,7219,6919,20200130,14138
20200127,1,대방,6061,6808,20200130,12869
20200127,1,영등포,42789,41136,20200130,83925
20200127,경부선,신도림,1736,2164,20200130,3900
20200127,1,신길,4543,4154,20200130,8697
20200127,1,구로,9603,10072,20200130,19675
20200127,1,가산디지털단지,4834,6733,20200130,11567
20200127,1,금천구청,6513,6422,20200130,12935
20200127,1,석수,5723,5267,20200130,10990
20200127,1,관악,5231,5004,20200130,10235
20200127,1,안양,16419,15942,20200130,32361
20200127,1,명학,3549,3497,20200130,7046
20200127,4,금정,13940,14758,20200130,28698
20200127,1,군포,3468,3127,20200130,6595
20200127,1,의왕,4490,4443,20200130,8933
20200127,1,성균관대,8075,9147,20200130,17222
20200127,1,화서,4018,3856,20200130,7874
20200127,1,수원,40806,38201,20200130,79007
20200127,1,독산,6220,6681,20200130,12901
20200127,1,세류,2708,2527,20200130,5235
20200127,1,병점,9339,10795,20200130,20134
20200127,1,세마,1888,1652,20200130,3540
20200127,1,오산대,1858,1738,20200130,3596
20200127,1,오산,8581,9040,20200130,17621
20200127,1,진위,797,732,20200130,1529
20200127,1,송탄,3468,4020,20200130,7488
20200127,1,서정리,3572,5417,20200130,8989
20200127,1,지제,1931,1853,20200130,3784
20200127,1,평택,12179,12711,20200130,24890
20200127,1,성환,2672,3183,20200130,5855
20200127,1,직산,637,644,20200130,1281
20200127,1,두정,3622,4011,20200130,7633
20200127,1,천안,6945,6047,20200130,12992
20200127,1,당정,3148,3198,20200130,6346
20200127,경부선,서동탄,1077,977,20200130,2054
20200127,경부선,광명,2935,1434,20200130,4369
20200128,경부선,서울역,8072,1456,20200131,9528
20200128,1,남영,9898,10617,20200131,20515
20200128,1,용산,40459,36358,20200131,76817
20200128,1,노량진,9947,9812,20200131,19759
20200128,1,대방,14036,14470,20200131,28506
20200128,1,영등포,44961,45751,20200131,90712
20200128,경부선,신도림,4108,4173,20200131,8281
20200128,1,신길,9547,8240,20200131,17787
20200128,1,구로,18906,19056,20200131,37962
20200128,1,가산디지털단지,19081,21549,20200131,40630
20200128,1,금천구청,12290,11849,20200131,24139
20200128,1,석수,10642,9305,20200131,19947
20200128,1,관악,7696,7098,20200131,14794
20200128,1,안양,23350,23299,20200131,46649
20200128,1,명학,9333,9138,20200131,18471
20200128,4,금정,26580,27266,20200131,53846
20200128,1,군포,7488,7470,20200131,14958
20200128,1,의왕,8996,8948,20200131,17944
20200128,1,성균관대,13967,14348,20200131,28315
20200128,1,화서,7595,7323,20200131,14918
20200128,1,수원,38732,39345,20200131,78077
20200128,1,독산,16789,17744,20200131,34533
20200128,1,세류,3490,3162,20200131,6652
20200128,1,병점,13786,14145,20200131,27931
20200128,1,세마,2544,2355,20200131,4899
20200128,1,오산대,2676,2356,20200131,5032
20200128,1,오산,9411,9700,20200131,19111
20200128,1,진위,1410,1225,20200131,2635
20200128,1,송탄,3710,3765,20200131,7475
20200128,1,서정리,4391,4961,20200131,9352
20200128,1,지제,2327,2080,20200131,4407
20200128,1,평택,11174,10881,20200131,22055
20200128,1,성환,3051,3202,20200131,6253
20200128,1,직산,768,749,20200131,1517
20200128,1,두정,4160,4535,20200131,8695
20200128,1,천안,5464,5383,20200131,10847
20200128,1,당정,6449,6199,20200131,12648
20200128,경부선,서동탄,1657,1362,20200131,3019
20200128,경부선,광명,3361,2361,20200131,5722
20200129,경부선,서울역,6651,1504,20200201,8155
20200129,1,남영,10528,11318,20200201,21846
20200129,1,용산,37062,36609,20200201,73671
20200129,1,노량진,10715,10284,20200201,20999
20200129,1,대방,15055,15304,20200201,30359
20200129,1,영등포,44663,45732,20200201,90395
20200129,경부선,신도림,4301,4338,20200201,8639
20200129,1,신길,10136,8583,20200201,18719
20200129,1,구로,19785,20109,20200201,39894
20200129,1,가산디지털단지,20613,23398,20200201,44011
20200129,1,금천구청,12916,12486,20200201,25402
20200129,1,석수,11198,9718,20200201,20916
20200129,1,관악,8002,7565,20200201,15567
20200129,1,안양,23948,24019,20200201,47967
20200129,1,명학,9825,9558,20200201,19383
20200129,4,금정,27940,28698,20200201,56638
20200129,1,군포,8066,7774,20200201,15840
20200129,1,의왕,9841,9677,20200201,19518
20200129,1,성균관대,14775,14802,20200201,29577
20200129,1,화서,8033,7811,20200201,15844
20200129,1,수원,36917,38800,20200201,75717
20200129,1,독산,18051,18912,20200201,36963
20200129,1,세류,3370,3203,20200201,6573
20200129,1,병점,14273,14425,20200201,28698
20200129,1,세마,2700,2409,20200201,5109
20200129,1,오산대,2798,2460,20200201,5258
20200129,1,오산,9281,8966,20200201,18247
20200129,1,진위,1445,1258,20200201,2703
20200129,1,송탄,3684,3701,20200201,7385
20200129,1,서정리,4643,4580,20200201,9223
20200129,1,지제,2291,2025,20200201,4316
20200129,1,평택,10448,10042,20200201,20490
20200129,1,성환,2908,2979,20200201,5887
20200129,1,직산,774,737,20200201,1511
20200129,1,두정,4298,4456,20200201,8754
20200129,1,천안,4922,5053,20200201,9975
20200129,1,당정,6941,6553,20200201,13494
20200129,경부선,서동탄,1770,1393,20200201,3163
20200129,경부선,광명,3255,2451,20200201,5706
20200130,경부선,광명,3109,2425,20200202,5534
20200130,경부선,서동탄,1732,1448,20200202,3180
20200130,1,당정,6839,6498,20200202,13337
20200130,1,천안,4677,4815,20200202,9492
20200130,1,두정,4232,4297,20200202,8529
20200130,1,직산,715,705,20200202,1420
20200130,1,성환,2820,2837,20200202,5657
20200130,1,평택,10160,9902,20200202,20062
20200130,1,지제,2212,1925,20200202,4137
20200130,1,서정리,4572,4540,20200202,9112
20200130,1,송탄,3687,3565,20200202,7252
20200130,1,진위,1463,1255,20200202,2718
20200130,1,오산,8907,8903,20200202,17810
20200130,1,오산대,2796,2543,20200202,5339
20200130,1,세마,2561,2394,20200202,4955
20200130,1,병점,14239,14034,20200202,28273
20200130,1,세류,3624,3277,20200202,6901
20200130,1,독산,17979,18840,20200202,36819
20200130,1,수원,36581,38262,20200202,74843
20200130,1,화서,8126,7976,20200202,16102
20200130,1,성균관대,14756,14741,20200202,29497
20200130,1,의왕,9784,9533,20200202,19317
20200130,1,군포,7852,7911,20200202,15763
20200130,4,금정,28044,28702,20200202,56746
20200130,1,명학,9883,9783,20200202,19666
20200130,1,안양,24214,24052,20200202,48266
20200130,1,관악,8214,7590,20200202,15804
20200130,1,석수,11405,9892,20200202,21297
20200130,1,금천구청,12988,12498,20200202,25486
20200130,1,가산디지털단지,20645,23555,20200202,44200
20200130,1,구로,19815,20640,20200202,40455
20200130,1,신길,10221,8610,20200202,18831
20200130,경부선,신도림,4345,4401,20200202,8746
20200130,1,영등포,44327,45507,20200202,89834
20200130,1,대방,15475,15784,20200202,31259
20200130,1,노량진,10868,10442,20200202,21310
20200130,1,용산,36680,36814,20200202,73494
20200130,1,남영,10598,11209,20200202,21807
20200130,경부선,서울역,6215,1400,20200202,7615
20200131,경부선,서울역,7635,1785,20200203,9420
20200131,1,남영,10778,11369,20200203,22147
20200131,1,용산,40481,40637,20200203,81118
20200131,1,노량진,11173,10647,20200203,21820
20200131,1,대방,15086,15120,20200203,30206
20200131,1,영등포,47222,50180,20200203,97402
20200131,경부선,신도림,4346,4372,20200203,8718
20200131,1,신길,10124,8527,20200203,18651
20200131,1,구로,19642,20176,20200203,39818
20200131,1,가산디지털단지,20553,23479,20200203,44032
20200131,1,금천구청,13007,12641,20200203,25648
20200131,1,석수,11493,9631,20200203,21124
20200131,1,관악,8123,7336,20200203,15459
20200131,1,안양,24529,24890,20200203,49419
20200131,1,명학,9775,9449,20200203,19224
20200131,4,금정,28857,29232,20200203,58089
20200131,1,군포,8042,7818,20200203,15860
20200131,1,의왕,9911,9644,20200203,19555
20200131,1,성균관대,15529,14899,20200203,30428
20200131,1,화서,8166,7700,20200203,15866
20200131,1,수원,39017,41891,20200203,80908
20200131,1,독산,17988,18733,20200203,36721
20200131,1,세류,3655,3268,20200203,6923
20200131,1,병점,15524,14792,20200203,30316
20200131,1,세마,2729,2345,20200203,5074
20200131,1,오산대,2874,2406,20200203,5280
20200131,1,오산,9812,9246,20200203,19058
20200131,1,진위,1658,1307,20200203,2965
20200131,1,송탄,4141,3786,20200203,7927
20200131,1,서정리,5238,4712,20200203,9950
20200131,1,지제,2681,2345,20200203,5026
20200131,1,평택,11815,10935,20200203,22750
20200131,1,성환,3300,3085,20200203,6385
20200131,1,직산,840,747,20200203,1587
20200131,1,두정,5052,4912,20200203,9964
20200131,1,천안,5172,5244,20200203,10416
20200131,1,당정,7004,6579,20200203,13583
20200131,경부선,서동탄,1758,1393,20200203,3151
20200131,경부선,광명,3516,2758,20200203,6274
20200201,경부선,서울역,5226,1123,20200204,6349
20200201,1,남영,6086,6100,20200204,12186
20200201,1,용산,30404,31577,20200204,61981
20200201,1,노량진,9841,8335,20200204,18176
20200201,1,대방,8711,8596,20200204,17307
20200201,1,영등포,41161,43327,20200204,84488
20200201,경부선,신도림,2718,2988,20200204,5706
20200201,1,신길,6201,5001,20200204,11202
20200201,1,구로,12288,12723,20200204,25011
20200201,1,가산디지털단지,5927,7739,20200204,13666
20200201,1,금천구청,7988,7986,20200204,15974
20200201,1,석수,6901,6434,20200204,13335
20200201,1,관악,5636,5373,20200204,11009
20200201,1,안양,18725,18494,20200204,37219
20200201,1,명학,5220,4953,20200204,10173
20200201,4,금정,18204,18679,20200204,36883
20200201,1,군포,4302,3831,20200204,8133
20200201,1,의왕,5613,5427,20200204,11040
20200201,1,성균관대,9766,9737,20200204,19503
20200201,1,화서,4926,4841,20200204,9767
20200201,1,수원,33575,36459,20200204,70034
20200201,1,독산,8707,8437,20200204,17144
20200201,1,세류,2681,2718,20200204,5399
20200201,1,병점,10657,10302,20200204,20959
20200201,1,세마,1890,1628,20200204,3518
20200201,1,오산대,1977,1684,20200204,3661
20200201,1,오산,7903,7437,20200204,15340
20200201,1,진위,894,772,20200204,1666
20200201,1,송탄,3852,3395,20200204,7247
20200201,1,서정리,4804,3828,20200204,8632
20200201,1,지제,1975,1596,20200204,3571
20200201,1,평택,10060,9680,20200204,19740
20200201,1,성환,2678,2345,20200204,5023
20200201,1,직산,593,528,20200204,1121
20200201,1,두정,4162,4332,20200204,8494
20200201,1,천안,5045,5043,20200204,10088
20200201,1,당정,4019,3835,20200204,7854
20200201,경부선,서동탄,1039,1073,20200204,2112
20200201,경부선,광명,2109,1660,20200204,3769
20200202,경부선,서울역,4997,925,20200205,5922
20200202,1,남영,4612,4842,20200205,9454
20200202,1,용산,25427,24279,20200205,49706
20200202,1,노량진,6455,5679,20200205,12134
20200202,1,대방,6315,6613,20200205,12928
20200202,1,영등포,31629,30862,20200205,62491
20200202,경부선,신도림,1941,2064,20200205,4005
20200202,1,신길,4572,3869,20200205,8441
20200202,1,구로,8640,8782,20200205,17422
20200202,1,가산디지털단지,4069,5407,20200205,9476
20200202,1,금천구청,5633,5516,20200205,11149
20200202,1,석수,5230,4953,20200205,10183
20200202,1,관악,4743,4375,20200205,9118
20200202,1,안양,13401,13129,20200205,26530
20200202,1,명학,3354,3250,20200205,6604
20200202,4,금정,13027,13685,20200205,26712
20200202,1,군포,2894,2668,20200205,5562
20200202,1,의왕,3894,3940,20200205,7834
20200202,1,성균관대,6824,7304,20200205,14128
20200202,1,화서,3514,3467,20200205,6981
20200202,1,수원,27615,27216,20200205,54831
20200202,1,독산,5249,5442,20200205,10691
20200202,1,세류,1886,1994,20200205,3880
20200202,1,병점,7813,8820,20200205,16633
20200202,1,세마,1397,1262,20200205,2659
20200202,1,오산대,1448,1387,20200205,2835
20200202,1,오산,6325,6905,20200205,13230
20200202,1,진위,624,622,20200205,1246
20200202,1,송탄,2893,3290,20200205,6183
20200202,1,서정리,2902,4295,20200205,7197
20200202,1,지제,1446,1403,20200205,2849
20200202,1,평택,8623,9281,20200205,17904
20200202,1,성환,2027,2427,20200205,4454
20200202,1,직산,501,561,20200205,1062
20200202,1,두정,3505,3821,20200205,7326
20200202,1,천안,4567,4503,20200205,9070
20200202,1,당정,2791,2710,20200205,5501
20200202,경부선,서동탄,737,737,20200205,1474
20200202,경부선,광명,1911,1271,20200205,3182
20200203,경부선,서울역,5014,1497,20200206,6511
20200203,1,남영,10491,11062,20200206,21553
20200203,1,용산,32360,34130,20200206,66490
20200203,1,노량진,9658,9646,20200206,19304
20200203,1,대방,14323,14597,20200206,28920
20200203,1,영등포,39209,40766,20200206,79975
20200203,경부선,신도림,3990,3939,20200206,7929
20200203,1,신길,9730,8140,20200206,17870
20200203,1,구로,18590,18587,20200206,37177
20200203,1,가산디지털단지,19884,22679,20200206,42563
20200203,1,금천구청,11983,11635,20200206,23618
20200203,1,석수,10461,9156,20200206,19617
20200203,1,관악,7488,6846,20200206,14334
20200203,1,안양,21803,21658,20200206,43461
20200203,1,명학,9218,8984,20200206,18202
20200203,4,금정,25783,26713,20200206,52496
20200203,1,군포,7328,7477,20200206,14805
20200203,1,의왕,8909,8781,20200206,17690
20200203,1,성균관대,13036,12783,20200206,25819
20200203,1,화서,7153,6926,20200206,14079
20200203,1,수원,30103,32035,20200206,62138
20200203,1,독산,17518,18375,20200206,35893
20200203,1,세류,3139,2836,20200206,5975
20200203,1,병점,12828,12746,20200206,25574
20200203,1,세마,2319,2060,20200206,4379
20200203,1,오산대,2523,2252,20200206,4775
20200203,1,오산,8447,8478,20200206,16925
20200203,1,진위,1385,1251,20200206,2636
20200203,1,송탄,3691,3621,20200206,7312
20200203,1,서정리,4523,4537,20200206,9060
20200203,1,지제,2271,2033,20200206,4304
20200203,1,평택,9911,10242,20200206,20153
20200203,1,성환,2855,2980,20200206,5835
20200203,1,직산,676,707,20200206,1383
20200203,1,두정,3999,4164,20200206,8163
20200203,1,천안,4320,4439,20200206,8759
20200203,1,당정,6170,5852,20200206,12022
20200203,경부선,서동탄,1559,1200,20200206,2759
20200203,경부선,광명,3009,2429,20200206,5438
20200204,경부선,서울역,4564,1305,20200207,5869
20200204,1,남영,10590,11161,20200207,21751
20200204,1,용산,31600,32327,20200207,63927
20200204,1,노량진,9739,9562,20200207,19301
20200204,1,대방,14282,14704,20200207,28986
20200204,1,영등포,39210,40519,20200207,79729
20200204,경부선,신도림,3926,3922,20200207,7848
20200204,1,신길,9573,8177,20200207,17750
20200204,1,구로,18769,18845,20200207,37614
20200204,1,가산디지털단지,19463,22435,20200207,41898
20200204,1,금천구청,11881,11521,20200207,23402
20200204,1,석수,10475,9272,20200207,19747
20200204,1,관악,7586,6986,20200207,14572
20200204,1,안양,21549,21618,20200207,43167
20200204,1,명학,9261,9033,20200207,18294
20200204,4,금정,25883,26655,20200207,52538
20200204,1,군포,7469,7447,20200207,14916
20200204,1,의왕,8866,8719,20200207,17585
20200204,1,성균관대,12971,12865,20200207,25836
20200204,1,화서,7036,6906,20200207,13942
20200204,1,수원,30230,32188,20200207,62418
20200204,1,독산,17473,18551,20200207,36024
20200204,1,세류,3136,2914,20200207,6050
20200204,1,병점,12721,12671,20200207,25392
20200204,1,세마,2330,2103,20200207,4433
20200204,1,오산대,2484,2240,20200207,4724
20200204,1,오산,8146,8043,20200207,16189
20200204,1,진위,1300,1170,20200207,2470
20200204,1,송탄,3396,3258,20200207,6654
20200204,1,서정리,4512,4494,20200207,9006
20200204,1,지제,2092,1864,20200207,3956
20200204,1,평택,9505,9252,20200207,18757
20200204,1,성환,2721,2724,20200207,5445
20200204,1,직산,687,674,20200207,1361
20200204,1,두정,3961,3917,20200207,7878
20200204,1,천안,4187,4326,20200207,8513
20200204,1,당정,6224,5845,20200207,12069
20200204,경부선,서동탄,1563,1206,20200207,2769
20200204,경부선,광명,2912,2393,20200207,5305
20200205,경부선,서울역,4664,1341,20200208,6005
20200205,1,남영,10182,10683,20200208,20865
20200205,1,용산,31184,32290,20200208,63474
20200205,1,노량진,9542,9341,20200208,18883
20200205,1,대방,14011,14379,20200208,28390
20200205,1,영등포,38090,39511,20200208,77601
20200205,경부선,신도림,3769,3679,20200208,7448
20200205,1,신길,9237,7774,20200208,17011
20200205,1,구로,17769,18140,20200208,35909
20200205,1,가산디지털단지,18943,21875,20200208,40818
20200205,1,금천구청,11379,11005,20200208,22384
20200205,1,석수,10091,8881,20200208,18972
20200205,1,관악,7061,6511,20200208,13572
20200205,1,안양,21153,21136,20200208,42289
20200205,1,명학,8999,8969,20200208,17968
20200205,4,금정,25465,25872,20200208,51337
20200205,1,군포,7200,7198,20200208,14398
20200205,1,의왕,8733,8604,20200208,17337
20200205,1,성균관대,12896,12608,20200208,25504
20200205,1,화서,6891,6607,20200208,13498
20200205,1,수원,29875,31720,20200208,61595
20200205,1,독산,17056,17965,20200208,35021
20200205,1,세류,2930,2720,20200208,5650
20200205,1,병점,12461,12337,20200208,24798
20200205,1,세마,2117,1971,20200208,4088
20200205,1,오산대,2403,2135,20200208,4538
20200205,1,오산,7957,7966,20200208,15923
20200205,1,진위,1310,1141,20200208,2451
20200205,1,송탄,3367,3223,20200208,6590
20200205,1,서정리,4506,4309,20200208,8815
20200205,1,지제,1985,1875,20200208,3860
20200205,1,평택,9221,8998,20200208,18219
20200205,1,성환,2618,2699,20200208,5317
20200205,1,직산,684,639,20200208,1323
20200205,1,두정,3862,3915,20200208,7777
20200205,1,천안,3793,3914,20200208,7707
20200205,1,당정,5983,5749,20200208,11732
20200205,경부선,서동탄,1578,1198,20200208,2776
20200205,경부선,광명,2784,2229,20200208,5013
20200206,경부선,서울역,4586,1278,20200209,5864
20200206,1,남영,10175,10705,20200209,20880
20200206,1,용산,32013,32582,20200209,64595
20200206,1,노량진,9827,9530,20200209,19357
20200206,1,대방,13754,14274,20200209,28028
20200206,1,영등포,37663,39239,20200209,76902
20200206,경부선,신도림,3703,3593,20200209,7296
20200206,1,신길,9265,7709,20200209,16974
20200206,1,구로,17638,17886,20200209,35524
20200206,1,가산디지털단지,19129,21584,20200209,40713
20200206,1,금천구청,11312,11033,20200209,22345
20200206,1,석수,10229,8839,20200209,19068
20200206,1,관악,6948,6546,20200209,13494
20200206,1,안양,21201,20949,20200209,42150
20200206,1,명학,9017,8771,20200209,17788
20200206,4,금정,25029,25507,20200209,50536
20200206,1,군포,7204,7068,20200209,14272
20200206,1,의왕,8558,8469,20200209,17027
20200206,1,성균관대,12809,12501,20200209,25310
20200206,1,화서,6933,6660,20200209,13593
20200206,1,수원,29679,31710,20200209,61389
20200206,1,독산,16974,17653,20200209,34627
20200206,1,세류,2908,2739,20200209,5647
20200206,1,병점,12519,12447,20200209,24966
20200206,1,세마,2231,2037,20200209,4268
20200206,1,오산대,2469,2119,20200209,4588
20200206,1,오산,7896,7824,20200209,15720
20200206,1,진위,1364,1174,20200209,2538
20200206,1,송탄,3307,3250,20200209,6557
20200206,1,서정리,4268,4228,20200209,8496
20200206,1,지제,2047,1846,20200209,3893
20200206,1,평택,9211,8951,20200209,18162
20200206,1,성환,2923,2899,20200209,5822
20200206,1,직산,602,631,20200209,1233
20200206,1,두정,3931,3956,20200209,7887
20200206,1,천안,3850,3996,20200209,7846
20200206,1,당정,6068,5888,20200209,11956
20200206,경부선,서동탄,1468,1183,20200209,2651
20200206,경부선,광명,2786,2335,20200209,5121
20200207,경부선,서울역,6577,1726,20200210,8303
20200207,1,남영,10582,10991,20200210,21573
20200207,1,용산,36448,36832,20200210,73280
20200207,1,노량진,10442,10211,20200210,20653
20200207,1,대방,14310,14447,20200210,28757
20200207,1,영등포,42494,45599,20200210,88093
20200207,경부선,신도림,3940,3853,20200210,7793
20200207,1,신길,9750,7940,20200210,17690
20200207,1,구로,18340,18935,20200210,37275
20200207,1,가산디지털단지,19833,22320,20200210,42153
20200207,1,금천구청,11998,11635,20200210,23633
20200207,1,석수,10754,9183,20200210,19937
20200207,1,관악,7506,6826,20200210,14332
20200207,1,안양,22663,22660,20200210,45323
20200207,1,명학,9124,8783,20200210,17907
20200207,4,금정,26971,27157,20200210,54128
20200207,1,군포,7473,7374,20200210,14847
20200207,1,의왕,9118,8858,20200210,17976
20200207,1,성균관대,13637,13252,20200210,26889
20200207,1,화서,7303,6943,20200210,14246
20200207,1,수원,33600,36467,20200210,70067
20200207,1,독산,17737,18194,20200210,35931
20200207,1,세류,3323,2992,20200210,6315
20200207,1,병점,14146,13434,20200210,27580
20200207,1,세마,2371,2110,20200210,4481
20200207,1,오산대,2762,2343,20200210,5105
20200207,1,오산,9404,9072,20200210,18476
20200207,1,진위,1622,1254,20200210,2876
20200207,1,송탄,4066,3736,20200210,7802
20200207,1,서정리,5416,4878,20200210,10294
20200207,1,지제,2550,2260,20200210,4810
20200207,1,평택,11166,10481,20200210,21647
20200207,1,성환,3273,2945,20200210,6218
20200207,1,직산,795,709,20200210,1504
20200207,1,두정,4951,4714,20200210,9665
20200207,1,천안,4745,4812,20200210,9557
20200207,1,당정,6384,5831,20200210,12215
20200207,경부선,서동탄,1622,1219,20200210,2841
20200207,경부선,광명,3362,2744,20200210,6106
20200208,경부선,서울역,4560,1062,20200211,5622
20200208,1,남영,5740,5836,20200211,11576
20200208,1,용산,28504,30092,20200211,58596
20200208,1,노량진,9327,7917,20200211,17244
20200208,1,대방,8321,8246,20200211,16567
20200208,1,영등포,38358,40304,20200211,78662
20200208,경부선,신도림,2503,2763,20200211,5266
20200208,1,신길,5814,4751,20200211,10565
20200208,1,구로,11498,12045,20200211,23543
20200208,1,가산디지털단지,5543,7353,20200211,12896
20200208,1,금천구청,7580,7437,20200211,15017
20200208,1,석수,6900,6161,20200211,13061
20200208,1,관악,5417,5181,20200211,10598
20200208,1,안양,17439,17420,20200211,34859
20200208,1,명학,5103,4852,20200211,9955
20200208,4,금정,17192,17449,20200211,34641
20200208,1,군포,4123,3709,20200211,7832
20200208,1,의왕,5284,5065,20200211,10349
20200208,1,성균관대,9150,9162,20200211,18312
20200208,1,화서,4569,4443,20200211,9012
20200208,1,수원,30584,33131,20200211,63715
20200208,1,독산,8146,7917,20200211,16063
20200208,1,세류,2439,2312,20200211,4751
20200208,1,병점,10370,10162,20200211,20532
20200208,1,세마,1710,1488,20200211,3198
20200208,1,오산대,1974,1715,20200211,3689
20200208,1,오산,8150,7654,20200211,15804
20200208,1,진위,917,762,20200211,1679
20200208,1,송탄,4009,3565,20200211,7574
20200208,1,서정리,4981,3934,20200211,8915
20200208,1,지제,1951,1699,20200211,3650
20200208,1,평택,10392,9740,20200211,20132
20200208,1,성환,2424,2289,20200211,4713
20200208,1,직산,606,543,20200211,1149
20200208,1,두정,4155,4312,20200211,8467
20200208,1,천안,4803,4921,20200211,9724
20200208,1,당정,3740,3576,20200211,7316
20200208,경부선,서동탄,957,942,20200211,1899
20200208,경부선,광명,2031,1686,20200211,3717
20200209,경부선,서울역,4797,1008,20200212,5805
20200209,1,남영,4666,4831,20200212,9497
20200209,1,용산,25652,23678,20200212,49330
20200209,1,노량진,6427,5676,20200212,12103
20200209,1,대방,6037,6243,20200212,12280
20200209,1,영등포,31599,30748,20200212,62347
20200209,경부선,신도림,1859,1884,20200212,3743
20200209,1,신길,4531,3805,20200212,8336
20200209,1,구로,8088,8158,20200212,16246
20200209,1,가산디지털단지,3978,5314,20200212,9292
20200209,1,금천구청,5400,5194,20200212,10594
20200209,1,석수,4976,4737,20200212,9713
20200209,1,관악,4353,4026,20200212,8379
20200209,1,안양,13394,12649,20200212,26043
20200209,1,명학,3155,3090,20200212,6245
20200209,4,금정,12779,13544,20200212,26323
20200209,1,군포,2755,2594,20200212,5349
20200209,1,의왕,3772,3874,20200212,7646
20200209,1,성균관대,7034,7335,20200212,14369
20200209,1,화서,3493,3376,20200212,6869
20200209,1,수원,26911,26785,20200212,53696
20200209,1,독산,5258,5287,20200212,10545
20200209,1,세류,1997,2001,20200212,3998
20200209,1,병점,7388,8615,20200212,16003
20200209,1,세마,1366,1275,20200212,2641
20200209,1,오산대,1474,1398,20200212,2872
20200209,1,오산,6224,6710,20200212,12934
20200209,1,진위,563,591,20200212,1154
20200209,1,송탄,2903,3288,20200212,6191
20200209,1,서정리,3096,4706,20200212,7802
20200209,1,지제,1617,1383,20200212,3000
20200209,1,평택,8970,9712,20200212,18682
20200209,1,성환,2030,2422,20200212,4452
20200209,1,직산,527,573,20200212,1100
20200209,1,두정,3509,3858,20200212,7367
20200209,1,천안,4497,4466,20200212,8963
20200209,1,당정,2720,2650,20200212,5370
20200209,경부선,서동탄,757,756,20200212,1513
20200209,경부선,광명,1930,1302,20200212,3232
20200210,경부선,서울역,4960,1343,20200213,6303
20200210,1,남영,10187,10810,20200213,20997
20200210,1,용산,31895,33471,20200213,65366
20200210,1,노량진,10153,9833,20200213,19986
20200210,1,대방,14322,14391,20200213,28713
20200210,1,영등포,37339,39078,20200213,76417
20200210,경부선,신도림,4044,4033,20200213,8077
20200210,1,신길,9743,8088,20200213,17831
20200210,1,구로,18622,18657,20200213,37279
20200210,1,가산디지털단지,20489,22745,20200213,43234
20200210,1,금천구청,12142,11772,20200213,23914
20200210,1,석수,10677,9313,20200213,19990
20200210,1,관악,7573,6931,20200213,14504
20200210,1,안양,22650,22228,20200213,44878
20200210,1,명학,9244,9063,20200213,18307
20200210,4,금정,26435,27116,20200213,53551
20200210,1,군포,7418,7603,20200213,15021
20200210,1,의왕,9246,9052,20200213,18298
20200210,1,성균관대,13747,13609,20200213,27356
20200210,1,화서,7407,7061,20200213,14468
20200210,1,수원,32206,34609,20200213,66815
20200210,1,독산,17556,18373,20200213,35929
20200210,1,세류,3240,2970,20200213,6210
20200210,1,병점,13337,13400,20200213,26737
20200210,1,세마,2376,2120,20200213,4496
20200210,1,오산대,2592,2322,20200213,4914
20200210,1,오산,8844,8811,20200213,17655
20200210,1,진위,1465,1310,20200213,2775
20200210,1,송탄,3919,3650,20200213,7569
20200210,1,서정리,4690,4798,20200213,9488
20200210,1,지제,2319,2074,20200213,4393
20200210,1,평택,10371,9562,20200213,19933
20200210,1,성환,2929,3186,20200213,6115
20200210,1,직산,717,690,20200213,1407
20200210,1,두정,4103,4224,20200213,8327
20200210,1,천안,4599,4584,20200213,9183
20200210,1,당정,6301,6071,20200213,12372
20200210,경부선,서동탄,1695,1271,20200213,2966
20200210,경부선,광명,3048,2482,20200213,5530
20200211,경부선,서울역,4579,1278,20200214,5857
20200211,1,남영,10326,10891,20200214,21217
20200211,1,용산,32457,33382,20200214,65839
20200211,1,노량진,10267,10169,20200214,20436
20200211,1,대방,14295,14820,20200214,29115
20200211,1,영등포,41170,42707,20200214,83877
20200211,경부선,신도림,4133,4021,20200214,8154
20200211,1,신길,9684,8202,20200214,17886
20200211,1,구로,18944,19489,20200214,38433
20200211,1,가산디지털단지,20819,23009,20200214,43828
20200211,1,금천구청,12270,11931,20200214,24201
20200211,1,석수,10962,9618,20200214,20580
20200211,1,관악,7823,7161,20200214,14984
20200211,1,안양,23466,23195,20200214,46661
20200211,1,명학,9348,9146,20200214,18494
20200211,4,금정,27097,27389,20200214,54486
20200211,1,군포,7732,7595,20200214,15327
20200211,1,의왕,9393,9167,20200214,18560
20200211,1,성균관대,13915,13729,20200214,27644
20200211,1,화서,7618,7323,20200214,14941
20200211,1,수원,33588,35624,20200214,69212
20200211,1,독산,17876,18777,20200214,36653
20200211,1,세류,3212,3036,20200214,6248
20200211,1,병점,13556,13471,20200214,27027
20200211,1,세마,2452,2165,20200214,4617
20200211,1,오산대,2660,2383,20200214,5043
20200211,1,오산,8886,8797,20200214,17683
20200211,1,진위,1438,1256,20200214,2694
20200211,1,송탄,3714,3592,20200214,7306
20200211,1,서정리,4818,4736,20200214,9554
20200211,1,지제,2276,1971,20200214,4247
20200211,1,평택,10366,9483,20200214,19849
20200211,1,성환,3015,3062,20200214,6077
20200211,1,직산,736,716,20200214,1452
20200211,1,두정,4237,4197,20200214,8434
20200211,1,천안,4489,4677,20200214,9166
20200211,1,당정,6702,6308,20200214,13010
20200211,경부선,서동탄,1674,1347,20200214,3021
20200211,경부선,광명,3028,2525,20200214,5553
20200212,경부선,서울역,4902,1341,20200215,6243
20200212,1,남영,10076,10661,20200215,20737
20200212,1,용산,32268,33179,20200215,65447
20200212,1,노량진,9690,9336,20200215,19026
20200212,1,대방,13858,14207,20200215,28065
20200212,1,영등포,39786,41588,20200215,81374
20200212,경부선,신도림,3761,3862,20200215,7623
20200212,1,신길,9373,7875,20200215,17248
20200212,1,구로,18426,18838,20200215,37264
20200212,1,가산디지털단지,19822,22358,20200215,42180
20200212,1,금천구청,11730,11385,20200215,23115
20200212,1,석수,10446,9034,20200215,19480
20200212,1,관악,7335,6720,20200215,14055
20200212,1,안양,22786,22662,20200215,45448
20200212,1,명학,9195,8974,20200215,18169
20200212,4,금정,26255,26793,20200215,53048
20200212,1,군포,7444,7431,20200215,14875
20200212,1,의왕,8913,8911,20200215,17824
20200212,1,성균관대,13638,13658,20200215,27296
20200212,1,화서,7241,6947,20200215,14188
20200212,1,수원,32077,34086,20200215,66163
20200212,1,독산,17440,18225,20200215,35665
20200212,1,세류,3029,2764,20200215,5793
20200212,1,병점,12892,12724,20200215,25616
20200212,1,세마,2228,2063,20200215,4291
20200212,1,오산대,2408,2181,20200215,4589
20200212,1,오산,8213,8146,20200215,16359
20200212,1,진위,1384,1232,20200215,2616
20200212,1,송탄,3619,3521,20200215,7140
20200212,1,서정리,4647,4548,20200215,9195
20200212,1,지제,2154,1890,20200215,4044
20200212,1,평택,9628,9448,20200215,19076
20200212,1,성환,2606,2620,20200215,5226
20200212,1,직산,663,691,20200215,1354
20200212,1,두정,4044,4123,20200215,8167
20200212,1,천안,4035,4044,20200215,8079
20200212,1,당정,6279,5902,20200215,12181
20200212,경부선,서동탄,1608,1274,20200215,2882
20200212,경부선,광명,2924,2433,20200215,5357
20200213,경부선,서울역,5083,1374,20200216,6457
20200213,1,남영,10855,11309,20200216,22164
20200213,1,용산,34443,35407,20200216,69850
20200213,1,노량진,10731,10320,20200216,21051
20200213,1,대방,14645,15013,20200216,29658
20200213,1,영등포,42370,44217,20200216,86587
20200213,경부선,신도림,4303,4143,20200216,8446
20200213,1,신길,9837,8238,20200216,18075
20200213,1,구로,18881,19435,20200216,38316
20200213,1,가산디지털단지,20559,23135,20200216,43694
20200213,1,금천구청,12364,11981,20200216,24345
20200213,1,석수,10969,9541,20200216,20510
20200213,1,관악,7953,7231,20200216,15184
20200213,1,안양,23500,23460,20200216,46960
20200213,1,명학,9456,9350,20200216,18806
20200213,4,금정,27396,27729,20200216,55125
20200213,1,군포,7740,7649,20200216,15389
20200213,1,의왕,9466,9287,20200216,18753
20200213,1,성균관대,14484,14115,20200216,28599
20200213,1,화서,7722,7406,20200216,15128
20200213,1,수원,34995,37197,20200216,72192
20200213,1,독산,17793,18467,20200216,36260
20200213,1,세류,3439,3038,20200216,6477
20200213,1,병점,13864,13782,20200216,27646
20200213,1,세마,2513,2277,20200216,4790
20200213,1,오산대,2599,2391,20200216,4990
20200213,1,오산,8911,8844,20200216,17755
20200213,1,진위,1408,1300,20200216,2708
20200213,1,송탄,3959,3767,20200216,7726
20200213,1,서정리,4987,4796,20200216,9783
20200213,1,지제,2171,2155,20200216,4326
20200213,1,평택,11008,10387,20200216,21395
20200213,1,성환,2968,2936,20200216,5904
20200213,1,직산,681,692,20200216,1373
20200213,1,두정,4322,4418,20200216,8740
20200213,1,천안,4698,4672,20200216,9370
20200213,1,당정,6645,6349,20200216,12994
20200213,경부선,서동탄,1758,1410,20200216,3168
20200213,경부선,광명,3079,2432,20200216,5511
20200214,경부선,서울역,7168,1899,20200217,9067
20200214,1,남영,10594,11112,20200217,21706
20200214,1,용산,40753,41918,20200217,82671
20200214,1,노량진,11416,11244,20200217,22660
20200214,1,대방,14819,14939,20200217,29758
20200214,1,영등포,48611,52719,20200217,101330
20200214,경부선,신도림,4372,4331,20200217,8703
20200214,1,신길,9940,8115,20200217,18055
20200214,1,구로,19593,20763,20200217,40356
20200214,1,가산디지털단지,20733,22499,20200217,43232
20200214,1,금천구청,12754,13136,20200217,25890
20200214,1,석수,11481,9995,20200217,21476
20200214,1,관악,7948,7217,20200217,15165
20200214,1,안양,25691,26363,20200217,52054
20200214,1,명학,9491,9126,20200217,18617
20200214,4,금정,29230,29485,20200217,58715
20200214,1,군포,8008,7741,20200217,15749
20200214,1,의왕,9870,9556,20200217,19426
20200214,1,성균관대,15421,15041,20200217,30462
20200214,1,화서,8033,7667,20200217,15700
20200214,1,수원,40348,43485,20200217,83833
20200214,1,독산,18114,18711,20200217,36825
20200214,1,세류,3667,3372,20200217,7039
20200214,1,병점,15762,14921,20200217,30683
20200214,1,세마,2670,2361,20200217,5031
20200214,1,오산대,3039,2643,20200217,5682
20200214,1,오산,10304,9589,20200217,19893
20200214,1,진위,1757,1338,20200217,3095
20200214,1,송탄,4811,4341,20200217,9152
20200214,1,서정리,5874,5188,20200217,11062
20200214,1,지제,2729,2452,20200217,5181
20200214,1,평택,13057,12438,20200217,25495
20200214,1,성환,3708,3423,20200217,7131
20200214,1,직산,883,798,20200217,1681
20200214,1,두정,5365,5315,20200217,10680
20200214,1,천안,5524,5705,20200217,11229
20200214,1,당정,7081,6629,20200217,13710
20200214,경부선,서동탄,1777,1510,20200217,3287
20200214,경부선,광명,3505,2939,20200217,6444
20200215,경부선,서울역,5597,1286,20200218,6883
20200215,1,남영,6367,6505,20200218,12872
20200215,1,용산,34032,35459,20200218,69491
20200215,1,노량진,10719,9285,20200218,20004
20200215,1,대방,9328,9356,20200218,18684
20200215,1,영등포,45775,47938,20200218,93713
20200215,경부선,신도림,3152,3350,20200218,6502
20200215,1,신길,6357,5156,20200218,11513
20200215,1,구로,13544,14217,20200218,27761
20200215,1,가산디지털단지,6234,8210,20200218,14444
20200215,1,금천구청,8562,8339,20200218,16901
20200215,1,석수,7878,7320,20200218,15198
20200215,1,관악,6315,5867,20200218,12182
20200215,1,안양,20134,20170,20200218,40304
20200215,1,명학,5904,5751,20200218,11655
20200215,4,금정,19824,19938,20200218,39762
20200215,1,군포,4604,4199,20200218,8803
20200215,1,의왕,6054,5862,20200218,11916
20200215,1,성균관대,11082,10675,20200218,21757
20200215,1,화서,5782,5510,20200218,11292
20200215,1,수원,38118,41482,20200218,79600
20200215,1,독산,9107,8887,20200218,17994
20200215,1,세류,2851,2759,20200218,5610
20200215,1,병점,12169,11754,20200218,23923
20200215,1,세마,2170,1859,20200218,4029
20200215,1,오산대,2381,2120,20200218,4501
20200215,1,오산,9072,8626,20200218,17698
20200215,1,진위,1107,956,20200218,2063
20200215,1,송탄,4786,4244,20200218,9030
20200215,1,서정리,5749,4596,20200218,10345
20200215,1,지제,2389,1985,20200218,4374
20200215,1,평택,12788,12190,20200218,24978
20200215,1,성환,3127,2739,20200218,5866
20200215,1,직산,698,626,20200218,1324
20200215,1,두정,4854,4954,20200218,9808
20200215,1,천안,5973,6050,20200218,12023
20200215,1,당정,4441,4134,20200218,8575
20200215,경부선,서동탄,1138,1150,20200218,2288
20200215,경부선,광명,2537,1941,20200218,4478
20200216,경부선,서울역,5770,1186,20200219,6956
20200216,1,남영,4840,5212,20200219,10052
20200216,1,용산,30393,28285,20200219,58678
20200216,1,노량진,7025,6148,20200219,13173
20200216,1,대방,6641,6938,20200219,13579
20200216,1,영등포,35970,34887,20200219,70857
20200216,경부선,신도림,1828,1936,20200219,3764
20200216,1,신길,4798,4044,20200219,8842
20200216,1,구로,8828,8990,20200219,17818
20200216,1,가산디지털단지,4015,5599,20200219,9614
20200216,1,금천구청,5758,5647,20200219,11405
20200216,1,석수,5092,4753,20200219,9845
20200216,1,관악,4482,4396,20200219,8878
20200216,1,안양,14136,13803,20200219,27939
20200216,1,명학,3443,3420,20200219,6863
20200216,4,금정,13789,14370,20200219,28159
20200216,1,군포,3127,2845,20200219,5972
20200216,1,의왕,3966,4098,20200219,8064
20200216,1,성균관대,7639,8053,20200219,15692
20200216,1,화서,3643,3527,20200219,7170
20200216,1,수원,31143,30445,20200219,61588
20200216,1,독산,5585,5685,20200219,11270
20200216,1,세류,2086,2217,20200219,4303
20200216,1,병점,8166,9375,20200219,17541
20200216,1,세마,1572,1452,20200219,3024
20200216,1,오산대,1638,1521,20200219,3159
20200216,1,오산,6951,7361,20200219,14312
20200216,1,진위,671,668,20200219,1339
20200216,1,송탄,3231,3469,20200219,6700
20200216,1,서정리,3210,4819,20200219,8029
20200216,1,지제,1648,1621,20200219,3269
20200216,1,평택,9634,10347,20200219,19981
20200216,1,성환,2255,2749,20200219,5004
20200216,1,직산,548,588,20200219,1136
20200216,1,두정,3804,4087,20200219,7891
20200216,1,천안,5090,4943,20200219,10033
20200216,1,당정,3086,3000,20200219,6086
20200216,경부선,서동탄,813,822,20200219,1635
20200216,경부선,광명,2172,1403,20200219,3575
20200217,경부선,서울역,5741,1664,20200220,7405
20200217,1,남영,10300,10746,20200220,21046
20200217,1,용산,34943,36422,20200220,71365
20200217,1,노량진,9704,9706,20200220,19410
20200217,1,대방,14254,14582,20200220,28836
20200217,1,영등포,40646,42497,20200220,83143
20200217,경부선,신도림,3871,3816,20200220,7687
20200217,1,신길,9655,8112,20200220,17767
20200217,1,구로,18821,19023,20200220,37844
20200217,1,가산디지털단지,19915,23049,20200220,42964
20200217,1,금천구청,12186,11707,20200220,23893
20200217,1,석수,10966,9611,20200220,20577
20200217,1,관악,7826,7097,20200220,14923
20200217,1,안양,23625,22975,20200220,46600
20200217,1,명학,9677,9558,20200220,19235
20200217,4,금정,27520,28406,20200220,55926
20200217,1,군포,7812,7935,20200220,15747
20200217,1,의왕,9464,9392,20200220,18856
20200217,1,성균관대,14803,14491,20200220,29294
20200217,1,화서,7785,7451,20200220,15236
20200217,1,수원,35142,37771,20200220,72913
20200217,1,독산,18035,18888,20200220,36923
20200217,1,세류,3305,3058,20200220,6363
20200217,1,병점,13992,13816,20200220,27808
20200217,1,세마,2666,2300,20200220,4966
20200217,1,오산대,2787,2469,20200220,5256
20200217,1,오산,8965,8998,20200220,17963
20200217,1,진위,1497,1292,20200220,2789
20200217,1,송탄,3967,3920,20200220,7887
20200217,1,서정리,4928,5228,20200220,10156
20200217,1,지제,2469,2239,20200220,4708
20200217,1,평택,10868,11037,20200220,21905
20200217,1,성환,3132,3326,20200220,6458
20200217,1,직산,770,779,20200220,1549
20200217,1,두정,4886,4970,20200220,9856
20200217,1,천안,5266,5217,20200220,10483
20200217,1,당정,6699,6474,20200220,13173
20200217,경부선,서동탄,1683,1333,20200220,3016
20200217,경부선,광명,3456,2759,20200220,6215
20200218,경부선,서울역,5051,1366,20200221,6417
20200218,1,남영,10379,10806,20200221,21185
20200218,1,용산,34240,35168,20200221,69408
20200218,1,노량진,10012,9675,20200221,19687
20200218,1,대방,14167,14535,20200221,28702
20200218,1,영등포,41454,43126,20200221,84580
20200218,경부선,신도림,4069,4061,20200221,8130
20200218,1,신길,9629,8106,20200221,17735
20200218,1,구로,18824,19081,20200221,37905
20200218,1,가산디지털단지,19953,22450,20200221,42403
20200218,1,금천구청,12141,11902,20200221,24043
20200218,1,석수,10677,9340,20200221,20017
20200218,1,관악,7572,7105,20200221,14677
20200218,1,안양,23203,22887,20200221,46090
20200218,1,명학,9372,9230,20200221,18602
20200218,4,금정,27153,28015,20200221,55168
20200218,1,군포,7642,7618,20200221,15260
20200218,1,의왕,9460,9227,20200221,18687
20200218,1,성균관대,14454,14212,20200221,28666
20200218,1,화서,7697,7481,20200221,15178
20200218,1,수원,34374,37206,20200221,71580
20200218,1,독산,17632,18338,20200221,35970
20200218,1,세류,3246,3069,20200221,6315
20200218,1,병점,13958,13800,20200221,27758
20200218,1,세마,2437,2203,20200221,4640
20200218,1,오산대,2682,2390,20200221,5072
20200218,1,오산,8886,8779,20200221,17665
20200218,1,진위,1425,1250,20200221,2675
20200218,1,송탄,3638,3687,20200221,7325
20200218,1,서정리,4997,4888,20200221,9885
20200218,1,지제,2227,1981,20200221,4208
20200218,1,평택,10444,10108,20200221,20552
20200218,1,성환,3034,3086,20200221,6120
20200218,1,직산,778,764,20200221,1542
20200218,1,두정,4551,4620,20200221,9171
20200218,1,천안,4900,5013,20200221,9913
20200218,1,당정,6829,6435,20200221,13264
20200218,경부선,서동탄,1637,1259,20200221,2896
20200218,경부선,광명,3173,2485,20200221,5658
20200219,경부선,서울역,5300,1421,20200222,6721
20200219,1,남영,10413,10951,20200222,21364
20200219,1,용산,35037,35936,20200222,70973
20200219,1,노량진,10343,9922,20200222,20265
20200219,1,대방,14326,14629,20200222,28955
20200219,1,영등포,41965,43719,20200222,85684
20200219,경부선,신도림,4170,4099,20200222,8269
20200219,1,신길,9851,8399,20200222,18250
20200219,1,구로,19331,19494,20200222,38825
20200219,1,가산디지털단지,20321,23033,20200222,43354
20200219,1,금천구청,12558,12066,20200222,24624
20200219,1,석수,11000,9533,20200222,20533
20200219,1,관악,7755,7091,20200222,14846
20200219,1,안양,23504,23466,20200222,46970
20200219,1,명학,9524,9424,20200222,18948
20200219,4,금정,27588,28111,20200222,55699
20200219,1,군포,7826,7802,20200222,15628
20200219,1,의왕,9641,9474,20200222,19115
20200219,1,성균관대,14811,14455,20200222,29266
20200219,1,화서,7761,7439,20200222,15200
20200219,1,수원,35939,38856,20200222,74795
20200219,1,독산,17794,18513,20200222,36307
20200219,1,세류,3290,3075,20200222,6365
20200219,1,병점,14089,14028,20200222,28117
20200219,1,세마,2528,2273,20200222,4801
20200219,1,오산대,2755,2439,20200222,5194
20200219,1,오산,9193,8871,20200222,18064
20200219,1,진위,1494,1282,20200222,2776
20200219,1,송탄,3835,3736,20200222,7571
20200219,1,서정리,5059,4931,20200222,9990
20200219,1,지제,2276,2068,20200222,4344
20200219,1,평택,10898,10654,20200222,21552
20200219,1,성환,2887,2911,20200222,5798
20200219,1,직산,734,741,20200222,1475
20200219,1,두정,4513,4576,20200222,9089
20200219,1,천안,4771,4860,20200222,9631
20200219,1,당정,6842,6541,20200222,13383
20200219,경부선,서동탄,1715,1371,20200222,3086
20200219,경부선,광명,3208,2522,20200222,5730
20200220,경부선,서울역,5231,1429,20200223,6660
20200220,1,남영,10260,10761,20200223,21021
20200220,1,용산,34568,35699,20200223,70267
20200220,1,노량진,10326,9957,20200223,20283
20200220,1,대방,14406,14519,20200223,28925
20200220,1,영등포,40920,42518,20200223,83438
20200220,경부선,신도림,4106,4100,20200223,8206
20200220,1,신길,9674,8140,20200223,17814
20200220,1,구로,18904,19178,20200223,38082
20200220,1,가산디지털단지,20256,22625,20200223,42881
20200220,1,금천구청,12271,11828,20200223,24099
20200220,1,석수,10629,9341,20200223,19970
20200220,1,관악,7757,7174,20200223,14931
20200220,1,안양,23169,23050,20200223,46219
20200220,1,명학,9422,9160,20200223,18582
20200220,4,금정,26876,27428,20200223,54304
20200220,1,군포,7657,7603,20200223,15260
20200220,1,의왕,9610,9396,20200223,19006
20200220,1,성균관대,14460,13925,20200223,28385
20200220,1,화서,7725,7407,20200223,15132
20200220,1,수원,34262,36542,20200223,70804
20200220,1,독산,17374,18305,20200223,35679
20200220,1,세류,3321,2953,20200223,6274
20200220,1,병점,13951,13776,20200223,27727
20200220,1,세마,2491,2305,20200223,4796
20200220,1,오산대,2694,2393,20200223,5087
20200220,1,오산,8839,8698,20200223,17537
20200220,1,진위,1451,1289,20200223,2740
20200220,1,송탄,3808,3637,20200223,7445
20200220,1,서정리,5030,4932,20200223,9962
20200220,1,지제,2212,2149,20200223,4361
20200220,1,평택,10732,10503,20200223,21235
20200220,1,성환,2902,2930,20200223,5832
20200220,1,직산,685,675,20200223,1360
20200220,1,두정,4688,4828,20200223,9516
20200220,1,천안,4606,4688,20200223,9294
20200220,1,당정,6732,6395,20200223,13127
20200220,경부선,서동탄,1640,1329,20200223,2969
20200220,경부선,광명,3116,2473,20200223,5589
20200221,경부선,서울역,5921,1612,20200224,7533
20200221,1,남영,9968,10454,20200224,20422
20200221,1,용산,37012,36878,20200224,73890
20200221,1,노량진,9448,9638,20200224,19086
20200221,1,대방,13717,13699,20200224,27416
20200221,1,영등포,43214,45511,20200224,88725
20200221,경부선,신도림,3935,3843,20200224,7778
20200221,1,신길,9626,7930,20200224,17556
20200221,1,구로,18471,18863,20200224,37334
20200221,1,가산디지털단지,19457,21679,20200224,41136
20200221,1,금천구청,11819,11586,20200224,23405
20200221,1,석수,10569,9208,20200224,19777
20200221,1,관악,7410,6707,20200224,14117
20200221,1,안양,22568,22959,20200224,45527
20200221,1,명학,9079,8960,20200224,18039
20200221,4,금정,26760,26942,20200224,53702
20200221,1,군포,7581,7398,20200224,14979
20200221,1,의왕,9436,9170,20200224,18606
20200221,1,성균관대,14385,13941,20200224,28326
20200221,1,화서,7747,7282,20200224,15029
20200221,1,수원,35331,38416,20200224,73747
20200221,1,독산,17022,17586,20200224,34608
20200221,1,세류,3310,3057,20200224,6367
20200221,1,병점,14282,13675,20200224,27957
20200221,1,세마,2595,2216,20200224,4811
20200221,1,오산대,2744,2445,20200224,5189
20200221,1,오산,9281,8927,20200224,18208
20200221,1,진위,1587,1225,20200224,2812
20200221,1,송탄,4244,3832,20200224,8076
20200221,1,서정리,5405,4860,20200224,10265
20200221,1,지제,2605,2195,20200224,4800
20200221,1,평택,11390,10960,20200224,22350
20200221,1,성환,3376,3089,20200224,6465
20200221,1,직산,809,707,20200224,1516
20200221,1,두정,5054,5084,20200224,10138
20200221,1,천안,4773,5007,20200224,9780
20200221,1,당정,6548,6178,20200224,12726
20200221,경부선,서동탄,1622,1428,20200224,3050
20200221,경부선,광명,3293,2729,20200224,6022
20200222,경부선,서울역,3556,832,20200225,4388
20200222,1,남영,4940,5012,20200225,9952
20200222,1,용산,26404,27745,20200225,54149
20200222,1,노량진,7845,6798,20200225,14643
20200222,1,대방,7726,7920,20200225,15646
20200222,1,영등포,34395,35828,20200225,70223
20200222,경부선,신도림,2299,2315,20200225,4614
20200222,1,신길,5572,4543,20200225,10115
20200222,1,구로,11458,11741,20200225,23199
20200222,1,가산디지털단지,5008,6628,20200225,11636
20200222,1,금천구청,6636,6602,20200225,13238
20200222,1,석수,5970,5364,20200225,11334
20200222,1,관악,4677,4327,20200225,9004
20200222,1,안양,15064,15409,20200225,30473
20200222,1,명학,4858,4625,20200225,9483
20200222,4,금정,15453,15957,20200225,31410
20200222,1,군포,3807,3458,20200225,7265
20200222,1,의왕,4744,4564,20200225,9308
20200222,1,성균관대,8883,8744,20200225,17627
20200222,1,화서,4285,4184,20200225,8469
20200222,1,수원,28515,30555,20200225,59070
20200222,1,독산,7257,7167,20200225,14424
20200222,1,세류,2147,2108,20200225,4255
20200222,1,병점,9424,9153,20200225,18577
20200222,1,세마,1580,1426,20200225,3006
20200222,1,오산대,1867,1585,20200225,3452
20200222,1,오산,7028,6683,20200225,13711
20200222,1,진위,837,693,20200225,1530
20200222,1,송탄,3602,3318,20200225,6920
20200222,1,서정리,4714,3842,20200225,8556
20200222,1,지제,1809,1551,20200225,3360
20200222,1,평택,9680,9245,20200225,18925
20200222,1,성환,2269,2131,20200225,4400
20200222,1,직산,527,463,20200225,990
20200222,1,두정,3961,3794,20200225,7755
20200222,1,천안,4220,4347,20200225,8567
20200222,1,당정,3405,3270,20200225,6675
20200222,경부선,서동탄,880,830,20200225,1710
20200222,경부선,광명,1817,1375,20200225,3192
20200223,경부선,서울역,3339,742,20200226,4081
20200223,1,남영,3146,3467,20200226,6613
20200223,1,용산,20672,19331,20200226,40003
20200223,1,노량진,5260,4693,20200226,9953
20200223,1,대방,4716,4877,20200226,9593
20200223,1,영등포,22962,22131,20200226,45093
20200223,경부선,신도림,1449,1515,20200226,2964
20200223,1,신길,3656,3155,20200226,6811
20200223,1,구로,6689,6798,20200226,13487
20200223,1,가산디지털단지,3251,4400,20200226,7651
20200223,1,금천구청,4468,4311,20200226,8779
20200223,1,석수,4158,3969,20200226,8127
20200223,1,관악,3556,3302,20200226,6858
20200223,1,안양,10455,9965,20200226,20420
20200223,1,명학,2862,2861,20200226,5723
20200223,4,금정,9818,10296,20200226,20114
20200223,1,군포,2337,2132,20200226,4469
20200223,1,의왕,3097,3156,20200226,6253
20200223,1,성균관대,5778,6014,20200226,11792
20200223,1,화서,2801,2779,20200226,5580
20200223,1,수원,21135,20948,20200226,42083
20200223,1,독산,4383,4369,20200226,8752
20200223,1,세류,1578,1607,20200226,3185
20200223,1,병점,6131,7015,20200226,13146
20200223,1,세마,1088,1064,20200226,2152
20200223,1,오산대,1204,1177,20200226,2381
20200223,1,오산,5277,5778,20200226,11055
20200223,1,진위,486,503,20200226,989
20200223,1,송탄,2469,2753,20200226,5222
20200223,1,서정리,2546,3843,20200226,6389
20200223,1,지제,1184,1130,20200226,2314
20200223,1,평택,7084,7726,20200226,14810
20200223,1,성환,1625,1875,20200226,3500
20200223,1,직산,396,428,20200226,824
20200223,1,두정,2478,2767,20200226,5245
20200223,1,천안,3403,3357,20200226,6760
20200223,1,당정,2211,2150,20200226,4361
20200223,경부선,서동탄,607,561,20200226,1168
20200223,경부선,광명,1303,865,20200226,2168
20200224,경부선,서울역,3361,1068,20200227,4429
20200224,1,남영,8939,9448,20200227,18387
20200224,1,용산,27188,28062,20200227,55250
20200224,1,노량진,8316,8269,20200227,16585
20200224,1,대방,12124,12515,20200227,24639
20200224,1,영등포,31071,32193,20200227,63264
20200224,경부선,신도림,3626,3494,20200227,7120
20200224,1,신길,8591,7166,20200227,15757
20200224,1,구로,16334,16425,20200227,32759
20200224,1,가산디지털단지,18237,20529,20200227,38766
20200224,1,금천구청,10611,10338,20200227,20949
20200224,1,석수,9355,8115,20200227,17470
20200224,1,관악,6501,6110,20200227,12611
20200224,1,안양,18358,18287,20200227,36645
20200224,1,명학,8264,8090,20200227,16354
20200224,4,금정,22788,23506,20200227,46294
20200224,1,군포,6812,6941,20200227,13753
20200224,1,의왕,8105,8125,20200227,16230
20200224,1,성균관대,11968,11818,20200227,23786
20200224,1,화서,6516,6332,20200227,12848
20200224,1,수원,25936,27248,20200227,53184
20200224,1,독산,15702,16661,20200227,32363
20200224,1,세류,2644,2445,20200227,5089
20200224,1,병점,11036,11051,20200227,22087
20200224,1,세마,1983,1820,20200227,3803
20200224,1,오산대,2160,1935,20200227,4095
20200224,1,오산,7230,7205,20200227,14435
20200224,1,진위,1202,1078,20200227,2280
20200224,1,송탄,3089,2892,20200227,5981
20200224,1,서정리,4003,4146,20200227,8149
20200224,1,지제,1772,1709,20200227,3481
20200224,1,평택,8247,8050,20200227,16297
20200224,1,성환,2483,2673,20200227,5156
20200224,1,직산,571,590,20200227,1161
20200224,1,두정,3562,3704,20200227,7266
20200224,1,천안,3516,3628,20200227,7144
20200224,1,당정,5560,5389,20200227,10949
20200224,경부선,서동탄,1346,1034,20200227,2380
20200224,경부선,광명,2502,2106,20200227,4608
20200225,경부선,서울역,2505,890,20200228,3395
20200225,1,남영,8356,8770,20200228,17126
20200225,1,용산,23436,23826,20200228,47262
20200225,1,노량진,6448,6596,20200228,13044
20200225,1,대방,11138,11235,20200228,22373
20200225,1,영등포,28595,29914,20200228,58509
20200225,경부선,신도림,3263,3033,20200228,6296
20200225,1,신길,8044,6540,20200228,14584
20200225,1,구로,15101,15305,20200228,30406
20200225,1,가산디지털단지,17228,19465,20200228,36693
20200225,1,금천구청,9535,9207,20200228,18742
20200225,1,석수,8376,7259,20200228,15635
20200225,1,관악,5673,5241,20200228,10914
20200225,1,안양,16314,16411,20200228,32725
20200225,1,명학,7877,7712,20200228,15589
20200225,4,금정,20944,21402,20200228,42346
20200225,1,군포,6406,6424,20200228,12830
20200225,1,의왕,7284,7313,20200228,14597
20200225,1,성균관대,10732,10662,20200228,21394
20200225,1,화서,5753,5617,20200228,11370
20200225,1,수원,22332,23847,20200228,46179
20200225,1,독산,14759,15824,20200228,30583
20200225,1,세류,2380,2198,20200228,4578
20200225,1,병점,9860,9806,20200228,19666
20200225,1,세마,1771,1623,20200228,3394
20200225,1,오산대,1956,1758,20200228,3714
20200225,1,오산,6394,6388,20200228,12782
20200225,1,진위,1123,974,20200228,2097
20200225,1,송탄,2659,2525,20200228,5184
20200225,1,서정리,3431,3482,20200228,6913
20200225,1,지제,1532,1433,20200228,2965
20200225,1,평택,6850,6691,20200228,13541
20200225,1,성환,2099,2077,20200228,4176
20200225,1,직산,501,493,20200228,994
20200225,1,두정,2881,2839,20200228,5720
20200225,1,천안,2656,2805,20200228,5461
20200225,1,당정,4980,4756,20200228,9736
20200225,경부선,서동탄,1213,951,20200228,2164
20200225,경부선,광명,2125,1858,20200228,3983
20200226,경부선,서울역,2304,802,20200229,3106
20200226,1,남영,8336,8845,20200229,17181
20200226,1,용산,23075,23657,20200229,46732
20200226,1,노량진,6633,6672,20200229,13305
20200226,1,대방,11041,11176,20200229,22217
20200226,1,영등포,29896,31300,20200229,61196
20200226,경부선,신도림,3389,3258,20200229,6647
20200226,1,신길,8119,6808,20200229,14927
20200226,1,구로,15506,15732,20200229,31238
20200226,1,가산디지털단지,16862,18709,20200229,35571
20200226,1,금천구청,9518,9342,20200229,18860
20200226,1,석수,8812,7630,20200229,16442
20200226,1,관악,5786,5295,20200229,11081
20200226,1,안양,16785,16905,20200229,33690
20200226,1,명학,7735,7541,20200229,15276
20200226,4,금정,21363,22026,20200229,43389
20200226,1,군포,6522,6528,20200229,13050
20200226,1,의왕,7597,7531,20200229,15128
20200226,1,성균관대,11007,10916,20200229,21923
20200226,1,화서,6058,5852,20200229,11910
20200226,1,수원,23424,25285,20200229,48709
20200226,1,독산,14432,15497,20200229,29929
20200226,1,세류,2390,2247,20200229,4637
20200226,1,병점,10099,9954,20200229,20053
20200226,1,세마,1867,1735,20200229,3602
20200226,1,오산대,2028,1778,20200229,3806
20200226,1,오산,6643,6588,20200229,13231
20200226,1,진위,1106,1008,20200229,2114
20200226,1,송탄,2781,2699,20200229,5480
20200226,1,서정리,3743,3713,20200229,7456
20200226,1,지제,1594,1448,20200229,3042
20200226,1,평택,7158,6968,20200229,14126
20200226,1,성환,2044,2070,20200229,4114
20200226,1,직산,515,545,20200229,1060
20200226,1,두정,2824,2791,20200229,5615
20200226,1,천안,2707,2750,20200229,5457
20200226,1,당정,5061,4829,20200229,9890
20200226,경부선,서동탄,1283,995,20200229,2278
20200226,경부선,광명,2073,1873,20200229,3946
20200227,경부선,서울역,2207,784,20200301,2991
20200227,1,남영,8171,8541,20200301,16712
20200227,1,용산,23082,23861,20200301,46943
20200227,1,노량진,6514,6612,20200301,13126
20200227,1,대방,10721,10829,20200301,21550
20200227,1,영등포,29144,29805,20200301,58949
20200227,경부선,신도림,3328,3188,20200301,6516
20200227,1,신길,7852,6504,20200301,14356
20200227,1,구로,15233,15506,20200301,30739
20200227,1,가산디지털단지,16074,17747,20200301,33821
20200227,1,금천구청,9411,9137,20200301,18548
20200227,1,석수,8336,7413,20200301,15749
20200227,1,관악,5740,5146,20200301,10886
20200227,1,안양,16380,16287,20200301,32667
20200227,1,명학,7661,7540,20200301,15201
20200227,4,금정,20739,21469,20200301,42208
20200227,1,군포,6248,6380,20200301,12628
20200227,1,의왕,7507,7429,20200301,14936
20200227,1,성균관대,10556,10450,20200301,21006
20200227,1,화서,5638,5539,20200301,11177
20200227,1,수원,22273,23908,20200301,46181
20200227,1,독산,14378,15070,20200301,29448
20200227,1,세류,2365,2089,20200301,4454
20200227,1,병점,9740,9537,20200301,19277
20200227,1,세마,1763,1597,20200301,3360
20200227,1,오산대,1957,1772,20200301,3729
20200227,1,오산,6227,6331,20200301,12558
20200227,1,진위,1135,1033,20200301,2168
20200227,1,송탄,2740,2519,20200301,5259
20200227,1,서정리,3674,3547,20200301,7221
20200227,1,지제,1547,1456,20200301,3003
20200227,1,평택,6874,6727,20200301,13601
20200227,1,성환,1914,1880,20200301,3794
20200227,1,직산,463,472,20200301,935
20200227,1,두정,2716,2632,20200301,5348
20200227,1,천안,2545,2585,20200301,5130
20200227,1,당정,5048,4770,20200301,9818
20200227,경부선,서동탄,1182,951,20200301,2133
20200227,경부선,광명,1999,1725,20200301,3724
20200228,경부선,서울역,2791,937,20200302,3728
20200228,1,남영,7978,8468,20200302,16446
20200228,1,용산,24696,25430,20200302,50126
20200228,1,노량진,6320,6435,20200302,12755
20200228,1,대방,10285,10453,20200302,20738
20200228,1,영등포,30135,31515,20200302,61650
20200228,경부선,신도림,3008,3002,20200302,6010
20200228,1,신길,7491,6248,20200302,13739
20200228,1,구로,14620,15021,20200302,29641
20200228,1,가산디지털단지,14889,16971,20200302,31860
20200228,1,금천구청,9027,8876,20200302,17903
20200228,1,석수,7955,6932,20200302,14887
20200228,1,관악,5462,4911,20200302,10373
20200228,1,안양,15909,16172,20200302,32081
20200228,1,명학,7338,7227,20200302,14565
20200228,4,금정,20244,20910,20200302,41154
20200228,1,군포,6124,6082,20200302,12206
20200228,1,의왕,7062,6887,20200302,13949
20200228,1,성균관대,10277,9963,20200302,20240
20200228,1,화서,5424,5187,20200302,10611
20200228,1,수원,22598,24331,20200302,46929
20200228,1,독산,14079,14652,20200302,28731
20200228,1,세류,2334,2049,20200302,4383
20200228,1,병점,9964,9399,20200302,19363
20200228,1,세마,1777,1601,20200302,3378
20200228,1,오산대,1931,1702,20200302,3633
20200228,1,오산,6644,6299,20200302,12943
20200228,1,진위,1215,969,20200302,2184
20200228,1,송탄,2685,2541,20200302,5226
20200228,1,서정리,3836,3361,20200302,7197
20200228,1,지제,1781,1488,20200302,3269
20200228,1,평택,7174,6839,20200302,14013
20200228,1,성환,2117,1875,20200302,3992
20200228,1,직산,486,452,20200302,938
20200228,1,두정,2791,2630,20200302,5421
20200228,1,천안,2592,2689,20200302,5281
20200228,1,당정,4738,4596,20200302,9334
20200228,경부선,서동탄,1137,883,20200302,2020
20200228,경부선,광명,2188,1895,20200302,4083
20200229,경부선,서울역,1235,336,20200303,1571
20200229,1,남영,3748,3710,20200303,7458
20200229,1,용산,15672,16995,20200303,32667
20200229,1,노량진,4863,4279,20200303,9142
20200229,1,대방,4941,4871,20200303,9812
20200229,1,영등포,21599,22870,20200303,44469
20200229,경부선,신도림,1789,1771,20200303,3560
20200229,1,신길,4182,3318,20200303,7500
20200229,1,구로,7849,8052,20200303,15901
20200229,1,가산디지털단지,3823,4757,20200303,8580
20200229,1,금천구청,4955,4919,20200303,9874
20200229,1,석수,4264,4000,20200303,8264
20200229,1,관악,3563,3186,20200303,6749
20200229,1,안양,10208,10422,20200303,20630
20200229,1,명학,3279,3201,20200303,6480
20200229,4,금정,11150,11228,20200303,22378
20200229,1,군포,2966,2679,20200303,5645
20200229,1,의왕,3615,3478,20200303,7093
20200229,1,성균관대,5354,5311,20200303,10665
20200229,1,화서,2832,2751,20200303,5583
20200229,1,수원,16624,18071,20200303,34695
20200229,1,독산,5347,5363,20200303,10710
20200229,1,세류,1365,1376,20200303,2741
20200229,1,병점,5740,5499,20200303,11239
20200229,1,세마,1007,881,20200303,1888
20200229,1,오산대,1125,1011,20200303,2136
20200229,1,오산,4556,4389,20200303,8945
20200229,1,진위,505,466,20200303,971
20200229,1,송탄,2257,1999,20200303,4256
20200229,1,서정리,3234,2423,20200303,5657
20200229,1,지제,1099,928,20200303,2027
20200229,1,평택,5869,5536,20200303,11405
20200229,1,성환,1416,1308,20200303,2724
20200229,1,직산,326,294,20200303,620
20200229,1,두정,1876,1844,20200303,3720
20200229,1,천안,2146,2232,20200303,4378
20200229,1,당정,2414,2332,20200303,4746
20200229,경부선,서동탄,453,436,20200303,889
20200229,경부선,광명,1049,848,20200303,1897
20200301,경부선,서울역,1390,362,20200304,1752
20200301,1,남영,2277,2454,20200304,4731
20200301,1,용산,13708,12769,20200304,26477
20200301,1,노량진,3281,3030,20200304,6311
20200301,1,대방,3237,3325,20200304,6562
20200301,1,영등포,15989,15867,20200304,31856
20200301,경부선,신도림,1075,1098,20200304,2173
20200301,1,신길,2788,2335,20200304,5123
20200301,1,구로,4795,4754,20200304,9549
20200301,1,가산디지털단지,2441,3236,20200304,5677
20200301,1,금천구청,3396,3107,20200304,6503
20200301,1,석수,3018,2959,20200304,5977
20200301,1,관악,2633,2390,20200304,5023
20200301,1,안양,7211,7036,20200304,14247
20200301,1,명학,2011,1893,20200304,3904
20200301,4,금정,7184,7694,20200304,14878
20200301,1,군포,1834,1699,20200304,3533
20200301,1,의왕,2459,2403,20200304,4862
20200301,1,성균관대,3651,3758,20200304,7409
20200301,1,화서,1781,1686,20200304,3467
20200301,1,수원,12951,13318,20200304,26269
20200301,1,독산,3118,3199,20200304,6317
20200301,1,세류,997,989,20200304,1986
20200301,1,병점,3820,4372,20200304,8192
20200301,1,세마,710,657,20200304,1367
20200301,1,오산대,776,723,20200304,1499
20200301,1,오산,3270,3742,20200304,7012
20200301,1,진위,320,311,20200304,631
20200301,1,송탄,1644,1694,20200304,3338
20200301,1,서정리,1778,2717,20200304,4495
20200301,1,지제,769,859,20200304,1628
20200301,1,평택,4567,4890,20200304,9457
20200301,1,성환,951,1187,20200304,2138
20200301,1,직산,181,239,20200304,420
20200301,1,두정,1360,1588,20200304,2948
20200301,1,천안,1902,1806,20200304,3708
20200301,1,당정,1659,1643,20200304,3302
20200301,경부선,서동탄,308,312,20200304,620
20200301,경부선,광명,839,660,20200304,1499
20200302,경부선,서울역,2162,780,20200305,2942
20200302,1,남영,7870,8372,20200305,16242
20200302,1,용산,22413,23020,20200305,45433
20200302,1,노량진,6862,6870,20200305,13732
20200302,1,대방,10264,10490,20200305,20754
20200302,1,영등포,27628,28696,20200305,56324
20200302,경부선,신도림,3227,3083,20200305,6310
20200302,1,신길,7539,6300,20200305,13839
20200302,1,구로,14791,14858,20200305,29649
20200302,1,가산디지털단지,15152,17229,20200305,32381
20200302,1,금천구청,9300,8986,20200305,18286
20200302,1,석수,8151,7018,20200305,15169
20200302,1,관악,5661,5179,20200305,10840
20200302,1,안양,16045,16038,20200305,32083
20200302,1,명학,7511,7421,20200305,14932
20200302,4,금정,19906,20888,20200305,40794
20200302,1,군포,6208,6331,20200305,12539
20200302,1,의왕,7001,7065,20200305,14066
20200302,1,성균관대,9973,9814,20200305,19787
20200302,1,화서,5568,5328,20200305,10896
20200302,1,수원,21267,22790,20200305,44057
20200302,1,독산,14138,14875,20200305,29013
20200302,1,세류,2235,2023,20200305,4258
20200302,1,병점,9203,9097,20200305,18300
20200302,1,세마,1681,1561,20200305,3242
20200302,1,오산대,1922,1738,20200305,3660
20200302,1,오산,6127,6238,20200305,12365
20200302,1,진위,1091,957,20200305,2048
20200302,1,송탄,2702,2535,20200305,5237
20200302,1,서정리,3548,3673,20200305,7221
20200302,1,지제,1530,1516,20200305,3046
20200302,1,평택,6953,6742,20200305,13695
20200302,1,성환,1920,1979,20200305,3899
20200302,1,직산,434,436,20200305,870
20200302,1,두정,2388,2470,20200305,4858
20200302,1,천안,2376,2391,20200305,4767
20200302,1,당정,4753,4615,20200305,9368
20200302,경부선,서동탄,1118,850,20200305,1968
20200302,경부선,광명,2078,1756,20200305,3834
20200303,경부선,서울역,1836,702,20200306,2538
20200303,1,남영,7795,8153,20200306,15948
20200303,1,용산,21590,22349,20200306,43939
20200303,1,노량진,6801,6779,20200306,13580
20200303,1,대방,10203,10404,20200306,20607
20200303,1,영등포,26028,26670,20200306,52698
20200303,경부선,신도림,3303,3096,20200306,6399
20200303,1,신길,7528,6290,20200306,13818
20200303,1,구로,14735,14846,20200306,29581
20200303,1,가산디지털단지,14979,17026,20200306,32005
20200303,1,금천구청,9161,9117,20200306,18278
20200303,1,석수,8132,7277,20200306,15409
20200303,1,관악,5682,5170,20200306,10852
20200303,1,안양,15946,15956,20200306,31902
20200303,1,명학,7528,7401,20200306,14929
20200303,4,금정,20449,20915,20200306,41364
20200303,1,군포,6389,6339,20200306,12728
20200303,1,의왕,6993,6926,20200306,13919
20200303,1,성균관대,9661,9616,20200306,19277
20200303,1,화서,5484,5238,20200306,10722
20200303,1,수원,20859,22430,20200306,43289
20200303,1,독산,14017,14911,20200306,28928
20200303,1,세류,2265,2025,20200306,4290
20200303,1,병점,9160,8938,20200306,18098
20200303,1,세마,1706,1586,20200306,3292
20200303,1,오산대,1859,1646,20200306,3505
20200303,1,오산,6076,6061,20200306,12137
20200303,1,진위,1043,963,20200306,2006
20200303,1,송탄,2558,2523,20200306,5081
20200303,1,서정리,3416,3365,20200306,6781
20200303,1,지제,1492,1411,20200306,2903
20200303,1,평택,6604,6454,20200306,13058
20200303,1,성환,1818,1804,20200306,3622
20200303,1,직산,420,423,20200306,843
20200303,1,두정,2354,2273,20200306,4627
20200303,1,천안,2199,2276,20200306,4475
20200303,1,당정,4803,4680,20200306,9483
20200303,경부선,서동탄,1119,857,20200306,1976
20200303,경부선,광명,1894,1721,20200306,3615
20200304,경부선,서울역,1879,727,20200307,2606
20200304,1,남영,7626,7991,20200307,15617
20200304,1,용산,21817,22573,20200307,44390
20200304,1,노량진,6894,6787,20200307,13681
20200304,1,대방,10261,10399,20200307,20660
20200304,1,영등포,27299,28317,20200307,55616
20200304,경부선,신도림,3143,2985,20200307,6128
20200304,1,신길,7338,6202,20200307,13540
20200304,1,구로,14415,14681,20200307,29096
20200304,1,가산디지털단지,14935,17084,20200307,32019
20200304,1,금천구청,9040,8884,20200307,17924
20200304,1,석수,8116,7052,20200307,15168
20200304,1,관악,5606,5216,20200307,10822
20200304,1,안양,15818,15828,20200307,31646
20200304,1,명학,7389,7183,20200307,14572
20200304,4,금정,20223,20697,20200307,40920
20200304,1,군포,6109,6261,20200307,12370
20200304,1,의왕,6899,6931,20200307,13830
20200304,1,성균관대,9730,9542,20200307,19272
20200304,1,화서,5361,5157,20200307,10518
20200304,1,수원,21035,22335,20200307,43370
20200304,1,독산,14022,14646,20200307,28668
20200304,1,세류,2231,2048,20200307,4279
20200304,1,병점,8926,8729,20200307,17655
20200304,1,세마,1663,1539,20200307,3202
20200304,1,오산대,1852,1638,20200307,3490
20200304,1,오산,5814,5912,20200307,11726
20200304,1,진위,1083,933,20200307,2016
20200304,1,송탄,2523,2407,20200307,4930
20200304,1,서정리,3516,3454,20200307,6970
20200304,1,지제,1513,1376,20200307,2889
20200304,1,평택,6435,6293,20200307,12728
20200304,1,성환,1741,1717,20200307,3458
20200304,1,직산,375,384,20200307,759
20200304,1,두정,2399,2356,20200307,4755
20200304,1,천안,2177,2269,20200307,4446
20200304,1,당정,4764,4575,20200307,9339
20200304,경부선,서동탄,1094,843,20200307,1937
20200304,경부선,광명,1941,1690,20200307,3631
20200305,경부선,서울역,2017,741,20200308,2758
20200305,1,남영,7820,8341,20200308,16161
20200305,1,용산,21930,22592,20200308,44522
20200305,1,노량진,6966,6905,20200308,13871
20200305,1,대방,10246,10418,20200308,20664
20200305,1,영등포,27929,28778,20200308,56707
20200305,경부선,신도림,3281,3145,20200308,6426
20200305,1,신길,7511,6237,20200308,13748
20200305,1,구로,14516,14762,20200308,29278
20200305,1,가산디지털단지,15133,17003,20200308,32136
20200305,1,금천구청,9097,8867,20200308,17964
20200305,1,석수,8149,7220,20200308,15369
20200305,1,관악,5583,5090,20200308,10673
20200305,1,안양,15895,15907,20200308,31802
20200305,1,명학,7461,7381,20200308,14842
20200305,4,금정,20184,20662,20200308,40846
20200305,1,군포,6199,6221,20200308,12420
20200305,1,의왕,7041,7021,20200308,14062
20200305,1,성균관대,9778,9588,20200308,19366
20200305,1,화서,5397,5211,20200308,10608
20200305,1,수원,21047,22835,20200308,43882
20200305,1,독산,14027,14800,20200308,28827
20200305,1,세류,2211,2057,20200308,4268
20200305,1,병점,9198,8952,20200308,18150
20200305,1,세마,1724,1589,20200308,3313
20200305,1,오산대,1853,1681,20200308,3534
20200305,1,오산,5834,5909,20200308,11743
20200305,1,진위,1059,946,20200308,2005
20200305,1,송탄,2525,2439,20200308,4964
20200305,1,서정리,3384,3335,20200308,6719
20200305,1,지제,1493,1399,20200308,2892
20200305,1,평택,6534,6318,20200308,12852
20200305,1,성환,1751,1725,20200308,3476
20200305,1,직산,396,397,20200308,793
20200305,1,두정,2368,2309,20200308,4677
20200305,1,천안,2197,2230,20200308,4427
20200305,1,당정,4817,4682,20200308,9499
20200305,경부선,서동탄,1113,874,20200308,1987
20200305,경부선,광명,1964,1757,20200308,3721
20200306,경부선,서울역,2796,977,20200309,3773
20200306,1,남영,7890,8346,20200309,16236
20200306,1,용산,25102,25891,20200309,50993
20200306,1,노량진,7492,7245,20200309,14737
20200306,1,대방,10666,10557,20200309,21223
20200306,1,영등포,30554,32662,20200309,63216
20200306,경부선,신도림,3307,3157,20200309,6464
20200306,1,신길,7652,6317,20200309,13969
20200306,1,구로,14723,15009,20200309,29732
20200306,1,가산디지털단지,15085,17175,20200309,32260
20200306,1,금천구청,9479,9253,20200309,18732
20200306,1,석수,8486,7158,20200309,15644
20200306,1,관악,5795,5277,20200309,11072
20200306,1,안양,16749,17134,20200309,33883
20200306,1,명학,7596,7347,20200309,14943
20200306,4,금정,20852,21227,20200309,42079
20200306,1,군포,6243,6195,20200309,12438
20200306,1,의왕,7052,6995,20200309,14047
20200306,1,성균관대,10377,10092,20200309,20469
20200306,1,화서,5630,5388,20200309,11018
20200306,1,수원,23614,25614,20200309,49228
20200306,1,독산,14167,14664,20200309,28831
20200306,1,세류,2362,2194,20200309,4556
20200306,1,병점,10249,9693,20200309,19942
20200306,1,세마,1781,1610,20200309,3391
20200306,1,오산대,2043,1801,20200309,3844
20200306,1,오산,6765,6468,20200309,13233
20200306,1,진위,1278,1030,20200309,2308
20200306,1,송탄,2997,2830,20200309,5827
20200306,1,서정리,4164,3614,20200309,7778
20200306,1,지제,1859,1584,20200309,3443
20200306,1,평택,7532,7423,20200309,14955
20200306,1,성환,2145,1940,20200309,4085
20200306,1,직산,546,447,20200309,993
20200306,1,두정,2887,2719,20200309,5606
20200306,1,천안,2654,2792,20200309,5446
20200306,1,당정,4896,4652,20200309,9548
20200306,경부선,서동탄,1210,919,20200309,2129
20200306,경부선,광명,2333,1984,20200309,4317
20200307,경부선,서울역,1546,370,20200310,1916
20200307,1,남영,3841,3968,20200310,7809
20200307,1,용산,16415,17248,20200310,33663
20200307,1,노량진,5644,4953,20200310,10597
20200307,1,대방,5112,5082,20200310,10194
20200307,1,영등포,23065,24498,20200310,47563
20200307,경부선,신도림,1878,1795,20200310,3673
20200307,1,신길,4433,3578,20200310,8011
20200307,1,구로,8040,8400,20200310,16440
20200307,1,가산디지털단지,4047,5114,20200310,9161
20200307,1,금천구청,5222,5214,20200310,10436
20200307,1,석수,4808,4589,20200310,9397
20200307,1,관악,3933,3571,20200310,7504
20200307,1,안양,11014,11375,20200310,22389
20200307,1,명학,3597,3374,20200310,6971
20200307,4,금정,11692,11722,20200310,23414
20200307,1,군포,2968,2613,20200310,5581
20200307,1,의왕,3827,3708,20200310,7535
20200307,1,성균관대,5812,5839,20200310,11651
20200307,1,화서,3123,2994,20200310,6117
20200307,1,수원,18497,20145,20200310,38642
20200307,1,독산,5751,5687,20200310,11438
20200307,1,세류,1494,1521,20200310,3015
20200307,1,병점,6496,6305,20200310,12801
20200307,1,세마,1087,971,20200310,2058
20200307,1,오산대,1293,1139,20200310,2432
20200307,1,오산,4985,4753,20200310,9738
20200307,1,진위,629,529,20200310,1158
20200307,1,송탄,2476,2222,20200310,4698
20200307,1,서정리,3628,2895,20200310,6523
20200307,1,지제,1258,1081,20200310,2339
20200307,1,평택,6531,6352,20200310,12883
20200307,1,성환,1560,1434,20200310,2994
20200307,1,직산,370,330,20200310,700
20200307,1,두정,2051,2003,20200310,4054
20200307,1,천안,2331,2370,20200310,4701
20200307,1,당정,2533,2333,20200310,4866
20200307,경부선,서동탄,568,549,20200310,1117
20200307,경부선,광명,1150,975,20200310,2125
20200308,경부선,서울역,1775,436,20200311,2211
20200308,1,남영,2654,2765,20200311,5419
20200308,1,용산,14727,13517,20200311,28244
20200308,1,노량진,4004,3653,20200311,7657
20200308,1,대방,3731,3894,20200311,7625
20200308,1,영등포,18059,17863,20200311,35922
20200308,경부선,신도림,1243,1195,20200311,2438
20200308,1,신길,3143,2698,20200311,5841
20200308,1,구로,5190,5229,20200311,10419
20200308,1,가산디지털단지,2862,3723,20200311,6585
20200308,1,금천구청,3807,3566,20200311,7373
20200308,1,석수,3426,3527,20200311,6953
20200308,1,관악,3211,2795,20200311,6006
20200308,1,안양,8613,8132,20200311,16745
20200308,1,명학,2075,1997,20200311,4072
20200308,4,금정,8019,8441,20200311,16460
20200308,1,군포,1905,1763,20200311,3668
20200308,1,의왕,2513,2539,20200311,5052
20200308,1,성균관대,4295,4490,20200311,8785
20200308,1,화서,2282,2108,20200311,4390
20200308,1,수원,15736,16162,20200311,31898
20200308,1,독산,3511,3507,20200311,7018
20200308,1,세류,1225,1191,20200311,2416
20200308,1,병점,4835,5390,20200311,10225
20200308,1,세마,859,801,20200311,1660
20200308,1,오산대,1036,978,20200311,2014
20200308,1,오산,3893,4345,20200311,8238
20200308,1,진위,404,381,20200311,785
20200308,1,송탄,1913,2004,20200311,3917
20200308,1,서정리,2034,3096,20200311,5130
20200308,1,지제,836,932,20200311,1768
20200308,1,평택,5509,5753,20200311,11262
20200308,1,성환,1104,1295,20200311,2399
20200308,1,직산,257,289,20200311,546
20200308,1,두정,1547,1826,20200311,3373
20200308,1,천안,2153,2113,20200311,4266
20200308,1,당정,1757,1753,20200311,3510
20200308,경부선,서동탄,399,423,20200311,822
20200308,경부선,광명,1027,823,20200311,1850
20200309,경부선,서울역,2586,903,20200312,3489
20200309,1,남영,8157,8665,20200312,16822
20200309,1,용산,23624,24241,20200312,47865
20200309,1,노량진,6956,7016,20200312,13972
20200309,1,대방,10945,11074,20200312,22019
20200309,1,영등포,29315,30328,20200312,59643
20200309,경부선,신도림,3533,3345,20200312,6878
20200309,1,신길,7750,6485,20200312,14235
20200309,1,구로,15056,14904,20200312,29960
20200309,1,가산디지털단지,15684,17766,20200312,33450
20200309,1,금천구청,9562,9264,20200312,18826
20200309,1,석수,8519,7378,20200312,15897
20200309,1,관악,5960,5420,20200312,11380
20200309,1,안양,17091,16921,20200312,34012
20200309,1,명학,7791,7659,20200312,15450
20200309,4,금정,20986,21824,20200312,42810
20200309,1,군포,6252,6419,20200312,12671
20200309,1,의왕,7345,7320,20200312,14665
20200309,1,성균관대,10462,10366,20200312,20828
20200309,1,화서,5997,5781,20200312,11778
20200309,1,수원,23403,25008,20200312,48411
20200309,1,독산,14695,15561,20200312,30256
20200309,1,세류,2358,2163,20200312,4521
20200309,1,병점,9795,9817,20200312,19612
20200309,1,세마,1833,1688,20200312,3521
20200309,1,오산대,2028,1810,20200312,3838
20200309,1,오산,6564,6561,20200312,13125
20200309,1,진위,1178,1029,20200312,2207
20200309,1,송탄,2865,2687,20200312,5552
20200309,1,서정리,3742,3805,20200312,7547
20200309,1,지제,1653,1567,20200312,3220
20200309,1,평택,7407,7299,20200312,14706
20200309,1,성환,1921,2029,20200312,3950
20200309,1,직산,483,487,20200312,970
20200309,1,두정,2656,2774,20200312,5430
20200309,1,천안,2706,2789,20200312,5495
20200309,1,당정,4977,4733,20200312,9710
20200309,경부선,서동탄,1303,1019,20200312,2322
20200309,경부선,광명,2215,1896,20200312,4111
20200310,경부선,서울역,2152,793,20200313,2945
20200310,1,남영,7628,8058,20200313,15686
20200310,1,용산,21980,22701,20200313,44681
20200310,1,노량진,5787,6107,20200313,11894
20200310,1,대방,10289,10536,20200313,20825
20200310,1,영등포,27017,28233,20200313,55250
20200310,경부선,신도림,2924,2784,20200313,5708
20200310,1,신길,7111,6014,20200313,13125
20200310,1,구로,13615,13855,20200313,27470
20200310,1,가산디지털단지,14703,16996,20200313,31699
20200310,1,금천구청,8847,8937,20200313,17784
20200310,1,석수,7873,6827,20200313,14700
20200310,1,관악,5435,5005,20200313,10440
20200310,1,안양,15891,15865,20200313,31756
20200310,1,명학,7456,7347,20200313,14803
20200310,4,금정,20052,20501,20200313,40553
20200310,1,군포,6009,6128,20200313,12137
20200310,1,의왕,6818,6779,20200313,13597
20200310,1,성균관대,9903,9784,20200313,19687
20200310,1,화서,5446,5116,20200313,10562
20200310,1,수원,21529,23280,20200313,44809
20200310,1,독산,14108,14712,20200313,28820
20200310,1,세류,2202,2018,20200313,4220
20200310,1,병점,9273,9108,20200313,18381
20200310,1,세마,1661,1552,20200313,3213
20200310,1,오산대,1904,1672,20200313,3576
20200310,1,오산,6034,6144,20200313,12178
20200310,1,진위,1104,972,20200313,2076
20200310,1,송탄,2532,2436,20200313,4968
20200310,1,서정리,3563,3514,20200313,7077
20200310,1,지제,1482,1423,20200313,2905
20200310,1,평택,6776,6598,20200313,13374
20200310,1,성환,1863,1805,20200313,3668
20200310,1,직산,396,417,20200313,813
20200310,1,두정,2500,2506,20200313,5006
20200310,1,천안,2363,2376,20200313,4739
20200310,1,당정,4631,4563,20200313,9194
20200310,경부선,서동탄,1179,922,20200313,2101
20200310,경부선,광명,1876,1735,20200313,3611
20200311,경부선,서울역,2111,770,20200314,2881
20200311,1,남영,7821,8140,20200314,15961
20200311,1,용산,22528,23282,20200314,45810
20200311,1,노량진,6223,6279,20200314,12502
20200311,1,대방,10196,10469,20200314,20665
20200311,1,영등포,27304,28437,20200314,55741
20200311,경부선,신도림,2994,2875,20200314,5869
20200311,1,신길,7445,6236,20200314,13681
20200311,1,구로,13197,13252,20200314,26449
20200311,1,가산디지털단지,14482,16522,20200314,31004
20200311,1,금천구청,8892,9029,20200314,17921
20200311,1,석수,8193,7097,20200314,15290
20200311,1,관악,5663,5190,20200314,10853
20200311,1,안양,16277,16265,20200314,32542
20200311,1,명학,7511,7396,20200314,14907
20200311,4,금정,20907,21443,20200314,42350
20200311,1,군포,6165,6200,20200314,12365
20200311,1,의왕,7190,7145,20200314,14335
20200311,1,성균관대,10355,10224,20200314,20579
20200311,1,화서,5727,5491,20200314,11218
20200311,1,수원,23132,25043,20200314,48175
20200311,1,독산,13996,14487,20200314,28483
20200311,1,세류,2292,2142,20200314,4434
20200311,1,병점,9667,9544,20200314,19211
20200311,1,세마,1846,1679,20200314,3525
20200311,1,오산대,1929,1765,20200314,3694
20200311,1,오산,6346,6320,20200314,12666
20200311,1,진위,1130,997,20200314,2127
20200311,1,송탄,2738,2683,20200314,5421
20200311,1,서정리,3706,3536,20200314,7242
20200311,1,지제,1631,1527,20200314,3158
20200311,1,평택,7300,7134,20200314,14434
20200311,1,성환,1969,1977,20200314,3946
20200311,1,직산,469,483,20200314,952
20200311,1,두정,2762,2693,20200314,5455
20200311,1,천안,2625,2742,20200314,5367
20200311,1,당정,4856,4709,20200314,9565
20200311,경부선,서동탄,1183,948,20200314,2131
20200311,경부선,광명,1968,1770,20200314,3738
20200312,경부선,서울역,2223,795,20200315,3018
20200312,1,남영,7743,8128,20200315,15871
20200312,1,용산,22278,22953,20200315,45231
20200312,1,노량진,6225,6349,20200315,12574
20200312,1,대방,10065,10258,20200315,20323
20200312,1,영등포,26796,27567,20200315,54363
20200312,경부선,신도림,2918,2795,20200315,5713
20200312,1,신길,7376,6105,20200315,13481
20200312,1,구로,12907,12883,20200315,25790
20200312,1,가산디지털단지,14480,16385,20200315,30865
20200312,1,금천구청,8826,8724,20200315,17550
20200312,1,석수,7927,6948,20200315,14875
20200312,1,관악,5607,5132,20200315,10739
20200312,1,안양,16035,16030,20200315,32065
20200312,1,명학,7333,7304,20200315,14637
20200312,4,금정,20515,20983,20200315,41498
20200312,1,군포,6008,6048,20200315,12056
20200312,1,의왕,7024,7003,20200315,14027
20200312,1,성균관대,10254,10204,20200315,20458
20200312,1,화서,5621,5409,20200315,11030
20200312,1,수원,22908,24634,20200315,47542
20200312,1,독산,13670,14166,20200315,27836
20200312,1,세류,2285,2090,20200315,4375
20200312,1,병점,9637,9584,20200315,19221
20200312,1,세마,1753,1602,20200315,3355
20200312,1,오산대,2068,1764,20200315,3832
20200312,1,오산,6122,6166,20200315,12288
20200312,1,진위,1192,996,20200315,2188
20200312,1,송탄,2698,2621,20200315,5319
20200312,1,서정리,3762,3645,20200315,7407
20200312,1,지제,1649,1567,20200315,3216
20200312,1,평택,7094,6946,20200315,14040
20200312,1,성환,1879,1902,20200315,3781
20200312,1,직산,477,477,20200315,954
20200312,1,두정,2692,2748,20200315,5440
20200312,1,천안,2577,2644,20200315,5221
20200312,1,당정,4772,4578,20200315,9350
20200312,경부선,서동탄,1196,932,20200315,2128
20200312,경부선,광명,1952,1727,20200315,3679
20200313,경부선,서울역,3174,967,20200316,4141
20200313,1,남영,7625,8071,20200316,15696
20200313,1,용산,24463,25685,20200316,50148
20200313,1,노량진,6439,6436,20200316,12875
20200313,1,대방,10005,10021,20200316,20026
20200313,1,영등포,28957,31025,20200316,59982
20200313,경부선,신도림,2959,2867,20200316,5826
20200313,1,신길,7525,6241,20200316,13766
20200313,1,구로,13166,13199,20200316,26365
20200313,1,가산디지털단지,14397,16223,20200316,30620
20200313,1,금천구청,8891,8862,20200316,17753
20200313,1,석수,8105,6976,20200316,15081
20200313,1,관악,5546,5065,20200316,10611
20200313,1,안양,16704,17154,20200316,33858
20200313,1,명학,7305,7120,20200316,14425
20200313,4,금정,21061,21479,20200316,42540
20200313,1,군포,6104,6012,20200316,12116
20200313,1,의왕,7267,7035,20200316,14302
20200313,1,성균관대,10658,10305,20200316,20963
20200313,1,화서,5647,5367,20200316,11014
20200313,1,수원,25377,27331,20200316,52708
20200313,1,독산,13754,14153,20200316,27907
20200313,1,세류,2338,2162,20200316,4500
20200313,1,병점,10594,10075,20200316,20669
20200313,1,세마,1900,1711,20200316,3611
20200313,1,오산대,2177,1878,20200316,4055
20200313,1,오산,7147,6773,20200316,13920
20200313,1,진위,1224,973,20200316,2197
20200313,1,송탄,2950,2806,20200316,5756
20200313,1,서정리,4206,3790,20200316,7996
20200313,1,지제,1908,1676,20200316,3584
20200313,1,평택,8170,7798,20200316,15968
20200313,1,성환,2298,2018,20200316,4316
20200313,1,직산,563,531,20200316,1094
20200313,1,두정,3145,3005,20200316,6150
20200313,1,천안,2791,3049,20200316,5840
20200313,1,당정,4838,4650,20200316,9488
20200313,경부선,서동탄,1239,1032,20200316,2271
20200313,경부선,광명,2239,1953,20200316,4192
20200314,경부선,서울역,1838,467,20200317,2305
20200314,1,남영,3873,3854,20200317,7727
20200314,1,용산,17481,18230,20200317,35711
20200314,1,노량진,5000,4433,20200317,9433
20200314,1,대방,5396,5373,20200317,10769
20200314,1,영등포,22679,24028,20200317,46707
20200314,경부선,신도림,1641,1603,20200317,3244
20200314,1,신길,4406,3633,20200317,8039
20200314,1,구로,7467,7512,20200317,14979
20200314,1,가산디지털단지,3816,4865,20200317,8681
20200314,1,금천구청,5086,5005,20200317,10091
20200314,1,석수,4772,4520,20200317,9292
20200314,1,관악,3869,3523,20200317,7392
20200314,1,안양,11649,11900,20200317,23549
20200314,1,명학,3415,3242,20200317,6657
20200314,4,금정,12332,12668,20200317,25000
20200314,1,군포,3124,2838,20200317,5962
20200314,1,의왕,4079,3879,20200317,7958
20200314,1,성균관대,6420,6247,20200317,12667
20200314,1,화서,3161,3095,20200317,6256
20200314,1,수원,20895,23053,20200317,43948
20200314,1,독산,5597,5533,20200317,11130
20200314,1,세류,1576,1652,20200317,3228
20200314,1,병점,7117,6859,20200317,13976
20200314,1,세마,1230,1054,20200317,2284
20200314,1,오산대,1432,1299,20200317,2731
20200314,1,오산,5380,5029,20200317,10409
20200314,1,진위,649,535,20200317,1184
20200314,1,송탄,2651,2422,20200317,5073
20200314,1,서정리,3694,2943,20200317,6637
20200314,1,지제,1386,1174,20200317,2560
20200314,1,평택,7115,6742,20200317,13857
20200314,1,성환,1720,1621,20200317,3341
20200314,1,직산,358,323,20200317,681
20200314,1,두정,2397,2403,20200317,4800
20200314,1,천안,2693,2785,20200317,5478
20200314,1,당정,2577,2432,20200317,5009
20200314,경부선,서동탄,569,543,20200317,1112
20200314,경부선,광명,1157,1029,20200317,2186
20200315,경부선,서울역,2158,511,20200318,2669
20200315,1,남영,2570,2737,20200318,5307
20200315,1,용산,15944,14375,20200318,30319
20200315,1,노량진,3503,3382,20200318,6885
20200315,1,대방,3416,3581,20200318,6997
20200315,1,영등포,17379,16958,20200318,34337
20200315,경부선,신도림,983,1042,20200318,2025
20200315,1,신길,2957,2575,20200318,5532
20200315,1,구로,4584,4574,20200318,9158
20200315,1,가산디지털단지,2458,3390,20200318,5848
20200315,1,금천구청,3451,3289,20200318,6740
20200315,1,석수,3154,3213,20200318,6367
20200315,1,관악,2859,2570,20200318,5429
20200315,1,안양,8494,8031,20200318,16525
20200315,1,명학,2021,2015,20200318,4036
20200315,4,금정,8188,8476,20200318,16664
20200315,1,군포,1884,1778,20200318,3662
20200315,1,의왕,2602,2638,20200318,5240
20200315,1,성균관대,4320,4561,20200318,8881
20200315,1,화서,2150,2039,20200318,4189
20200315,1,수원,16590,16910,20200318,33500
20200315,1,독산,3396,3416,20200318,6812
20200315,1,세류,1224,1206,20200318,2430
20200315,1,병점,4951,5677,20200318,10628
20200315,1,세마,856,795,20200318,1651
20200315,1,오산대,1021,950,20200318,1971
20200315,1,오산,3976,4432,20200318,8408
20200315,1,진위,409,393,20200318,802
20200315,1,송탄,1879,1960,20200318,3839
20200315,1,서정리,2136,3215,20200318,5351
20200315,1,지제,946,868,20200318,1814
20200315,1,평택,5572,5940,20200318,11512
20200315,1,성환,1191,1504,20200318,2695
20200315,1,직산,286,320,20200318,606
20200315,1,두정,1765,2094,20200318,3859
20200315,1,천안,2457,2386,20200318,4843
20200315,1,당정,1868,1857,20200318,3725
20200315,경부선,서동탄,397,434,20200318,831
20200315,경부선,광명,953,751,20200318,1704
20200316,경부선,서울역,2621,893,20200319,3514
20200316,1,남영,7771,8238,20200319,16009
20200316,1,용산,22533,22937,20200319,45470
20200316,1,노량진,7005,7014,20200319,14019
20200316,1,대방,10279,10586,20200319,20865
20200316,1,영등포,27075,28036,20200319,55111
20200316,경부선,신도림,3050,3020,20200319,6070
20200316,1,신길,7559,6424,20200319,13983
20200316,1,구로,13868,13748,20200319,27616
20200316,1,가산디지털단지,14930,17086,20200319,32016
20200316,1,금천구청,9117,9022,20200319,18139
20200316,1,석수,8253,7275,20200319,15528
20200316,1,관악,5700,5207,20200319,10907
20200316,1,안양,16724,16663,20200319,33387
20200316,1,명학,7530,7532,20200319,15062
20200316,4,금정,20912,21603,20200319,42515
20200316,1,군포,6235,6416,20200319,12651
20200316,1,의왕,7161,7218,20200319,14379
20200316,1,성균관대,10490,10426,20200319,20916
20200316,1,화서,5768,5502,20200319,11270
20200316,1,수원,23393,25188,20200319,48581
20200316,1,독산,14222,14886,20200319,29108
20200316,1,세류,2294,2162,20200319,4456
20200316,1,병점,9860,9860,20200319,19720
20200316,1,세마,1808,1634,20200319,3442
20200316,1,오산대,1994,1800,20200319,3794
20200316,1,오산,6696,6569,20200319,13265
20200316,1,진위,1110,993,20200319,2103
20200316,1,송탄,2852,2638,20200319,5490
20200316,1,서정리,3673,3822,20200319,7495
20200316,1,지제,1717,1619,20200319,3336
20200316,1,평택,7605,7459,20200319,15064
20200316,1,성환,2106,2283,20200319,4389
20200316,1,직산,470,490,20200319,960
20200316,1,두정,2925,3029,20200319,5954
20200316,1,천안,2829,2922,20200319,5751
20200316,1,당정,4904,4793,20200319,9697
20200316,경부선,서동탄,1232,1006,20200319,2238
20200316,경부선,광명,2211,1894,20200319,4105
20200317,경부선,서울역,2287,790,20200320,3077
20200317,1,남영,7699,8123,20200320,15822
20200317,1,용산,22021,22146,20200320,44167
20200317,1,노량진,7100,7164,20200320,14264
20200317,1,대방,10332,10525,20200320,20857
20200317,1,영등포,27634,28597,20200320,56231
20200317,경부선,신도림,3081,2958,20200320,6039
20200317,1,신길,7628,6335,20200320,13963
20200317,1,구로,13694,13801,20200320,27495
20200317,1,가산디지털단지,14939,16975,20200320,31914
20200317,1,금천구청,9161,9013,20200320,18174
20200317,1,석수,8190,7134,20200320,15324
20200317,1,관악,5812,5247,20200320,11059
20200317,1,안양,16357,16400,20200320,32757
20200317,1,명학,7728,7565,20200320,15293
20200317,4,금정,21106,21627,20200320,42733
20200317,1,군포,6347,6400,20200320,12747
20200317,1,의왕,7191,7135,20200320,14326
20200317,1,성균관대,10464,10271,20200320,20735
20200317,1,화서,5749,5516,20200320,11265
20200317,1,수원,23145,24799,20200320,47944
20200317,1,독산,14160,14745,20200320,28905
20200317,1,세류,2331,2110,20200320,4441
20200317,1,병점,9688,9587,20200320,19275
20200317,1,세마,1779,1626,20200320,3405
20200317,1,오산대,1944,1829,20200320,3773
20200317,1,오산,6306,6158,20200320,12464
20200317,1,진위,1080,954,20200320,2034
20200317,1,송탄,2723,2660,20200320,5383
20200317,1,서정리,3634,3733,20200320,7367
20200317,1,지제,1609,1543,20200320,3152
20200317,1,평택,7395,7166,20200320,14561
20200317,1,성환,2012,2062,20200320,4074
20200317,1,직산,496,497,20200320,993
20200317,1,두정,2917,2876,20200320,5793
20200317,1,천안,2677,2719,20200320,5396
20200317,1,당정,4907,4717,20200320,9624
20200317,경부선,서동탄,1209,967,20200320,2176
20200317,경부선,광명,2012,1776,20200320,3788
20200318,경부선,서울역,2386,809,20200321,3195
20200318,1,남영,8013,8398,20200321,16411
20200318,1,용산,22242,22571,20200321,44813
20200318,1,노량진,7437,7344,20200321,14781
20200318,1,대방,10396,10528,20200321,20924
20200318,1,영등포,28374,29269,20200321,57643
20200318,경부선,신도림,3279,3102,20200321,6381
20200318,1,신길,7778,6483,20200321,14261
20200318,1,구로,14200,14363,20200321,28563
20200318,1,가산디지털단지,15194,17191,20200321,32385
20200318,1,금천구청,9542,9426,20200321,18968
20200318,1,석수,8601,7492,20200321,16093
20200318,1,관악,6035,5388,20200321,11423
20200318,1,안양,17251,17467,20200321,34718
20200318,1,명학,7655,7588,20200321,15243
20200318,4,금정,21728,22135,20200321,43863
20200318,1,군포,6474,6550,20200321,13024
20200318,1,의왕,7447,7325,20200321,14772
20200318,1,성균관대,10822,10639,20200321,21461
20200318,1,화서,5921,5703,20200321,11624
20200318,1,수원,24133,26068,20200321,50201
20200318,1,독산,14362,14988,20200321,29350
20200318,1,세류,2435,2250,20200321,4685
20200318,1,병점,10242,9961,20200321,20203
20200318,1,세마,1805,1714,20200321,3519
20200318,1,오산대,2143,1962,20200321,4105
20200318,1,오산,6710,6733,20200321,13443
20200318,1,진위,1155,1035,20200321,2190
20200318,1,송탄,2835,2742,20200321,5577
20200318,1,서정리,3865,3803,20200321,7668
20200318,1,지제,1736,1569,20200321,3305
20200318,1,평택,7599,7410,20200321,15009
20200318,1,성환,2123,2073,20200321,4196
20200318,1,직산,495,505,20200321,1000
20200318,1,두정,3009,3003,20200321,6012
20200318,1,천안,2817,2848,20200321,5665
20200318,1,당정,5061,4863,20200321,9924
20200318,경부선,서동탄,1263,994,20200321,2257
20200318,경부선,광명,2051,1786,20200321,3837
20200319,경부선,서울역,2417,834,20200322,3251
20200319,1,남영,7647,8068,20200322,15715
20200319,1,용산,22219,22720,20200322,44939
20200319,1,노량진,6999,7127,20200322,14126
20200319,1,대방,10075,10265,20200322,20340
20200319,1,영등포,27181,28229,20200322,55410
20200319,경부선,신도림,2966,2870,20200322,5836
20200319,1,신길,7265,6212,20200322,13477
20200319,1,구로,13770,13755,20200322,27525
20200319,1,가산디지털단지,14650,16694,20200322,31344
20200319,1,금천구청,8899,8692,20200322,17591
20200319,1,석수,7859,6927,20200322,14786
20200319,1,관악,5597,5141,20200322,10738
20200319,1,안양,16151,16166,20200322,32317
20200319,1,명학,7356,7311,20200322,14667
20200319,4,금정,20548,20982,20200322,41530
20200319,1,군포,6220,6197,20200322,12417
20200319,1,의왕,6927,6977,20200322,13904
20200319,1,성균관대,10134,9863,20200322,19997
20200319,1,화서,5471,5249,20200322,10720
20200319,1,수원,22233,24181,20200322,46414
20200319,1,독산,13933,14581,20200322,28514
20200319,1,세류,2240,2032,20200322,4272
20200319,1,병점,9379,9318,20200322,18697
20200319,1,세마,1727,1593,20200322,3320
20200319,1,오산대,1905,1723,20200322,3628
20200319,1,오산,6147,6136,20200322,12283
20200319,1,진위,1110,966,20200322,2076
20200319,1,송탄,2654,2528,20200322,5182
20200319,1,서정리,3619,3586,20200322,7205
20200319,1,지제,1578,1531,20200322,3109
20200319,1,평택,6926,6720,20200322,13646
20200319,1,성환,1938,1955,20200322,3893
20200319,1,직산,449,460,20200322,909
20200319,1,두정,2850,2751,20200322,5601
20200319,1,천안,2577,2744,20200322,5321
20200319,1,당정,4802,4598,20200322,9400
20200319,경부선,서동탄,1132,910,20200322,2042
20200319,경부선,광명,2080,1857,20200322,3937
20200320,경부선,서울역,3523,1068,20200323,4591
20200320,1,남영,8108,8488,20200323,16596
20200320,1,용산,27897,29111,20200323,57008
20200320,1,노량진,8128,7800,20200323,15928
20200320,1,대방,10647,10691,20200323,21338
20200320,1,영등포,31316,33460,20200323,64776
20200320,경부선,신도림,3217,3146,20200323,6363
20200320,1,신길,7837,6606,20200323,14443
20200320,1,구로,14333,14485,20200323,28818
20200320,1,가산디지털단지,15169,17291,20200323,32460
20200320,1,금천구청,9664,9473,20200323,19137
20200320,1,석수,8638,7418,20200323,16056
20200320,1,관악,6031,5359,20200323,11390
20200320,1,안양,17961,18421,20200323,36382
20200320,1,명학,7699,7377,20200323,15076
20200320,4,금정,22204,22720,20200323,44924
20200320,1,군포,6457,6386,20200323,12843
20200320,1,의왕,7512,7337,20200323,14849
20200320,1,성균관대,11502,11189,20200323,22691
20200320,1,화서,6054,5768,20200323,11822
20200320,1,수원,27057,29780,20200323,56837
20200320,1,독산,14631,14994,20200323,29625
20200320,1,세류,2497,2324,20200323,4821
20200320,1,병점,11251,10874,20200323,22125
20200320,1,세마,1973,1812,20200323,3785
20200320,1,오산대,2298,2096,20200323,4394
20200320,1,오산,7660,7070,20200323,14730
20200320,1,진위,1320,1095,20200323,2415
20200320,1,송탄,3132,2945,20200323,6077
20200320,1,서정리,4508,4004,20200323,8512
20200320,1,지제,2014,1778,20200323,3792
20200320,1,평택,8907,8501,20200323,17408
20200320,1,성환,2610,2400,20200323,5010
20200320,1,직산,587,546,20200323,1133
20200320,1,두정,3673,3441,20200323,7114
20200320,1,천안,3402,3502,20200323,6904
20200320,1,당정,5199,4855,20200323,10054
20200320,경부선,서동탄,1313,1055,20200323,2368
20200320,경부선,광명,2490,2075,20200323,4565
20200321,경부선,서울역,2099,521,20200324,2620
20200321,1,남영,3998,4003,20200324,8001
20200321,1,용산,17656,18952,20200324,36608
20200321,1,노량진,6514,5448,20200324,11962
20200321,1,대방,5567,5488,20200324,11055
20200321,1,영등포,24772,26219,20200324,50991
20200321,경부선,신도림,1922,1767,20200324,3689
20200321,1,신길,4711,3708,20200324,8419
20200321,1,구로,7893,8141,20200324,16034
20200321,1,가산디지털단지,4377,5612,20200324,9989
20200321,1,금천구청,5575,5522,20200324,11097
20200321,1,석수,5147,4801,20200324,9948
20200321,1,관악,4236,3865,20200324,8101
20200321,1,안양,12504,12792,20200324,25296
20200321,1,명학,3843,3547,20200324,7390
20200321,4,금정,13182,13251,20200324,26433
20200321,1,군포,3335,2962,20200324,6297
20200321,1,의왕,4297,4235,20200324,8532
20200321,1,성균관대,6911,6802,20200324,13713
20200321,1,화서,3642,3475,20200324,7117
20200321,1,수원,22416,25132,20200324,47548
20200321,1,독산,6058,5975,20200324,12033
20200321,1,세류,1661,1749,20200324,3410
20200321,1,병점,7707,7496,20200324,15203
20200321,1,세마,1294,1115,20200324,2409
20200321,1,오산대,1606,1388,20200324,2994
20200321,1,오산,5936,5479,20200324,11415
20200321,1,진위,692,650,20200324,1342
20200321,1,송탄,2701,2466,20200324,5167
20200321,1,서정리,4001,3259,20200324,7260
20200321,1,지제,1455,1208,20200324,2663
20200321,1,평택,7728,7330,20200324,15058
20200321,1,성환,1992,1789,20200324,3781
20200321,1,직산,416,401,20200324,817
20200321,1,두정,2641,2656,20200324,5297
20200321,1,천안,3184,3227,20200324,6411
20200321,1,당정,2814,2734,20200324,5548
20200321,경부선,서동탄,642,681,20200324,1323
20200321,경부선,광명,1297,1100,20200324,2397
20200322,경부선,서울역,2382,503,20200325,2885
20200322,1,남영,2692,2798,20200325,5490
20200322,1,용산,15989,14436,20200325,30425
20200322,1,노량진,4313,3858,20200325,8171
20200322,1,대방,3795,4045,20200325,7840
20200322,1,영등포,19158,18543,20200325,37701
20200322,경부선,신도림,1283,1267,20200325,2550
20200322,1,신길,3273,2958,20200325,6231
20200322,1,구로,5372,5288,20200325,10660
20200322,1,가산디지털단지,2961,3985,20200325,6946
20200322,1,금천구청,4008,3829,20200325,7837
20200322,1,석수,3743,3821,20200325,7564
20200322,1,관악,3577,3140,20200325,6717
20200322,1,안양,9505,9019,20200325,18524
20200322,1,명학,2306,2134,20200325,4440
20200322,4,금정,9127,9383,20200325,18510
20200322,1,군포,2176,1974,20200325,4150
20200322,1,의왕,2901,2822,20200325,5723
20200322,1,성균관대,4881,5164,20200325,10045
20200322,1,화서,2526,2457,20200325,4983
20200322,1,수원,18720,19173,20200325,37893
20200322,1,독산,3903,3849,20200325,7752
20200322,1,세류,1337,1348,20200325,2685
20200322,1,병점,5407,6063,20200325,11470
20200322,1,세마,981,918,20200325,1899
20200322,1,오산대,1206,1126,20200325,2332
20200322,1,오산,4461,4910,20200325,9371
20200322,1,진위,461,452,20200325,913
20200322,1,송탄,2050,2223,20200325,4273
20200322,1,서정리,2432,3551,20200325,5983
20200322,1,지제,1053,970,20200325,2023
20200322,1,평택,6197,6601,20200325,12798
20200322,1,성환,1417,1707,20200325,3124
20200322,1,직산,351,391,20200325,742
20200322,1,두정,2088,2383,20200325,4471
20200322,1,천안,2844,2872,20200325,5716
20200322,1,당정,1976,1928,20200325,3904
20200322,경부선,서동탄,462,487,20200325,949
20200322,경부선,광명,1117,808,20200325,1925
20200323,경부선,서울역,2789,915,20200326,3704
20200323,1,남영,7810,8262,20200326,16072
20200323,1,용산,23222,23728,20200326,46950
20200323,1,노량진,7592,7368,20200326,14960
20200323,1,대방,10843,11066,20200326,21909
20200323,1,영등포,28706,29582,20200326,58288
20200323,경부선,신도림,3331,3193,20200326,6524
20200323,1,신길,7883,6644,20200326,14527
20200323,1,구로,14426,14472,20200326,28898
20200323,1,가산디지털단지,15907,17962,20200326,33869
20200323,1,금천구청,9650,9501,20200326,19151
20200323,1,석수,8543,7459,20200326,16002
20200323,1,관악,5891,5463,20200326,11354
20200323,1,안양,17099,17007,20200326,34106
20200323,1,명학,7835,7715,20200326,15550
20200323,4,금정,21396,22228,20200326,43624
20200323,1,군포,6391,6607,20200326,12998
20200323,1,의왕,7577,7573,20200326,15150
20200323,1,성균관대,10794,10703,20200326,21497
20200323,1,화서,6085,5863,20200326,11948
20200323,1,수원,24493,26232,20200326,50725
20200323,1,독산,14389,15156,20200326,29545
20200323,1,세류,2483,2276,20200326,4759
20200323,1,병점,10221,10320,20200326,20541
20200323,1,세마,1876,1684,20200326,3560
20200323,1,오산대,2203,1505,20200326,3708
20200323,1,오산,7059,7103,20200326,14162
20200323,1,진위,1213,1048,20200326,2261
20200323,1,송탄,2928,2797,20200326,5725
20200323,1,서정리,3866,4068,20200326,7934
20200323,1,지제,1777,1695,20200326,3472
20200323,1,평택,7929,7784,20200326,15713
20200323,1,성환,2202,2425,20200326,4627
20200323,1,직산,527,519,20200326,1046
20200323,1,두정,3113,3311,20200326,6424
20200323,1,천안,3217,3222,20200326,6439
20200323,1,당정,5038,4841,20200326,9879
20200323,경부선,서동탄,1241,1000,20200326,2241
20200323,경부선,광명,2081,1828,20200326,3909
20200324,경부선,서울역,2413,842,20200327,3255
20200324,1,남영,7882,8416,20200327,16298
20200324,1,용산,22546,23066,20200327,45612
20200324,1,노량진,7545,7424,20200327,14969
20200324,1,대방,10665,10942,20200327,21607
20200324,1,영등포,28350,29354,20200327,57704
20200324,경부선,신도림,3295,3206,20200327,6501
20200324,1,신길,7922,6643,20200327,14565
20200324,1,구로,14671,14655,20200327,29326
20200324,1,가산디지털단지,15832,18033,20200327,33865
20200324,1,금천구청,9601,9393,20200327,18994
20200324,1,석수,8587,7414,20200327,16001
20200324,1,관악,6054,5579,20200327,11633
20200324,1,안양,17150,17253,20200327,34403
20200324,1,명학,7735,7616,20200327,15351
20200324,4,금정,21353,22067,20200327,43420
20200324,1,군포,6539,6588,20200327,13127
20200324,1,의왕,7562,7490,20200327,15052
20200324,1,성균관대,10784,10605,20200327,21389
20200324,1,화서,6028,5735,20200327,11763
20200324,1,수원,23936,25854,20200327,49790
20200324,1,독산,14474,15218,20200327,29692
20200324,1,세류,2424,2266,20200327,4690
20200324,1,병점,10302,10136,20200327,20438
20200324,1,세마,1851,1710,20200327,3561
20200324,1,오산대,2144,1504,20200327,3648
20200324,1,오산,6589,6565,20200327,13154
20200324,1,진위,1180,1021,20200327,2201
20200324,1,송탄,2686,2549,20200327,5235
20200324,1,서정리,3712,3763,20200327,7475
20200324,1,지제,1663,1564,20200327,3227
20200324,1,평택,7528,7198,20200327,14726
20200324,1,성환,2188,2193,20200327,4381
20200324,1,직산,529,531,20200327,1060
20200324,1,두정,2973,3038,20200327,6011
20200324,1,천안,2909,3158,20200327,6067
20200324,1,당정,5025,4959,20200327,9984
20200324,경부선,서동탄,1257,1073,20200327,2330
20200324,경부선,광명,2012,1681,20200327,3693
20200325,경부선,서울역,2418,834,20200328,3252
20200325,1,남영,8027,8385,20200328,16412
20200325,1,용산,22977,23631,20200328,46608
20200325,1,노량진,7726,7412,20200328,15138
20200325,1,대방,10723,10956,20200328,21679
20200325,1,영등포,29552,30821,20200328,60373
20200325,경부선,신도림,3351,3344,20200328,6695
20200325,1,신길,8085,6733,20200328,14818
20200325,1,구로,14695,14891,20200328,29586
20200325,1,가산디지털단지,15875,17864,20200328,33739
20200325,1,금천구청,9754,9577,20200328,19331
20200325,1,석수,8643,7622,20200328,16265
20200325,1,관악,6148,5650,20200328,11798
20200325,1,안양,17410,17729,20200328,35139
20200325,1,명학,7858,7739,20200328,15597
20200325,4,금정,21746,22306,20200328,44052
20200325,1,군포,6555,6644,20200328,13199
20200325,1,의왕,7697,7622,20200328,15319
20200325,1,성균관대,11050,10935,20200328,21985
20200325,1,화서,6134,5939,20200328,12073
20200325,1,수원,25046,26819,20200328,51865
20200325,1,독산,14517,15328,20200328,29845
20200325,1,세류,2409,2313,20200328,4722
20200325,1,병점,10519,10193,20200328,20712
20200325,1,세마,1860,1788,20200328,3648
20200325,1,오산대,2209,1874,20200328,4083
20200325,1,오산,6657,6639,20200328,13296
20200325,1,진위,1198,1028,20200328,2226
20200325,1,송탄,2924,2689,20200328,5613
20200325,1,서정리,3920,3925,20200328,7845
20200325,1,지제,1698,1590,20200328,3288
20200325,1,평택,7669,7536,20200328,15205
20200325,1,성환,2226,2310,20200328,4536
20200325,1,직산,525,537,20200328,1062
20200325,1,두정,3101,3130,20200328,6231
20200325,1,천안,3020,3128,20200328,6148
20200325,1,당정,5102,4885,20200328,9987
20200325,경부선,서동탄,1280,1047,20200328,2327
20200325,경부선,광명,2071,1801,20200328,3872
20200326,경부선,서울역,2442,891,20200329,3333
20200326,1,남영,7935,8362,20200329,16297
20200326,1,용산,23094,23801,20200329,46895
20200326,1,노량진,7345,7399,20200329,14744
20200326,1,대방,10654,10886,20200329,21540
20200326,1,영등포,28603,29671,20200329,58274
20200326,경부선,신도림,3216,3189,20200329,6405
20200326,1,신길,7650,6429,20200329,14079
20200326,1,구로,14487,14626,20200329,29113
20200326,1,가산디지털단지,15535,17785,20200329,33320
20200326,1,금천구청,9460,9315,20200329,18775
20200326,1,석수,8518,7434,20200329,15952
20200326,1,관악,5885,5439,20200329,11324
20200326,1,안양,17017,17019,20200329,34036
20200326,1,명학,7812,7658,20200329,15470
20200326,4,금정,21219,21864,20200329,43083
20200326,1,군포,6350,6390,20200329,12740
20200326,1,의왕,7361,7411,20200329,14772
20200326,1,성균관대,10846,10606,20200329,21452
20200326,1,화서,5925,5534,20200329,11459
20200326,1,수원,24114,25965,20200329,50079
20200326,1,독산,14330,15014,20200329,29344
20200326,1,세류,2424,2184,20200329,4608
20200326,1,병점,10115,9819,20200329,19934
20200326,1,세마,1888,1768,20200329,3656
20200326,1,오산대,2094,1883,20200329,3977
20200326,1,오산,6504,6461,20200329,12965
20200326,1,진위,1144,1018,20200329,2162
20200326,1,송탄,2730,2636,20200329,5366
20200326,1,서정리,3720,3767,20200329,7487
20200326,1,지제,1726,1526,20200329,3252
20200326,1,평택,7454,7183,20200329,14637
20200326,1,성환,2067,2071,20200329,4138
20200326,1,직산,476,519,20200329,995
20200326,1,두정,2999,2971,20200329,5970
20200326,1,천안,2849,2924,20200329,5773
20200326,1,당정,5023,4763,20200329,9786
20200326,경부선,서동탄,1222,1071,20200329,2293
20200326,경부선,광명,2004,1794,20200329,3798
20200327,경부선,서울역,3353,1157,20200330,4510
20200327,1,남영,7960,8363,20200330,16323
20200327,1,용산,26496,27864,20200330,54360
20200327,1,노량진,8020,7845,20200330,15865
20200327,1,대방,10841,10818,20200330,21659
20200327,1,영등포,32812,34605,20200330,67417
20200327,경부선,신도림,3319,3268,20200330,6587
20200327,1,신길,7913,6543,20200330,14456
20200327,1,구로,14791,15040,20200330,29831
20200327,1,가산디지털단지,15599,17743,20200330,33342
20200327,1,금천구청,9662,9416,20200330,19078
20200327,1,석수,8672,7489,20200330,16161
20200327,1,관악,6006,5505,20200330,11511
20200327,1,안양,17894,18520,20200330,36414
20200327,1,명학,7730,7277,20200330,15007
20200327,4,금정,22301,22760,20200330,45061
20200327,1,군포,6497,6469,20200330,12966
20200327,1,의왕,7708,7570,20200330,15278
20200327,1,성균관대,11358,11129,20200330,22487
20200327,1,화서,6129,5811,20200330,11940
20200327,1,수원,27134,29427,20200330,56561
20200327,1,독산,14632,15058,20200330,29690
20200327,1,세류,2506,2371,20200330,4877
20200327,1,병점,11219,10684,20200330,21903
20200327,1,세마,2019,1823,20200330,3842
20200327,1,오산대,2364,2032,20200330,4396
20200327,1,오산,7483,7107,20200330,14590
20200327,1,진위,1348,1096,20200330,2444
20200327,1,송탄,3065,2951,20200330,6016
20200327,1,서정리,4401,3974,20200330,8375
20200327,1,지제,2058,1785,20200330,3843
20200327,1,평택,8417,8269,20200330,16686
20200327,1,성환,2479,2232,20200330,4711
20200327,1,직산,549,539,20200330,1088
20200327,1,두정,3555,3358,20200330,6913
20200327,1,천안,3288,3485,20200330,6773
20200327,1,당정,5241,4940,20200330,10181
20200327,경부선,서동탄,1337,1089,20200330,2426
20200327,경부선,광명,2364,1986,20200330,4350
20200328,경부선,서울역,2124,543,20200331,2667
20200328,1,남영,4039,4047,20200331,8086
20200328,1,용산,18003,19142,20200331,37145
20200328,1,노량진,6538,5543,20200331,12081
20200328,1,대방,5610,5634,20200331,11244
20200328,1,영등포,25988,27133,20200331,53121
20200328,경부선,신도림,1888,1880,20200331,3768
20200328,1,신길,4848,4052,20200331,8900
20200328,1,구로,8153,8361,20200331,16514
20200328,1,가산디지털단지,4354,5640,20200331,9994
20200328,1,금천구청,5848,5770,20200331,11618
20200328,1,석수,5304,5017,20200331,10321
20200328,1,관악,4407,4077,20200331,8484
20200328,1,안양,12955,13221,20200331,26176
20200328,1,명학,3746,3560,20200331,7306
20200328,4,금정,13199,13500,20200331,26699
20200328,1,군포,3283,3006,20200331,6289
20200328,1,의왕,4341,4189,20200331,8530
20200328,1,성균관대,7020,6899,20200331,13919
20200328,1,화서,3608,3573,20200331,7181
20200328,1,수원,22811,24682,20200331,47493
20200328,1,독산,6154,6117,20200331,12271
20200328,1,세류,1728,1834,20200331,3562
20200328,1,병점,7844,7750,20200331,15594
20200328,1,세마,1360,1159,20200331,2519
20200328,1,오산대,1660,1466,20200331,3126
20200328,1,오산,5894,5731,20200331,11625
20200328,1,진위,745,636,20200331,1381
20200328,1,송탄,2612,2398,20200331,5010
20200328,1,서정리,4014,3098,20200331,7112
20200328,1,지제,1403,1173,20200331,2576
20200328,1,평택,7638,7401,20200331,15039
20200328,1,성환,2026,1786,20200331,3812
20200328,1,직산,427,433,20200331,860
20200328,1,두정,2879,2902,20200331,5781
20200328,1,천안,3180,3378,20200331,6558
20200328,1,당정,2901,2726,20200331,5627
20200328,경부선,서동탄,681,667,20200331,1348
20200328,경부선,광명,1256,1069,20200331,2325
20200329,경부선,서울역,2508,562,20200401,3070
20200329,1,남영,2729,2853,20200401,5582
20200329,1,용산,16372,14856,20200401,31228
20200329,1,노량진,4407,3989,20200401,8396
20200329,1,대방,3926,4074,20200401,8000
20200329,1,영등포,20253,19619,20200401,39872
20200329,경부선,신도림,1324,1272,20200401,2596
20200329,1,신길,3406,2888,20200401,6294
20200329,1,구로,5565,5473,20200401,11038
20200329,1,가산디지털단지,3001,3951,20200401,6952
20200329,1,금천구청,4016,3935,20200401,7951
20200329,1,석수,3780,3809,20200401,7589
20200329,1,관악,3406,3035,20200401,6441
20200329,1,안양,9694,9253,20200401,18947
20200329,1,명학,2362,2297,20200401,4659
20200329,4,금정,9021,9475,20200401,18496
20200329,1,군포,2217,2022,20200401,4239
20200329,1,의왕,2852,2835,20200401,5687
20200329,1,성균관대,5050,5261,20200401,10311
20200329,1,화서,2533,2350,20200401,4883
20200329,1,수원,18502,18798,20200401,37300
20200329,1,독산,3920,3908,20200401,7828
20200329,1,세류,1381,1368,20200401,2749
20200329,1,병점,5470,6190,20200401,11660
20200329,1,세마,985,894,20200401,1879
20200329,1,오산대,1219,1079,20200401,2298
20200329,1,오산,4426,4871,20200401,9297
20200329,1,진위,498,482,20200401,980
20200329,1,송탄,2129,2115,20200401,4244
20200329,1,서정리,2332,3579,20200401,5911
20200329,1,지제,1092,1014,20200401,2106
20200329,1,평택,6414,6724,20200401,13138
20200329,1,성환,1427,1749,20200401,3176
20200329,1,직산,335,381,20200401,716
20200329,1,두정,2185,2578,20200401,4763
20200329,1,천안,3051,2920,20200401,5971
20200329,1,당정,2061,1997,20200401,4058
20200329,경부선,서동탄,486,508,20200401,994
20200329,경부선,광명,1173,845,20200401,2018
20200330,경부선,서울역,3006,936,20200402,3942
20200330,1,남영,7891,8474,20200402,16365
20200330,1,용산,23807,24151,20200402,47958
20200330,1,노량진,7656,7559,20200402,15215
20200330,1,대방,11064,11377,20200402,22441
20200330,1,영등포,29179,29952,20200402,59131
20200330,경부선,신도림,3418,3350,20200402,6768
20200330,1,신길,8063,6765,20200402,14828
20200330,1,구로,14834,14876,20200402,29710
20200330,1,가산디지털단지,16226,18445,20200402,34671
20200330,1,금천구청,9840,9588,20200402,19428
20200330,1,석수,8678,7545,20200402,16223
20200330,1,관악,5989,5555,20200402,11544
20200330,1,안양,17511,17483,20200402,34994
20200330,1,명학,7971,7789,20200402,15760
20200330,4,금정,21739,22438,20200402,44177
20200330,1,군포,6504,6658,20200402,13162
20200330,1,의왕,7679,7682,20200402,15361
20200330,1,성균관대,11013,10978,20200402,21991
20200330,1,화서,6023,5830,20200402,11853
20200330,1,수원,24634,26251,20200402,50885
20200330,1,독산,14625,15372,20200402,29997
20200330,1,세류,2455,2233,20200402,4688
20200330,1,병점,10457,10245,20200402,20702
20200330,1,세마,1962,1754,20200402,3716
20200330,1,오산대,2087,1966,20200402,4053
20200330,1,오산,6873,7006,20200402,13879
20200330,1,진위,1241,1075,20200402,2316
20200330,1,송탄,2926,2814,20200402,5740
20200330,1,서정리,3964,4052,20200402,8016
20200330,1,지제,1772,1679,20200402,3451
20200330,1,평택,8163,7912,20200402,16075
20200330,1,성환,2238,2385,20200402,4623
20200330,1,직산,487,521,20200402,1008
20200330,1,두정,3218,3352,20200402,6570
20200330,1,천안,3083,3203,20200402,6286
20200330,1,당정,5161,5004,20200402,10165
20200330,경부선,서동탄,1291,1065,20200402,2356
20200330,경부선,광명,2177,1861,20200402,4038
20200331,경부선,서울역,2425,876,20200403,3301
20200331,1,남영,8205,8514,20200403,16719
20200331,1,용산,23158,23746,20200403,46904
20200331,1,노량진,7609,7540,20200403,15149
20200331,1,대방,11128,11317,20200403,22445
20200331,1,영등포,29166,30612,20200403,59778
20200331,경부선,신도림,3496,3315,20200403,6811
20200331,1,신길,8116,6748,20200403,14864
20200331,1,구로,14698,14778,20200403,29476
20200331,1,가산디지털단지,16296,18308,20200403,34604
20200331,1,금천구청,9777,9616,20200403,19393
20200331,1,석수,8669,7664,20200403,16333
20200331,1,관악,6152,5575,20200403,11727
20200331,1,안양,17412,17630,20200403,35042
20200331,1,명학,7820,7650,20200403,15470
20200331,4,금정,21833,22346,20200403,44179
20200331,1,군포,6454,6553,20200403,13007
20200331,1,의왕,7687,7593,20200403,15280
20200331,1,성균관대,11160,10863,20200403,22023
20200331,1,화서,6076,5888,20200403,11964
20200331,1,수원,24581,26501,20200403,51082
20200331,1,독산,14503,15305,20200403,29808
20200331,1,세류,2465,2306,20200403,4771
20200331,1,병점,10334,10103,20200403,20437
20200331,1,세마,1911,1743,20200403,3654
20200331,1,오산대,2219,2043,20200403,4262
20200331,1,오산,6596,6577,20200403,13173
20200331,1,진위,1220,1085,20200403,2305
20200331,1,송탄,2836,2729,20200403,5565
20200331,1,서정리,3806,3850,20200403,7656
20200331,1,지제,1769,1590,20200403,3359
20200331,1,평택,7923,7690,20200403,15613
20200331,1,성환,2287,2289,20200403,4576
20200331,1,직산,537,562,20200403,1099
20200331,1,두정,3018,3104,20200403,6122
20200331,1,천안,3036,2954,20200403,5990
20200331,1,당정,5126,4919,20200403,10045
20200331,경부선,서동탄,1308,1087,20200403,2395
20200331,경부선,광명,2090,1781,20200403,3871
20200401,경부선,서울역,2305,786,20200404,3091
20200401,1,남영,8150,8658,20200404,16808
20200401,1,용산,23128,23729,20200404,46857
20200401,1,노량진,7679,7576,20200404,15255
20200401,1,대방,11208,11340,20200404,22548
20200401,1,영등포,29700,30830,20200404,60530
20200401,경부선,신도림,3405,3454,20200404,6859
20200401,1,신길,8114,6654,20200404,14768
20200401,1,구로,15008,15196,20200404,30204
20200401,1,가산디지털단지,15966,18329,20200404,34295
20200401,1,금천구청,9773,9676,20200404,19449
20200401,1,석수,8778,7724,20200404,16502
20200401,1,관악,6093,5552,20200404,11645
20200401,1,안양,17500,17867,20200404,35367
20200401,1,명학,7884,7660,20200404,15544
20200401,4,금정,21876,22383,20200404,44259
20200401,1,군포,6544,6500,20200404,13044
20200401,1,의왕,7635,7708,20200404,15343
20200401,1,성균관대,11016,10860,20200404,21876
20200401,1,화서,6094,5823,20200404,11917
20200401,1,수원,24798,26801,20200404,51599
20200401,1,독산,14505,15253,20200404,29758
20200401,1,세류,2418,2307,20200404,4725
20200401,1,병점,10380,10081,20200404,20461
20200401,1,세마,1932,1767,20200404,3699
20200401,1,오산대,2161,1942,20200404,4103
20200401,1,오산,6623,6624,20200404,13247
20200401,1,진위,1223,1131,20200404,2354
20200401,1,송탄,2893,2747,20200404,5640
20200401,1,서정리,3856,3895,20200404,7751
20200401,1,지제,1772,1634,20200404,3406
20200401,1,평택,7730,7575,20200404,15305
20200401,1,성환,2270,2295,20200404,4565
20200401,1,직산,533,539,20200404,1072
20200401,1,두정,3221,3220,20200404,6441
20200401,1,천안,3095,3000,20200404,6095
20200401,1,당정,5150,4933,20200404,10083
20200401,경부선,서동탄,1334,1134,20200404,2468
20200401,경부선,광명,1991,1803,20200404,3794
20200402,경부선,서울역,2560,869,20200405,3429
20200402,1,남영,8246,8633,20200405,16879
20200402,1,용산,23006,23978,20200405,46984
20200402,1,노량진,7607,7463,20200405,15070
20200402,1,대방,11079,11169,20200405,22248
20200402,1,영등포,29472,30643,20200405,60115
20200402,경부선,신도림,3458,3369,20200405,6827
20200402,1,신길,8097,6794,20200405,14891
20200402,1,구로,14893,15237,20200405,30130
20200402,1,가산디지털단지,15966,18321,20200405,34287
20200402,1,금천구청,9787,9645,20200405,19432
20200402,1,석수,8730,7623,20200405,16353
20200402,1,관악,6103,5605,20200405,11708
20200402,1,안양,17850,18023,20200405,35873
20200402,1,명학,7806,7836,20200405,15642
20200402,4,금정,22020,22551,20200405,44571
20200402,1,군포,6554,6541,20200405,13095
20200402,1,의왕,7800,7763,20200405,15563
20200402,1,성균관대,11190,10907,20200405,22097
20200402,1,화서,6036,5972,20200405,12008
20200402,1,수원,25140,26874,20200405,52014
20200402,1,독산,14583,15309,20200405,29892
20200402,1,세류,2407,2273,20200405,4680
20200402,1,병점,10189,10116,20200405,20305
20200402,1,세마,1928,1846,20200405,3774
20200402,1,오산대,2227,1957,20200405,4184
20200402,1,오산,6628,6694,20200405,13322
20200402,1,진위,1217,1104,20200405,2321
20200402,1,송탄,2764,2602,20200405,5366
20200402,1,서정리,3926,3873,20200405,7799
20200402,1,지제,1761,1579,20200405,3340
20200402,1,평택,7636,7508,20200405,15144
20200402,1,성환,2267,2303,20200405,4570
20200402,1,직산,529,556,20200405,1085
20200402,1,두정,3288,3283,20200405,6571
20200402,1,천안,3094,3128,20200405,6222
20200402,1,당정,5226,4946,20200405,10172
20200402,경부선,서동탄,1344,1116,20200405,2460
20200402,경부선,광명,2068,1824,20200405,3892
20200403,1,금천구청,10036,10071,20200406,20107
20200403,경부선,서울역,3540,1136,20200406,4676
20200403,1,남영,8288,8695,20200406,16983
20200403,1,용산,26758,28509,20200406,55267
20200403,1,노량진,8173,7745,20200406,15918
20200403,1,대방,11443,11230,20200406,22673
20200403,1,영등포,32873,35012,20200406,67885
20200403,경부선,신도림,3502,3493,20200406,6995
20200403,1,신길,8182,6808,20200406,14990
20200403,1,구로,15202,15462,20200406,30664
20200403,1,가산디지털단지,16040,18310,20200406,34350
20200403,1,석수,9119,7829,20200406,16948
20200403,1,관악,6257,5689,20200406,11946
20200403,1,안양,18703,19193,20200406,37896
20200403,1,명학,7847,7590,20200406,15437
20200403,4,금정,22873,23273,20200406,46146
20200403,1,군포,6750,6580,20200406,13330
20200403,1,의왕,7895,7777,20200406,15672
20200403,1,성균관대,11833,11620,20200406,23453
20200403,1,화서,6319,6049,20200406,12368
20200403,1,수원,28049,30859,20200406,58908
20200403,1,독산,14935,15277,20200406,30212
20200403,1,세류,2626,2505,20200406,5131
20200403,1,병점,11871,10989,20200406,22860
20200403,1,세마,2073,1916,20200406,3989
20200403,1,오산대,2431,2158,20200406,4589
20200403,1,오산,7803,7383,20200406,15186
20200403,1,진위,1405,1114,20200406,2519
20200403,1,송탄,3035,2807,20200406,5842
20200403,1,서정리,4632,4099,20200406,8731
20200403,1,지제,2195,1821,20200406,4016
20200403,1,평택,8823,8610,20200406,17433
20200403,1,성환,2642,2374,20200406,5016
20200403,1,직산,669,609,20200406,1278
20200403,1,두정,3859,3718,20200406,7577
20200403,1,천안,3595,3829,20200406,7424
20200403,1,당정,5303,5021,20200406,10324
20200403,경부선,서동탄,1359,1217,20200406,2576
20200403,경부선,광명,2479,2155,20200406,4634
20200404,경부선,서울역,2095,540,20200407,2635
20200404,1,남영,4049,4111,20200407,8160
20200404,1,용산,18339,19332,20200407,37671
20200404,1,노량진,6469,5594,20200407,12063
20200404,1,대방,5875,5652,20200407,11527
20200404,1,영등포,26696,27993,20200407,54689
20200404,경부선,신도림,1947,1907,20200407,3854
20200404,1,신길,4893,4060,20200407,8953
20200404,1,구로,8447,8732,20200407,17179
20200404,1,가산디지털단지,4410,5935,20200407,10345
20200404,1,금천구청,6060,6072,20200407,12132
20200404,1,석수,5335,5170,20200407,10505
20200404,1,관악,4334,4073,20200407,8407
20200404,1,안양,13424,13602,20200407,27026
20200404,1,명학,3723,3473,20200407,7196
20200404,4,금정,13560,13853,20200407,27413
20200404,1,군포,3379,3010,20200407,6389
20200404,1,의왕,4398,4256,20200407,8654
20200404,1,성균관대,7097,7078,20200407,14175
20200404,1,화서,3798,3726,20200407,7524
20200404,1,수원,23317,25853,20200407,49170
20200404,1,독산,6334,6235,20200407,12569
20200404,1,세류,1738,1750,20200407,3488
20200404,1,병점,7975,7685,20200407,15660
20200404,1,세마,1421,1251,20200407,2672
20200404,1,오산대,1603,1484,20200407,3087
20200404,1,오산,6010,5562,20200407,11572
20200404,1,진위,717,613,20200407,1330
20200404,1,송탄,2543,2277,20200407,4820
20200404,1,서정리,3908,3120,20200407,7028
20200404,1,지제,1393,1206,20200407,2599
20200404,1,평택,7608,7387,20200407,14995
20200404,1,성환,2117,1899,20200407,4016
20200404,1,직산,422,439,20200407,861
20200404,1,두정,2915,2894,20200407,5809
20200404,1,천안,3350,3526,20200407,6876
20200404,1,당정,2878,2713,20200407,5591
20200404,경부선,서동탄,673,669,20200407,1342
20200404,경부선,광명,1383,1121,20200407,2504
20200405,경부선,서울역,2710,557,20200408,3267
20200405,1,남영,2697,3027,20200408,5724
20200405,1,용산,17274,14947,20200408,32221
20200405,1,노량진,4356,3882,20200408,8238
20200405,1,대방,4017,4295,20200408,8312
20200405,1,영등포,20766,20060,20200408,40826
20200405,경부선,신도림,1405,1344,20200408,2749
20200405,1,신길,3445,3082,20200408,6527
20200405,1,구로,5472,5552,20200408,11024
20200405,1,가산디지털단지,3154,4246,20200408,7400
20200405,1,금천구청,4108,4061,20200408,8169
20200405,1,석수,3732,3963,20200408,7695
20200405,1,관악,3670,3291,20200408,6961
20200405,1,안양,9753,9299,20200408,19052
20200405,1,명학,2290,2218,20200408,4508
20200405,4,금정,9392,9720,20200408,19112
20200405,1,군포,2175,2026,20200408,4201
20200405,1,의왕,3029,3033,20200408,6062
20200405,1,성균관대,4967,5326,20200408,10293
20200405,1,화서,2716,2567,20200408,5283
20200405,1,수원,19456,19502,20200408,38958
20200405,1,독산,4024,4153,20200408,8177
20200405,1,세류,1454,1406,20200408,2860
20200405,1,병점,5750,6360,20200408,12110
20200405,1,세마,1014,899,20200408,1913
20200405,1,오산대,1198,1114,20200408,2312
20200405,1,오산,4627,5039,20200408,9666
20200405,1,진위,510,492,20200408,1002
20200405,1,송탄,1856,1977,20200408,3833
20200405,1,서정리,2208,3458,20200408,5666
20200405,1,지제,1079,1015,20200408,2094
20200405,1,평택,6311,6687,20200408,12998
20200405,1,성환,1460,1755,20200408,3215
20200405,1,직산,348,352,20200408,700
20200405,1,두정,2195,2574,20200408,4769
20200405,1,천안,3367,3170,20200408,6537
20200405,1,당정,2027,1940,20200408,3967
20200405,경부선,서동탄,472,549,20200408,1021
20200405,경부선,광명,1344,921,20200408,2265
20200406,경부선,서울역,3175,954,20200409,4129
20200406,1,남영,8800,9269,20200409,18069
20200406,1,용산,24018,23952,20200409,47970
20200406,1,노량진,7797,7797,20200409,15594
20200406,1,대방,11413,11608,20200409,23021
20200406,1,영등포,30045,31117,20200409,61162
20200406,경부선,신도림,3546,3538,20200409,7084
20200406,1,신길,8292,6841,20200409,15133
20200406,1,구로,15380,15525,20200409,30905
20200406,1,가산디지털단지,16749,19213,20200409,35962
20200406,1,금천구청,10020,10017,20200409,20037
20200406,1,석수,8977,7791,20200409,16768
20200406,1,관악,6305,5730,20200409,12035
20200406,1,안양,17987,18029,20200409,36016
20200406,1,명학,8003,7991,20200409,15994
20200406,4,금정,22370,23223,20200409,45593
20200406,1,군포,6655,6661,20200409,13316
20200406,1,의왕,7955,7965,20200409,15920
20200406,1,성균관대,11427,11254,20200409,22681
20200406,1,화서,6492,6324,20200409,12816
20200406,1,수원,25864,27564,20200409,53428
20200406,1,독산,15036,15818,20200409,30854
20200406,1,세류,2492,2314,20200409,4806
20200406,1,병점,10520,10477,20200409,20997
20200406,1,세마,2029,1848,20200409,3877
20200406,1,오산대,2228,2044,20200409,4272
20200406,1,오산,7045,6936,20200409,13981
20200406,1,진위,1226,1118,20200409,2344
20200406,1,송탄,2864,2671,20200409,5535
20200406,1,서정리,3806,4061,20200409,7867
20200406,1,지제,1734,1661,20200409,3395
20200406,1,평택,8024,7939,20200409,15963
20200406,1,성환,2372,2563,20200409,4935
20200406,1,직산,580,586,20200409,1166
20200406,1,두정,3287,3576,20200409,6863
20200406,1,천안,3317,3466,20200409,6783
20200406,1,당정,5292,5035,20200409,10327
20200406,경부선,서동탄,1322,1096,20200409,2418
20200406,경부선,광명,2312,2051,20200409,4363
20200407,경부선,서울역,2660,866,20200410,3526
20200407,1,남영,8958,9323,20200410,18281
20200407,1,용산,23019,23428,20200410,46447
20200407,1,노량진,7933,7796,20200410,15729
20200407,1,대방,11523,11766,20200410,23289
20200407,1,영등포,29473,30867,20200410,60340
20200407,경부선,신도림,3606,3559,20200410,7165
20200407,1,신길,8296,6911,20200410,15207
20200407,1,구로,15454,15552,20200410,31006
20200407,1,가산디지털단지,16585,19023,20200410,35608
20200407,1,금천구청,9960,9836,20200410,19796
20200407,1,석수,8991,7913,20200410,16904
20200407,1,관악,6337,5756,20200410,12093
20200407,1,안양,18018,18019,20200410,36037
20200407,1,명학,8169,8048,20200410,16217
20200407,4,금정,22510,23098,20200410,45608
20200407,1,군포,6629,6681,20200410,13310
20200407,1,의왕,7918,7872,20200410,15790
20200407,1,성균관대,11366,11259,20200410,22625
20200407,1,화서,6373,6216,20200410,12589
20200407,1,수원,25442,27256,20200410,52698
20200407,1,독산,14866,15646,20200410,30512
20200407,1,세류,2479,2277,20200410,4756
20200407,1,병점,10684,10549,20200410,21233
20200407,1,세마,2002,1831,20200410,3833
20200407,1,오산대,2196,2074,20200410,4270
20200407,1,오산,6878,6677,20200410,13555
20200407,1,진위,1270,1095,20200410,2365
20200407,1,송탄,2765,2621,20200410,5386
20200407,1,서정리,3858,3851,20200410,7709
20200407,1,지제,1759,1642,20200410,3401
20200407,1,평택,7720,7699,20200410,15419
20200407,1,성환,2292,2205,20200410,4497
20200407,1,직산,553,557,20200410,1110
20200407,1,두정,3160,3315,20200410,6475
20200407,1,천안,3201,3349,20200410,6550
20200407,1,당정,5150,4949,20200410,10099
20200407,경부선,서동탄,1372,1120,20200410,2492
20200407,경부선,광명,2170,1899,20200410,4069
20200408,경부선,서울역,2638,848,20200411,3486
20200408,1,남영,8985,9357,20200411,18342
20200408,1,용산,23264,23750,20200411,47014
20200408,1,노량진,7568,7564,20200411,15132
20200408,1,대방,11400,11662,20200411,23062
20200408,1,영등포,30217,31438,20200411,61655
20200408,경부선,신도림,3578,3492,20200411,7070
20200408,1,신길,8420,7011,20200411,15431
20200408,1,구로,15418,15772,20200411,31190
20200408,1,가산디지털단지,16507,19000,20200411,35507
20200408,1,금천구청,10033,9938,20200411,19971
20200408,1,석수,8955,7875,20200411,16830
20200408,1,관악,6340,5795,20200411,12135
20200408,1,안양,18086,18350,20200411,36436
20200408,1,명학,8059,8020,20200411,16079
20200408,4,금정,22511,23178,20200411,45689
20200408,1,군포,6723,6710,20200411,13433
20200408,1,의왕,7888,7868,20200411,15756
20200408,1,성균관대,11521,11372,20200411,22893
20200408,1,화서,6497,6336,20200411,12833
20200408,1,수원,25721,27374,20200411,53095
20200408,1,독산,15035,15849,20200411,30884
20200408,1,세류,2436,2263,20200411,4699
20200408,1,병점,10709,10588,20200411,21297
20200408,1,세마,2071,1893,20200411,3964
20200408,1,오산대,2309,2073,20200411,4382
20200408,1,오산,6882,6865,20200411,13747
20200408,1,진위,1259,1120,20200411,2379
20200408,1,송탄,2670,2642,20200411,5312
20200408,1,서정리,3851,3859,20200411,7710
20200408,1,지제,1792,1642,20200411,3434
20200408,1,평택,7794,7591,20200411,15385
20200408,1,성환,2216,2258,20200411,4474
20200408,1,직산,565,579,20200411,1144
20200408,1,두정,3280,3334,20200411,6614
20200408,1,천안,3205,3282,20200411,6487
20200408,1,당정,5259,5098,20200411,10357
20200408,경부선,서동탄,1299,1087,20200411,2386
20200408,경부선,광명,2211,1833,20200411,4044
20200409,경부선,서울역,2864,903,20200412,3767
20200409,1,남영,8909,9358,20200412,18267
20200409,1,용산,23397,24132,20200412,47529
20200409,1,노량진,7345,7298,20200412,14643
20200409,1,대방,11408,11485,20200412,22893
20200409,1,영등포,30163,31340,20200412,61503
20200409,경부선,신도림,3464,3562,20200412,7026
20200409,1,신길,8310,6956,20200412,15266
20200409,1,구로,15525,15735,20200412,31260
20200409,1,가산디지털단지,16532,19120,20200412,35652
20200409,1,금천구청,10056,9875,20200412,19931
20200409,1,석수,9155,7979,20200412,17134
20200409,1,관악,6406,5801,20200412,12207
20200409,1,안양,18154,18409,20200412,36563
20200409,1,명학,8008,7925,20200412,15933
20200409,4,금정,22554,23070,20200412,45624
20200409,1,군포,6733,6724,20200412,13457
20200409,1,의왕,7909,7874,20200412,15783
20200409,1,성균관대,11296,11142,20200412,22438
20200409,1,화서,6425,6148,20200412,12573
20200409,1,수원,25621,27431,20200412,53052
20200409,1,독산,14915,15729,20200412,30644
20200409,1,세류,2518,2312,20200412,4830
20200409,1,병점,10426,10368,20200412,20794
20200409,1,세마,2056,1836,20200412,3892
20200409,1,오산대,2203,2041,20200412,4244
20200409,1,오산,6832,6705,20200412,13537
20200409,1,진위,1181,1056,20200412,2237
20200409,1,송탄,2703,2598,20200412,5301
20200409,1,서정리,3857,3874,20200412,7731
20200409,1,지제,1771,1641,20200412,3412
20200409,1,평택,7680,7667,20200412,15347
20200409,1,성환,2257,2191,20200412,4448
20200409,1,직산,579,581,20200412,1160
20200409,1,두정,3368,3364,20200412,6732
20200409,1,천안,3219,3308,20200412,6527
20200409,1,당정,5312,5175,20200412,10487
20200409,경부선,서동탄,1298,1092,20200412,2390
20200409,경부선,광명,2288,1974,20200412,4262
20200410,경부선,서울역,3845,1208,20200413,5053
20200410,1,남영,9027,9378,20200413,18405
20200410,1,용산,27307,28617,20200413,55924
20200410,1,노량진,7938,7600,20200413,15538
20200410,1,대방,11681,11469,20200413,23150
20200410,1,영등포,33928,36192,20200413,70120
20200410,경부선,신도림,3528,3601,20200413,7129
20200410,1,신길,8486,6944,20200413,15430
20200410,1,구로,15780,16130,20200413,31910
20200410,1,가산디지털단지,16787,19088,20200413,35875
20200410,1,금천구청,10389,10212,20200413,20601
20200410,1,석수,9095,7803,20200413,16898
20200410,1,관악,6474,5904,20200413,12378
20200410,1,안양,18988,19499,20200413,38487
20200410,1,명학,7865,7640,20200413,15505
20200410,4,금정,23105,23502,20200413,46607
20200410,1,군포,6886,6705,20200413,13591
20200410,1,의왕,8031,7773,20200413,15804
20200410,1,성균관대,12204,11815,20200413,24019
20200410,1,화서,6558,6297,20200413,12855
20200410,1,수원,29116,31958,20200413,61074
20200410,1,독산,14714,15461,20200413,30175
20200410,1,세류,2656,2575,20200413,5231
20200410,1,병점,12208,11398,20200413,23606
20200410,1,세마,2164,1891,20200413,4055
20200410,1,오산대,2464,2198,20200413,4662
20200410,1,오산,7707,7391,20200413,15098
20200410,1,진위,1424,1135,20200413,2559
20200410,1,송탄,3063,2773,20200413,5836
20200410,1,서정리,4659,4200,20200413,8859
20200410,1,지제,2197,1949,20200413,4146
20200410,1,평택,8985,8819,20200413,17804
20200410,1,성환,2819,2501,20200413,5320
20200410,1,직산,689,617,20200413,1306
20200410,1,두정,4119,3756,20200413,7875
20200410,1,천안,3771,4092,20200413,7863
20200410,1,당정,5476,5232,20200413,10708
20200410,경부선,서동탄,1420,1167,20200413,2587
20200410,경부선,광명,2504,2158,20200413,4662
20200411,경부선,서울역,2354,627,20200414,2981
20200411,1,남영,4243,4375,20200414,8618
20200411,1,용산,19744,21314,20200414,41058
20200411,1,노량진,6311,5427,20200414,11738
20200411,1,대방,6171,5996,20200414,12167
20200411,1,영등포,28031,29336,20200414,57367
20200411,경부선,신도림,2215,2144,20200414,4359
20200411,1,신길,4950,4025,20200414,8975
20200411,1,구로,9067,9263,20200414,18330
20200411,1,가산디지털단지,4854,6283,20200414,11137
20200411,1,금천구청,6280,6245,20200414,12525
20200411,1,석수,5658,5373,20200414,11031
20200411,1,관악,4643,4261,20200414,8904
20200411,1,안양,14168,14477,20200414,28645
20200411,1,명학,4053,3895,20200414,7948
20200411,4,금정,14348,14463,20200414,28811
20200411,1,군포,3592,3282,20200414,6874
20200411,1,의왕,4597,4454,20200414,9051
20200411,1,성균관대,7561,7468,20200414,15029
20200411,1,화서,4001,3938,20200414,7939
20200411,1,수원,25058,27703,20200414,52761
20200411,1,독산,6604,6454,20200414,13058
20200411,1,세류,1904,1852,20200414,3756
20200411,1,병점,8568,8405,20200414,16973
20200411,1,세마,1526,1334,20200414,2860
20200411,1,오산대,1826,1568,20200414,3394
20200411,1,오산,6309,5876,20200414,12185
20200411,1,진위,795,692,20200414,1487
20200411,1,송탄,2826,2489,20200414,5315
20200411,1,서정리,4230,3324,20200414,7554
20200411,1,지제,1570,1324,20200414,2894
20200411,1,평택,8222,8118,20200414,16340
20200411,1,성환,2284,2174,20200414,4458
20200411,1,직산,531,474,20200414,1005
20200411,1,두정,3017,3064,20200414,6081
20200411,1,천안,3859,3948,20200414,7807
20200411,1,당정,3071,2912,20200414,5983
20200411,경부선,서동탄,739,755,20200414,1494
20200411,경부선,광명,1519,1242,20200414,2761
20200412,경부선,서울역,2854,611,20200415,3465
20200412,1,남영,2944,3139,20200415,6083
20200412,1,용산,18045,15750,20200415,33795
20200412,1,노량진,4186,3857,20200415,8043
20200412,1,대방,4190,4471,20200415,8661
20200412,1,영등포,21524,20990,20200415,42514
20200412,경부선,신도림,1378,1400,20200415,2778
20200412,1,신길,3626,3140,20200415,6766
20200412,1,구로,6288,6200,20200415,12488
20200412,1,가산디지털단지,3358,4564,20200415,7922
20200412,1,금천구청,4398,4232,20200415,8630
20200412,1,석수,4070,4248,20200415,8318
20200412,1,관악,3831,3367,20200415,7198
20200412,1,안양,10389,9834,20200415,20223
20200412,1,명학,2474,2439,20200415,4913
20200412,4,금정,9929,10319,20200415,20248
20200412,1,군포,2389,2197,20200415,4586
20200412,1,의왕,3170,3138,20200415,6308
20200412,1,성균관대,5235,5577,20200415,10812
20200412,1,화서,2690,2558,20200415,5248
20200412,1,수원,21155,21382,20200415,42537
20200412,1,독산,4151,4260,20200415,8411
20200412,1,세류,1459,1398,20200415,2857
20200412,1,병점,5982,6707,20200415,12689
20200412,1,세마,1034,929,20200415,1963
20200412,1,오산대,1275,1226,20200415,2501
20200412,1,오산,4751,5230,20200415,9981
20200412,1,진위,550,560,20200415,1110
20200412,1,송탄,2025,2252,20200415,4277
20200412,1,서정리,2500,3677,20200415,6177
20200412,1,지제,1169,1158,20200415,2327
20200412,1,평택,6925,7200,20200415,14125
20200412,1,성환,1701,2048,20200415,3749
20200412,1,직산,396,486,20200415,882
20200412,1,두정,2418,2750,20200415,5168
20200412,1,천안,3469,3488,20200415,6957
20200412,1,당정,2099,2114,20200415,4213
20200412,경부선,서동탄,570,567,20200415,1137
20200412,경부선,광명,1390,897,20200415,2287
20200413,경부선,서울역,3338,968,20200416,4306
20200413,1,남영,8959,9471,20200416,18430
20200413,1,용산,25306,25293,20200416,50599
20200413,1,노량진,7221,7451,20200416,14672
20200413,1,대방,11914,12010,20200416,23924
20200413,1,영등포,31036,32048,20200416,63084
20200413,경부선,신도림,3721,3615,20200416,7336
20200413,1,신길,8447,7070,20200416,15517
20200413,1,구로,15799,15892,20200416,31691
20200413,1,가산디지털단지,17364,19913,20200416,37277
20200413,1,금천구청,10289,10082,20200416,20371
20200413,1,석수,9114,8008,20200416,17122
20200413,1,관악,6357,5867,20200416,12224
20200413,1,안양,18547,18652,20200416,37199
20200413,1,명학,8183,8076,20200416,16259
20200413,4,금정,22628,23613,20200416,46241
20200413,1,군포,6748,6994,20200416,13742
20200413,1,의왕,7958,8014,20200416,15972
20200413,1,성균관대,11570,11452,20200416,23022
20200413,1,화서,6588,6323,20200416,12911
20200413,1,수원,26772,28334,20200416,55106
20200413,1,독산,15169,16099,20200416,31268
20200413,1,세류,2538,2429,20200416,4967
20200413,1,병점,11043,10824,20200416,21867
20200413,1,세마,2043,1891,20200416,3934
20200413,1,오산대,2363,2124,20200416,4487
20200413,1,오산,7319,7373,20200416,14692
20200413,1,진위,1278,1131,20200416,2409
20200413,1,송탄,2999,2772,20200416,5771
20200413,1,서정리,3969,4164,20200416,8133
20200413,1,지제,1881,1813,20200416,3694
20200413,1,평택,8478,8296,20200416,16774
20200413,1,성환,2457,2579,20200416,5036
20200413,1,직산,620,623,20200416,1243
20200413,1,두정,3465,3637,20200416,7102
20200413,1,천안,3556,3643,20200416,7199
20200413,1,당정,5410,5086,20200416,10496
20200413,경부선,서동탄,1397,1151,20200416,2548
20200413,경부선,광명,2453,2053,20200416,4506
20200414,경부선,서울역,3280,1077,20200417,4357
20200414,1,남영,8706,8373,20200417,17079
20200414,1,용산,24312,23956,20200417,48268
20200414,1,노량진,7350,7196,20200417,14546
20200414,1,대방,11196,10381,20200417,21577
20200414,1,영등포,31428,32180,20200417,63608
20200414,경부선,신도림,3606,3521,20200417,7127
20200414,1,신길,8419,7139,20200417,15558
20200414,1,구로,15995,20993,20200417,36988
20200414,1,가산디지털단지,16943,17007,20200417,33950
20200414,1,금천구청,9824,9651,20200417,19475
20200414,1,석수,9049,8171,20200417,17220
20200414,1,관악,6334,5750,20200417,12084
20200414,1,안양,18804,18959,20200417,37763
20200414,1,명학,7961,7595,20200417,15556
20200414,4,금정,23857,24816,20200417,48673
20200414,1,군포,6766,6311,20200417,13077
20200414,1,의왕,8022,7837,20200417,15859
20200414,1,성균관대,12020,11722,20200417,23742
20200414,1,화서,6456,6183,20200417,12639
20200414,1,수원,27841,30171,20200417,58012
20200414,1,독산,14534,13994,20200417,28528
20200414,1,세류,2622,2453,20200417,5075
20200414,1,병점,11841,11727,20200417,23568
20200414,1,세마,2071,1850,20200417,3921
20200414,1,오산대,2364,2054,20200417,4418
20200414,1,오산,7349,6827,20200417,14176
20200414,1,진위,1263,1108,20200417,2371
20200414,1,송탄,3027,2930,20200417,5957
20200414,1,서정리,4727,3876,20200417,8603
20200414,1,지제,2122,1805,20200417,3927
20200414,1,평택,8405,7990,20200417,16395
20200414,1,성환,2427,2351,20200417,4778
20200414,1,직산,649,656,20200417,1305
20200414,1,두정,3632,3576,20200417,7208
20200414,1,천안,3536,3892,20200417,7428
20200414,1,당정,5407,5003,20200417,10410
20200414,경부선,서동탄,1219,1056,20200417,2275
20200414,경부선,광명,2461,2006,20200417,4467
20200415,경부선,서울역,1791,459,20200418,2250
20200415,1,남영,3785,3960,20200418,7745
20200415,1,용산,15291,15158,20200418,30449
20200415,1,노량진,5552,5037,20200418,10589
20200415,1,대방,5416,5429,20200418,10845
20200415,1,영등포,23368,23562,20200418,46930
20200415,경부선,신도림,1894,1859,20200418,3753
20200415,1,신길,4565,3801,20200418,8366
20200415,1,구로,8139,8225,20200418,16364
20200415,1,가산디지털단지,4624,5992,20200418,10616
20200415,1,금천구청,5710,5517,20200418,11227
20200415,1,석수,5096,4977,20200418,10073
20200415,1,관악,4198,3871,20200418,8069
20200415,1,안양,12501,12408,20200418,24909
20200415,1,명학,3947,3824,20200418,7771
20200415,4,금정,12798,12874,20200418,25672
20200415,1,군포,4007,3795,20200418,7802
20200415,1,의왕,4249,4298,20200418,8547
20200415,1,성균관대,6619,6799,20200418,13418
20200415,1,화서,3395,3239,20200418,6634
20200415,1,수원,21951,22837,20200418,44788
20200415,1,독산,6461,6392,20200418,12853
20200415,1,세류,1619,1635,20200418,3254
20200415,1,병점,7110,7534,20200418,14644
20200415,1,세마,1339,1186,20200418,2525
20200415,1,오산대,1626,1512,20200418,3138
20200415,1,오산,5183,5271,20200418,10454
20200415,1,진위,664,645,20200418,1309
20200415,1,송탄,2272,2288,20200418,4560
20200415,1,서정리,2908,3423,20200418,6331
20200415,1,지제,1136,1200,20200418,2336
20200415,1,평택,7028,7101,20200418,14129
20200415,1,성환,1807,1934,20200418,3741
20200415,1,직산,355,395,20200418,750
20200415,1,두정,2720,2779,20200418,5499
20200415,1,천안,3137,3198,20200418,6335
20200415,1,당정,2819,2730,20200418,5549
20200415,경부선,서동탄,671,688,20200418,1359
20200415,경부선,광명,1208,955,20200418,2163
20200416,경부선,서울역,3170,1003,20200419,4173
20200416,1,남영,8879,9303,20200419,18182
20200416,1,용산,24583,25311,20200419,49894
20200416,1,노량진,7407,7451,20200419,14858
20200416,1,대방,11694,11877,20200419,23571
20200416,1,영등포,31458,32819,20200419,64277
20200416,경부선,신도림,3663,3642,20200419,7305
20200416,1,신길,8564,7089,20200419,15653
20200416,1,구로,15725,15916,20200419,31641
20200416,1,가산디지털단지,17178,19626,20200419,36804
20200416,1,금천구청,10230,10013,20200419,20243
20200416,1,석수,9389,8174,20200419,17563
20200416,1,관악,6511,6029,20200419,12540
20200416,1,안양,18731,18819,20200419,37550
20200416,1,명학,8245,8176,20200419,16421
20200416,4,금정,23007,23733,20200419,46740
20200416,1,군포,6809,6880,20200419,13689
20200416,1,의왕,7945,7970,20200419,15915
20200416,1,성균관대,11815,11636,20200419,23451
20200416,1,화서,6531,6226,20200419,12757
20200416,1,수원,26773,29023,20200419,55796
20200416,1,독산,14969,15763,20200419,30732
20200416,1,세류,2600,2384,20200419,4984
20200416,1,병점,11169,10941,20200419,22110
20200416,1,세마,2119,1933,20200419,4052
20200416,1,오산대,2358,2182,20200419,4540
20200416,1,오산,7159,7118,20200419,14277
20200416,1,진위,1266,1091,20200419,2357
20200416,1,송탄,3017,2861,20200419,5878
20200416,1,서정리,4193,4160,20200419,8353
20200416,1,지제,1902,1746,20200419,3648
20200416,1,평택,8615,8399,20200419,17014
20200416,1,성환,2601,2589,20200419,5190
20200416,1,직산,625,620,20200419,1245
20200416,1,두정,3507,3578,20200419,7085
20200416,1,천안,3616,3787,20200419,7403
20200416,1,당정,5483,5252,20200419,10735
20200416,경부선,서동탄,1401,1170,20200419,2571
20200416,경부선,광명,2388,2063,20200419,4451
20200417,경부선,서울역,4159,1205,20200420,5364
20200417,1,남영,8544,8859,20200420,17403
20200417,1,용산,26979,27871,20200420,54850
20200417,1,노량진,7601,7267,20200420,14868
20200417,1,대방,11370,11390,20200420,22760
20200417,1,영등포,33625,36297,20200420,69922
20200417,경부선,신도림,3406,3461,20200420,6867
20200417,1,신길,8367,6778,20200420,15145
20200417,1,구로,15564,15955,20200420,31519
20200417,1,가산디지털단지,17036,19240,20200420,36276
20200417,1,금천구청,9863,9907,20200420,19770
20200417,1,석수,8943,7772,20200420,16715
20200417,1,관악,6287,5782,20200420,12069
20200417,1,안양,18969,19408,20200420,38377
20200417,1,명학,7983,7784,20200420,15767
20200417,4,금정,22924,23395,20200420,46319
20200417,1,군포,6775,6766,20200420,13541
20200417,1,의왕,7786,7715,20200420,15501
20200417,1,성균관대,11933,11479,20200420,23412
20200417,1,화서,6337,6080,20200420,12417
20200417,1,수원,28609,31099,20200420,59708
20200417,1,독산,14900,15508,20200420,30408
20200417,1,세류,2601,2411,20200420,5012
20200417,1,병점,11607,11095,20200420,22702
20200417,1,세마,2133,1857,20200420,3990
20200417,1,오산대,2351,2087,20200420,4438
20200417,1,오산,7938,7619,20200420,15557
20200417,1,진위,1466,1117,20200420,2583
20200417,1,송탄,3155,2961,20200420,6116
20200417,1,서정리,4643,4191,20200420,8834
20200417,1,지제,2191,1838,20200420,4029
20200417,1,평택,8982,8908,20200420,17890
20200417,1,성환,2659,2316,20200420,4975
20200417,1,직산,624,602,20200420,1226
20200417,1,두정,3802,3732,20200420,7534
20200417,1,천안,3926,4107,20200420,8033
20200417,1,당정,5560,5213,20200420,10773
20200417,경부선,서동탄,1321,1198,20200420,2519
20200417,경부선,광명,2676,2351,20200420,5027
20200418,경부선,서울역,2689,655,20200421,3344
20200418,1,남영,4696,4604,20200421,9300
20200418,1,용산,19953,21481,20200421,41434
20200418,1,노량진,6949,6138,20200421,13087
20200418,1,대방,6599,6387,20200421,12986
20200418,1,영등포,30390,32113,20200421,62503
20200418,경부선,신도림,2478,2412,20200421,4890
20200418,1,신길,5329,4401,20200421,9730
20200418,1,구로,9474,9496,20200421,18970
20200418,1,가산디지털단지,5183,6789,20200421,11972
20200418,1,금천구청,6748,6641,20200421,13389
20200418,1,석수,6208,5860,20200421,12068
20200418,1,관악,5132,4773,20200421,9905
20200418,1,안양,15018,15364,20200421,30382
20200418,1,명학,4185,3983,20200421,8168
20200418,4,금정,15321,15349,20200421,30670
20200418,1,군포,3835,3361,20200421,7196
20200418,1,의왕,4895,4677,20200421,9572
20200418,1,성균관대,8136,8104,20200421,16240
20200418,1,화서,4223,4168,20200421,8391
20200418,1,수원,27908,30553,20200421,58461
20200418,1,독산,7087,6960,20200421,14047
20200418,1,세류,2050,2014,20200421,4064
20200418,1,병점,9171,8999,20200421,18170
20200418,1,세마,1660,1439,20200421,3099
20200418,1,오산대,1966,1741,20200421,3707
20200418,1,오산,7256,6770,20200421,14026
20200418,1,진위,890,755,20200421,1645
20200418,1,송탄,3112,2730,20200421,5842
20200418,1,서정리,4536,3575,20200421,8111
20200418,1,지제,1657,1473,20200421,3130
20200418,1,평택,9279,9029,20200421,18308
20200418,1,성환,2459,2325,20200421,4784
20200418,1,직산,569,518,20200421,1087
20200418,1,두정,3289,3353,20200421,6642
20200418,1,천안,4354,4491,20200421,8845
20200418,1,당정,3367,3188,20200421,6555
20200418,경부선,서동탄,854,886,20200421,1740
20200418,경부선,광명,1681,1340,20200421,3021
20200419,경부선,서울역,3274,622,20200422,3896
20200419,1,남영,2877,3101,20200422,5978
20200419,1,용산,18385,16162,20200422,34547
20200419,1,노량진,4166,3813,20200422,7979
20200419,1,대방,4158,4571,20200422,8729
20200419,1,영등포,23161,22080,20200422,45241
20200419,경부선,신도림,1350,1357,20200422,2707
20200419,1,신길,3542,3040,20200422,6582
20200419,1,구로,6361,6403,20200422,12764
20200419,1,가산디지털단지,3151,4468,20200422,7619
20200419,1,금천구청,4474,4386,20200422,8860
20200419,1,석수,4003,4120,20200422,8123
20200419,1,관악,3715,3202,20200422,6917
20200419,1,안양,10410,9765,20200422,20175
20200419,1,명학,2594,2591,20200422,5185
20200419,4,금정,9927,10312,20200422,20239
20200419,1,군포,2410,2253,20200422,4663
20200419,1,의왕,3103,3063,20200422,6166
20200419,1,성균관대,5291,5578,20200422,10869
20200419,1,화서,2656,2538,20200422,5194
20200419,1,수원,21564,21510,20200422,43074
20200419,1,독산,4127,4133,20200422,8260
20200419,1,세류,1415,1402,20200422,2817
20200419,1,병점,5983,6830,20200422,12813
20200419,1,세마,1107,929,20200422,2036
20200419,1,오산대,1230,1194,20200422,2424
20200419,1,오산,5005,5622,20200422,10627
20200419,1,진위,497,552,20200422,1049
20200419,1,송탄,2099,2279,20200422,4378
20200419,1,서정리,2469,3701,20200422,6170
20200419,1,지제,1212,1163,20200422,2375
20200419,1,평택,6974,7505,20200422,14479
20200419,1,성환,1732,1916,20200422,3648
20200419,1,직산,368,419,20200422,787
20200419,1,두정,2406,2727,20200422,5133
20200419,1,천안,3688,3651,20200422,7339
20200419,1,당정,2197,2209,20200422,4406
20200419,경부선,서동탄,566,555,20200422,1121
20200419,경부선,광명,1458,993,20200422,2451
20200420,경부선,서울역,3603,1060,20200423,4663
20200420,1,남영,8998,9484,20200423,18482
20200420,1,용산,25097,25568,20200423,50665
20200420,1,노량진,7825,7842,20200423,15667
20200420,1,대방,11975,12199,20200423,24174
20200420,1,영등포,31955,33188,20200423,65143
20200420,경부선,신도림,3506,3576,20200423,7082
20200420,1,신길,8630,7347,20200423,15977
20200420,1,구로,16385,16351,20200423,32736
20200420,1,가산디지털단지,17549,20185,20200423,37734
20200420,1,금천구청,10406,10190,20200423,20596
20200420,1,석수,9321,8045,20200423,17366
20200420,1,관악,6346,5970,20200423,12316
20200420,1,안양,18749,18875,20200423,37624
20200420,1,명학,8388,8304,20200423,16692
20200420,4,금정,23217,24201,20200423,47418
20200420,1,군포,6692,6869,20200423,13561
20200420,1,의왕,8073,8028,20200423,16101
20200420,1,성균관대,11803,11748,20200423,23551
20200420,1,화서,6550,6254,20200423,12804
20200420,1,수원,27153,29037,20200423,56190
20200420,1,독산,15380,16341,20200423,31721
20200420,1,세류,2611,2375,20200423,4986
20200420,1,병점,10938,10892,20200423,21830
20200420,1,세마,2161,1927,20200423,4088
20200420,1,오산대,2278,2068,20200423,4346
20200420,1,오산,7312,7479,20200423,14791
20200420,1,진위,1261,1135,20200423,2396
20200420,1,송탄,3205,2975,20200423,6180
20200420,1,서정리,4191,4382,20200423,8573
20200420,1,지제,1988,1869,20200423,3857
20200420,1,평택,8592,8596,20200423,17188
20200420,1,성환,2393,2600,20200423,4993
20200420,1,직산,604,624,20200423,1228
20200420,1,두정,3412,3701,20200423,7113
20200420,1,천안,3754,3862,20200423,7616
20200420,1,당정,5588,5257,20200423,10845
20200420,경부선,서동탄,1434,1181,20200423,2615
20200420,경부선,광명,2529,2219,20200423,4748
20200421,경부선,서울역,3165,927,20200424,4092
20200421,1,남영,9039,9518,20200424,18557
20200421,1,용산,25442,25894,20200424,51336
20200421,1,노량진,7973,7995,20200424,15968
20200421,1,대방,11854,12212,20200424,24066
20200421,1,영등포,32480,33641,20200424,66121
20200421,경부선,신도림,3631,3520,20200424,7151
20200421,1,신길,8478,7280,20200424,15758
20200421,1,구로,16238,16497,20200424,32735
20200421,1,가산디지털단지,17213,20085,20200424,37298
20200421,1,금천구청,10544,10409,20200424,20953
20200421,1,석수,9457,8338,20200424,17795
20200421,1,관악,6712,6239,20200424,12951
20200421,1,안양,19180,19171,20200424,38351
20200421,1,명학,8462,8318,20200424,16780
20200421,4,금정,23725,24381,20200424,48106
20200421,1,군포,6840,6842,20200424,13682
20200421,1,의왕,8262,8191,20200424,16453
20200421,1,성균관대,12089,11751,20200424,23840
20200421,1,화서,6552,6256,20200424,12808
20200421,1,수원,27294,29099,20200424,56393
20200421,1,독산,15605,16251,20200424,31856
20200421,1,세류,2676,2439,20200424,5115
20200421,1,병점,11278,11174,20200424,22452
20200421,1,세마,2111,1935,20200424,4046
20200421,1,오산대,2381,2140,20200424,4521
20200421,1,오산,7248,7154,20200424,14402
20200421,1,진위,1220,1097,20200424,2317
20200421,1,송탄,3025,2861,20200424,5886
20200421,1,서정리,4122,4042,20200424,8164
20200421,1,지제,1876,1720,20200424,3596
20200421,1,평택,8406,8332,20200424,16738
20200421,1,성환,2467,2437,20200424,4904
20200421,1,직산,599,644,20200424,1243
20200421,1,두정,3470,3539,20200424,7009
20200421,1,천안,3618,3747,20200424,7365
20200421,1,당정,5595,5345,20200424,10940
20200421,경부선,서동탄,1437,1157,20200424,2594
20200421,경부선,광명,2387,2073,20200424,4460
20200422,경부선,서울역,3170,978,20200425,4148
20200422,1,남영,9114,9633,20200425,18747
20200422,1,용산,24951,25610,20200425,50561
20200422,1,노량진,8091,8085,20200425,16176
20200422,1,대방,11754,12174,20200425,23928
20200422,1,영등포,32489,33591,20200425,66080
20200422,경부선,신도림,3587,3526,20200425,7113
20200422,1,신길,8474,7219,20200425,15693
20200422,1,구로,16012,16360,20200425,32372
20200422,1,가산디지털단지,17177,19715,20200425,36892
20200422,1,금천구청,10448,10226,20200425,20674
20200422,1,석수,9365,8173,20200425,17538
20200422,1,관악,6493,5998,20200425,12491
20200422,1,안양,19004,19474,20200425,38478
20200422,1,명학,8313,8270,20200425,16583
20200422,4,금정,23437,24171,20200425,47608
20200422,1,군포,6794,6790,20200425,13584
20200422,1,의왕,8040,7893,20200425,15933
20200422,1,성균관대,11869,11686,20200425,23555
20200422,1,화서,6498,6148,20200425,12646
20200422,1,수원,27259,29195,20200425,56454
20200422,1,독산,15183,16136,20200425,31319
20200422,1,세류,2532,2334,20200425,4866
20200422,1,병점,10938,10777,20200425,21715
20200422,1,세마,2039,1897,20200425,3936
20200422,1,오산대,2288,2078,20200425,4366
20200422,1,오산,7044,7189,20200425,14233
20200422,1,진위,1221,1116,20200425,2337
20200422,1,송탄,2929,2826,20200425,5755
20200422,1,서정리,4151,4237,20200425,8388
20200422,1,지제,1822,1711,20200425,3533
20200422,1,평택,8296,8058,20200425,16354
20200422,1,성환,2352,2314,20200425,4666
20200422,1,직산,602,593,20200425,1195
20200422,1,두정,3440,3414,20200425,6854
20200422,1,천안,3497,3584,20200425,7081
20200422,1,당정,5487,5215,20200425,10702
20200422,경부선,서동탄,1394,1129,20200425,2523
20200422,경부선,광명,2473,2041,20200425,4514
20200423,경부선,서울역,3369,1042,20200426,4411
20200423,1,남영,9147,9610,20200426,18757
20200423,1,용산,26382,26653,20200426,53035
20200423,1,노량진,8390,8258,20200426,16648
20200423,1,대방,11956,12216,20200426,24172
20200423,1,영등포,33418,34489,20200426,67907
20200423,경부선,신도림,3647,3616,20200426,7263
20200423,1,신길,8492,7170,20200426,15662
20200423,1,구로,16297,16561,20200426,32858
20200423,1,가산디지털단지,17428,20120,20200426,37548
20200423,1,금천구청,10668,10530,20200426,21198
20200423,1,석수,9535,8356,20200426,17891
20200423,1,관악,6777,6288,20200426,13065
20200423,1,안양,19380,19856,20200426,39236
20200423,1,명학,8566,8231,20200426,16797
20200423,4,금정,23747,24381,20200426,48128
20200423,1,군포,6967,7018,20200426,13985
20200423,1,의왕,8233,8193,20200426,16426
20200423,1,성균관대,12213,12028,20200426,24241
20200423,1,화서,6696,6466,20200426,13162
20200423,1,수원,27660,29937,20200426,57597
20200423,1,독산,15672,16286,20200426,31958
20200423,1,세류,2666,2433,20200426,5099
20200423,1,병점,11358,11222,20200426,22580
20200423,1,세마,2138,1959,20200426,4097
20200423,1,오산대,2357,2153,20200426,4510
20200423,1,오산,7250,7361,20200426,14611
20200423,1,진위,1259,1131,20200426,2390
20200423,1,송탄,3071,2984,20200426,6055
20200423,1,서정리,4234,4142,20200426,8376
20200423,1,지제,1933,1797,20200426,3730
20200423,1,평택,8538,8267,20200426,16805
20200423,1,성환,2448,2421,20200426,4869
20200423,1,직산,593,635,20200426,1228
20200423,1,두정,3534,3542,20200426,7076
20200423,1,천안,3666,3833,20200426,7499
20200423,1,당정,5777,5449,20200426,11226
20200423,경부선,서동탄,1450,1157,20200426,2607
20200423,경부선,광명,2516,2069,20200426,4585
20200424,경부선,서울역,4592,1359,20200427,5951
20200424,1,남영,9418,9701,20200427,19119
20200424,1,용산,30643,31576,20200427,62219
20200424,1,노량진,9141,8796,20200427,17937
20200424,1,대방,12466,12396,20200427,24862
20200424,1,영등포,37573,40415,20200427,77988
20200424,경부선,신도림,3742,3845,20200427,7587
20200424,1,신길,8889,7463,20200427,16352
20200424,1,구로,16909,17216,20200427,34125
20200424,1,가산디지털단지,17941,20605,20200427,38546
20200424,1,금천구청,11205,10815,20200427,22020
20200424,1,석수,9945,8590,20200427,18535
20200424,1,관악,6953,6253,20200427,13206
20200424,1,안양,20517,21269,20200427,41786
20200424,1,명학,8460,8222,20200427,16682
20200424,4,금정,25193,25548,20200427,50741
20200424,1,군포,7150,7076,20200427,14226
20200424,1,의왕,8636,8406,20200427,17042
20200424,1,성균관대,13007,12579,20200427,25586
20200424,1,화서,6954,6556,20200427,13510
20200424,1,수원,31932,34763,20200427,66695
20200424,1,독산,15928,16491,20200427,32419
20200424,1,세류,2873,2699,20200427,5572
20200424,1,병점,13040,12355,20200427,25395
20200424,1,세마,2371,2108,20200427,4479
20200424,1,오산대,2648,2357,20200427,5005
20200424,1,오산,8324,8094,20200427,16418
20200424,1,진위,1523,1204,20200427,2727
20200424,1,송탄,3492,3284,20200427,6776
20200424,1,서정리,5039,4609,20200427,9648
20200424,1,지제,2323,1959,20200427,4282
20200424,1,평택,10046,9885,20200427,19931
20200424,1,성환,3000,2595,20200427,5595
20200424,1,직산,760,707,20200427,1467
20200424,1,두정,4399,4237,20200427,8636
20200424,1,천안,4534,4603,20200427,9137
20200424,1,당정,5855,5494,20200427,11349
20200424,경부선,서동탄,1494,1332,20200427,2826
20200424,경부선,광명,2931,2516,20200427,5447
20200425,경부선,서울역,3247,800,20200428,4047
20200425,1,남영,4792,4807,20200428,9599
20200425,1,용산,23030,24511,20200428,47541
20200425,1,노량진,7863,6651,20200428,14514
20200425,1,대방,7161,7052,20200428,14213
20200425,1,영등포,32667,34907,20200428,67574
20200425,경부선,신도림,2434,2442,20200428,4876
20200425,1,신길,5606,4603,20200428,10209
20200425,1,구로,10416,10701,20200428,21117
20200425,1,가산디지털단지,5315,7091,20200428,12406
20200425,1,금천구청,7065,7026,20200428,14091
20200425,1,석수,6327,6081,20200428,12408
20200425,1,관악,5396,4995,20200428,10391
20200425,1,안양,16400,16528,20200428,32928
20200425,1,명학,4750,4500,20200428,9250
20200425,4,금정,16339,16439,20200428,32778
20200425,1,군포,4079,3791,20200428,7870
20200425,1,의왕,5197,5002,20200428,10199
20200425,1,성균관대,8697,8616,20200428,17313
20200425,1,화서,4559,4424,20200428,8983
20200425,1,수원,30122,33006,20200428,63128
20200425,1,독산,7587,7209,20200428,14796
20200425,1,세류,2201,2126,20200428,4327
20200425,1,병점,9984,9732,20200428,19716
20200425,1,세마,1652,1464,20200428,3116
20200425,1,오산대,2071,1859,20200428,3930
20200425,1,오산,7336,6907,20200428,14243
20200425,1,진위,893,733,20200428,1626
20200425,1,송탄,3324,2964,20200428,6288
20200425,1,서정리,4755,3805,20200428,8560
20200425,1,지제,1811,1487,20200428,3298
20200425,1,평택,9694,9513,20200428,19207
20200425,1,성환,2576,2376,20200428,4952
20200425,1,직산,565,535,20200428,1100
20200425,1,두정,3536,3524,20200428,7060
20200425,1,천안,4524,4731,20200428,9255
20200425,1,당정,3566,3347,20200428,6913
20200425,경부선,서동탄,881,971,20200428,1852
20200425,경부선,광명,1768,1369,20200428,3137
20200426,경부선,서울역,3365,695,20200429,4060
20200426,1,남영,3471,3760,20200429,7231
20200426,1,용산,20263,18137,20200429,38400
20200426,1,노량진,5786,5249,20200429,11035
20200426,1,대방,4848,5180,20200429,10028
20200426,1,영등포,25833,25183,20200429,51016
20200426,경부선,신도림,1718,1670,20200429,3388
20200426,1,신길,4191,3523,20200429,7714
20200426,1,구로,7440,7654,20200429,15094
20200426,1,가산디지털단지,3867,5032,20200429,8899
20200426,1,금천구청,5173,5002,20200429,10175
20200426,1,석수,4871,5044,20200429,9915
20200426,1,관악,4727,4055,20200429,8782
20200426,1,안양,12285,11745,20200429,24030
20200426,1,명학,2981,2975,20200429,5956
20200426,4,금정,11433,11888,20200429,23321
20200426,1,군포,2993,2794,20200429,5787
20200426,1,의왕,3796,3771,20200429,7567
20200426,1,성균관대,6250,6550,20200429,12800
20200426,1,화서,3350,3231,20200429,6581
20200426,1,수원,25561,25672,20200429,51233
20200426,1,독산,4993,4955,20200429,9948
20200426,1,세류,1756,1769,20200429,3525
20200426,1,병점,7184,7839,20200429,15023
20200426,1,세마,1297,1230,20200429,2527
20200426,1,오산대,1654,1563,20200429,3217
20200426,1,오산,5773,6177,20200429,11950
20200426,1,진위,581,631,20200429,1212
20200426,1,송탄,2547,2665,20200429,5212
20200426,1,서정리,2883,4194,20200429,7077
20200426,1,지제,1307,1271,20200429,2578
20200426,1,평택,8381,8759,20200429,17140
20200426,1,성환,2011,2283,20200429,4294
20200426,1,직산,425,491,20200429,916
20200426,1,두정,2695,3143,20200429,5838
20200426,1,천안,4168,4002,20200429,8170
20200426,1,당정,2580,2560,20200429,5140
20200426,경부선,서동탄,662,654,20200429,1316
20200426,경부선,광명,1607,1198,20200429,2805
20200427,경부선,서울역,3906,1092,20200430,4998
20200427,1,남영,9336,9927,20200430,19263
20200427,1,용산,27280,27866,20200430,55146
20200427,1,노량진,8362,8565,20200430,16927
20200427,1,대방,12452,12742,20200430,25194
20200427,1,영등포,34403,35785,20200430,70188
20200427,경부선,신도림,3914,3966,20200430,7880
20200427,1,신길,8944,7587,20200430,16531
20200427,1,구로,17230,17224,20200430,34454
20200427,1,가산디지털단지,18270,20804,20200430,39074
20200427,1,금천구청,10898,10640,20200430,21538
20200427,1,석수,9662,8435,20200430,18097
20200427,1,관악,6838,6352,20200430,13190
20200427,1,안양,20454,20532,20200430,40986
20200427,1,명학,8611,8529,20200430,17140
20200427,4,금정,24549,25170,20200430,49719
20200427,1,군포,7072,7311,20200430,14383
20200427,1,의왕,8510,8516,20200430,17026
20200427,1,성균관대,12458,12292,20200430,24750
20200427,1,화서,6946,6677,20200430,13623
20200427,1,수원,29081,31087,20200430,60168
20200427,1,독산,15881,16806,20200430,32687
20200427,1,세류,2893,2538,20200430,5431
20200427,1,병점,11572,11601,20200430,23173
20200427,1,세마,2297,2089,20200430,4386
20200427,1,오산대,2467,2187,20200430,4654
20200427,1,오산,7786,7861,20200430,15647
20200427,1,진위,1328,1221,20200430,2549
20200427,1,송탄,3317,3063,20200430,6380
20200427,1,서정리,4600,4746,20200430,9346
20200427,1,지제,2012,1905,20200430,3917
20200427,1,평택,9508,9322,20200430,18830
20200427,1,성환,2604,2793,20200430,5397
20200427,1,직산,633,690,20200430,1323
20200427,1,두정,3689,3933,20200430,7622
20200427,1,천안,4095,4129,20200430,8224
20200427,1,당정,5734,5445,20200430,11179
20200427,경부선,서동탄,1559,1240,20200430,2799
20200427,경부선,광명,2708,2274,20200430,4982
20200428,경부선,서울역,3621,1042,20200501,4663
20200428,1,남영,9528,9988,20200501,19516
20200428,1,용산,27231,28046,20200501,55277
20200428,1,노량진,8682,8770,20200501,17452
20200428,1,대방,12484,12723,20200501,25207
20200428,1,영등포,35198,36616,20200501,71814
20200428,경부선,신도림,3952,4036,20200501,7988
20200428,1,신길,9077,7543,20200501,16620
20200428,1,구로,17194,17464,20200501,34658
20200428,1,가산디지털단지,18266,20879,20200501,39145
20200428,1,금천구청,11036,10857,20200501,21893
20200428,1,석수,9963,8676,20200501,18639
20200428,1,관악,7071,6519,20200501,13590
20200428,1,안양,20648,21035,20200501,41683
20200428,1,명학,8652,8521,20200501,17173
20200428,4,금정,24583,25326,20200501,49909
20200428,1,군포,7159,7239,20200501,14398
20200428,1,의왕,8737,8584,20200501,17321
20200428,1,성균관대,12695,12334,20200501,25029
20200428,1,화서,6966,6836,20200501,13802
20200428,1,수원,29546,31456,20200501,61002
20200428,1,독산,15979,16888,20200501,32867
20200428,1,세류,2883,2651,20200501,5534
20200428,1,병점,11949,11756,20200501,23705
20200428,1,세마,2276,2084,20200501,4360
20200428,1,오산대,2637,2369,20200501,5006
20200428,1,오산,7978,7914,20200501,15892
20200428,1,진위,1383,1254,20200501,2637
20200428,1,송탄,3350,3213,20200501,6563
20200428,1,서정리,4574,4453,20200501,9027
20200428,1,지제,1910,1875,20200501,3785
20200428,1,평택,9261,8992,20200501,18253
20200428,1,성환,2600,2601,20200501,5201
20200428,1,직산,674,693,20200501,1367
20200428,1,두정,3676,3696,20200501,7372
20200428,1,천안,3944,4065,20200501,8009
20200428,1,당정,5840,5516,20200501,11356
20200428,경부선,서동탄,1504,1300,20200501,2804
20200428,경부선,광명,2700,2197,20200501,4897
20200429,경부선,서울역,4720,1482,20200502,6202
20200429,1,남영,10035,10238,20200502,20273
20200429,1,용산,31649,35465,20200502,67114
20200429,1,노량진,9459,9098,20200502,18557
20200429,1,대방,13078,12861,20200502,25939
20200429,1,영등포,38665,41488,20200502,80153
20200429,경부선,신도림,4089,3944,20200502,8033
20200429,1,신길,9396,7781,20200502,17177
20200429,1,구로,17721,18183,20200502,35904
20200429,1,가산디지털단지,18739,21469,20200502,40208
20200429,1,금천구청,11409,11329,20200502,22738
20200429,1,석수,10151,8744,20200502,18895
20200429,1,관악,7246,6519,20200502,13765
20200429,1,안양,21946,22665,20200502,44611
20200429,1,명학,8863,8553,20200502,17416
20200429,4,금정,26074,26334,20200502,52408
20200429,1,군포,7399,7362,20200502,14761
20200429,1,의왕,8884,8643,20200502,17527
20200429,1,성균관대,13302,13043,20200502,26345
20200429,1,화서,7460,7003,20200502,14463
20200429,1,수원,32917,36375,20200502,69292
20200429,1,독산,16574,16994,20200502,33568
20200429,1,세류,3033,2843,20200502,5876
20200429,1,병점,13254,12699,20200502,25953
20200429,1,세마,2399,2169,20200502,4568
20200429,1,오산대,2878,2574,20200502,5452
20200429,1,오산,8782,8409,20200502,17191
20200429,1,진위,1540,1256,20200502,2796
20200429,1,송탄,3789,3399,20200502,7188
20200429,1,서정리,5859,4808,20200502,10667
20200429,1,지제,2674,2189,20200502,4863
20200429,1,평택,10771,10672,20200502,21443
20200429,1,성환,2977,2719,20200502,5696
20200429,1,직산,775,764,20200502,1539
20200429,1,두정,4370,4353,20200502,8723
20200429,1,천안,4468,5143,20200502,9611
20200429,1,당정,6201,5705,20200502,11906
20200429,경부선,서동탄,1629,1372,20200502,3001
20200429,경부선,광명,3046,2677,20200502,5723
20200430,경부선,서울역,3322,1003,20200503,4325
20200430,1,남영,4316,4223,20200503,8539
20200430,1,용산,22062,28345,20200503,50407
20200430,1,노량진,7361,6288,20200503,13649
20200430,1,대방,6442,6027,20200503,12469
20200430,1,영등포,30346,32662,20200503,63008
20200430,경부선,신도림,2293,2260,20200503,4553
20200430,1,신길,5483,4234,20200503,9717
20200430,1,구로,9357,9232,20200503,18589
20200430,1,가산디지털단지,5187,6583,20200503,11770
20200430,1,금천구청,6897,6563,20200503,13460
20200430,1,석수,6196,5842,20200503,12038
20200430,1,관악,5515,5091,20200503,10606
20200430,1,안양,14940,14846,20200503,29786
20200430,1,명학,4042,3738,20200503,7780
20200430,4,금정,15052,15133,20200503,30185
20200430,1,군포,4492,4098,20200503,8590
20200430,1,의왕,4917,4644,20200503,9561
20200430,1,성균관대,7881,7786,20200503,15667
20200430,1,화서,4343,4140,20200503,8483
20200430,1,수원,29220,32231,20200503,61451
20200430,1,독산,7192,6795,20200503,13987
20200430,1,세류,2142,2201,20200503,4343
20200430,1,병점,9360,9034,20200503,18394
20200430,1,세마,1668,1449,20200503,3117
20200430,1,오산대,2232,1970,20200503,4202
20200430,1,오산,7352,6697,20200503,14049
20200430,1,진위,915,789,20200503,1704
20200430,1,송탄,3062,2701,20200503,5763
20200430,1,서정리,4241,3465,20200503,7706
20200430,1,지제,1609,1565,20200503,3174
20200430,1,평택,9643,9407,20200503,19050
20200430,1,성환,2425,2261,20200503,4686
20200430,1,직산,568,515,20200503,1083
20200430,1,두정,3370,3430,20200503,6800
20200430,1,천안,4808,5336,20200503,10144
20200430,1,당정,3459,3206,20200503,6665
20200430,경부선,서동탄,881,947,20200503,1828
20200430,경부선,광명,1721,1855,20200503,3576
20200501,경부선,광명,1768,1629,20200504,3397
20200501,경부선,서동탄,902,907,20200504,1809
20200501,1,당정,3615,3424,20200504,7039
20200501,1,천안,5034,5221,20200504,10255
20200501,1,두정,3548,3535,20200504,7083
20200501,1,직산,609,572,20200504,1181
20200501,1,성환,2545,2402,20200504,4947
20200501,1,평택,10059,9987,20200504,20046
20200501,1,지제,1447,1462,20200504,2909
20200501,1,서정리,3759,3778,20200504,7537
20200501,1,송탄,3152,2933,20200504,6085
20200501,1,진위,835,761,20200504,1596
20200501,1,오산,7438,7142,20200504,14580
20200501,1,오산대,2018,1929,20200504,3947
20200501,1,세마,1720,1438,20200504,3158
20200501,1,병점,9148,9264,20200504,18412
20200501,1,세류,2230,2151,20200504,4381
20200501,1,독산,7500,7454,20200504,14954
20200501,1,수원,29948,33391,20200504,63339
20200501,1,화서,4391,4168,20200504,8559
20200501,1,성균관대,8462,8337,20200504,16799
20200501,1,의왕,5097,4924,20200504,10021
20200501,1,군포,4037,3778,20200504,7815
20200501,4,금정,15383,15739,20200504,31122
20200501,1,명학,3958,3681,20200504,7639
20200501,1,안양,15716,15775,20200504,31491
20200501,1,관악,4669,4359,20200504,9028
20200501,1,석수,6220,5650,20200504,11870
20200501,1,금천구청,7423,7061,20200504,14484
20200501,1,가산디지털단지,5551,7202,20200504,12753
20200501,1,구로,9687,10213,20200504,19900
20200501,1,신길,5369,4340,20200504,9709
20200501,경부선,신도림,2306,2286,20200504,4592
20200501,1,영등포,31989,33621,20200504,65610
20200501,1,대방,6598,6670,20200504,13268
20200501,1,노량진,7616,6783,20200504,14399
20200501,1,용산,25618,28480,20200504,54098
20200501,1,남영,5286,5472,20200504,10758
20200501,경부선,서울역,3804,935,20200504,4739
20200502,경부선,광명,2018,1536,20200505,3554
20200502,경부선,서동탄,871,904,20200505,1775
20200502,1,당정,3357,3186,20200505,6543
20200502,1,천안,5103,4921,20200505,10024
20200502,1,두정,3217,3363,20200505,6580
20200502,1,직산,637,583,20200505,1220
20200502,1,성환,2586,2498,20200505,5084
20200502,1,평택,9924,9824,20200505,19748
20200502,1,지제,1442,1340,20200505,2782
20200502,1,서정리,3763,4014,20200505,7777
20200502,1,송탄,3105,2962,20200505,6067
20200502,1,진위,792,680,20200505,1472
20200502,1,오산,7212,6948,20200505,14160
20200502,1,오산대,1982,1744,20200505,3726
20200502,1,세마,1670,1507,20200505,3177
20200502,1,병점,8957,9138,20200505,18095
20200502,경부선,서울역,4251,785,20200505,5036
20200502,1,남영,4370,4439,20200505,8809
20200502,1,용산,26873,26519,20200505,53392
20200502,1,노량진,7415,6448,20200505,13863
20200502,1,대방,6800,6752,20200505,13552
20200502,1,영등포,32023,33412,20200505,65435
20200502,경부선,신도림,2383,2448,20200505,4831
20200502,1,신길,5110,4254,20200505,9364
20200502,1,구로,9436,9750,20200505,19186
20200502,1,가산디지털단지,4667,6411,20200505,11078
20200502,1,금천구청,6698,6541,20200505,13239
20200502,1,석수,5891,5471,20200505,11362
20200502,1,관악,4749,4415,20200505,9164
20200502,1,안양,14891,14948,20200505,29839
20200502,1,명학,4041,3828,20200505,7869
20200502,4,금정,14762,14769,20200505,29531
20200502,1,군포,3852,3500,20200505,7352
20200502,1,의왕,4771,4647,20200505,9418
20200502,1,성균관대,8177,8094,20200505,16271
20200502,1,화서,4045,3917,20200505,7962
20200502,1,수원,30680,32718,20200505,63398
20200502,1,독산,6718,6573,20200505,13291
20200502,1,세류,2128,2055,20200505,4183
20200503,경부선,광명,2187,1229,20200506,3416
20200503,경부선,서동탄,808,766,20200506,1574
20200503,1,당정,2624,2666,20200506,5290
20200503,1,천안,5267,4553,20200506,9820
20200503,1,두정,2845,3123,20200506,5968
20200503,1,직산,516,534,20200506,1050
20200503,1,성환,2154,2419,20200506,4573
20200503,1,평택,9134,9401,20200506,18535
20200503,1,지제,1526,1326,20200506,2852
20200503,1,서정리,2891,4641,20200506,7532
20200503,1,송탄,2556,2750,20200506,5306
20200503,1,진위,648,604,20200506,1252
20200503,1,오산,6546,6879,20200506,13425
20200503,1,오산대,1599,1400,20200506,2999
20200503,1,세마,1244,1161,20200506,2405
20200503,1,병점,7473,7986,20200506,15459
20200503,1,세류,1924,1814,20200506,3738
20200503,1,독산,5217,5306,20200506,10523
20200503,1,수원,27673,27465,20200506,55138
20200503,1,화서,3492,3310,20200506,6802
20200503,1,성균관대,6298,6728,20200506,13026
20200503,1,의왕,3703,3727,20200506,7430
20200503,1,군포,2949,2695,20200506,5644
20200503,4,금정,11865,12176,20200506,24041
20200503,1,명학,2822,2782,20200506,5604
20200503,1,안양,12423,11953,20200506,24376
20200503,1,관악,4131,3773,20200506,7904
20200503,1,석수,4578,4569,20200506,9147
20200503,1,금천구청,5358,5269,20200506,10627
20200503,1,가산디지털단지,3922,5576,20200506,9498
20200503,1,구로,7309,7540,20200506,14849
20200503,1,신길,4017,3483,20200506,7500
20200503,경부선,신도림,1719,1712,20200506,3431
20200503,1,영등포,28421,27225,20200506,55646
20200503,1,대방,5223,5485,20200506,10708
20200503,1,노량진,5534,5053,20200506,10587
20200503,1,용산,26067,20800,20200506,46867
20200503,1,남영,3389,3659,20200506,7048
20200503,경부선,서울역,5346,768,20200506,6114
20200504,경부선,광명,2476,1888,20200507,4364
20200504,경부선,서동탄,1269,1093,20200507,2362
20200504,1,당정,4988,4645,20200507,9633
20200504,1,천안,4588,4754,20200507,9342
20200504,1,두정,3947,4240,20200507,8187
20200504,1,직산,649,652,20200507,1301
20200504,1,성환,3387,3426,20200507,6813
20200504,1,평택,10482,10498,20200507,20980
20200504,1,지제,2007,1745,20200507,3752
20200504,1,서정리,5904,5655,20200507,11559
20200504,1,송탄,3755,3491,20200507,7246
20200504,1,진위,1107,1070,20200507,2177
20200504,1,오산,7888,8060,20200507,15948
20200504,1,오산대,2442,2192,20200507,4634
20200504,1,세마,2167,1892,20200507,4059
20200504,1,병점,11398,11465,20200507,22863
20200504,1,세류,2573,2418,20200507,4991
20200504,1,독산,12100,12441,20200507,24541
20200504,1,수원,32105,34283,20200507,66388
20200504,1,화서,6139,5731,20200507,11870
20200504,1,성균관대,11087,11003,20200507,22090
20200504,1,의왕,6862,6800,20200507,13662
20200504,1,군포,5800,5809,20200507,11609
20200504,4,금정,20889,21361,20200507,42250
20200504,1,명학,6502,6293,20200507,12795
20200504,1,안양,19329,19428,20200507,38757
20200504,1,관악,6059,5623,20200507,11682
20200504,1,석수,8414,7368,20200507,15782
20200504,1,금천구청,9832,9817,20200507,19649
20200504,1,가산디지털단지,11458,13959,20200507,25417
20200504,1,구로,14987,15240,20200507,30227
20200504,1,신길,7979,6630,20200507,14609
20200504,경부선,신도림,3371,3407,20200507,6778
20200504,1,영등포,37066,38774,20200507,75840
20200504,1,대방,10776,10815,20200507,21591
20200504,1,노량진,8488,8222,20200507,16710
20200504,1,용산,29208,27933,20200507,57141
20200504,1,남영,8186,8823,20200507,17009
20200504,경부선,서울역,4434,984,20200507,5418
20200505,경부선,서울역,4152,672,20200508,4824
20200505,1,남영,3874,3908,20200508,7782
20200505,1,용산,23699,20882,20200508,44581
20200505,1,노량진,6540,5910,20200508,12450
20200505,1,대방,5544,5865,20200508,11409
20200505,1,영등포,29664,29226,20200508,58890
20200505,경부선,신도림,1938,1922,20200508,3860
20200505,1,신길,4478,3928,20200508,8406
20200505,1,구로,8265,8169,20200508,16434
20200505,1,가산디지털단지,4376,6177,20200508,10553
20200505,1,금천구청,5822,5744,20200508,11566
20200505,1,석수,5171,4871,20200508,10042
20200505,1,관악,4227,3976,20200508,8203
20200505,1,안양,13210,13205,20200508,26415
20200505,1,명학,3500,3322,20200508,6822
20200505,4,금정,13070,13403,20200508,26473
20200505,1,군포,3625,3363,20200508,6988
20200505,1,의왕,4250,4288,20200508,8538
20200505,1,성균관대,6879,7200,20200508,14079
20200505,1,화서,3553,3429,20200508,6982
20200505,1,수원,26548,26732,20200508,53280
20200505,1,독산,6033,6152,20200508,12185
20200505,1,세류,1790,1773,20200508,3563
20200505,1,병점,7471,8396,20200508,15867
20200505,1,세마,1422,1372,20200508,2794
20200505,1,오산대,1767,1735,20200508,3502
20200505,1,오산,5753,6278,20200508,12031
20200505,1,진위,683,655,20200508,1338
20200505,1,송탄,2592,2594,20200508,5186
20200505,1,서정리,3367,3834,20200508,7201
20200505,1,지제,1622,1369,20200508,2991
20200505,1,평택,7792,8027,20200508,15819
20200505,1,성환,1935,2186,20200508,4121
20200505,1,직산,438,478,20200508,916
20200505,1,두정,2751,2962,20200508,5713
20200505,1,천안,4012,3831,20200508,7843
20200505,1,당정,2800,2770,20200508,5570
20200505,경부선,서동탄,818,828,20200508,1646
20200505,경부선,광명,2064,1196,20200508,3260
20200506,1,성환,3706,3731,20200509,7437
20200506,1,평택,10333,10040,20200509,20373
20200506,1,지제,2222,1944,20200509,4166
20200506,1,서정리,6292,6006,20200509,12298
20200506,1,송탄,3687,3524,20200509,7211
20200506,1,진위,1418,1256,20200509,2674
20200506,1,오산,8447,8520,20200509,16967
20200506,1,오산대,3050,2696,20200509,5746
20200506,1,세마,2416,2193,20200509,4609
20200506,1,병점,12930,12949,20200509,25879
20200506,1,세류,2955,2732,20200509,5687
20200506,1,독산,16665,17551,20200509,34216
20200506,1,수원,32512,34853,20200509,67365
20200506,1,화서,7437,7148,20200509,14585
20200506,1,성균관대,13656,13384,20200509,27040
20200506,1,의왕,8925,8843,20200509,17768
20200506,1,군포,7488,7541,20200509,15029
20200506,4,금정,25798,26447,20200509,52245
20200506,1,명학,9224,9111,20200509,18335
20200506,1,안양,23178,23013,20200509,46191
20200506,1,관악,7277,6695,20200509,13972
20200506,1,석수,10132,8945,20200509,19077
20200506,1,금천구청,11600,11358,20200509,22958
20200506,1,가산디지털단지,18845,21509,20200509,40354
20200506,1,구로,18065,18225,20200509,36290
20200506,1,신길,9400,7861,20200509,17261
20200506,경부선,신도림,4182,4118,20200509,8300
20200506,1,영등포,37221,38609,20200509,75830
20200506,1,대방,12934,13135,20200509,26069
20200506,1,노량진,8921,8827,20200509,17748
20200506,1,용산,28779,29041,20200509,57820
20200506,1,남영,9994,10508,20200509,20502
20200506,경부선,서울역,4196,1128,20200509,5324
20200506,1,직산,724,714,20200509,1438
20200506,1,두정,3924,4090,20200509,8014
20200506,1,천안,4362,4505,20200509,8867
20200506,1,당정,6066,5860,20200509,11926
20200506,경부선,서동탄,1672,1349,20200509,3021
20200506,경부선,광명,2849,2274,20200509,5123
20200507,1,세마,2418,2225,20200510,4643
20200507,1,오산대,2900,2678,20200510,5578
20200507,1,오산,8366,8391,20200510,16757
20200507,1,진위,1441,1320,20200510,2761
20200507,1,송탄,3760,3519,20200510,7279
20200507,1,서정리,6289,6047,20200510,12336
20200507,1,지제,2216,1981,20200510,4197
20200507,1,평택,10272,10158,20200510,20430
20200507,1,성환,3905,3659,20200510,7564
20200507,1,직산,658,689,20200510,1347
20200507,1,두정,4196,4138,20200510,8334
20200507,1,천안,4484,4653,20200510,9137
20200507,1,당정,6327,5963,20200510,12290
20200507,경부선,서동탄,1678,1430,20200510,3108
20200507,1,화서,7364,7090,20200510,14454
20200507,1,성균관대,13957,13676,20200510,27633
20200507,1,의왕,9198,9028,20200510,18226
20200507,1,군포,7577,7566,20200510,15143
20200507,4,금정,25958,26474,20200510,52432
20200507,1,명학,9466,9265,20200510,18731
20200507,1,안양,23028,23354,20200510,46382
20200507,1,관악,7367,6875,20200510,14242
20200507,1,석수,10611,9225,20200510,19836
20200507,1,금천구청,11863,11559,20200510,23422
20200507,1,가산디지털단지,18811,21659,20200510,40470
20200507,1,구로,17870,18146,20200510,36016
20200507,1,신길,9573,8051,20200510,17624
20200507,경부선,신도림,4181,4181,20200510,8362
20200507,경부선,광명,2770,2321,20200510,5091
20200507,1,영등포,37990,39820,20200510,77810
20200507,1,대방,13201,13408,20200510,26609
20200507,1,노량진,9183,8998,20200510,18181
20200507,1,용산,28993,29877,20200510,58870
20200507,1,남영,10110,10555,20200510,20665
20200507,경부선,서울역,3982,1102,20200510,5084
20200507,1,병점,13144,12943,20200510,26087
20200507,1,세류,3011,2740,20200510,5751
20200507,1,독산,16736,17599,20200510,34335
20200507,1,수원,33028,35486,20200510,68514
20200508,경부선,서울역,5620,1659,20200511,7279
20200508,1,남영,10141,10543,20200511,20684
20200508,1,용산,34546,36593,20200511,71139
20200508,1,노량진,9325,9404,20200511,18729
20200508,1,대방,13623,13662,20200511,27285
20200508,1,영등포,41722,43659,20200511,85381
20200508,경부선,신도림,4066,4072,20200511,8138
20200508,1,신길,9734,7985,20200511,17719
20200508,1,구로,18533,18643,20200511,37176
20200508,1,가산디지털단지,18928,21618,20200511,40546
20200508,1,금천구청,11985,11961,20200511,23946
20200508,1,석수,10570,9334,20200511,19904
20200508,1,관악,7444,7063,20200511,14507
20200508,1,안양,22793,23717,20200511,46510
20200508,1,명학,9176,8953,20200511,18129
20200508,4,금정,26163,26905,20200511,53068
20200508,1,군포,7539,7563,20200511,15102
20200508,1,의왕,9104,9068,20200511,18172
20200508,1,성균관대,14460,14211,20200511,28671
20200508,1,화서,7448,7375,20200511,14823
20200508,1,수원,36397,39704,20200511,76101
20200508,1,독산,17149,17888,20200511,35037
20200508,1,세류,3354,2935,20200511,6289
20200508,1,병점,14312,13797,20200511,28109
20200508,1,세마,2546,2322,20200511,4868
20200508,1,오산대,3029,2701,20200511,5730
20200508,1,오산,9611,9341,20200511,18952
20200508,1,진위,1754,1364,20200511,3118
20200508,1,송탄,4187,3741,20200511,7928
20200508,1,서정리,6674,5872,20200511,12546
20200508,1,지제,2703,2410,20200511,5113
20200508,1,평택,11798,11715,20200511,23513
20200508,1,성환,3854,3327,20200511,7181
20200508,1,직산,807,784,20200511,1591
20200508,1,두정,4876,4528,20200511,9404
20200508,1,천안,5279,5527,20200511,10806
20200508,1,당정,6326,6029,20200511,12355
20200508,경부선,서동탄,1701,1453,20200511,3154
20200508,경부선,광명,3104,2733,20200511,5837
20200509,경부선,서울역,4085,954,20200512,5039
20200509,1,남영,4661,4733,20200512,9394
20200509,1,용산,23498,25677,20200512,49175
20200509,1,노량진,6793,5904,20200512,12697
20200509,1,대방,6538,6565,20200512,13103
20200509,1,영등포,33782,35696,20200512,69478
20200509,경부선,신도림,1866,2097,20200512,3963
20200509,1,신길,5004,4231,20200512,9235
20200509,1,구로,9960,10173,20200512,20133
20200509,1,가산디지털단지,4839,6588,20200512,11427
20200509,1,금천구청,6389,6383,20200512,12772
20200509,1,석수,5632,4885,20200512,10517
20200509,1,관악,4354,4230,20200512,8584
20200509,1,안양,14852,15113,20200512,29965
20200509,1,명학,4410,4135,20200512,8545
20200509,4,금정,15003,15168,20200512,30171
20200509,1,군포,3769,3405,20200512,7174
20200509,1,의왕,4672,4455,20200512,9127
20200509,1,성균관대,8327,8238,20200512,16565
20200509,1,화서,4094,3943,20200512,8037
20200509,1,수원,28945,31615,20200512,60560
20200509,1,독산,6981,6878,20200512,13859
20200509,1,세류,2020,2043,20200512,4063
20200509,1,병점,9158,8894,20200512,18052
20200509,1,세마,1504,1378,20200512,2882
20200509,1,오산대,1832,1677,20200512,3509
20200509,1,오산,6897,6484,20200512,13381
20200509,1,진위,806,746,20200512,1552
20200509,1,송탄,3307,2929,20200512,6236
20200509,1,서정리,4672,3854,20200512,8526
20200509,1,지제,1748,1537,20200512,3285
20200509,1,평택,9749,9282,20200512,19031
20200509,1,성환,2604,2336,20200512,4940
20200509,1,직산,510,499,20200512,1009
20200509,1,두정,3391,3568,20200512,6959
20200509,1,천안,4706,4819,20200512,9525
20200509,1,당정,3335,3031,20200512,6366
20200509,경부선,서동탄,843,901,20200512,1744
20200509,경부선,광명,1870,1555,20200512,3425
20200510,경부선,서울역,4541,853,20200513,5394
20200510,1,남영,3773,4135,20200513,7908
20200510,1,용산,23304,19405,20200513,42709
20200510,1,노량진,5442,4934,20200513,10376
20200510,1,대방,5337,5801,20200513,11138
20200510,1,영등포,28278,27283,20200513,55561
20200510,경부선,신도림,1814,1898,20200513,3712
20200510,1,신길,4364,3943,20200513,8307
20200510,1,구로,7952,8116,20200513,16068
20200510,1,가산디지털단지,4062,5749,20200513,9811
20200510,1,금천구청,5516,5433,20200513,10949
20200510,1,석수,5079,5078,20200513,10157
20200510,1,관악,5009,4338,20200513,9347
20200510,1,안양,12834,12418,20200513,25252
20200510,1,명학,3452,3422,20200513,6874
20200510,4,금정,12255,12622,20200513,24877
20200510,1,군포,3019,2837,20200513,5856
20200510,1,의왕,3703,3572,20200513,7275
20200510,1,성균관대,6694,7173,20200513,13867
20200510,1,화서,3522,3388,20200513,6910
20200510,1,수원,28697,28335,20200513,57032
20200510,1,독산,5164,5359,20200513,10523
20200510,1,세류,1916,1933,20200513,3849
20200510,1,병점,7836,8645,20200513,16481
20200510,1,세마,1330,1248,20200513,2578
20200510,1,오산대,1704,1620,20200513,3324
20200510,1,오산,6422,6828,20200513,13250
20200510,1,진위,686,675,20200513,1361
20200510,1,송탄,2784,2981,20200513,5765
20200510,1,서정리,3276,4753,20200513,8029
20200510,1,지제,1461,1432,20200513,2893
20200510,1,평택,9673,10151,20200513,19824
20200510,1,성환,2229,2737,20200513,4966
20200510,1,직산,473,560,20200513,1033
20200510,1,두정,3102,3589,20200513,6691
20200510,1,천안,5207,4726,20200513,9933
20200510,1,당정,2754,2651,20200513,5405
20200510,경부선,서동탄,812,753,20200513,1565
20200510,경부선,광명,1953,1226,20200513,3179
20200511,경부선,광명,2906,2313,20200514,5219
20200511,경부선,서동탄,1559,1269,20200514,2828
20200511,1,당정,6070,5824,20200514,11894
20200511,1,천안,4620,4781,20200514,9401
20200511,1,두정,4237,4546,20200514,8783
20200511,1,직산,729,754,20200514,1483
20200511,1,성환,3685,3833,20200514,7518
20200511,1,평택,10555,10508,20200514,21063
20200511,1,지제,2208,2049,20200514,4257
20200511,1,서정리,6213,6179,20200514,12392
20200511,1,송탄,3877,3578,20200514,7455
20200511,1,진위,1369,1237,20200514,2606
20200511,1,오산,8469,8565,20200514,17034
20200511,1,오산대,2896,2594,20200514,5490
20200511,1,세마,2396,2088,20200514,4484
20200511,1,병점,12739,12813,20200514,25552
20200511,1,세류,3062,2890,20200514,5952
20200511,1,독산,16740,17485,20200514,34225
20200511,1,수원,31983,33879,20200514,65862
20200511,1,화서,7287,7030,20200514,14317
20200511,1,성균관대,13429,13373,20200514,26802
20200511,1,의왕,8761,8690,20200514,17451
20200511,1,군포,7411,7480,20200514,14891
20200511,4,금정,25387,26034,20200514,51421
20200511,1,명학,9195,8985,20200514,18180
20200511,1,안양,21574,21819,20200514,43393
20200511,1,관악,7244,6717,20200514,13961
20200511,1,석수,10250,8976,20200514,19226
20200511,1,금천구청,11401,11301,20200514,22702
20200511,1,가산디지털단지,18993,21644,20200514,40637
20200511,1,구로,17978,17897,20200514,35875
20200511,1,신길,9395,7854,20200514,17249
20200511,경부선,신도림,3937,4064,20200514,8001
20200511,1,영등포,35313,36859,20200514,72172
20200511,1,대방,13158,13291,20200514,26449
20200511,1,노량진,8468,8374,20200514,16842
20200511,1,용산,28150,28578,20200514,56728
20200511,1,남영,9849,10497,20200514,20346
20200511,경부선,서울역,4440,1224,20200514,5664
20200512,경부선,서울역,3779,1158,20200515,4937
20200512,1,남영,9839,10183,20200515,20022
20200512,1,용산,26825,27370,20200515,54195
20200512,1,노량진,8473,8277,20200515,16750
20200512,1,대방,13279,13367,20200515,26646
20200512,1,영등포,34901,36176,20200515,71077
20200512,경부선,신도림,3960,3910,20200515,7870
20200512,1,신길,9194,7844,20200515,17038
20200512,1,구로,17868,17900,20200515,35768
20200512,1,가산디지털단지,18601,21310,20200515,39911
20200512,1,금천구청,11368,11356,20200515,22724
20200512,1,석수,10107,8951,20200515,19058
20200512,1,관악,7185,6608,20200515,13793
20200512,1,안양,21240,21433,20200515,42673
20200512,1,명학,8890,8779,20200515,17669
20200512,4,금정,25295,25925,20200515,51220
20200512,1,군포,7340,7254,20200515,14594
20200512,1,의왕,8627,8564,20200515,17191
20200512,1,성균관대,13430,13377,20200515,26807
20200512,1,화서,7206,6921,20200515,14127
20200512,1,수원,31284,33352,20200515,64636
20200512,1,독산,16478,17386,20200515,33864
20200512,1,세류,3019,2718,20200515,5737
20200512,1,병점,12852,12781,20200515,25633
20200512,1,세마,2411,2217,20200515,4628
20200512,1,오산대,2915,2671,20200515,5586
20200512,1,오산,8327,8222,20200515,16549
20200512,1,진위,1407,1250,20200515,2657
20200512,1,송탄,3680,3527,20200515,7207
20200512,1,서정리,6245,6052,20200515,12297
20200512,1,지제,2153,1978,20200515,4131
20200512,1,평택,9958,9913,20200515,19871
20200512,1,성환,3690,3672,20200515,7362
20200512,1,직산,659,668,20200515,1327
20200512,1,두정,4387,4572,20200515,8959
20200512,1,천안,4556,4610,20200515,9166
20200512,1,당정,6081,5750,20200515,11831
20200512,경부선,서동탄,1608,1352,20200515,2960
20200512,경부선,광명,2683,2237,20200515,4920
20200513,경부선,서울역,3848,1100,20200516,4948
20200513,1,남영,9668,10325,20200516,19993
20200513,1,용산,26737,27217,20200516,53954
20200513,1,노량진,8764,8553,20200516,17317
20200513,1,대방,13068,13168,20200516,26236
20200513,1,영등포,34930,36657,20200516,71587
20200513,경부선,신도림,4063,4087,20200516,8150
20200513,1,신길,9268,7741,20200516,17009
20200513,1,구로,17889,17941,20200516,35830
20200513,1,가산디지털단지,18707,21452,20200516,40159
20200513,1,금천구청,11503,11260,20200516,22763
20200513,1,석수,10272,8979,20200516,19251
20200513,1,관악,7284,6738,20200516,14022
20200513,1,안양,21560,21867,20200516,43427
20200513,1,명학,9045,8860,20200516,17905
20200513,4,금정,25488,26051,20200516,51539
20200513,1,군포,7466,7423,20200516,14889
20200513,1,의왕,8754,8730,20200516,17484
20200513,1,성균관대,13102,12878,20200516,25980
20200513,1,화서,7409,7163,20200516,14572
20200513,1,수원,31221,33274,20200516,64495
20200513,1,독산,16552,17394,20200516,33946
20200513,1,세류,2955,2800,20200516,5755
20200513,1,병점,12805,12547,20200516,25352
20200513,1,세마,2360,2244,20200516,4604
20200513,1,오산대,3154,2786,20200516,5940
20200513,1,오산,8542,8562,20200516,17104
20200513,1,진위,1392,1271,20200516,2663
20200513,1,송탄,3622,3458,20200516,7080
20200513,1,서정리,5130,5002,20200516,10132
20200513,1,지제,2159,1971,20200516,4130
20200513,1,평택,10082,9896,20200516,19978
20200513,1,성환,3724,3713,20200516,7437
20200513,1,직산,674,702,20200516,1376
20200513,1,두정,4314,4489,20200516,8803
20200513,1,천안,4449,4576,20200516,9025
20200513,1,당정,6050,5737,20200516,11787
20200513,경부선,서동탄,1574,1328,20200516,2902
20200513,경부선,광명,2730,2237,20200516,4967
20200514,경부선,서울역,4309,1176,20200517,5485
20200514,1,남영,9798,10244,20200517,20042
20200514,1,용산,27778,27985,20200517,55763
20200514,1,노량진,8547,8431,20200517,16978
20200514,1,대방,13142,13111,20200517,26253
20200514,1,영등포,35176,36604,20200517,71780
20200514,경부선,신도림,4058,3979,20200517,8037
20200514,1,신길,9160,7777,20200517,16937
20200514,1,구로,17464,17880,20200517,35344
20200514,1,가산디지털단지,18569,21245,20200517,39814
20200514,1,금천구청,11382,11190,20200517,22572
20200514,1,석수,10056,8909,20200517,18965
20200514,1,관악,7277,6623,20200517,13900
20200514,1,안양,21394,21891,20200517,43285
20200514,1,명학,9106,8792,20200517,17898
20200514,4,금정,25202,25860,20200517,51062
20200514,1,군포,7323,7132,20200517,14455
20200514,1,의왕,8641,8623,20200517,17264
20200514,1,성균관대,12994,12819,20200517,25813
20200514,1,화서,7115,6912,20200517,14027
20200514,1,수원,30878,33315,20200517,64193
20200514,1,독산,16596,17310,20200517,33906
20200514,1,세류,2846,2646,20200517,5492
20200514,1,병점,12530,12351,20200517,24881
20200514,1,세마,2383,2187,20200517,4570
20200514,1,오산대,2877,2657,20200517,5534
20200514,1,오산,8128,7971,20200517,16099
20200514,1,진위,1365,1262,20200517,2627
20200514,1,송탄,3814,3356,20200517,7170
20200514,1,서정리,5509,4826,20200517,10335
20200514,1,지제,2364,1977,20200517,4341
20200514,1,평택,10457,10118,20200517,20575
20200514,1,성환,3765,3511,20200517,7276
20200514,1,직산,658,741,20200517,1399
20200514,1,두정,4518,4460,20200517,8978
20200514,1,천안,4581,4521,20200517,9102
20200514,1,당정,6020,5764,20200517,11784
20200514,경부선,서동탄,1561,1311,20200517,2872
20200514,경부선,광명,2759,2305,20200517,5064
20200515,경부선,광명,3179,2713,20200518,5892
20200515,경부선,서동탄,1468,1368,20200518,2836
20200515,1,당정,5888,5525,20200518,11413
20200515,1,천안,4680,4860,20200518,9540
20200515,1,두정,4423,4304,20200518,8727
20200515,1,직산,746,719,20200518,1465
20200515,1,성환,3399,2897,20200518,6296
20200515,1,평택,10714,10287,20200518,21001
20200515,1,지제,2333,1996,20200518,4329
20200515,1,서정리,5324,4542,20200518,9866
20200515,1,송탄,3663,3355,20200518,7018
20200515,1,진위,1516,1165,20200518,2681
20200515,1,오산,8337,8033,20200518,16370
20200515,1,오산대,2664,2369,20200518,5033
20200515,1,세마,2241,1975,20200518,4216
20200515,1,병점,12809,12347,20200518,25156
20200515,1,세류,2949,2766,20200518,5715
20200515,1,독산,16241,16924,20200518,33165
20200515,1,수원,32207,34826,20200518,67033
20200515,1,화서,6713,6607,20200518,13320
20200515,1,성균관대,12915,12577,20200518,25492
20200515,1,의왕,8225,8126,20200518,16351
20200515,1,군포,7058,6922,20200518,13980
20200515,4,금정,24933,25282,20200518,50215
20200515,1,명학,8418,8214,20200518,16632
20200515,1,안양,20891,21635,20200518,42526
20200515,1,관악,6842,6288,20200518,13130
20200515,1,석수,9592,8350,20200518,17942
20200515,1,금천구청,10795,10817,20200518,21612
20200515,1,가산디지털단지,17997,20776,20200518,38773
20200515,1,구로,17127,17442,20200518,34569
20200515,1,신길,8801,7269,20200518,16070
20200515,경부선,신도림,3529,3722,20200518,7251
20200515,1,영등포,37272,39643,20200518,76915
20200515,1,대방,12471,12761,20200518,25232
20200515,1,노량진,8424,8067,20200518,16491
20200515,1,용산,31628,32295,20200518,63923
20200515,1,남영,9553,9951,20200518,19504
20200515,경부선,서울역,5660,1632,20200518,7292
20200516,경부선,광명,2051,1696,20200519,3747
20200516,경부선,서동탄,879,940,20200519,1819
20200516,1,당정,3557,3382,20200519,6939
20200516,1,천안,5121,5242,20200519,10363
20200516,1,두정,3994,3915,20200519,7909
20200516,1,직산,588,558,20200519,1146
20200516,1,성환,2975,2637,20200519,5612
20200516,1,평택,10449,10526,20200519,20975
20200516,1,지제,1662,1585,20200519,3247
20200516,1,서정리,4311,3916,20200519,8227
20200516,1,송탄,3342,3144,20200519,6486
20200516,1,진위,930,813,20200519,1743
20200516,1,오산,7487,7073,20200519,14560
20200516,1,오산대,2165,1974,20200519,4139
20200516,1,세마,1692,1516,20200519,3208
20200516,1,병점,9730,9803,20200519,19533
20200516,1,세류,2455,2310,20200519,4765
20200516,1,수원,30638,32985,20200519,63623
20200516,1,화서,4554,4456,20200519,9010
20200516,1,성균관대,8712,8790,20200519,17502
20200516,1,의왕,5037,4875,20200519,9912
20200516,1,군포,4205,3837,20200519,8042
20200516,4,금정,16459,16816,20200519,33275
20200516,1,명학,4923,4728,20200519,9651
20200516,1,안양,16377,16684,20200519,33061
20200516,1,관악,5206,4934,20200519,10140
20200516,1,석수,6288,5784,20200519,12072
20200516,1,금천구청,7166,7076,20200519,14242
20200516,1,가산디지털단지,5520,7290,20200519,12810
20200516,1,구로,11403,11771,20200519,23174
20200516,1,신길,5552,4607,20200519,10159
20200516,경부선,신도림,2544,2632,20200519,5176
20200516,1,영등포,33104,35122,20200519,68226
20200516,1,대방,7442,7251,20200519,14693
20200516,1,노량진,7619,6581,20200519,14200
20200516,1,용산,22402,24368,20200519,46770
20200516,1,남영,4895,4877,20200519,9772
20200516,경부선,서울역,3438,867,20200519,4305
20200516,1,독산,7822,7625,20200519,15447
20200517,경부선,광명,1915,1222,20200520,3137
20200517,경부선,서동탄,738,708,20200520,1446
20200517,1,당정,2796,2688,20200520,5484
20200517,1,천안,4953,4951,20200520,9904
20200517,1,두정,2947,3405,20200520,6352
20200517,1,직산,563,556,20200520,1119
20200517,1,성환,2070,2647,20200520,4717
20200517,1,평택,9222,9908,20200520,19130
20200517,1,지제,1612,1464,20200520,3076
20200517,1,서정리,3190,4754,20200520,7944
20200517,1,송탄,2840,3039,20200520,5879
20200517,1,진위,677,717,20200520,1394
20200517,1,오산,6208,6791,20200520,12999
20200517,1,오산대,1748,1605,20200520,3353
20200517,1,세마,1359,1220,20200520,2579
20200517,1,병점,7396,8146,20200520,15542
20200517,1,세류,1868,1742,20200520,3610
20200517,1,독산,5286,5315,20200520,10601
20200517,1,수원,27164,26868,20200520,54032
20200517,1,화서,3537,3374,20200520,6911
20200517,1,성균관대,6696,7083,20200520,13779
20200517,1,의왕,3879,3910,20200520,7789
20200517,1,군포,3001,2813,20200520,5814
20200517,4,금정,12420,12718,20200520,25138
20200517,1,명학,3303,3339,20200520,6642
20200517,1,안양,12742,12274,20200520,25016
20200517,1,관악,4826,4296,20200520,9122
20200517,1,석수,5115,5176,20200520,10291
20200517,1,금천구청,5605,5464,20200520,11069
20200517,1,가산디지털단지,4258,5778,20200520,10036
20200517,1,구로,8272,8397,20200520,16669
20200517,1,신길,4623,4005,20200520,8628
20200517,경부선,신도림,1955,1989,20200520,3944
20200517,1,영등포,26932,26133,20200520,53065
20200517,1,대방,5428,5700,20200520,11128
20200517,1,노량진,5468,4798,20200520,10266
20200517,1,용산,21139,19039,20200520,40178
20200517,1,남영,3585,3855,20200520,7440
20200517,경부선,서울역,4129,761,20200520,4890
20200518,경부선,서울역,4383,1251,20200521,5634
20200518,1,남영,9276,9980,20200521,19256
20200518,1,용산,27493,27835,20200521,55328
20200518,1,노량진,7802,7907,20200521,15709
20200518,1,대방,12529,13013,20200521,25542
20200518,1,영등포,33758,35062,20200521,68820
20200518,경부선,신도림,3683,3768,20200521,7451
20200518,1,신길,8624,7618,20200521,16242
20200518,1,구로,17594,17126,20200521,34720
20200518,1,가산디지털단지,17727,20786,20200521,38513
20200518,1,금천구청,10868,10720,20200521,21588
20200518,1,석수,9468,8420,20200521,17888
20200518,1,관악,6822,6380,20200521,13202
20200518,1,안양,20560,20517,20200521,41077
20200518,1,명학,8919,8826,20200521,17745
20200518,4,금정,24087,24998,20200521,49085
20200518,1,군포,6966,7202,20200521,14168
20200518,1,의왕,8159,8116,20200521,16275
20200518,1,성균관대,12327,12178,20200521,24505
20200518,1,화서,6912,6540,20200521,13452
20200518,1,수원,29640,31281,20200521,60921
20200518,1,독산,16430,17205,20200521,33635
20200518,1,세류,2783,2606,20200521,5389
20200518,1,병점,11774,11718,20200521,23492
20200518,1,세마,2199,2067,20200521,4266
20200518,1,오산대,2519,2220,20200521,4739
20200518,1,오산,8114,8123,20200521,16237
20200518,1,진위,1356,1223,20200521,2579
20200518,1,송탄,3489,3329,20200521,6818
20200518,1,서정리,4831,4876,20200521,9707
20200518,1,지제,2113,1929,20200521,4042
20200518,1,평택,9518,9349,20200521,18867
20200518,1,성환,2889,3084,20200521,5973
20200518,1,직산,644,671,20200521,1315
20200518,1,두정,3820,4051,20200521,7871
20200518,1,천안,4129,4270,20200521,8399
20200518,1,당정,5677,5480,20200521,11157
20200518,경부선,서동탄,1511,1263,20200521,2774
20200518,경부선,광명,2812,2345,20200521,5157
20200519,경부선,광명,2699,2178,20200522,4877
20200519,경부선,서동탄,1526,1302,20200522,2828
20200519,1,당정,5791,5471,20200522,11262
20200519,1,천안,4110,4244,20200522,8354
20200519,1,두정,3839,3917,20200522,7756
20200519,1,직산,654,667,20200522,1321
20200519,1,성환,2865,2901,20200522,5766
20200519,1,평택,9186,8952,20200522,18138
20200519,1,지제,2015,1813,20200522,3828
20200519,1,서정리,4606,4797,20200522,9403
20200519,1,송탄,3226,3188,20200522,6414
20200519,1,진위,1383,1175,20200522,2558
20200519,1,오산,7549,7670,20200522,15219
20200519,1,오산대,2494,2282,20200522,4776
20200519,1,세마,2149,1995,20200522,4144
20200519,1,병점,11856,11694,20200522,23550
20200519,1,세류,2780,2734,20200522,5514
20200519,1,독산,16184,17189,20200522,33373
20200519,1,수원,29647,31730,20200522,61377
20200519,1,화서,6862,6598,20200522,13460
20200519,1,성균관대,12537,12408,20200522,24945
20200519,1,의왕,8341,8203,20200522,16544
20200519,1,군포,6993,6958,20200522,13951
20200519,4,금정,24623,24962,20200522,49585
20200519,1,명학,8959,8845,20200522,17804
20200519,1,안양,20733,20843,20200522,41576
20200519,1,관악,6799,6302,20200522,13101
20200519,1,석수,9600,8421,20200522,18021
20200519,1,금천구청,10704,10756,20200522,21460
20200519,1,가산디지털단지,18269,20976,20200522,39245
20200519,1,구로,17049,17370,20200522,34419
20200519,1,신길,8986,7202,20200522,16188
20200519,경부선,신도림,3697,3780,20200522,7477
20200519,1,영등포,33855,35446,20200522,69301
20200519,1,대방,12876,12935,20200522,25811
20200519,1,노량진,8097,8146,20200522,16243
20200519,1,용산,26608,27256,20200522,53864
20200519,1,남영,9438,10012,20200522,19450
20200519,경부선,서울역,3781,1097,20200522,4878
20200520,경부선,광명,2816,2304,20200523,5120
20200520,경부선,서동탄,1649,1358,20200523,3007
20200520,1,당정,6016,5833,20200523,11849
20200520,1,천안,4412,4609,20200523,9021
20200520,1,두정,4289,4366,20200523,8655
20200520,1,직산,725,726,20200523,1451
20200520,1,성환,3245,3257,20200523,6502
20200520,1,평택,10319,10192,20200523,20511
20200520,1,지제,2193,2005,20200523,4198
20200520,1,서정리,6213,5936,20200523,12149
20200520,1,송탄,3766,3632,20200523,7398
20200520,1,진위,1442,1265,20200523,2707
20200520,1,오산,8373,8306,20200523,16679
20200520,1,오산대,2944,2589,20200523,5533
20200520,1,세마,2350,2167,20200523,4517
20200520,1,병점,12750,12705,20200523,25455
20200520,1,세류,3147,2788,20200523,5935
20200520,1,독산,16624,17603,20200523,34227
20200520,1,수원,32239,34328,20200523,66567
20200520,1,화서,7448,7188,20200523,14636
20200520,1,성균관대,13325,13165,20200523,26490
20200520,1,의왕,8991,8926,20200523,17917
20200520,1,군포,7378,7389,20200523,14767
20200520,4,금정,25986,26487,20200523,52473
20200520,1,명학,9239,9158,20200523,18397
20200520,1,안양,21402,21095,20200523,42497
20200520,1,관악,7513,6885,20200523,14398
20200520,1,석수,10282,9043,20200523,19325
20200520,1,금천구청,11620,11475,20200523,23095
20200520,1,가산디지털단지,18780,21507,20200523,40287
20200520,1,구로,18159,18219,20200523,36378
20200520,1,신길,9518,7948,20200523,17466
20200520,경부선,신도림,4019,4077,20200523,8096
20200520,1,영등포,36147,37817,20200523,73964
20200520,1,대방,13416,13640,20200523,27056
20200520,1,노량진,9094,8848,20200523,17942
20200520,1,용산,28202,28945,20200523,57147
20200520,1,남영,9691,10088,20200523,19779
20200520,경부선,서울역,3924,1169,20200523,5093
20200521,경부선,광명,2943,2308,20200524,5251
20200521,경부선,서동탄,1586,1371,20200524,2957
20200521,1,당정,6116,5781,20200524,11897
20200521,1,천안,4629,4721,20200524,9350
20200521,1,두정,4262,4257,20200524,8519
20200521,1,직산,727,768,20200524,1495
20200521,1,성환,3245,3101,20200524,6346
20200521,1,평택,10569,10117,20200524,20686
20200521,1,지제,2265,2105,20200524,4370
20200521,1,서정리,6126,5850,20200524,11976
20200521,1,송탄,3915,3617,20200524,7532
20200521,1,진위,1467,1323,20200524,2790
20200521,1,오산,8199,8220,20200524,16419
20200521,1,오산대,2828,2519,20200524,5347
20200521,1,세마,2419,2179,20200524,4598
20200521,1,병점,12659,12653,20200524,25312
20200521,1,세류,2999,2790,20200524,5789
20200521,1,독산,16529,17313,20200524,33842
20200521,1,수원,32128,34303,20200524,66431
20200521,1,화서,7306,7072,20200524,14378
20200521,1,성균관대,13273,13006,20200524,26279
20200521,1,의왕,8923,8703,20200524,17626
20200521,1,군포,7346,7291,20200524,14637
20200521,4,금정,25521,26091,20200524,51612
20200521,1,명학,9257,9110,20200524,18367
20200521,1,안양,20327,20392,20200524,40719
20200521,1,관악,7317,6775,20200524,14092
20200521,1,석수,10183,8955,20200524,19138
20200521,1,금천구청,11534,11387,20200524,22921
20200521,1,가산디지털단지,18933,21536,20200524,40469
20200521,1,구로,17588,17877,20200524,35465
20200521,1,신길,9428,7978,20200524,17406
20200521,경부선,신도림,4073,4025,20200524,8098
20200521,1,영등포,36253,37281,20200524,73534
20200521,1,대방,13427,13556,20200524,26983
20200521,1,노량진,8735,8654,20200524,17389
20200521,1,용산,29467,29728,20200524,59195
20200521,1,남영,9724,10100,20200524,19824
20200521,경부선,서울역,4482,1263,20200524,5745
20200522,경부선,서울역,5714,1630,20200525,7344
20200522,1,남영,9511,9842,20200525,19353
20200522,1,용산,33347,34585,20200525,67932
20200522,1,노량진,9519,9204,20200525,18723
20200522,1,대방,13566,13575,20200525,27141
20200522,1,영등포,39707,42838,20200525,82545
20200522,경부선,신도림,4115,4200,20200525,8315
20200522,1,신길,9490,7956,20200525,17446
20200522,1,구로,18048,18291,20200525,36339
20200522,1,가산디지털단지,18831,21359,20200525,40190
20200522,1,금천구청,11643,11596,20200525,23239
20200522,1,석수,10432,8862,20200525,19294
20200522,1,관악,7374,6757,20200525,14131
20200522,1,안양,20746,20522,20200525,41268
20200522,1,명학,9017,8671,20200525,17688
20200522,4,금정,26296,27104,20200525,53400
20200522,1,군포,7315,7307,20200525,14622
20200522,1,의왕,8974,8882,20200525,17856
20200522,1,성균관대,14012,13722,20200525,27734
20200522,1,화서,7564,7372,20200525,14936
20200522,1,수원,36063,39168,20200525,75231
20200522,1,독산,16772,17354,20200525,34126
20200522,1,세류,3263,2885,20200525,6148
20200522,1,병점,13957,13686,20200525,27643
20200522,1,세마,2509,2235,20200525,4744
20200522,1,오산대,3058,2713,20200525,5771
20200522,1,오산,9243,9021,20200525,18264
20200522,1,진위,1682,1360,20200525,3042
20200522,1,송탄,4623,4071,20200525,8694
20200522,1,서정리,6377,5627,20200525,12004
20200522,1,지제,2707,2384,20200525,5091
20200522,1,평택,11921,11648,20200525,23569
20200522,1,성환,3650,3145,20200525,6795
20200522,1,직산,842,808,20200525,1650
20200522,1,두정,4923,4692,20200525,9615
20200522,1,천안,5463,5631,20200525,11094
20200522,1,당정,6308,5924,20200525,12232
20200522,경부선,서동탄,1617,1445,20200525,3062
20200522,경부선,광명,3307,2835,20200525,6142
20200523,경부선,서울역,4223,951,20200526,5174
20200523,1,남영,5799,5870,20200526,11669
20200523,1,용산,25296,27289,20200526,52585
20200523,1,노량진,8303,7410,20200526,15713
20200523,1,대방,8013,7787,20200526,15800
20200523,1,영등포,35755,37616,20200526,73371
20200523,경부선,신도림,2982,2946,20200526,5928
20200523,1,신길,6151,4958,20200526,11109
20200523,1,구로,11968,12423,20200526,24391
20200523,1,가산디지털단지,6064,8092,20200526,14156
20200523,1,금천구청,7815,7709,20200526,15524
20200523,1,석수,6841,6470,20200526,13311
20200523,1,관악,5998,5697,20200526,11695
20200523,1,안양,15593,15262,20200526,30855
20200523,1,명학,4962,4837,20200526,9799
20200523,4,금정,17474,17496,20200526,34970
20200523,1,군포,4133,3762,20200526,7895
20200523,1,의왕,5490,5349,20200526,10839
20200523,1,성균관대,9570,9517,20200526,19087
20200523,1,화서,5147,5066,20200526,10213
20200523,1,수원,34140,37211,20200526,71351
20200523,1,독산,8313,8059,20200526,16372
20200523,1,세류,2610,2559,20200526,5169
20200523,1,병점,10830,10767,20200526,21597
20200523,1,세마,1874,1688,20200526,3562
20200523,1,오산대,2546,2283,20200526,4829
20200523,1,오산,8559,8121,20200526,16680
20200523,1,진위,1087,935,20200526,2022
20200523,1,송탄,4283,3824,20200526,8107
20200523,1,서정리,5508,4521,20200526,10029
20200523,1,지제,2109,1884,20200526,3993
20200523,1,평택,11900,11474,20200526,23374
20200523,1,성환,2860,2588,20200526,5448
20200523,1,직산,645,588,20200526,1233
20200523,1,두정,4138,4160,20200526,8298
20200523,1,천안,5746,5724,20200526,11470
20200523,1,당정,3858,3711,20200526,7569
20200523,경부선,서동탄,1049,1099,20200526,2148
20200523,경부선,광명,2253,1874,20200526,4127
20200524,경부선,광명,1823,1208,20200527,3031
20200524,경부선,서동탄,687,652,20200527,1339
20200524,1,당정,2623,2572,20200527,5195
20200524,1,천안,5039,4976,20200527,10015
20200524,1,두정,3107,3507,20200527,6614
20200524,1,직산,481,524,20200527,1005
20200524,1,성환,2157,2651,20200527,4808
20200524,1,평택,9328,10187,20200527,19515
20200524,1,지제,1661,1376,20200527,3037
20200524,1,서정리,3152,4767,20200527,7919
20200524,1,송탄,3112,3336,20200527,6448
20200524,1,진위,683,689,20200527,1372
20200524,1,오산,6329,6757,20200527,13086
20200524,1,오산대,1652,1537,20200527,3189
20200524,1,세마,1303,1142,20200527,2445
20200524,1,병점,7064,8036,20200527,15100
20200524,1,세류,1915,1893,20200527,3808
20200524,1,독산,4995,5064,20200527,10059
20200524,1,수원,26863,26594,20200527,53457
20200524,1,화서,3316,3222,20200527,6538
20200524,1,성균관대,6347,6728,20200527,13075
20200524,1,의왕,3632,3592,20200527,7224
20200524,1,군포,2839,2545,20200527,5384
20200524,4,금정,11700,12192,20200527,23892
20200524,1,명학,2870,2892,20200527,5762
20200524,1,안양,10612,10316,20200527,20928
20200524,1,관악,3976,3535,20200527,7511
20200524,1,석수,4542,4215,20200527,8757
20200524,1,금천구청,5166,5156,20200527,10322
20200524,1,가산디지털단지,3945,5451,20200527,9396
20200524,1,구로,7637,7741,20200527,15378
20200524,1,신길,4177,3636,20200527,7813
20200524,경부선,신도림,1807,1830,20200527,3637
20200524,1,영등포,26789,25938,20200527,52727
20200524,1,대방,5346,5646,20200527,10992
20200524,1,노량진,5382,5021,20200527,10403
20200524,1,용산,21419,18920,20200527,40339
20200524,1,남영,3633,3957,20200527,7590
20200524,경부선,서울역,4429,835,20200527,5264
20200525,경부선,광명,2911,2409,20200528,5320
20200525,경부선,서동탄,1581,1316,20200528,2897
20200525,1,당정,6075,5758,20200528,11833
20200525,1,천안,4620,4864,20200528,9484
20200525,1,두정,4177,4445,20200528,8622
20200525,1,직산,741,756,20200528,1497
20200525,1,성환,3239,3467,20200528,6706
20200525,1,평택,10564,10971,20200528,21535
20200525,1,지제,2482,2002,20200528,4484
20200525,1,서정리,6309,6276,20200528,12585
20200525,1,송탄,4186,3964,20200528,8150
20200525,1,진위,1448,1273,20200528,2721
20200525,1,오산,8549,8580,20200528,17129
20200525,1,오산대,2865,2644,20200528,5509
20200525,1,세마,2411,2182,20200528,4593
20200525,1,병점,12626,12559,20200528,25185
20200525,1,세류,2989,2803,20200528,5792
20200525,1,독산,16736,17557,20200528,34293
20200525,1,수원,32128,34272,20200528,66400
20200525,1,화서,7362,7106,20200528,14468
20200525,1,성균관대,13255,13195,20200528,26450
20200525,1,의왕,8721,8774,20200528,17495
20200525,1,군포,7207,7346,20200528,14553
20200525,4,금정,25249,26165,20200528,51414
20200525,1,명학,9007,8856,20200528,17863
20200525,1,안양,20681,20419,20200528,41100
20200525,1,관악,7213,6719,20200528,13932
20200525,1,석수,9957,8825,20200528,18782
20200525,1,금천구청,11663,11262,20200528,22925
20200525,1,가산디지털단지,18685,21451,20200528,40136
20200525,1,구로,17893,18035,20200528,35928
20200525,1,신길,9453,7934,20200528,17387
20200525,경부선,신도림,4168,4098,20200528,8266
20200525,1,영등포,35805,37154,20200528,72959
20200525,1,대방,13330,13537,20200528,26867
20200525,1,노량진,8629,8588,20200528,17217
20200525,1,용산,28844,29637,20200528,58481
20200525,1,남영,9861,10463,20200528,20324
20200525,경부선,서울역,4666,1235,20200528,5901
20200526,경부선,광명,2813,2356,20200529,5169
20200526,경부선,서동탄,1551,1315,20200529,2866
20200526,1,당정,6116,5862,20200529,11978
20200526,1,천안,4378,4528,20200529,8906
20200526,1,두정,4074,4108,20200529,8182
20200526,1,직산,717,738,20200529,1455
20200526,1,성환,3144,3189,20200529,6333
20200526,1,평택,9916,9844,20200529,19760
20200526,1,지제,2147,1964,20200529,4111
20200526,1,서정리,6183,5977,20200529,12160
20200526,1,송탄,3701,3533,20200529,7234
20200526,1,진위,1412,1226,20200529,2638
20200526,1,오산,8276,8342,20200529,16618
20200526,1,오산대,3014,2683,20200529,5697
20200526,1,세마,2378,2114,20200529,4492
20200526,1,병점,12642,12505,20200529,25147
20200526,1,세류,2864,2637,20200529,5501
20200526,1,독산,16502,17396,20200529,33898
20200526,1,수원,31670,33373,20200529,65043
20200526,1,화서,7215,6954,20200529,14169
20200526,1,성균관대,13132,12966,20200529,26098
20200526,1,의왕,8939,8831,20200529,17770
20200526,1,군포,7282,7152,20200529,14434
20200526,4,금정,25409,26294,20200529,51703
20200526,1,명학,9010,8880,20200529,17890
20200526,1,안양,20565,20441,20200529,41006
20200526,1,관악,7174,6663,20200529,13837
20200526,1,석수,10058,8819,20200529,18877
20200526,1,금천구청,11533,11456,20200529,22989
20200526,1,가산디지털단지,18527,21314,20200529,39841
20200526,1,구로,17889,18019,20200529,35908
20200526,1,신길,9454,7887,20200529,17341
20200526,경부선,신도림,4036,4001,20200529,8037
20200526,1,영등포,35444,36528,20200529,71972
20200526,1,대방,13504,13795,20200529,27299
20200526,1,노량진,8601,8645,20200529,17246
20200526,1,용산,28239,28830,20200529,57069
20200526,1,남영,10133,10588,20200529,20721
20200526,경부선,서울역,3949,1150,20200529,5099
20200527,경부선,광명,2864,2290,20200530,5154
20200527,경부선,서동탄,1617,1421,20200530,3038
20200527,1,당정,6177,5882,20200530,12059
20200527,1,천안,4524,4728,20200530,9252
20200527,1,두정,4214,4275,20200530,8489
20200527,1,직산,713,718,20200530,1431
20200527,1,성환,3103,3108,20200530,6211
20200527,1,평택,10217,10210,20200530,20427
20200527,1,지제,2188,2029,20200530,4217
20200527,1,서정리,6601,6220,20200530,12821
20200527,1,송탄,3839,3599,20200530,7438
20200527,1,진위,1484,1313,20200530,2797
20200527,1,오산,8578,8483,20200530,17061
20200527,1,오산대,3083,2815,20200530,5898
20200527,1,세마,2445,2234,20200530,4679
20200527,1,병점,13014,13066,20200530,26080
20200527,1,세류,2970,2842,20200530,5812
20200527,1,독산,16722,17450,20200530,34172
20200527,1,수원,32906,35240,20200530,68146
20200527,1,화서,7508,7326,20200530,14834
20200527,1,성균관대,13412,13140,20200530,26552
20200527,1,의왕,9144,8929,20200530,18073
20200527,1,군포,7284,7247,20200530,14531
20200527,4,금정,25827,26361,20200530,52188
20200527,1,명학,9289,9088,20200530,18377
20200527,1,안양,21430,21339,20200530,42769
20200527,1,관악,7488,6814,20200530,14302
20200527,1,석수,10368,9186,20200530,19554
20200527,1,금천구청,11591,11705,20200530,23296
20200527,1,가산디지털단지,18785,21448,20200530,40233
20200527,1,구로,18115,18455,20200530,36570
20200527,1,신길,9594,8071,20200530,17665
20200527,경부선,신도림,4239,4246,20200530,8485
20200527,1,영등포,36192,37920,20200530,74112
20200527,1,대방,13607,13676,20200530,27283
20200527,1,노량진,8983,8929,20200530,17912
20200527,1,용산,29141,29544,20200530,58685
20200527,1,남영,10382,10946,20200530,21328
20200527,경부선,서울역,3919,1131,20200530,5050
20200528,경부선,광명,2836,2405,20200531,5241
20200528,경부선,서동탄,1612,1391,20200531,3003
20200528,1,당정,6223,6026,20200531,12249
20200528,1,천안,4496,4721,20200531,9217
20200528,1,두정,4328,4255,20200531,8583
20200528,1,직산,651,710,20200531,1361
20200528,1,성환,3132,2888,20200531,6020
20200528,1,평택,10187,10105,20200531,20292
20200528,1,지제,2269,2072,20200531,4341
20200528,1,서정리,6286,5910,20200531,12196
20200528,1,송탄,3807,3733,20200531,7540
20200528,1,진위,1450,1292,20200531,2742
20200528,1,오산,8791,8853,20200531,17644
20200528,1,오산대,3044,2739,20200531,5783
20200528,1,세마,2495,2287,20200531,4782
20200528,1,병점,12644,12565,20200531,25209
20200528,1,세류,3070,2838,20200531,5908
20200528,1,독산,16407,17358,20200531,33765
20200528,1,수원,32258,34361,20200531,66619
20200528,1,화서,7389,7182,20200531,14571
20200528,1,성균관대,13234,13102,20200531,26336
20200528,1,의왕,9075,8963,20200531,18038
20200528,1,군포,7335,7200,20200531,14535
20200528,4,금정,25301,25933,20200531,51234
20200528,1,명학,9112,9124,20200531,18236
20200528,1,안양,20966,20866,20200531,41832
20200528,1,관악,7449,6870,20200531,14319
20200528,1,석수,10236,9011,20200531,19247
20200528,1,금천구청,11357,11229,20200531,22586
20200528,1,가산디지털단지,18673,21273,20200531,39946
20200528,1,구로,17729,17736,20200531,35465
20200528,1,신길,9469,8008,20200531,17477
20200528,경부선,신도림,4101,4181,20200531,8282
20200528,1,영등포,35456,36752,20200531,72208
20200528,1,대방,13390,13639,20200531,27029
20200528,1,노량진,8666,8563,20200531,17229
20200528,1,용산,29133,29751,20200531,58884
20200528,1,남영,10218,10763,20200531,20981
20200528,경부선,서울역,4470,1182,20200531,5652
20200529,경부선,서울역,5369,1635,20200601,7004
20200529,1,남영,10203,10648,20200601,20851
20200529,1,용산,33777,35192,20200601,68969
20200529,1,노량진,9284,8719,20200601,18003
20200529,1,대방,13389,13167,20200601,26556
20200529,1,영등포,39106,41702,20200601,80808
20200529,경부선,신도림,4221,4182,20200601,8403
20200529,1,신길,9348,7850,20200601,17198
20200529,1,구로,17834,18175,20200601,36009
20200529,1,가산디지털단지,18551,21384,20200601,39935
20200529,1,금천구청,11743,11666,20200601,23409
20200529,1,석수,10415,9092,20200601,19507
20200529,1,관악,7303,6897,20200601,14200
20200529,1,안양,21515,21474,20200601,42989
20200529,1,명학,8975,8797,20200601,17772
20200529,4,금정,26281,26623,20200601,52904
20200529,1,군포,7375,7262,20200601,14637
20200529,1,의왕,9042,8907,20200601,17949
20200529,1,성균관대,13742,13438,20200601,27180
20200529,1,화서,7489,7410,20200601,14899
20200529,1,수원,35975,39064,20200601,75039
20200529,1,독산,16323,16965,20200601,33288
20200529,1,세류,3269,3001,20200601,6270
20200529,1,병점,14106,13622,20200601,27728
20200529,1,세마,2576,2299,20200601,4875
20200529,1,오산대,3065,2803,20200601,5868
20200529,1,오산,9355,9095,20200601,18450
20200529,1,진위,1719,1345,20200601,3064
20200529,1,송탄,4369,3899,20200601,8268
20200529,1,서정리,6492,5503,20200601,11995
20200529,1,지제,2775,2467,20200601,5242
20200529,1,평택,12443,11801,20200601,24244
20200529,1,성환,3512,3052,20200601,6564
20200529,1,직산,760,709,20200601,1469
20200529,1,두정,4900,4730,20200601,9630
20200529,1,천안,5618,5742,20200601,11360
20200529,1,당정,6352,6041,20200601,12393
20200529,경부선,서동탄,1622,1370,20200601,2992
20200529,경부선,광명,3213,2861,20200601,6074
20200530,경부선,서울역,3969,892,20200602,4861
20200530,1,남영,5080,5154,20200602,10234
20200530,1,용산,24449,26498,20200602,50947
20200530,1,노량진,8276,7028,20200602,15304
20200530,1,대방,7696,7406,20200602,15102
20200530,1,영등포,33360,35702,20200602,69062
20200530,경부선,신도림,2698,2805,20200602,5503
20200530,1,신길,5658,4721,20200602,10379
20200530,1,구로,11282,11501,20200602,22783
20200530,1,가산디지털단지,5655,7635,20200602,13290
20200530,1,금천구청,7368,7349,20200602,14717
20200530,1,석수,6617,6133,20200602,12750
20200530,1,관악,6214,5740,20200602,11954
20200530,1,안양,15545,15428,20200602,30973
20200530,1,명학,4852,4650,20200602,9502
20200530,4,금정,17046,17026,20200602,34072
20200530,1,군포,4207,3814,20200602,8021
20200530,1,의왕,5259,5082,20200602,10341
20200530,1,성균관대,9351,9405,20200602,18756
20200530,1,화서,4747,4581,20200602,9328
20200530,1,수원,32289,35614,20200602,67903
20200530,1,독산,8038,7693,20200602,15731
20200530,1,세류,2357,2320,20200602,4677
20200530,1,병점,10315,10344,20200602,20659
20200530,1,세마,1796,1563,20200602,3359
20200530,1,오산대,2331,2078,20200602,4409
20200530,1,오산,7950,7569,20200602,15519
20200530,1,진위,890,783,20200602,1673
20200530,1,송탄,4122,3699,20200602,7821
20200530,1,서정리,5307,4459,20200602,9766
20200530,1,지제,2020,1776,20200602,3796
20200530,1,평택,11358,11079,20200602,22437
20200530,1,성환,2757,2600,20200602,5357
20200530,1,직산,613,613,20200602,1226
20200530,1,두정,3961,3926,20200602,7887
20200530,1,천안,5490,5530,20200602,11020
20200530,1,당정,3769,3523,20200602,7292
20200530,경부선,서동탄,938,964,20200602,1902
20200530,경부선,광명,1992,1612,20200602,3604
20200531,경부선,광명,1789,1202,20200603,2991
20200531,경부선,서동탄,695,773,20200603,1468
20200531,1,당정,2639,2557,20200603,5196
20200531,1,천안,4905,4788,20200603,9693
20200531,1,두정,2989,3451,20200603,6440
20200531,1,직산,468,456,20200603,924
20200531,1,성환,2153,2585,20200603,4738
20200531,1,평택,9273,10208,20200603,19481
20200531,1,지제,1695,1406,20200603,3101
20200531,1,서정리,3203,4654,20200603,7857
20200531,1,송탄,3014,3240,20200603,6254
20200531,1,진위,627,649,20200603,1276
20200531,1,오산,6093,6508,20200603,12601
20200531,1,오산대,1764,1650,20200603,3414
20200531,1,세마,1354,1224,20200603,2578
20200531,1,병점,7395,8011,20200603,15406
20200531,1,세류,1780,1808,20200603,3588
20200531,1,독산,5156,5137,20200603,10293
20200531,1,수원,27088,26641,20200603,53729
20200531,1,화서,3456,3381,20200603,6837
20200531,1,성균관대,6525,6927,20200603,13452
20200531,1,의왕,3812,3766,20200603,7578
20200531,1,군포,2850,2613,20200603,5463
20200531,4,금정,11958,12392,20200603,24350
20200531,1,명학,2912,2871,20200603,5783
20200531,1,안양,11223,10739,20200603,21962
20200531,1,관악,4334,3841,20200603,8175
20200531,1,석수,4839,4759,20200603,9598
20200531,1,금천구청,5237,5244,20200603,10481
20200531,1,가산디지털단지,4033,5640,20200603,9673
20200531,1,구로,7783,7846,20200603,15629
20200531,1,신길,4258,3704,20200603,7962
20200531,경부선,신도림,1876,1875,20200603,3751
20200531,1,영등포,26365,25409,20200603,51774
20200531,1,대방,5153,5389,20200603,10542
20200531,1,노량진,5257,4894,20200603,10151
20200531,1,용산,22215,19295,20200603,41510
20200531,1,남영,3535,3858,20200603,7393
20200531,경부선,서울역,4349,735,20200603,5084
20200101,1,소요산,2963,2384,20200104,5347
20200101,1,동두천,1180,1599,20200104,2779
20200101,1,보산,1203,1509,20200104,2712
20200101,1,동두천중앙,2094,2146,20200104,4240
20200101,1,지행,4009,4087,20200104,8096
20200101,1,덕정,3074,3429,20200104,6503
20200101,1,덕계,1158,1139,20200104,2297
20200101,1,양주,4287,4397,20200104,8684
20200101,1,녹양,2424,2354,20200104,4778
20200101,1,가능,3470,3358,20200104,6828
20200101,1,의정부,13231,13522,20200104,26753
20200101,1,회룡,5960,6012,20200104,11972
20200101,1,망월사,4030,4244,20200104,8274
20200101,1,도봉산,5909,4044,20200104,9953
20200101,1,도봉,2864,2678,20200104,5542
20200101,1,방학,5248,5115,20200104,10363
20200101,1,창동,1,0,20200104,1
20200101,1,녹천,2277,2026,20200104,4303
20200101,1,월계,3278,3025,20200104,6303
20200101,1,광운대,4030,4461,20200104,8491
20200101,1,석계,5006,5668,20200104,10674
20200101,1,신이문,4436,4248,20200104,8684
20200101,1,외대앞,4752,4782,20200104,9534
20200101,경원선,청량리,12243,10866,20200104,23109
20200101,경원선,왕십리,9318,10901,20200104,20219
20200101,경원선,응봉,1167,1054,20200104,2221
20200101,경원선,옥수,46,19,20200104,65
20200101,경원선,한남,2026,1923,20200104,3949
20200101,경원선,서빙고,977,920,20200104,1897
20200101,경원선,이촌,1805,1575,20200104,3380
20200102,경원선,이촌,4226,3435,20200105,7661
20200102,경원선,서빙고,2002,1880,20200105,3882
20200102,경원선,한남,4918,4588,20200105,9506
20200102,경원선,옥수,46,31,20200105,77
20200102,경원선,응봉,1947,1687,20200105,3634
20200102,경원선,왕십리,15804,17558,20200105,33362
20200102,경원선,청량리,16755,17492,20200105,34247
20200102,1,외대앞,9457,9451,20200105,18908
20200102,1,신이문,9509,8724,20200105,18233
20200102,1,석계,9836,11171,20200105,21007
20200102,1,광운대,8933,8536,20200105,17469
20200102,1,월계,6408,5964,20200105,12372
20200102,1,녹천,5050,4198,20200105,9248
20200102,1,창동,1,0,20200105,1
20200102,1,방학,10331,9933,20200105,20264
20200102,1,도봉,6340,5966,20200105,12306
20200102,1,도봉산,7864,4691,20200105,12555
20200102,1,망월사,8041,8233,20200105,16274
20200102,1,회룡,13789,13256,20200105,27045
20200102,1,의정부,20764,21309,20200105,42073
20200102,1,가능,6987,6590,20200105,13577
20200102,1,녹양,5217,4753,20200105,9970
20200102,1,양주,8695,7755,20200105,16450
20200102,1,덕계,2525,2193,20200105,4718
20200102,1,덕정,6137,6008,20200105,12145
20200102,1,지행,7375,7257,20200105,14632
20200102,1,동두천중앙,3683,3610,20200105,7293
20200102,1,보산,1670,2068,20200105,3738
20200102,1,동두천,2262,2485,20200105,4747
20200102,1,소요산,3133,2366,20200105,5499
20200103,경원선,이촌,4595,3541,20200106,8136
20200103,경원선,서빙고,2121,2107,20200106,4228
20200103,경원선,한남,5039,4969,20200106,10008
20200103,경원선,옥수,60,30,20200106,90
20200103,경원선,응봉,2000,1679,20200106,3679
20200103,경원선,왕십리,17362,19586,20200106,36948
20200103,경원선,청량리,18679,19544,20200106,38223
20200103,1,외대앞,10214,9760,20200106,19974
20200103,1,신이문,10177,8953,20200106,19130
20200103,1,석계,10558,11747,20200106,22305
20200103,1,광운대,9757,9054,20200106,18811
20200103,1,월계,6915,6306,20200106,13221
20200103,1,녹천,5235,4377,20200106,9612
20200103,1,창동,1,0,20200106,1
20200103,1,방학,10911,10548,20200106,21459
20200103,1,도봉,6648,6222,20200106,12870
20200103,1,도봉산,8115,4867,20200106,12982
20200103,1,망월사,8313,8157,20200106,16470
20200103,1,회룡,14475,13961,20200106,28436
20200103,1,의정부,22560,24113,20200106,46673
20200103,1,가능,7370,7058,20200106,14428
20200103,1,녹양,5463,5030,20200106,10493
20200103,1,양주,9643,8559,20200106,18202
20200103,1,덕계,2628,2286,20200106,4914
20200103,1,덕정,6487,6179,20200106,12666
20200103,1,지행,7938,7906,20200106,15844
20200103,1,동두천중앙,3937,3759,20200106,7696
20200103,1,보산,1935,1518,20200106,3453
20200103,1,동두천,2462,2861,20200106,5323
20200103,1,소요산,3254,2938,20200106,6192
20200104,경원선,이촌,3490,2510,20200107,6000
20200104,경원선,서빙고,1433,1376,20200107,2809
20200104,경원선,한남,3384,3289,20200107,6673
20200104,경원선,옥수,34,33,20200107,67
20200104,경원선,응봉,1512,1297,20200107,2809
20200104,경원선,왕십리,14906,16943,20200107,31849
20200104,경원선,청량리,18550,19272,20200107,37822
20200104,1,외대앞,8104,7680,20200107,15784
20200104,1,신이문,7227,6533,20200107,13760
20200104,1,석계,8592,9320,20200107,17912
20200104,1,광운대,7268,7070,20200107,14338
20200104,1,월계,5152,4644,20200107,9796
20200104,1,녹천,3830,3077,20200107,6907
20200104,1,창동,1,0,20200107,1
20200104,1,방학,8247,8063,20200107,16310
20200104,1,도봉,4893,4595,20200107,9488
20200104,1,도봉산,8934,5854,20200107,14788
20200104,1,망월사,6250,6504,20200107,12754
20200104,1,회룡,11219,11043,20200107,22262
20200104,1,의정부,21815,23764,20200107,45579
20200104,1,가능,6030,5698,20200107,11728
20200104,1,녹양,4214,3883,20200107,8097
20200104,1,양주,7638,6880,20200107,14518
20200104,1,덕계,2062,1782,20200107,3844
20200104,1,덕정,5597,4898,20200107,10495
20200104,1,지행,6714,6402,20200107,13116
20200104,1,동두천중앙,3327,3242,20200107,6569
20200104,1,보산,1741,1619,20200107,3360
20200104,1,동두천,1884,2217,20200107,4101
20200104,1,소요산,4548,3328,20200107,7876
20200105,1,방학,6921,6645,20200108,13566
20200105,경원선,이촌,3360,2533,20200108,5893
20200105,경원선,서빙고,2197,2355,20200108,4552
20200105,경원선,한남,2300,2244,20200108,4544
20200105,경원선,옥수,61,38,20200108,99
20200105,경원선,응봉,1126,1035,20200108,2161
20200105,경원선,왕십리,10792,12079,20200108,22871
20200105,경원선,청량리,15666,14497,20200108,30163
20200105,1,외대앞,5834,5716,20200108,11550
20200105,1,신이문,5555,5144,20200108,10699
20200105,1,석계,6352,7011,20200108,13363
20200105,1,광운대,5203,5369,20200108,10572
20200105,1,월계,4084,3730,20200108,7814
20200105,1,녹천,3027,2566,20200108,5593
20200105,1,창동,1,0,20200108,1
20200105,1,도봉,3856,3675,20200108,7531
20200105,1,도봉산,8656,5876,20200108,14532
20200105,1,망월사,5225,5310,20200108,10535
20200105,1,회룡,8368,8325,20200108,16693
20200105,1,의정부,17571,17110,20200108,34681
20200105,1,가능,4622,4380,20200108,9002
20200105,1,녹양,3313,3098,20200108,6411
20200105,1,양주,5827,5627,20200108,11454
20200105,1,덕계,1614,1407,20200108,3021
20200105,1,덕정,3964,4360,20200108,8324
20200105,1,지행,5082,5426,20200108,10508
20200105,1,동두천중앙,2757,2735,20200108,5492
20200105,1,보산,1337,1666,20200108,3003
20200105,1,동두천,1426,2059,20200108,3485
20200105,1,소요산,4139,3813,20200108,7952
20200106,경원선,이촌,4403,3488,20200109,7891
20200106,경원선,서빙고,2148,1963,20200109,4111
20200106,경원선,한남,4906,4845,20200109,9751
20200106,경원선,옥수,54,22,20200109,76
20200106,경원선,응봉,1939,1672,20200109,3611
20200106,경원선,왕십리,16250,17872,20200109,34122
20200106,경원선,청량리,16095,17026,20200109,33121
20200106,1,외대앞,9922,9931,20200109,19853
20200106,1,신이문,9832,9077,20200109,18909
20200106,1,석계,9957,11433,20200109,21390
20200106,1,광운대,9609,9166,20200109,18775
20200106,1,월계,6434,5902,20200109,12336
20200106,1,녹천,5339,4396,20200109,9735
20200106,1,방학,10739,10304,20200109,21043
20200106,1,도봉,6603,6141,20200109,12744
20200106,1,도봉산,7191,4317,20200109,11508
20200106,1,망월사,8098,8264,20200109,16362
20200106,1,회룡,14141,13559,20200109,27700
20200106,1,의정부,20609,20803,20200109,41412
20200106,1,가능,7271,6959,20200109,14230
20200106,1,녹양,5259,4911,20200109,10170
20200106,1,양주,8948,8219,20200109,17167
20200106,1,덕계,2600,2242,20200109,4842
20200106,1,덕정,6292,6090,20200109,12382
20200106,1,지행,7560,7257,20200109,14817
20200106,1,동두천중앙,3778,3570,20200109,7348
20200106,1,보산,1724,1431,20200109,3155
20200106,1,동두천,2363,2674,20200109,5037
20200106,1,소요산,2885,2188,20200109,5073
20200107,경원선,이촌,4165,3361,20200110,7526
20200107,경원선,서빙고,2112,2000,20200110,4112
20200107,경원선,한남,4980,4752,20200110,9732
20200107,경원선,옥수,39,31,20200110,70
20200107,경원선,응봉,1880,1594,20200110,3474
20200107,경원선,왕십리,15543,17667,20200110,33210
20200107,경원선,청량리,14980,15971,20200110,30951
20200107,1,외대앞,9407,9461,20200110,18868
20200107,1,신이문,9478,8738,20200110,18216
20200107,1,석계,9263,10668,20200110,19931
20200107,1,광운대,8978,8425,20200110,17403
20200107,1,월계,5996,5583,20200110,11579
20200107,1,녹천,5025,4217,20200110,9242
20200107,1,방학,10002,9688,20200110,19690
20200107,1,도봉,6332,6036,20200110,12368
20200107,1,도봉산,6411,3693,20200110,10104
20200107,1,망월사,7910,8019,20200110,15929
20200107,1,회룡,13212,12668,20200110,25880
20200107,1,의정부,19092,19643,20200110,38735
20200107,1,가능,6901,6597,20200110,13498
20200107,1,녹양,4820,4652,20200110,9472
20200107,1,양주,8287,7672,20200110,15959
20200107,1,덕계,2514,2110,20200110,4624
20200107,1,덕정,5804,5619,20200110,11423
20200107,1,지행,6747,6631,20200110,13378
20200107,1,동두천중앙,3412,3273,20200110,6685
20200107,1,보산,1518,1393,20200110,2911
20200107,1,동두천,2155,2389,20200110,4544
20200107,1,소요산,2001,1641,20200110,3642
20200108,경원선,이촌,4518,3579,20200111,8097
20200108,경원선,서빙고,2042,1917,20200111,3959
20200108,경원선,한남,5094,4781,20200111,9875
20200108,경원선,옥수,50,35,20200111,85
20200108,경원선,응봉,2059,1750,20200111,3809
20200108,경원선,왕십리,17183,19234,20200111,36417
20200108,경원선,청량리,16217,17532,20200111,33749
20200108,1,외대앞,10397,10089,20200111,20486
20200108,1,신이문,9983,9143,20200111,19126
20200108,1,석계,10134,11438,20200111,21572
20200108,1,광운대,9494,8884,20200111,18378
20200108,1,월계,6577,6241,20200111,12818
20200108,1,녹천,5278,4513,20200111,9791
20200108,1,방학,10914,10344,20200111,21258
20200108,1,도봉,6736,6310,20200111,13046
20200108,1,도봉산,7451,4496,20200111,11947
20200108,1,망월사,8572,8681,20200111,17253
20200108,1,회룡,14190,13650,20200111,27840
20200108,1,의정부,21219,21824,20200111,43043
20200108,1,가능,7176,7128,20200111,14304
20200108,1,녹양,5351,5028,20200111,10379
20200108,1,양주,8742,8078,20200111,16820
20200108,1,덕계,2618,2290,20200111,4908
20200108,1,덕정,6353,5955,20200111,12308
20200108,1,지행,7439,7059,20200111,14498
20200108,1,동두천중앙,3744,3563,20200111,7307
20200108,1,보산,1563,1479,20200111,3042
20200108,1,동두천,2320,2691,20200111,5011
20200108,1,소요산,2731,2184,20200111,4915
20200109,경원선,이촌,4544,3554,20200112,8098
20200109,경원선,서빙고,2091,1993,20200112,4084
20200109,경원선,한남,5185,5029,20200112,10214
20200109,경원선,옥수,50,28,20200112,78
20200109,경원선,응봉,2051,1778,20200112,3829
20200109,경원선,왕십리,17159,18876,20200112,36035
20200109,경원선,청량리,17002,18056,20200112,35058
20200109,1,외대앞,10130,9983,20200112,20113
20200109,1,신이문,10129,9194,20200112,19323
20200109,1,석계,10286,11760,20200112,22046
20200109,1,광운대,9561,8904,20200112,18465
20200109,1,월계,6643,6193,20200112,12836
20200109,1,녹천,5457,4434,20200112,9891
20200109,1,방학,10994,10456,20200112,21450
20200109,1,도봉,6949,6628,20200112,13577
20200109,1,도봉산,8172,4965,20200112,13137
20200109,1,망월사,8326,8387,20200112,16713
20200109,1,회룡,14525,13905,20200112,28430
20200109,1,의정부,21330,21921,20200112,43251
20200109,1,가능,7365,7014,20200112,14379
20200109,1,녹양,5436,5097,20200112,10533
20200109,1,양주,9112,8524,20200112,17636
20200109,1,덕계,2684,2304,20200112,4988
20200109,1,덕정,6410,6077,20200112,12487
20200109,1,지행,7517,7420,20200112,14937
20200109,1,동두천중앙,3790,3581,20200112,7371
20200109,1,보산,1543,1567,20200112,3110
20200109,1,동두천,2205,2510,20200112,4715
20200109,1,소요산,3334,2599,20200112,5933
20200110,경원선,이촌,4678,3729,20200113,8407
20200110,경원선,서빙고,2193,2017,20200113,4210
20200110,경원선,한남,5000,4913,20200113,9913
20200110,경원선,옥수,55,40,20200113,95
20200110,경원선,응봉,2099,1743,20200113,3842
20200110,경원선,왕십리,18085,20669,20200113,38754
20200110,경원선,청량리,19557,20618,20200113,40175
20200110,1,외대앞,10703,10146,20200113,20849
20200110,1,신이문,10294,9112,20200113,19406
20200110,1,석계,10829,11978,20200113,22807
20200110,1,광운대,9695,8907,20200113,18602
20200110,1,월계,6688,6114,20200113,12802
20200110,1,녹천,5418,4472,20200113,9890
20200110,1,창동,1,0,20200113,1
20200110,1,방학,11225,10737,20200113,21962
20200110,1,도봉,6968,6624,20200113,13592
20200110,1,도봉산,8425,5101,20200113,13526
20200110,1,망월사,8581,8504,20200113,17085
20200110,1,회룡,14858,14159,20200113,29017
20200110,1,의정부,22547,24569,20200113,47116
20200110,1,가능,7749,7298,20200113,15047
20200110,1,녹양,5675,5145,20200113,10820
20200110,1,양주,9593,8504,20200113,18097
20200110,1,덕계,2722,2350,20200113,5072
20200110,1,덕정,6864,6279,20200113,13143
20200110,1,지행,7774,7637,20200113,15411
20200110,1,동두천중앙,4110,3963,20200113,8073
20200110,1,보산,2058,1653,20200113,3711
20200110,1,동두천,2408,2761,20200113,5169
20200110,1,소요산,3450,2924,20200113,6374
20200111,경원선,이촌,3679,2801,20200114,6480
20200111,경원선,서빙고,1402,1363,20200114,2765
20200111,경원선,한남,3340,3395,20200114,6735
20200111,경원선,옥수,46,31,20200114,77
20200111,경원선,응봉,1584,1369,20200114,2953
20200111,경원선,왕십리,15502,17913,20200114,33415
20200111,경원선,청량리,20072,21035,20200114,41107
20200111,1,외대앞,9451,8628,20200114,18079
20200111,1,신이문,7791,7074,20200114,14865
20200111,1,석계,9146,10000,20200114,19146
20200111,1,광운대,7469,7197,20200114,14666
20200111,1,월계,5417,4790,20200114,10207
20200111,1,녹천,4126,3329,20200114,7455
20200111,1,방학,8781,8482,20200114,17263
20200111,1,도봉,5121,4873,20200114,9994
20200111,1,도봉산,8753,5754,20200114,14507
20200111,1,망월사,7375,7333,20200114,14708
20200111,1,회룡,11747,11388,20200114,23135
20200111,1,의정부,23503,25595,20200114,49098
20200111,1,가능,6177,5760,20200114,11937
20200111,1,녹양,4469,4260,20200114,8729
20200111,1,양주,8246,7129,20200114,15375
20200111,1,덕계,2134,1842,20200114,3976
20200111,1,덕정,5988,5220,20200114,11208
20200111,1,지행,7291,7159,20200114,14450
20200111,1,동두천중앙,3383,3275,20200114,6658
20200111,1,보산,1874,1695,20200114,3569
20200111,1,동두천,2078,2424,20200114,4502
20200111,1,소요산,5010,3533,20200114,8543
20200112,경원선,이촌,3349,2531,20200115,5880
20200112,경원선,서빙고,2172,2201,20200115,4373
20200112,경원선,한남,2294,2248,20200115,4542
20200112,경원선,옥수,31,25,20200115,56
20200112,경원선,응봉,1172,1049,20200115,2221
20200112,경원선,왕십리,11461,12292,20200115,23753
20200112,경원선,청량리,15573,14885,20200115,30458
20200112,1,외대앞,6435,6313,20200115,12748
20200112,1,신이문,5886,5426,20200115,11312
20200112,1,석계,6541,7345,20200115,13886
20200112,1,광운대,5382,5372,20200115,10754
20200112,1,월계,4010,3636,20200115,7646
20200112,1,녹천,3008,2630,20200115,5638
20200112,1,방학,6730,6454,20200115,13184
20200112,1,도봉,4113,3868,20200115,7981
20200112,1,도봉산,8548,5826,20200115,14374
20200112,1,망월사,5832,6064,20200115,11896
20200112,1,회룡,8616,8498,20200115,17114
20200112,1,의정부,18822,18583,20200115,37405
20200112,1,가능,4698,4403,20200115,9101
20200112,1,녹양,3297,3046,20200115,6343
20200112,1,양주,5890,5912,20200115,11802
20200112,1,덕계,1584,1494,20200115,3078
20200112,1,덕정,4142,4526,20200115,8668
20200112,1,지행,5222,5457,20200115,10679
20200112,1,동두천중앙,2707,2636,20200115,5343
20200112,1,보산,1395,1755,20200115,3150
20200112,1,동두천,1380,2135,20200115,3515
20200112,1,소요산,4246,3993,20200115,8239
20200113,경원선,이촌,4567,3486,20200116,8053
20200113,경원선,서빙고,2143,1992,20200116,4135
20200113,경원선,한남,5160,4991,20200116,10151
20200113,경원선,옥수,39,31,20200116,70
20200113,경원선,응봉,1914,1686,20200116,3600
20200113,경원선,왕십리,16251,18154,20200116,34405
20200113,경원선,청량리,16810,17896,20200116,34706
20200113,1,외대앞,9946,9749,20200116,19695
20200113,1,신이문,9911,8920,20200116,18831
20200113,1,석계,10050,11500,20200116,21550
20200113,1,광운대,9557,9065,20200116,18622
20200113,1,월계,6578,6025,20200116,12603
20200113,1,녹천,5368,4527,20200116,9895
20200113,1,방학,10874,10461,20200116,21335
20200113,1,도봉,6811,6454,20200116,13265
20200113,1,도봉산,7645,4578,20200116,12223
20200113,1,망월사,8229,8350,20200116,16579
20200113,1,회룡,14321,13793,20200116,28114
20200113,1,의정부,20927,21262,20200116,42189
20200113,1,가능,7353,7012,20200116,14365
20200113,1,녹양,5399,5019,20200116,10418
20200113,1,양주,9194,8351,20200116,17545
20200113,1,덕계,2604,2285,20200116,4889
20200113,1,덕정,6283,6106,20200116,12389
20200113,1,지행,7353,7049,20200116,14402
20200113,1,동두천중앙,3907,3628,20200116,7535
20200113,1,보산,1757,1540,20200116,3297
20200113,1,동두천,2241,2647,20200116,4888
20200113,1,소요산,3151,2351,20200116,5502
20200114,1,소요산,3003,2357,20200117,5360
20200114,1,동두천,2197,2661,20200117,4858
20200114,1,보산,1651,1462,20200117,3113
20200114,1,동두천중앙,3701,3525,20200117,7226
20200114,1,지행,7208,6997,20200117,14205
20200114,1,덕정,6193,5945,20200117,12138
20200114,1,덕계,2500,2168,20200117,4668
20200114,1,양주,8902,8129,20200117,17031
20200114,1,녹양,5266,5032,20200117,10298
20200114,1,가능,7218,6924,20200117,14142
20200114,1,의정부,20645,21566,20200117,42211
20200114,1,회룡,14518,14021,20200117,28539
20200114,1,망월사,8437,8462,20200117,16899
20200114,1,도봉산,7856,4754,20200117,12610
20200114,1,도봉,6931,6491,20200117,13422
20200114,1,방학,10899,10496,20200117,21395
20200114,1,창동,1,0,20200117,1
20200114,1,녹천,5473,4493,20200117,9966
20200114,1,월계,6508,6187,20200117,12695
20200114,1,광운대,9646,8874,20200117,18520
20200114,1,석계,10348,11671,20200117,22019
20200114,1,신이문,10053,9088,20200117,19141
20200114,1,외대앞,9790,9701,20200117,19491
20200114,경원선,청량리,16630,17943,20200117,34573
20200114,경원선,왕십리,16375,18186,20200117,34561
20200114,경원선,응봉,1968,1709,20200117,3677
20200114,경원선,옥수,41,21,20200117,62
20200114,경원선,한남,5042,4952,20200117,9994
20200114,경원선,서빙고,2127,1976,20200117,4103
20200114,경원선,이촌,4563,3523,20200117,8086
20200115,경원선,이촌,4553,3577,20200118,8130
20200115,경원선,서빙고,2033,1853,20200118,3886
20200115,경원선,한남,5138,4814,20200118,9952
20200115,경원선,옥수,57,27,20200118,84
20200115,경원선,응봉,1996,1693,20200118,3689
20200115,경원선,왕십리,16654,18687,20200118,35341
20200115,경원선,청량리,17158,18395,20200118,35553
20200115,1,외대앞,10016,9732,20200118,19748
20200115,1,신이문,10027,9079,20200118,19106
20200115,1,석계,10298,11670,20200118,21968
20200115,1,광운대,11121,10412,20200118,21533
20200115,1,월계,6555,6157,20200118,12712
20200115,1,녹천,5422,4548,20200118,9970
20200115,1,방학,10959,10594,20200118,21553
20200115,1,도봉,7078,6681,20200118,13759
20200115,1,도봉산,7842,4801,20200118,12643
20200115,1,망월사,8794,8841,20200118,17635
20200115,1,회룡,14508,14129,20200118,28637
20200115,1,의정부,21180,21871,20200118,43051
20200115,1,가능,7263,6924,20200118,14187
20200115,1,녹양,5365,4925,20200118,10290
20200115,1,양주,8983,8271,20200118,17254
20200115,1,덕계,2649,2241,20200118,4890
20200115,1,덕정,6509,6178,20200118,12687
20200115,1,지행,7121,6942,20200118,14063
20200115,1,동두천중앙,3899,3685,20200118,7584
20200115,1,보산,1594,1502,20200118,3096
20200115,1,동두천,2220,2567,20200118,4787
20200115,1,소요산,2909,2250,20200118,5159
20200116,1,소요산,3003,2491,20200119,5494
20200116,1,동두천,2239,2604,20200119,4843
20200116,1,보산,1895,1522,20200119,3417
20200116,1,동두천중앙,3879,3601,20200119,7480
20200116,1,지행,7202,7088,20200119,14290
20200116,1,덕정,6166,6002,20200119,12168
20200116,1,덕계,2625,2231,20200119,4856
20200116,1,양주,9049,8365,20200119,17414
20200116,1,녹양,5334,5029,20200119,10363
20200116,1,가능,7330,7028,20200119,14358
20200116,1,의정부,21172,21791,20200119,42963
20200116,1,회룡,14528,13793,20200119,28321
20200116,1,망월사,8617,8589,20200119,17206
20200116,1,도봉산,8014,4825,20200119,12839
20200116,1,도봉,6908,6562,20200119,13470
20200116,1,방학,10957,10576,20200119,21533
20200116,1,녹천,5313,4454,20200119,9767
20200116,1,월계,6534,6077,20200119,12611
20200116,1,광운대,9331,8841,20200119,18172
20200116,1,석계,10345,11724,20200119,22069
20200116,1,신이문,10028,9099,20200119,19127
20200116,1,외대앞,9449,9235,20200119,18684
20200116,경원선,청량리,17812,18835,20200119,36647
20200116,경원선,왕십리,16477,18532,20200119,35009
20200116,경원선,응봉,2009,1675,20200119,3684
20200116,경원선,옥수,47,37,20200119,84
20200116,경원선,한남,5035,4781,20200119,9816
20200116,경원선,서빙고,2064,1919,20200119,3983
20200116,경원선,이촌,4629,3450,20200119,8079
20200117,경원선,이촌,4845,3651,20200120,8496
20200117,경원선,서빙고,2135,1922,20200120,4057
20200117,경원선,한남,5132,4981,20200120,10113
20200117,경원선,옥수,69,27,20200120,96
20200117,경원선,응봉,2053,1687,20200120,3740
20200117,경원선,왕십리,17564,20156,20200120,37720
20200117,경원선,청량리,19493,20519,20200120,40012
20200117,1,외대앞,9876,9320,20200120,19196
20200117,1,신이문,10294,9116,20200120,19410
20200117,1,석계,10805,12060,20200120,22865
20200117,1,광운대,9799,9002,20200120,18801
20200117,1,월계,6770,6180,20200120,12950
20200117,1,녹천,5421,4466,20200120,9887
20200117,1,방학,11131,10764,20200120,21895
20200117,1,도봉,7012,6512,20200120,13524
20200117,1,도봉산,8210,4908,20200120,13118
20200117,1,망월사,8552,8282,20200120,16834
20200117,1,회룡,14790,14223,20200120,29013
20200117,1,의정부,22300,23838,20200120,46138
20200117,1,가능,7554,7075,20200120,14629
20200117,1,녹양,5662,5086,20200120,10748
20200117,1,양주,9520,8418,20200120,17938
20200117,1,덕계,2691,2380,20200120,5071
20200117,1,덕정,6647,6273,20200120,12920
20200117,1,지행,7720,7569,20200120,15289
20200117,1,동두천중앙,3763,3693,20200120,7456
20200117,1,보산,2125,1709,20200120,3834
20200117,1,동두천,2352,2804,20200120,5156
20200117,1,소요산,3269,2887,20200120,6156
20200118,경원선,이촌,3870,2827,20200121,6697
20200118,경원선,서빙고,1467,1392,20200121,2859
20200118,경원선,한남,3524,3505,20200121,7029
20200118,경원선,옥수,33,38,20200121,71
20200118,경원선,응봉,1519,1354,20200121,2873
20200118,경원선,왕십리,15422,17336,20200121,32758
20200118,경원선,청량리,20696,21373,20200121,42069
20200118,1,외대앞,8067,7522,20200121,15589
20200118,1,신이문,7656,6854,20200121,14510
20200118,1,석계,9288,9869,20200121,19157
20200118,1,광운대,7431,7087,20200121,14518
20200118,1,월계,5578,4863,20200121,10441
20200118,1,녹천,4019,3296,20200121,7315
20200118,1,방학,8596,8172,20200121,16768
20200118,1,도봉,5241,4890,20200121,10131
20200118,1,도봉산,8981,5888,20200121,14869
20200118,1,망월사,7195,7060,20200121,14255
20200118,1,회룡,11591,11322,20200121,22913
20200118,1,의정부,22402,24462,20200121,46864
20200118,1,가능,6187,5777,20200121,11964
20200118,1,녹양,4248,4052,20200121,8300
20200118,1,양주,8138,7193,20200121,15331
20200118,1,덕계,2181,1890,20200121,4071
20200118,1,덕정,5910,5190,20200121,11100
20200118,1,지행,7027,6763,20200121,13790
20200118,1,동두천중앙,3434,3333,20200121,6767
20200118,1,보산,1900,1755,20200121,3655
20200118,1,동두천,1992,2347,20200121,4339
20200118,1,소요산,4623,3369,20200121,7992
20200119,경원선,이촌,3261,2459,20200122,5720
20200119,경원선,서빙고,2120,2278,20200122,4398
20200119,경원선,한남,2192,2084,20200122,4276
20200119,경원선,옥수,42,26,20200122,68
20200119,경원선,응봉,1119,1012,20200122,2131
20200119,경원선,왕십리,11428,12583,20200122,24011
20200119,경원선,청량리,15172,14916,20200122,30088
20200119,1,외대앞,5953,5644,20200122,11597
20200119,1,신이문,5692,5248,20200122,10940
20200119,1,석계,6335,6924,20200122,13259
20200119,1,광운대,5362,5343,20200122,10705
20200119,1,월계,4101,3789,20200122,7890
20200119,1,녹천,3076,2629,20200122,5705
20200119,1,방학,6803,6570,20200122,13373
20200119,1,도봉,3883,3642,20200122,7525
20200119,1,도봉산,7370,4896,20200122,12266
20200119,1,망월사,5254,5505,20200122,10759
20200119,1,회룡,8344,8357,20200122,16701
20200119,1,의정부,18001,17504,20200122,35505
20200119,1,가능,4452,4173,20200122,8625
20200119,1,녹양,3203,3093,20200122,6296
20200119,1,양주,5694,5755,20200122,11449
20200119,1,덕계,1578,1415,20200122,2993
20200119,1,덕정,3983,4200,20200122,8183
20200119,1,지행,5025,5160,20200122,10185
20200119,1,동두천중앙,2554,2487,20200122,5041
20200119,1,보산,1450,1518,20200122,2968
20200119,1,동두천,1461,2135,20200122,3596
20200119,1,소요산,3448,3391,20200122,6839
20200120,1,소요산,3103,2428,20200123,5531
20200120,1,동두천,2242,2610,20200123,4852
20200120,1,보산,1749,1966,20200123,3715
20200120,1,동두천중앙,4022,3896,20200123,7918
20200120,1,지행,7368,7061,20200123,14429
20200120,1,덕정,6159,6030,20200123,12189
20200120,1,덕계,2687,2299,20200123,4986
20200120,1,양주,9289,8399,20200123,17688
20200120,1,녹양,5380,4996,20200123,10376
20200120,1,가능,7358,6951,20200123,14309
20200120,1,의정부,21036,21611,20200123,42647
20200120,1,회룡,14469,13667,20200123,28136
20200120,1,망월사,8242,8349,20200123,16591
20200120,1,도봉산,7843,4721,20200123,12564
20200120,1,도봉,6814,6405,20200123,13219
20200120,1,방학,10966,10378,20200123,21344
20200120,1,창동,1,0,20200123,1
20200120,1,녹천,5380,4523,20200123,9903
20200120,1,월계,6760,6273,20200123,13033
20200120,1,광운대,9545,9016,20200123,18561
20200120,1,석계,10421,11811,20200123,22232
20200120,1,신이문,10110,9275,20200123,19385
20200120,1,외대앞,9323,9092,20200123,18415
20200120,경원선,청량리,17418,18670,20200123,36088
20200120,경원선,왕십리,16496,18211,20200123,34707
20200120,경원선,응봉,2028,1676,20200123,3704
20200120,경원선,옥수,59,36,20200123,95
20200120,경원선,한남,5158,4956,20200123,10114
20200120,경원선,서빙고,2031,1945,20200123,3976
20200120,경원선,이촌,4588,3565,20200123,8153
20200121,경원선,이촌,4586,3557,20200124,8143
20200121,경원선,서빙고,2125,2045,20200124,4170
20200121,경원선,한남,5193,4860,20200124,10053
20200121,경원선,옥수,52,36,20200124,88
20200121,경원선,응봉,2026,1669,20200124,3695
20200121,경원선,왕십리,16284,18270,20200124,34554
20200121,경원선,청량리,17303,18506,20200124,35809
20200121,1,외대앞,13033,12569,20200124,25602
20200121,1,신이문,10266,9250,20200124,19516
20200121,1,석계,10217,11441,20200124,21658
20200121,1,광운대,9449,8697,20200124,18146
20200121,1,월계,6776,6305,20200124,13081
20200121,1,녹천,5288,4429,20200124,9717
20200121,1,방학,10861,10462,20200124,21323
20200121,1,도봉,6944,6495,20200124,13439
20200121,1,도봉산,7927,4662,20200124,12589
20200121,1,망월사,8460,8421,20200124,16881
20200121,1,회룡,14299,13740,20200124,28039
20200121,1,의정부,20837,21532,20200124,42369
20200121,1,가능,7129,6773,20200124,13902
20200121,1,녹양,5321,4888,20200124,10209
20200121,1,양주,8832,8136,20200124,16968
20200121,1,덕계,2549,2162,20200124,4711
20200121,1,덕정,6085,5866,20200124,11951
20200121,1,지행,7102,6870,20200124,13972
20200121,1,동두천중앙,3798,3657,20200124,7455
20200121,1,보산,1618,1504,20200124,3122
20200121,1,동두천,2238,2574,20200124,4812
20200121,1,소요산,2863,2336,20200124,5199
20200122,경원선,이촌,4604,3564,20200125,8168
20200122,경원선,서빙고,2011,1848,20200125,3859
20200122,경원선,한남,5064,4814,20200125,9878
20200122,경원선,옥수,42,29,20200125,71
20200122,경원선,응봉,1957,1704,20200125,3661
20200122,경원선,왕십리,17094,18708,20200125,35802
20200122,경원선,청량리,17221,18966,20200125,36187
20200122,1,외대앞,9573,9047,20200125,18620
20200122,1,신이문,10427,9308,20200125,19735
20200122,1,석계,10421,11621,20200125,22042
20200122,1,광운대,9588,8559,20200125,18147
20200122,1,월계,6762,6183,20200125,12945
20200122,1,녹천,5328,4437,20200125,9765
20200122,1,창동,1,0,20200125,1
20200122,1,방학,11075,10711,20200125,21786
20200122,1,도봉,6856,6329,20200125,13185
20200122,1,도봉산,7804,4714,20200125,12518
20200122,1,망월사,8513,8615,20200125,17128
20200122,1,회룡,14278,13598,20200125,27876
20200122,1,의정부,21506,22522,20200125,44028
20200122,1,가능,7248,6980,20200125,14228
20200122,1,녹양,5435,5184,20200125,10619
20200122,1,양주,9059,8023,20200125,17082
20200122,1,덕계,2669,2363,20200125,5032
20200122,1,덕정,6262,5928,20200125,12190
20200122,1,지행,7265,7141,20200125,14406
20200122,1,동두천중앙,3746,3510,20200125,7256
20200122,1,보산,1577,1477,20200125,3054
20200122,1,동두천,2216,2603,20200125,4819
20200122,1,소요산,3012,2347,20200125,5359
20200123,경원선,이촌,4573,3354,20200126,7927
20200123,경원선,서빙고,1956,1775,20200126,3731
20200123,경원선,한남,4953,4558,20200126,9511
20200123,경원선,옥수,46,30,20200126,76
20200123,경원선,응봉,1998,1645,20200126,3643
20200123,경원선,왕십리,17079,18560,20200126,35639
20200123,경원선,청량리,17363,21285,20200126,38648
20200123,1,외대앞,9192,8165,20200126,17357
20200123,1,신이문,9955,8581,20200126,18536
20200123,1,석계,10170,10881,20200126,21051
20200123,1,광운대,9224,8202,20200126,17426
20200123,1,월계,6507,5876,20200126,12383
20200123,1,녹천,5128,4086,20200126,9214
20200123,1,창동,3,0,20200126,3
20200123,1,방학,10327,10042,20200126,20369
20200123,1,도봉,6322,5810,20200126,12132
20200123,1,도봉산,7582,4494,20200126,12076
20200123,1,망월사,8048,7769,20200126,15817
20200123,1,회룡,13206,12817,20200126,26023
20200123,1,의정부,22509,24944,20200126,47453
20200123,1,가능,6820,6336,20200126,13156
20200123,1,녹양,5121,4876,20200126,9997
20200123,1,양주,9010,7974,20200126,16984
20200123,1,덕계,2462,2070,20200126,4532
20200123,1,덕정,6369,5745,20200126,12114
20200123,1,지행,7370,7421,20200126,14791
20200123,1,동두천중앙,3708,3819,20200126,7527
20200123,1,보산,1903,1657,20200126,3560
20200123,1,동두천,2167,2692,20200126,4859
20200123,1,소요산,2928,2808,20200126,5736
20200124,1,소요산,2841,2813,20200127,5654
20200124,1,동두천,1338,1943,20200127,3281
20200124,1,보산,1285,1260,20200127,2545
20200124,1,동두천중앙,2208,2829,20200127,5037
20200124,1,지행,4040,4723,20200127,8763
20200124,1,덕정,3728,3694,20200127,7422
20200124,1,덕계,1177,1342,20200127,2519
20200124,1,양주,4931,5295,20200127,10226
20200124,1,녹양,2333,2427,20200127,4760
20200124,1,가능,3627,3641,20200127,7268
20200124,1,의정부,14963,15943,20200127,30906
20200124,1,회룡,5774,6209,20200127,11983
20200124,1,망월사,3734,3818,20200127,7552
20200124,1,도봉산,4755,3158,20200127,7913
20200124,1,도봉,3026,2861,20200127,5887
20200124,1,방학,5218,5101,20200127,10319
20200124,1,창동,1,0,20200127,1
20200124,1,녹천,2530,1906,20200127,4436
20200124,1,월계,3274,2942,20200127,6216
20200124,1,광운대,4151,3830,20200127,7981
20200124,1,석계,5512,5318,20200127,10830
20200124,1,신이문,4947,4433,20200127,9380
20200124,1,외대앞,4739,3828,20200127,8567
20200124,경원선,청량리,10188,13810,20200127,23998
20200124,경원선,왕십리,8643,8824,20200127,17467
20200124,경원선,응봉,979,759,20200127,1738
20200124,경원선,옥수,19,58,20200127,77
20200124,경원선,한남,1969,1733,20200127,3702
20200124,경원선,서빙고,786,668,20200127,1454
20200124,경원선,이촌,1853,1482,20200127,3335
20200125,경원선,이촌,1382,1116,20200128,2498
20200125,경원선,서빙고,704,605,20200128,1309
20200125,경원선,한남,1726,1664,20200128,3390
20200125,경원선,옥수,39,18,20200128,57
20200125,경원선,응봉,979,831,20200128,1810
20200125,경원선,왕십리,6347,7596,20200128,13943
20200125,경원선,청량리,11412,11038,20200128,22450
20200125,1,외대앞,3740,3733,20200128,7473
20200125,1,신이문,4865,4501,20200128,9366
20200125,1,석계,5213,5706,20200128,10919
20200125,1,광운대,4027,4156,20200128,8183
20200125,1,월계,3278,2870,20200128,6148
20200125,1,녹천,2778,2287,20200128,5065
20200125,1,방학,5420,5385,20200128,10805
20200125,1,도봉,3074,2860,20200128,5934
20200125,1,도봉산,4501,2862,20200128,7363
20200125,1,망월사,3630,3700,20200128,7330
20200125,1,회룡,6496,6144,20200128,12640
20200125,1,의정부,13152,13688,20200128,26840
20200125,1,가능,3987,3667,20200128,7654
20200125,1,녹양,2802,2504,20200128,5306
20200125,1,양주,5637,4992,20200128,10629
20200125,1,덕계,1273,1216,20200128,2489
20200125,1,덕정,3866,3524,20200128,7390
20200125,1,지행,4564,4413,20200128,8977
20200125,1,동두천중앙,2535,2470,20200128,5005
20200125,1,보산,1494,1409,20200128,2903
20200125,1,동두천,1298,1594,20200128,2892
20200125,1,소요산,3324,2591,20200128,5915
20200126,경원선,이촌,2656,2073,20200129,4729
20200126,경원선,서빙고,1747,1828,20200129,3575
20200126,경원선,한남,1792,1904,20200129,3696
20200126,경원선,옥수,55,18,20200129,73
20200126,경원선,응봉,1083,1033,20200129,2116
20200126,경원선,왕십리,7954,10227,20200129,18181
20200126,경원선,청량리,14634,12100,20200129,26734
20200126,1,외대앞,4286,4478,20200129,8764
20200126,1,신이문,5031,4696,20200129,9727
20200126,1,석계,5568,6212,20200129,11780
20200126,1,광운대,4285,4482,20200129,8767
20200126,1,월계,3378,3153,20200129,6531
20200126,1,녹천,2687,2187,20200129,4874
20200126,1,방학,5952,5760,20200129,11712
20200126,1,도봉,3407,3103,20200129,6510
20200126,1,도봉산,7616,5039,20200129,12655
20200126,1,망월사,4480,4522,20200129,9002
20200126,1,회룡,7301,6876,20200129,14177
20200126,1,의정부,17537,19087,20200129,36624
20200126,1,가능,4160,3691,20200129,7851
20200126,1,녹양,2830,2511,20200129,5341
20200126,1,양주,5953,5263,20200129,11216
20200126,1,덕계,1461,1277,20200129,2738
20200126,1,덕정,4221,3933,20200129,8154
20200126,1,지행,5040,4880,20200129,9920
20200126,1,동두천중앙,2668,2370,20200129,5038
20200126,1,보산,1510,1408,20200129,2918
20200126,1,동두천,1410,1705,20200129,3115
20200126,1,소요산,4105,3214,20200129,7319
20200127,경원선,이촌,1879,1600,20200130,3479
20200127,경원선,서빙고,749,785,20200130,1534
20200127,경원선,한남,2328,2260,20200130,4588
20200127,경원선,옥수,50,18,20200130,68
20200127,경원선,응봉,978,874,20200130,1852
20200127,경원선,왕십리,9602,11910,20200130,21512
20200127,경원선,청량리,14935,12540,20200130,27475
20200127,1,외대앞,4465,4816,20200130,9281
20200127,1,신이문,4792,4463,20200130,9255
20200127,1,석계,5763,6540,20200130,12303
20200127,1,광운대,4264,4629,20200130,8893
20200127,1,월계,3432,3160,20200130,6592
20200127,1,녹천,2604,2349,20200130,4953
20200127,1,방학,5649,5644,20200130,11293
20200127,1,도봉,3478,3288,20200130,6766
20200127,1,도봉산,6751,4416,20200130,11167
20200127,1,망월사,4365,4529,20200130,8894
20200127,1,회룡,7266,6997,20200130,14263
20200127,1,의정부,17275,17377,20200130,34652
20200127,1,가능,4081,3730,20200130,7811
20200127,1,녹양,2829,2641,20200130,5470
20200127,1,양주,5430,5078,20200130,10508
20200127,1,덕계,1465,1268,20200130,2733
20200127,1,덕정,3856,3919,20200130,7775
20200127,1,지행,4977,4856,20200130,9833
20200127,1,동두천중앙,2678,2419,20200130,5097
20200127,1,보산,1356,1672,20200130,3028
20200127,1,동두천,1385,1881,20200130,3266
20200127,1,소요산,3671,3053,20200130,6724
20200128,경원선,이촌,4077,3191,20200131,7268
20200128,경원선,서빙고,1876,1829,20200131,3705
20200128,경원선,한남,4625,4450,20200131,9075
20200128,경원선,옥수,46,29,20200131,75
20200128,경원선,응봉,1766,1522,20200131,3288
20200128,경원선,왕십리,14417,16737,20200131,31154
20200128,경원선,청량리,14971,15449,20200131,30420
20200128,1,외대앞,7739,8134,20200131,15873
20200128,1,신이문,9143,8232,20200131,17375
20200128,1,석계,9099,10502,20200131,19601
20200128,1,광운대,8354,7995,20200131,16349
20200128,1,월계,5887,5560,20200131,11447
20200128,1,녹천,4956,4093,20200131,9049
20200128,1,창동,1,0,20200131,1
20200128,1,방학,10008,9674,20200131,19682
20200128,1,도봉,6174,5809,20200131,11983
20200128,1,도봉산,7246,4279,20200131,11525
20200128,1,망월사,7640,7688,20200131,15328
20200128,1,회룡,13290,12801,20200131,26091
20200128,1,의정부,19435,20202,20200131,39637
20200128,1,가능,6664,6283,20200131,12947
20200128,1,녹양,5023,4673,20200131,9696
20200128,1,양주,8411,7555,20200131,15966
20200128,1,덕계,2372,2112,20200131,4484
20200128,1,덕정,5717,5622,20200131,11339
20200128,1,지행,6839,6684,20200131,13523
20200128,1,동두천중앙,3526,3343,20200131,6869
20200128,1,보산,1745,1448,20200131,3193
20200128,1,동두천,2128,2460,20200131,4588
20200128,1,소요산,2909,2395,20200131,5304
20200129,경원선,이촌,4187,3259,20200201,7446
20200129,경원선,서빙고,1885,1812,20200201,3697
20200129,경원선,한남,4777,4552,20200201,9329
20200129,경원선,옥수,57,25,20200201,82
20200129,경원선,응봉,1847,1604,20200201,3451
20200129,경원선,왕십리,15495,17485,20200201,32980
20200129,경원선,청량리,14600,15574,20200201,30174
20200129,1,외대앞,8213,8162,20200201,16375
20200129,1,신이문,9648,8814,20200201,18462
20200129,1,석계,9438,10860,20200201,20298
20200129,1,광운대,8963,8327,20200201,17290
20200129,1,월계,6206,5803,20200201,12009
20200129,1,녹천,5109,4419,20200201,9528
20200129,1,방학,10561,10220,20200201,20781
20200129,1,도봉,6420,6012,20200201,12432
20200129,1,도봉산,7932,4796,20200201,12728
20200129,1,망월사,8062,8236,20200201,16298
20200129,1,회룡,13628,13213,20200201,26841
20200129,1,의정부,20130,20773,20200201,40903
20200129,1,가능,7043,6631,20200201,13674
20200129,1,녹양,5169,4886,20200201,10055
20200129,1,양주,8707,7973,20200201,16680
20200129,1,덕계,2540,2184,20200201,4724
20200129,1,덕정,5826,5651,20200201,11477
20200129,1,지행,6805,6732,20200201,13537
20200129,1,동두천중앙,3509,3312,20200201,6821
20200129,1,보산,1617,1437,20200201,3054
20200129,1,동두천,2035,2491,20200201,4526
20200129,1,소요산,2930,2427,20200201,5357
20200130,1,소요산,2891,2429,20200202,5320
20200130,1,동두천,2080,2416,20200202,4496
20200130,1,보산,1522,1430,20200202,2952
20200130,1,동두천중앙,3635,3483,20200202,7118
20200130,1,지행,6763,6710,20200202,13473
20200130,1,덕정,5897,5777,20200202,11674
20200130,1,덕계,2513,2172,20200202,4685
20200130,1,양주,8458,7728,20200202,16186
20200130,1,녹양,5159,4916,20200202,10075
20200130,1,가능,6919,6640,20200202,13559
20200130,1,의정부,19912,20483,20200202,40395
20200130,1,회룡,13682,13288,20200202,26970
20200130,1,망월사,7842,8007,20200202,15849
20200130,1,도봉산,7956,4839,20200202,12795
20200130,1,도봉,6525,6037,20200202,12562
20200130,1,방학,10410,10081,20200202,20491
20200130,1,창동,1,0,20200202,1
20200130,1,녹천,5126,4246,20200202,9372
20200130,1,월계,6251,5862,20200202,12113
20200130,1,광운대,8875,8340,20200202,17215
20200130,1,석계,9512,10844,20200202,20356
20200130,1,신이문,9712,8826,20200202,18538
20200130,1,외대앞,8599,8383,20200202,16982
20200130,경원선,청량리,15171,16103,20200202,31274
20200130,경원선,왕십리,16209,17655,20200202,33864
20200130,경원선,응봉,2034,1755,20200202,3789
20200130,경원선,옥수,43,17,20200202,60
20200130,경원선,한남,4851,4641,20200202,9492
20200130,경원선,서빙고,1917,1838,20200202,3755
20200130,경원선,이촌,4306,3320,20200202,7626
20200131,경원선,이촌,4237,3312,20200203,7549
20200131,경원선,서빙고,1898,1795,20200203,3693
20200131,경원선,한남,4711,4529,20200203,9240
20200131,경원선,옥수,64,43,20200203,107
20200131,경원선,응봉,1908,1618,20200203,3526
20200131,경원선,왕십리,16695,18990,20200203,35685
20200131,경원선,청량리,15906,17371,20200203,33277
20200131,1,외대앞,8532,8348,20200203,16880
20200131,1,신이문,9738,8564,20200203,18302
20200131,1,석계,9739,10971,20200203,20710
20200131,1,광운대,9017,8366,20200203,17383
20200131,1,월계,6240,5788,20200203,12028
20200131,1,녹천,5019,4140,20200203,9159
20200131,1,방학,10464,10182,20200203,20646
20200131,1,도봉,6287,5916,20200203,12203
20200131,1,도봉산,7811,4645,20200203,12456
20200131,1,망월사,7883,7888,20200203,15771
20200131,1,회룡,13573,13209,20200203,26782
20200131,1,의정부,20585,22072,20200203,42657
20200131,1,가능,6968,6709,20200203,13677
20200131,1,녹양,5320,4949,20200203,10269
20200131,1,양주,8817,7792,20200203,16609
20200131,1,덕계,2560,2229,20200203,4789
20200131,1,덕정,6061,5803,20200203,11864
20200131,1,지행,7193,7048,20200203,14241
20200131,1,동두천중앙,3573,3347,20200203,6920
20200131,1,보산,2048,1612,20200203,3660
20200131,1,동두천,2196,2538,20200203,4734
20200131,1,소요산,2999,2582,20200203,5581
20200201,경원선,이촌,2973,2226,20200204,5199
20200201,경원선,서빙고,1153,1097,20200204,2250
20200201,경원선,한남,2857,2844,20200204,5701
20200201,경원선,옥수,32,32,20200204,64
20200201,경원선,응봉,1193,1125,20200204,2318
20200201,경원선,왕십리,12708,14617,20200204,27325
20200201,경원선,청량리,14095,14853,20200204,28948
20200201,1,외대앞,6689,6285,20200204,12974
20200201,1,신이문,6338,5708,20200204,12046
20200201,1,석계,7189,7661,20200204,14850
20200201,1,광운대,5816,5755,20200204,11571
20200201,1,월계,4320,3976,20200204,8296
20200201,1,녹천,3392,2784,20200204,6176
20200201,1,방학,7236,7246,20200204,14482
20200201,1,도봉,4268,3922,20200204,8190
20200201,1,도봉산,7522,5093,20200204,12615
20200201,1,망월사,6049,6112,20200204,12161
20200201,1,회룡,9308,9265,20200204,18573
20200201,1,의정부,18583,19928,20200204,38511
20200201,1,가능,5192,4840,20200204,10032
20200201,1,녹양,3565,3442,20200204,7007
20200201,1,양주,6351,5756,20200204,12107
20200201,1,덕계,1816,1613,20200204,3429
20200201,1,덕정,4759,4256,20200204,9015
20200201,1,지행,5767,5625,20200204,11392
20200201,1,동두천중앙,2682,2638,20200204,5320
20200201,1,보산,1756,1567,20200204,3323
20200201,1,동두천,1657,1823,20200204,3480
20200201,1,소요산,3964,2897,20200204,6861
20200202,경원선,이촌,2627,1955,20200205,4582
20200202,경원선,서빙고,1677,1838,20200205,3515
20200202,경원선,한남,1995,1900,20200205,3895
20200202,경원선,옥수,44,21,20200205,65
20200202,경원선,응봉,904,896,20200205,1800
20200202,경원선,왕십리,9127,10298,20200205,19425
20200202,경원선,청량리,11499,10867,20200205,22366
20200202,1,외대앞,5469,5222,20200205,10691
20200202,1,신이문,4715,4318,20200205,9033
20200202,1,석계,5289,5719,20200205,11008
20200202,1,광운대,4315,4402,20200205,8717
20200202,1,월계,3302,3056,20200205,6358
20200202,1,녹천,2515,2169,20200205,4684
20200202,1,방학,5883,5561,20200205,11444
20200202,1,도봉,3220,3042,20200205,6262
20200202,1,도봉산,7182,4899,20200205,12081
20200202,1,망월사,4532,4701,20200205,9233
20200202,1,회룡,6923,6972,20200205,13895
20200202,1,의정부,14775,14628,20200205,29403
20200202,1,가능,3939,3618,20200205,7557
20200202,1,녹양,2763,2595,20200205,5358
20200202,1,양주,4961,4923,20200205,9884
20200202,1,덕계,1272,1236,20200205,2508
20200202,1,덕정,3530,3586,20200205,7116
20200202,1,지행,4359,4364,20200205,8723
20200202,1,동두천중앙,2105,1979,20200205,4084
20200202,1,보산,1293,1339,20200205,2632
20200202,1,동두천,1147,1690,20200205,2837
20200202,1,소요산,3198,2929,20200205,6127
20200203,경원선,이촌,4130,3144,20200206,7274
20200203,경원선,서빙고,1873,1767,20200206,3640
20200203,경원선,한남,4604,4402,20200206,9006
20200203,경원선,옥수,47,32,20200206,79
20200203,경원선,응봉,1785,1523,20200206,3308
20200203,경원선,왕십리,14395,16002,20200206,30397
20200203,경원선,청량리,13044,14401,20200206,27445
20200203,1,외대앞,8303,8179,20200206,16482
20200203,1,신이문,9298,8427,20200206,17725
20200203,1,석계,8986,10339,20200206,19325
20200203,1,광운대,8436,7827,20200206,16263
20200203,1,월계,6025,5757,20200206,11782
20200203,1,녹천,5048,4182,20200206,9230
20200203,1,창동,1,0,20200206,1
20200203,1,방학,9811,9457,20200206,19268
20200203,1,도봉,5990,5622,20200206,11612
20200203,1,도봉산,7253,4172,20200206,11425
20200203,1,망월사,7343,7585,20200206,14928
20200203,1,회룡,12871,12398,20200206,25269
20200203,1,의정부,18794,18927,20200206,37721
20200203,1,가능,6790,6515,20200206,13305
20200203,1,녹양,4881,4624,20200206,9505
20200203,1,양주,8165,7559,20200206,15724
20200203,1,덕계,2422,2085,20200206,4507
20200203,1,덕정,5672,5611,20200206,11283
20200203,1,지행,6522,6400,20200206,12922
20200203,1,동두천중앙,3294,3083,20200206,6377
20200203,1,보산,1692,1886,20200206,3578
20200203,1,동두천,2015,2402,20200206,4417
20200203,1,소요산,2727,1975,20200206,4702
20200204,경원선,이촌,4017,3103,20200207,7120
20200204,경원선,서빙고,1924,1858,20200207,3782
20200204,경원선,한남,4677,4417,20200207,9094
20200204,경원선,옥수,46,29,20200207,75
20200204,경원선,응봉,1773,1570,20200207,3343
20200204,경원선,왕십리,14191,16188,20200207,30379
20200204,경원선,청량리,12893,14097,20200207,26990
20200204,1,외대앞,8014,7912,20200207,15926
20200204,1,신이문,9292,8294,20200207,17586
20200204,1,석계,8902,10221,20200207,19123
20200204,1,광운대,8361,7754,20200207,16115
20200204,1,월계,6050,5792,20200207,11842
20200204,1,녹천,4914,4134,20200207,9048
20200204,1,방학,9614,9365,20200207,18979
20200204,1,도봉,6154,5787,20200207,11941
20200204,1,도봉산,7496,4417,20200207,11913
20200204,1,망월사,7686,7757,20200207,15443
20200204,1,회룡,12797,12571,20200207,25368
20200204,1,의정부,18452,18542,20200207,36994
20200204,1,가능,6596,6443,20200207,13039
20200204,1,녹양,5068,4840,20200207,9908
20200204,1,양주,7975,7380,20200207,15355
20200204,1,덕계,2342,2096,20200207,4438
20200204,1,덕정,5632,5485,20200207,11117
20200204,1,지행,6467,6372,20200207,12839
20200204,1,동두천중앙,3309,3192,20200207,6501
20200204,1,보산,1567,1366,20200207,2933
20200204,1,동두천,1913,2248,20200207,4161
20200204,1,소요산,2573,2094,20200207,4667
20200205,경원선,이촌,3709,2927,20200208,6636
20200205,경원선,서빙고,1769,1712,20200208,3481
20200205,경원선,한남,4303,4155,20200208,8458
20200205,경원선,옥수,36,20,20200208,56
20200205,경원선,응봉,1705,1441,20200208,3146
20200205,경원선,왕십리,14699,16530,20200208,31229
20200205,경원선,청량리,12233,13285,20200208,25518
20200205,1,외대앞,8112,7939,20200208,16051
20200205,1,신이문,8826,8095,20200208,16921
20200205,1,석계,8387,9645,20200208,18032
20200205,1,광운대,8152,7531,20200208,15683
20200205,1,월계,5656,5357,20200208,11013
20200205,1,녹천,4707,3927,20200208,8634
20200205,1,방학,9268,8992,20200208,18260
20200205,1,도봉,5761,5454,20200208,11215
20200205,1,도봉산,6229,3475,20200208,9704
20200205,1,망월사,7517,7663,20200208,15180
20200205,1,회룡,12093,11616,20200208,23709
20200205,1,의정부,18000,18274,20200208,36274
20200205,1,가능,6283,6059,20200208,12342
20200205,1,녹양,4670,4430,20200208,9100
20200205,1,양주,7610,7025,20200208,14635
20200205,1,덕계,2217,1966,20200208,4183
20200205,1,덕정,5258,5138,20200208,10396
20200205,1,지행,6153,6044,20200208,12197
20200205,1,동두천중앙,3101,2982,20200208,6083
20200205,1,보산,1457,1249,20200208,2706
20200205,1,동두천,1863,2117,20200208,3980
20200205,1,소요산,1958,1609,20200208,3567
20200206,경원선,이촌,3776,2827,20200209,6603
20200206,경원선,서빙고,1780,1684,20200209,3464
20200206,경원선,한남,4504,4257,20200209,8761
20200206,경원선,옥수,37,25,20200209,62
20200206,경원선,응봉,1750,1498,20200209,3248
20200206,경원선,왕십리,14752,16234,20200209,30986
20200206,경원선,청량리,12442,13333,20200209,25775
20200206,1,외대앞,7857,7621,20200209,15478
20200206,1,신이문,8878,7974,20200209,16852
20200206,1,석계,8492,9686,20200209,18178
20200206,1,광운대,8104,7503,20200209,15607
20200206,1,월계,5650,5364,20200209,11014
20200206,1,녹천,4528,3886,20200209,8414
20200206,1,창동,2,0,20200209,2
20200206,1,방학,9096,8823,20200209,17919
20200206,1,도봉,5788,5361,20200209,11149
20200206,1,도봉산,6318,3561,20200209,9879
20200206,1,망월사,7230,7293,20200209,14523
20200206,1,회룡,11937,11601,20200209,23538
20200206,1,의정부,17579,18025,20200209,35604
20200206,1,가능,6191,5891,20200209,12082
20200206,1,녹양,4557,4370,20200209,8927
20200206,1,양주,7645,7043,20200209,14688
20200206,1,덕계,2226,1892,20200209,4118
20200206,1,덕정,5298,5155,20200209,10453
20200206,1,지행,6062,5974,20200209,12036
20200206,1,동두천중앙,2977,2853,20200209,5830
20200206,1,보산,1348,1277,20200209,2625
20200206,1,동두천,1805,2099,20200209,3904
20200206,1,소요산,2017,1811,20200209,3828
20200207,경원선,이촌,4054,3055,20200210,7109
20200207,경원선,서빙고,1840,1729,20200210,3569
20200207,경원선,한남,4619,4476,20200210,9095
20200207,경원선,옥수,48,37,20200210,85
20200207,경원선,응봉,1796,1506,20200210,3302
20200207,경원선,왕십리,15522,17466,20200210,32988
20200207,경원선,청량리,14393,15675,20200210,30068
20200207,1,외대앞,8591,8171,20200210,16762
20200207,1,신이문,9170,8250,20200210,17420
20200207,1,석계,9072,10380,20200210,19452
20200207,1,광운대,8657,7844,20200210,16501
20200207,1,월계,6013,5626,20200210,11639
20200207,1,녹천,4919,3967,20200210,8886
20200207,1,방학,9507,9188,20200210,18695
20200207,1,도봉,6071,5697,20200210,11768
20200207,1,도봉산,6953,4031,20200210,10984
20200207,1,망월사,7460,7578,20200210,15038
20200207,1,회룡,12880,12307,20200210,25187
20200207,1,의정부,19187,20756,20200210,39943
20200207,1,가능,6621,6339,20200210,12960
20200207,1,녹양,4844,4548,20200210,9392
20200207,1,양주,8255,7477,20200210,15732
20200207,1,덕계,2410,2097,20200210,4507
20200207,1,덕정,5789,5555,20200210,11344
20200207,1,지행,6684,6650,20200210,13334
20200207,1,동두천중앙,3210,3101,20200210,6311
20200207,1,보산,1680,1527,20200210,3207
20200207,1,동두천,2018,2384,20200210,4402
20200207,1,소요산,2598,2285,20200210,4883
20200208,경원선,이촌,2731,2102,20200211,4833
20200208,경원선,서빙고,1115,1058,20200211,2173
20200208,경원선,한남,2726,2730,20200211,5456
20200208,경원선,옥수,14,37,20200211,51
20200208,경원선,응봉,1170,1032,20200211,2202
20200208,경원선,왕십리,12540,14394,20200211,26934
20200208,경원선,청량리,12367,13407,20200211,25774
20200208,1,외대앞,6824,6395,20200211,13219
20200208,1,신이문,6054,5425,20200211,11479
20200208,1,석계,6923,7360,20200211,14283
20200208,1,광운대,5493,5495,20200211,10988
20200208,1,월계,4186,3852,20200211,8038
20200208,1,녹천,3300,2745,20200211,6045
20200208,1,창동,1,0,20200211,1
20200208,1,방학,7031,6916,20200211,13947
20200208,1,도봉,4115,3870,20200211,7985
20200208,1,도봉산,7339,4764,20200211,12103
20200208,1,망월사,5787,5837,20200211,11624
20200208,1,회룡,8727,8651,20200211,17378
20200208,1,의정부,17998,19212,20200211,37210
20200208,1,가능,5045,4790,20200211,9835
20200208,1,녹양,3506,3299,20200211,6805
20200208,1,양주,6034,5640,20200211,11674
20200208,1,덕계,1745,1524,20200211,3269
20200208,1,덕정,4639,4232,20200211,8871
20200208,1,지행,5266,5256,20200211,10522
20200208,1,동두천중앙,2561,2470,20200211,5031
20200208,1,보산,1452,1403,20200211,2855
20200208,1,동두천,1561,1809,20200211,3370
20200208,1,소요산,3490,2644,20200211,6134
20200209,경원선,이촌,2654,1919,20200212,4573
20200209,경원선,서빙고,1718,1883,20200212,3601
20200209,경원선,한남,1830,1873,20200212,3703
20200209,경원선,옥수,32,20,20200212,52
20200209,경원선,응봉,906,842,20200212,1748
20200209,경원선,왕십리,8920,9922,20200212,18842
20200209,경원선,청량리,10352,9919,20200212,20271
20200209,1,외대앞,4721,4551,20200212,9272
20200209,1,신이문,4556,4206,20200212,8762
20200209,1,석계,5006,5432,20200212,10438
20200209,1,광운대,4314,4267,20200212,8581
20200209,1,월계,3211,2977,20200212,6188
20200209,1,녹천,2444,2048,20200212,4492
20200209,1,창동,2,0,20200212,2
20200209,1,방학,5497,5229,20200212,10726
20200209,1,도봉,3232,2971,20200212,6203
20200209,1,도봉산,7110,4804,20200212,11914
20200209,1,망월사,4326,4512,20200212,8838
20200209,1,회룡,6625,6463,20200212,13088
20200209,1,의정부,13416,13893,20200212,27309
20200209,1,가능,3735,3392,20200212,7127
20200209,1,녹양,2669,2517,20200212,5186
20200209,1,양주,4618,4534,20200212,9152
20200209,1,덕계,1258,1123,20200212,2381
20200209,1,덕정,3144,3314,20200212,6458
20200209,1,지행,3969,4002,20200212,7971
20200209,1,동두천중앙,2032,1958,20200212,3990
20200209,1,보산,1210,1301,20200212,2511
20200209,1,동두천,1230,1598,20200212,2828
20200209,1,소요산,3170,2742,20200212,5912
20200210,경원선,이촌,4049,3075,20200213,7124
20200210,경원선,서빙고,1798,1727,20200213,3525
20200210,경원선,한남,4426,4190,20200213,8616
20200210,경원선,옥수,54,27,20200213,81
20200210,경원선,응봉,1768,1541,20200213,3309
20200210,경원선,왕십리,14556,16353,20200213,30909
20200210,경원선,청량리,12334,13111,20200213,25445
20200210,1,외대앞,8115,7997,20200213,16112
20200210,1,신이문,9169,8230,20200213,17399
20200210,1,석계,8939,10210,20200213,19149
20200210,1,광운대,8480,7983,20200213,16463
20200210,1,월계,5843,5527,20200213,11370
20200210,1,녹천,4876,4026,20200213,8902
20200210,1,방학,9689,9374,20200213,19063
20200210,1,도봉,6053,5746,20200213,11799
20200210,1,도봉산,7322,4294,20200213,11616
20200210,1,망월사,7498,7672,20200213,15170
20200210,1,회룡,12765,12253,20200213,25018
20200210,1,의정부,18128,18511,20200213,36639
20200210,1,가능,6619,6392,20200213,13011
20200210,1,녹양,4946,4507,20200213,9453
20200210,1,양주,8190,7421,20200213,15611
20200210,1,덕계,2472,2135,20200213,4607
20200210,1,덕정,5634,5500,20200213,11134
20200210,1,지행,6537,6208,20200213,12745
20200210,1,동두천중앙,3473,3295,20200213,6768
20200210,1,보산,1515,1288,20200213,2803
20200210,1,동두천,2053,2365,20200213,4418
20200210,1,소요산,2846,2275,20200213,5121
20200211,경원선,이촌,4129,3044,20200214,7173
20200211,경원선,서빙고,1927,1901,20200214,3828
20200211,경원선,한남,4421,4266,20200214,8687
20200211,경원선,옥수,44,28,20200214,72
20200211,경원선,응봉,1817,1554,20200214,3371
20200211,경원선,왕십리,14976,16692,20200214,31668
20200211,경원선,청량리,13857,14919,20200214,28776
20200211,1,외대앞,8341,8091,20200214,16432
20200211,1,신이문,9334,8363,20200214,17697
20200211,1,석계,9152,10612,20200214,19764
20200211,1,광운대,8766,8175,20200214,16941
20200211,1,월계,6042,5675,20200214,11717
20200211,1,녹천,4863,4073,20200214,8936
20200211,1,방학,9904,9613,20200214,19517
20200211,1,도봉,6388,5931,20200214,12319
20200211,1,도봉산,7915,4757,20200214,12672
20200211,1,망월사,7733,7832,20200214,15565
20200211,1,회룡,13119,12777,20200214,25896
20200211,1,의정부,19136,19934,20200214,39070
20200211,1,가능,6738,6357,20200214,13095
20200211,1,녹양,5052,4844,20200214,9896
20200211,1,양주,8214,7531,20200214,15745
20200211,1,덕계,2442,2132,20200214,4574
20200211,1,덕정,5721,5601,20200214,11322
20200211,1,지행,6671,6618,20200214,13289
20200211,1,동두천중앙,3555,3344,20200214,6899
20200211,1,보산,1454,1296,20200214,2750
20200211,1,동두천,2035,2381,20200214,4416
20200211,1,소요산,3045,2508,20200214,5553
20200212,경원선,이촌,3900,3054,20200215,6954
20200212,경원선,서빙고,1719,1629,20200215,3348
20200212,경원선,한남,4258,4064,20200215,8322
20200212,경원선,옥수,44,32,20200215,76
20200212,경원선,응봉,1703,1404,20200215,3107
20200212,경원선,왕십리,14741,16373,20200215,31114
20200212,경원선,청량리,12779,14065,20200215,26844
20200212,1,외대앞,8049,7658,20200215,15707
20200212,1,신이문,9015,8268,20200215,17283
20200212,1,석계,8720,9878,20200215,18598
20200212,1,광운대,8405,7911,20200215,16316
20200212,1,월계,5745,5344,20200215,11089
20200212,1,녹천,4730,3948,20200215,8678
20200212,1,방학,9469,9170,20200215,18639
20200212,1,도봉,6002,5643,20200215,11645
20200212,1,도봉산,6272,3705,20200215,9977
20200212,1,망월사,7711,7771,20200215,15482
20200212,1,회룡,12491,12035,20200215,24526
20200212,1,의정부,18516,19056,20200215,37572
20200212,1,가능,6362,6157,20200215,12519
20200212,1,녹양,4812,4534,20200215,9346
20200212,1,양주,7963,7291,20200215,15254
20200212,1,덕계,2279,1966,20200215,4245
20200212,1,덕정,5539,5305,20200215,10844
20200212,1,지행,6251,6142,20200215,12393
20200212,1,동두천중앙,3178,3019,20200215,6197
20200212,1,보산,1403,1361,20200215,2764
20200212,1,동두천,1997,2183,20200215,4180
20200212,1,소요산,2121,1709,20200215,3830
20200213,경원선,이촌,4077,3146,20200216,7223
20200213,경원선,서빙고,1962,1825,20200216,3787
20200213,경원선,한남,4643,4339,20200216,8982
20200213,경원선,옥수,43,22,20200216,65
20200213,경원선,응봉,1895,1651,20200216,3546
20200213,경원선,왕십리,15882,17297,20200216,33179
20200213,경원선,청량리,14177,15437,20200216,29614
20200213,1,외대앞,8422,8346,20200216,16768
20200213,1,신이문,9387,8416,20200216,17803
20200213,1,석계,9495,10412,20200216,19907
20200213,1,광운대,8884,8285,20200216,17169
20200213,1,월계,6154,5692,20200216,11846
20200213,1,녹천,4903,4005,20200216,8908
20200213,1,방학,10110,9728,20200216,19838
20200213,1,도봉,6379,6009,20200216,12388
20200213,1,도봉산,7797,4630,20200216,12427
20200213,1,망월사,7904,7928,20200216,15832
20200213,1,회룡,13318,12722,20200216,26040
20200213,1,의정부,19998,20996,20200216,40994
20200213,1,가능,6726,6350,20200216,13076
20200213,1,녹양,5056,4858,20200216,9914
20200213,1,양주,8337,7642,20200216,15979
20200213,1,덕계,2445,2097,20200216,4542
20200213,1,덕정,6291,6100,20200216,12391
20200213,1,지행,6875,6557,20200216,13432
20200213,1,동두천중앙,3420,3324,20200216,6744
20200213,1,보산,1842,1428,20200216,3270
20200213,1,동두천,2098,2444,20200216,4542
20200213,1,소요산,3027,2570,20200216,5597
20200214,경원선,이촌,4264,3283,20200217,7547
20200214,경원선,서빙고,2002,1846,20200217,3848
20200214,경원선,한남,4673,4530,20200217,9203
20200214,경원선,옥수,70,24,20200217,94
20200214,경원선,응봉,1960,1599,20200217,3559
20200214,경원선,왕십리,17277,19593,20200217,36870
20200214,경원선,청량리,16377,17821,20200217,34198
20200214,1,외대앞,8928,8502,20200217,17430
20200214,1,신이문,9594,8443,20200217,18037
20200214,1,석계,9846,11079,20200217,20925
20200214,1,광운대,9074,8275,20200217,17349
20200214,1,월계,6594,6170,20200217,12764
20200214,1,녹천,4924,4051,20200217,8975
20200214,1,방학,10342,9994,20200217,20336
20200214,1,도봉,6396,6069,20200217,12465
20200214,1,도봉산,8137,4824,20200217,12961
20200214,1,망월사,8208,8300,20200217,16508
20200214,1,회룡,13653,13177,20200217,26830
20200214,1,의정부,22021,23595,20200217,45616
20200214,1,가능,7026,6637,20200217,13663
20200214,1,녹양,5349,4941,20200217,10290
20200214,1,양주,9167,8116,20200217,17283
20200214,1,덕계,2638,2328,20200217,4966
20200214,1,덕정,6468,5910,20200217,12378
20200214,1,지행,7338,7299,20200217,14637
20200214,1,동두천중앙,3703,3527,20200217,7230
20200214,1,보산,2000,1688,20200217,3688
20200214,1,동두천,2248,2659,20200217,4907
20200214,1,소요산,3429,2913,20200217,6342
20200215,경원선,이촌,3132,2353,20200218,5485
20200215,경원선,서빙고,1321,1242,20200218,2563
20200215,경원선,한남,2952,2833,20200218,5785
20200215,경원선,옥수,31,34,20200218,65
20200215,경원선,응봉,1355,1175,20200218,2530
20200215,경원선,왕십리,14346,16338,20200218,30684
20200215,경원선,청량리,14733,15857,20200218,30590
20200215,1,외대앞,6833,6424,20200218,13257
20200215,1,신이문,6640,6067,20200218,12707
20200215,1,석계,7806,8421,20200218,16227
20200215,1,광운대,6235,6069,20200218,12304
20200215,1,월계,4787,4297,20200218,9084
20200215,1,녹천,3664,2955,20200218,6619
20200215,1,창동,3,0,20200218,3
20200215,1,방학,7910,7578,20200218,15488
20200215,1,도봉,4552,4369,20200218,8921
20200215,1,도봉산,8636,5640,20200218,14276
20200215,1,망월사,6151,6354,20200218,12505
20200215,1,회룡,9990,9962,20200218,19952
20200215,1,의정부,20558,21719,20200218,42277
20200215,1,가능,5685,5322,20200218,11007
20200215,1,녹양,4089,3776,20200218,7865
20200215,1,양주,6977,6453,20200218,13430
20200215,1,덕계,1862,1732,20200218,3594
20200215,1,덕정,4902,4396,20200218,9298
20200215,1,지행,5931,5875,20200218,11806
20200215,1,동두천중앙,3092,3149,20200218,6241
20200215,1,보산,1847,1787,20200218,3634
20200215,1,동두천,1716,2164,20200218,3880
20200215,1,소요산,4211,3303,20200218,7514
20200216,경원선,이촌,2804,2094,20200219,4898
20200216,경원선,서빙고,1886,2022,20200219,3908
20200216,경원선,한남,1886,1934,20200219,3820
20200216,경원선,옥수,45,23,20200219,68
20200216,경원선,응봉,848,796,20200219,1644
20200216,경원선,왕십리,9875,11170,20200219,21045
20200216,경원선,청량리,11955,11428,20200219,23383
20200216,1,외대앞,4901,4656,20200219,9557
20200216,1,신이문,4757,4444,20200219,9201
20200216,1,석계,5026,5577,20200219,10603
20200216,1,광운대,4534,4597,20200219,9131
20200216,1,월계,3360,3107,20200219,6467
20200216,1,녹천,2467,2133,20200219,4600
20200216,1,방학,5731,5471,20200219,11202
20200216,1,도봉,3310,3117,20200219,6427
20200216,1,도봉산,5909,3936,20200219,9845
20200216,1,망월사,4675,4645,20200219,9320
20200216,1,회룡,6962,6772,20200219,13734
20200216,1,의정부,15170,15599,20200219,30769
20200216,1,가능,3868,3552,20200219,7420
20200216,1,녹양,2770,2766,20200219,5536
20200216,1,양주,4979,4823,20200219,9802
20200216,1,덕계,1329,1208,20200219,2537
20200216,1,덕정,3388,3556,20200219,6944
20200216,1,지행,4239,4151,20200219,8390
20200216,1,동두천중앙,2030,1993,20200219,4023
20200216,1,보산,1468,1478,20200219,2946
20200216,1,동두천,1235,1596,20200219,2831
20200216,1,소요산,2722,2240,20200219,4962
20200217,경원선,이촌,4046,3171,20200220,7217
20200217,경원선,서빙고,1809,1765,20200220,3574
20200217,경원선,한남,4494,4305,20200220,8799
20200217,경원선,옥수,46,41,20200220,87
20200217,경원선,응봉,1861,1542,20200220,3403
20200217,경원선,왕십리,14730,16535,20200220,31265
20200217,경원선,청량리,13900,14630,20200220,28530
20200217,1,외대앞,7980,7869,20200220,15849
20200217,1,신이문,9029,8260,20200220,17289
20200217,1,석계,8663,10033,20200220,18696
20200217,1,광운대,8719,8301,20200220,17020
20200217,1,월계,5718,5363,20200220,11081
20200217,1,녹천,4709,3920,20200220,8629
20200217,1,창동,1,0,20200220,1
20200217,1,방학,9538,9409,20200220,18947
20200217,1,도봉,6012,5636,20200220,11648
20200217,1,도봉산,6850,3923,20200220,10773
20200217,1,망월사,7588,7622,20200220,15210
20200217,1,회룡,12768,12266,20200220,25034
20200217,1,의정부,19344,19282,20200220,38626
20200217,1,가능,6807,6607,20200220,13414
20200217,1,녹양,4966,4576,20200220,9542
20200217,1,양주,8179,7561,20200220,15740
20200217,1,덕계,2376,2073,20200220,4449
20200217,1,덕정,5751,5620,20200220,11371
20200217,1,지행,6613,6508,20200220,13121
20200217,1,동두천중앙,3301,3138,20200220,6439
20200217,1,보산,1647,1914,20200220,3561
20200217,1,동두천,1971,2270,20200220,4241
20200217,1,소요산,2482,1890,20200220,4372
20200218,경원선,이촌,4022,3073,20200221,7095
20200218,경원선,서빙고,1921,1838,20200221,3759
20200218,경원선,한남,4519,4293,20200221,8812
20200218,경원선,옥수,43,29,20200221,72
20200218,경원선,응봉,1832,1553,20200221,3385
20200218,경원선,왕십리,14915,16718,20200221,31633
20200218,경원선,청량리,13406,14493,20200221,27899
20200218,1,외대앞,8077,7881,20200221,15958
20200218,1,신이문,9052,8134,20200221,17186
20200218,1,석계,9051,10273,20200221,19324
20200218,1,광운대,9002,8647,20200221,17649
20200218,1,월계,5692,5427,20200221,11119
20200218,1,녹천,4787,3987,20200221,8774
20200218,1,창동,1,0,20200221,1
20200218,1,방학,9441,9103,20200221,18544
20200218,1,도봉,6013,5677,20200221,11690
20200218,1,도봉산,7198,4201,20200221,11399
20200218,1,망월사,7669,7878,20200221,15547
20200218,1,회룡,12912,12499,20200221,25411
20200218,1,의정부,18996,19488,20200221,38484
20200218,1,가능,6658,6369,20200221,13027
20200218,1,녹양,4873,4662,20200221,9535
20200218,1,양주,8041,7275,20200221,15316
20200218,1,덕계,2302,2011,20200221,4313
20200218,1,덕정,5645,5452,20200221,11097
20200218,1,지행,6452,6254,20200221,12706
20200218,1,동두천중앙,3232,3180,20200221,6412
20200218,1,보산,1489,1339,20200221,2828
20200218,1,동두천,1925,2262,20200221,4187
20200218,1,소요산,2556,2085,20200221,4641
20200219,경원선,이촌,4239,3311,20200222,7550
20200219,경원선,서빙고,1897,1729,20200222,3626
20200219,경원선,한남,4498,4248,20200222,8746
20200219,경원선,옥수,51,26,20200222,77
20200219,경원선,응봉,1820,1556,20200222,3376
20200219,경원선,왕십리,14240,16048,20200222,30288
20200219,경원선,청량리,13861,14893,20200222,28754
20200219,1,외대앞,8460,8281,20200222,16741
20200219,1,신이문,9283,8326,20200222,17609
20200219,1,석계,9292,10238,20200222,19530
20200219,1,광운대,8803,8235,20200222,17038
20200219,1,월계,5966,5553,20200222,11519
20200219,1,녹천,4874,4111,20200222,8985
20200219,1,창동,1,0,20200222,1
20200219,1,방학,9991,9571,20200222,19562
20200219,1,도봉,6191,5854,20200222,12045
20200219,1,도봉산,7590,4439,20200222,12029
20200219,1,망월사,7989,8153,20200222,16142
20200219,1,회룡,13285,12981,20200222,26266
20200219,1,의정부,19657,20322,20200222,39979
20200219,1,가능,6708,6523,20200222,13231
20200219,1,녹양,5055,4851,20200222,9906
20200219,1,양주,8367,7671,20200222,16038
20200219,1,덕계,2436,2073,20200222,4509
20200219,1,덕정,6171,5965,20200222,12136
20200219,1,지행,6733,6623,20200222,13356
20200219,1,동두천중앙,3415,3232,20200222,6647
20200219,1,보산,1526,1398,20200222,2924
20200219,1,동두천,1989,2318,20200222,4307
20200219,1,소요산,2772,2274,20200222,5046
20200220,경원선,이촌,3946,3032,20200223,6978
20200220,경원선,서빙고,1842,1732,20200223,3574
20200220,경원선,한남,4411,4306,20200223,8717
20200220,경원선,옥수,26,43,20200223,69
20200220,경원선,응봉,1810,1555,20200223,3365
20200220,경원선,왕십리,13907,15439,20200223,29346
20200220,경원선,청량리,13565,14726,20200223,28291
20200220,1,외대앞,8387,8002,20200223,16389
20200220,1,신이문,9093,8104,20200223,17197
20200220,1,석계,9089,10160,20200223,19249
20200220,1,광운대,8573,7835,20200223,16408
20200220,1,월계,5911,5518,20200223,11429
20200220,1,녹천,4749,3980,20200223,8729
20200220,1,방학,9693,9505,20200223,19198
20200220,1,도봉,6174,5735,20200223,11909
20200220,1,도봉산,7605,4551,20200223,12156
20200220,1,망월사,7482,7635,20200223,15117
20200220,1,회룡,12979,12501,20200223,25480
20200220,1,의정부,19250,19827,20200223,39077
20200220,1,가능,6563,6343,20200223,12906
20200220,1,녹양,5034,4675,20200223,9709
20200220,1,양주,8157,7506,20200223,15663
20200220,1,덕계,2385,2082,20200223,4467
20200220,1,덕정,5889,5737,20200223,11626
20200220,1,지행,6468,6258,20200223,12726
20200220,1,동두천중앙,3394,3231,20200223,6625
20200220,1,보산,1496,1464,20200223,2960
20200220,1,동두천,2055,2390,20200223,4445
20200220,1,소요산,2736,2345,20200223,5081
20200221,경원선,이촌,3665,2628,20200224,6293
20200221,경원선,서빙고,1458,1156,20200224,2614
20200221,경원선,한남,3616,2943,20200224,6559
20200221,경원선,옥수,53,25,20200224,78
20200221,경원선,응봉,1107,1271,20200224,2378
20200221,경원선,왕십리,13676,15523,20200224,29199
20200221,경원선,청량리,14244,16204,20200224,30448
20200221,1,외대앞,8258,7847,20200224,16105
20200221,1,신이문,8821,7848,20200224,16669
20200221,1,석계,8937,10026,20200224,18963
20200221,1,광운대,8263,7598,20200224,15861
20200221,1,월계,5721,5408,20200224,11129
20200221,1,녹천,4613,3775,20200224,8388
20200221,1,방학,9527,9067,20200224,18594
20200221,1,도봉,5963,5565,20200224,11528
20200221,1,도봉산,6953,4074,20200224,11027
20200221,1,망월사,7100,7195,20200224,14295
20200221,1,회룡,12486,11891,20200224,24377
20200221,1,의정부,18887,20139,20200224,39026
20200221,1,가능,6430,6057,20200224,12487
20200221,1,녹양,4799,4371,20200224,9170
20200221,1,양주,8040,7154,20200224,15194
20200221,1,덕계,2296,2024,20200224,4320
20200221,1,덕정,5527,5287,20200224,10814
20200221,1,지행,6281,6343,20200224,12624
20200221,1,동두천중앙,3069,3038,20200224,6107
20200221,1,보산,1637,1506,20200224,3143
20200221,1,동두천,1943,2333,20200224,4276
20200221,1,소요산,2539,2224,20200224,4763
20200222,경원선,이촌,2383,1782,20200225,4165
20200222,경원선,서빙고,1000,914,20200225,1914
20200222,경원선,한남,2439,2331,20200225,4770
20200222,경원선,옥수,24,19,20200225,43
20200222,경원선,응봉,981,818,20200225,1799
20200222,경원선,왕십리,10260,12060,20200225,22320
20200222,경원선,청량리,10691,11676,20200225,22367
20200222,1,외대앞,5607,5274,20200225,10881
20200222,1,신이문,5319,4822,20200225,10141
20200222,1,석계,5932,6466,20200225,12398
20200222,1,광운대,4965,4769,20200225,9734
20200222,1,월계,3691,3349,20200225,7040
20200222,1,녹천,2725,2237,20200225,4962
20200222,1,방학,6117,5981,20200225,12098
20200222,1,도봉,3678,3381,20200225,7059
20200222,1,도봉산,6155,3813,20200225,9968
20200222,1,망월사,4741,4839,20200225,9580
20200222,1,회룡,7718,7753,20200225,15471
20200222,1,의정부,15440,16377,20200225,31817
20200222,1,가능,4565,4259,20200225,8824
20200222,1,녹양,2984,2867,20200225,5851
20200222,1,양주,5091,4822,20200225,9913
20200222,1,덕계,1431,1276,20200225,2707
20200222,1,덕정,3625,3392,20200225,7017
20200222,1,지행,4345,4398,20200225,8743
20200222,1,동두천중앙,2014,2055,20200225,4069
20200222,1,보산,1361,1404,20200225,2765
20200222,1,동두천,1226,1481,20200225,2707
20200222,1,소요산,2081,1774,20200225,3855
20200223,경원선,이촌,1756,1275,20200226,3031
20200223,경원선,서빙고,974,1066,20200226,2040
20200223,경원선,한남,1613,1607,20200226,3220
20200223,경원선,옥수,19,13,20200226,32
20200223,경원선,응봉,674,598,20200226,1272
20200223,경원선,왕십리,7075,8043,20200226,15118
20200223,경원선,청량리,8165,7922,20200226,16087
20200223,1,외대앞,3969,3836,20200226,7805
20200223,1,신이문,3727,3478,20200226,7205
20200223,1,석계,4055,4436,20200226,8491
20200223,1,광운대,3599,3519,20200226,7118
20200223,1,월계,2624,2373,20200226,4997
20200223,1,녹천,2186,1872,20200226,4058
20200223,1,방학,4567,4311,20200226,8878
20200223,1,도봉,2556,2307,20200226,4863
20200223,1,도봉산,6408,4221,20200226,10629
20200223,1,망월사,3347,3488,20200226,6835
20200223,1,회룡,5317,5284,20200226,10601
20200223,1,의정부,10629,11110,20200226,21739
20200223,1,가능,3135,2880,20200226,6015
20200223,1,녹양,2239,2020,20200226,4259
20200223,1,양주,3639,3545,20200226,7184
20200223,1,덕계,979,879,20200226,1858
20200223,1,덕정,2548,2614,20200226,5162
20200223,1,지행,3101,3032,20200226,6133
20200223,1,동두천중앙,1538,1470,20200226,3008
20200223,1,보산,1092,1061,20200226,2153
20200223,1,동두천,912,1105,20200226,2017
20200223,1,소요산,2328,1997,20200226,4325
20200224,경원선,이촌,3086,2387,20200227,5473
20200224,경원선,서빙고,1477,1401,20200227,2878
20200224,경원선,한남,3860,3661,20200227,7521
20200224,경원선,옥수,26,14,20200227,40
20200224,경원선,응봉,1466,1241,20200227,2707
20200224,경원선,왕십리,11544,13221,20200227,24765
20200224,경원선,청량리,10608,11652,20200227,22260
20200224,1,외대앞,6922,6785,20200227,13707
20200224,1,신이문,7986,7213,20200227,15199
20200224,1,석계,7552,8755,20200227,16307
20200224,1,광운대,7461,6852,20200227,14313
20200224,1,월계,4980,4856,20200227,9836
20200224,1,녹천,4132,3384,20200227,7516
20200224,1,방학,8531,8218,20200227,16749
20200224,1,도봉,5331,5055,20200227,10386
20200224,1,도봉산,6350,3616,20200227,9966
20200224,1,망월사,6196,6337,20200227,12533
20200224,1,회룡,10985,10578,20200227,21563
20200224,1,의정부,15467,15804,20200227,31271
20200224,1,가능,5660,5451,20200227,11111
20200224,1,녹양,4194,4003,20200227,8197
20200224,1,양주,6919,6304,20200227,13223
20200224,1,덕계,2028,1768,20200227,3796
20200224,1,덕정,4606,4659,20200227,9265
20200224,1,지행,5271,5076,20200227,10347
20200224,1,동두천중앙,2734,2599,20200227,5333
20200224,1,보산,1275,1102,20200227,2377
20200224,1,동두천,1508,1783,20200227,3291
20200224,1,소요산,1959,1607,20200227,3566
20200225,경원선,이촌,2720,2109,20200228,4829
20200225,경원선,서빙고,1308,1229,20200228,2537
20200225,경원선,한남,3523,3357,20200228,6880
20200225,경원선,옥수,25,12,20200228,37
20200225,경원선,응봉,1344,1120,20200228,2464
20200225,경원선,왕십리,10785,12064,20200228,22849
20200225,경원선,청량리,8969,10053,20200228,19022
20200225,1,외대앞,6265,6144,20200228,12409
20200225,1,신이문,7367,6678,20200228,14045
20200225,1,석계,6980,7987,20200228,14967
20200225,1,광운대,6868,6229,20200228,13097
20200225,1,월계,4531,4322,20200228,8853
20200225,1,녹천,4001,3338,20200228,7339
20200225,1,방학,7705,7575,20200228,15280
20200225,1,도봉,4884,4617,20200228,9501
20200225,1,도봉산,4826,2566,20200228,7392
20200225,1,망월사,5926,6092,20200228,12018
20200225,1,회룡,9967,9725,20200228,19692
20200225,1,의정부,13807,14168,20200228,27975
20200225,1,가능,5093,5046,20200228,10139
20200225,1,녹양,3795,3591,20200228,7386
20200225,1,양주,6134,5639,20200228,11773
20200225,1,덕계,1756,1559,20200228,3315
20200225,1,덕정,4129,4110,20200228,8239
20200225,1,지행,4563,4529,20200228,9092
20200225,1,동두천중앙,2447,2337,20200228,4784
20200225,1,보산,1102,989,20200228,2091
20200225,1,동두천,1440,1596,20200228,3036
20200225,1,소요산,1232,1019,20200228,2251
20200226,경원선,이촌,2762,2172,20200229,4934
20200226,경원선,서빙고,1355,1230,20200229,2585
20200226,경원선,한남,3575,3374,20200229,6949
20200226,경원선,옥수,27,19,20200229,46
20200226,경원선,응봉,1330,1168,20200229,2498
20200226,경원선,왕십리,11212,12687,20200229,23899
20200226,경원선,청량리,9755,10811,20200229,20566
20200226,1,외대앞,6426,6332,20200229,12758
20200226,1,신이문,7568,6793,20200229,14361
20200226,1,석계,7055,8138,20200229,15193
20200226,1,광운대,6908,6235,20200229,13143
20200226,1,월계,4763,4461,20200229,9224
20200226,1,녹천,3946,3365,20200229,7311
20200226,1,창동,1,0,20200229,1
20200226,1,방학,7922,7712,20200229,15634
20200226,1,도봉,5045,4767,20200229,9812
20200226,1,도봉산,6114,3497,20200229,9611
20200226,1,망월사,6046,6106,20200229,12152
20200226,1,회룡,10262,10066,20200229,20328
20200226,1,의정부,14648,15084,20200229,29732
20200226,1,가능,5308,5145,20200229,10453
20200226,1,녹양,3917,3737,20200229,7654
20200226,1,양주,6422,5862,20200229,12284
20200226,1,덕계,1880,1641,20200229,3521
20200226,1,덕정,4321,4275,20200229,8596
20200226,1,지행,4735,4630,20200229,9365
20200226,1,동두천중앙,2498,2421,20200229,4919
20200226,1,보산,1221,1162,20200229,2383
20200226,1,동두천,1433,1672,20200229,3105
20200226,1,소요산,1749,1474,20200229,3223
20200227,경원선,이촌,2653,2067,20200301,4720
20200227,경원선,서빙고,1379,1240,20200301,2619
20200227,경원선,한남,3496,3282,20200301,6778
20200227,경원선,옥수,26,15,20200301,41
20200227,경원선,응봉,1338,1188,20200301,2526
20200227,경원선,왕십리,10875,11939,20200301,22814
20200227,경원선,청량리,9423,10568,20200301,19991
20200227,1,외대앞,6275,6126,20200301,12401
20200227,1,신이문,7410,6743,20200301,14153
20200227,1,석계,6947,7879,20200301,14826
20200227,1,광운대,6689,6158,20200301,12847
20200227,1,월계,4561,4469,20200301,9030
20200227,1,녹천,3820,3214,20200301,7034
20200227,1,방학,7650,7504,20200301,15154
20200227,1,도봉,4874,4578,20200301,9452
20200227,1,도봉산,6207,3561,20200301,9768
20200227,1,망월사,5765,5875,20200301,11640
20200227,1,회룡,9989,9723,20200301,19712
20200227,1,의정부,14126,14598,20200301,28724
20200227,1,가능,5285,5059,20200301,10344
20200227,1,녹양,3741,3692,20200301,7433
20200227,1,양주,6199,5801,20200301,12000
20200227,1,덕계,1878,1650,20200301,3528
20200227,1,덕정,4326,4195,20200301,8521
20200227,1,지행,4656,4578,20200301,9234
20200227,1,동두천중앙,2372,2289,20200301,4661
20200227,1,보산,1142,1082,20200301,2224
20200227,1,동두천,1483,1717,20200301,3200
20200227,1,소요산,1783,1522,20200301,3305
20200228,경원선,이촌,2481,1960,20200302,4441
20200228,경원선,서빙고,1313,1198,20200302,2511
20200228,경원선,한남,3317,3164,20200302,6481
20200228,경원선,옥수,28,20,20200302,48
20200228,경원선,응봉,1233,1072,20200302,2305
20200228,경원선,왕십리,10680,12277,20200302,22957
20200228,경원선,청량리,9503,10647,20200302,20150
20200228,1,외대앞,6087,5880,20200302,11967
20200228,1,신이문,7074,6333,20200302,13407
20200228,1,석계,6662,7609,20200302,14271
20200228,1,광운대,6502,5862,20200302,12364
20200228,1,월계,4366,4128,20200302,8494
20200228,1,녹천,3772,3145,20200302,6917
20200228,1,창동,1,0,20200302,1
20200228,1,방학,7383,7245,20200302,14628
20200228,1,도봉,4767,4427,20200302,9194
20200228,1,도봉산,5035,2760,20200302,7795
20200228,1,망월사,5632,5672,20200302,11304
20200228,1,회룡,9636,9298,20200302,18934
20200228,1,의정부,13974,15011,20200302,28985
20200228,1,가능,5080,4915,20200302,9995
20200228,1,녹양,3794,3498,20200302,7292
20200228,1,양주,6077,5532,20200302,11609
20200228,1,덕계,1746,1570,20200302,3316
20200228,1,덕정,4098,3944,20200302,8042
20200228,1,지행,4562,4590,20200302,9152
20200228,1,동두천중앙,2258,2226,20200302,4484
20200228,1,보산,1089,990,20200302,2079
20200228,1,동두천,1347,1581,20200302,2928
20200228,1,소요산,1402,1139,20200302,2541
20200229,경원선,이촌,1568,1181,20200303,2749
20200229,경원선,서빙고,684,618,20200303,1302
20200229,경원선,한남,1896,1886,20200303,3782
20200229,경원선,옥수,9,16,20200303,25
20200229,경원선,응봉,726,605,20200303,1331
20200229,경원선,왕십리,7402,8411,20200303,15813
20200229,경원선,청량리,7203,8041,20200303,15244
20200229,1,외대앞,4208,4015,20200303,8223
20200229,1,신이문,4332,3859,20200303,8191
20200229,1,석계,4557,5012,20200303,9569
20200229,1,광운대,3915,3727,20200303,7642
20200229,1,월계,2905,2763,20200303,5668
20200229,1,녹천,2370,1902,20200303,4272
20200229,1,방학,5069,4990,20200303,10059
20200229,1,도봉,3168,2866,20200303,6034
20200229,1,도봉산,5706,3778,20200303,9484
20200229,1,망월사,3669,3773,20200303,7442
20200229,1,회룡,6055,5982,20200303,12037
20200229,1,의정부,11219,11857,20200303,23076
20200229,1,가능,3581,3405,20200303,6986
20200229,1,녹양,2380,2312,20200303,4692
20200229,1,양주,3862,3659,20200303,7521
20200229,1,덕계,1104,1027,20200303,2131
20200229,1,덕정,2798,2616,20200303,5414
20200229,1,지행,3212,3253,20200303,6465
20200229,1,동두천중앙,1718,1650,20200303,3368
20200229,1,보산,877,941,20200303,1818
20200229,1,동두천,1032,1193,20200303,2225
20200229,1,소요산,2041,1775,20200303,3816
20200301,경원선,이촌,947,843,20200304,1790
20200301,경원선,서빙고,478,435,20200304,913
20200301,경원선,한남,1256,1260,20200304,2516
20200301,경원선,옥수,12,6,20200304,18
20200301,경원선,응봉,498,441,20200304,939
20200301,경원선,왕십리,5166,5842,20200304,11008
20200301,경원선,청량리,5751,5707,20200304,11458
20200301,1,외대앞,2939,2816,20200304,5755
20200301,1,신이문,2904,2641,20200304,5545
20200301,1,석계,2991,3241,20200304,6232
20200301,1,광운대,2593,2529,20200304,5122
20200301,1,월계,2164,2011,20200304,4175
20200301,1,녹천,1516,1282,20200304,2798
20200301,1,방학,3709,3491,20200304,7200
20200301,1,도봉,2175,2043,20200304,4218
20200301,1,도봉산,5178,3544,20200304,8722
20200301,1,망월사,2484,2660,20200304,5144
20200301,1,회룡,3955,3965,20200304,7920
20200301,1,의정부,8123,8012,20200304,16135
20200301,1,가능,2469,2352,20200304,4821
20200301,1,녹양,1675,1643,20200304,3318
20200301,1,양주,2638,2657,20200304,5295
20200301,1,덕계,844,730,20200304,1574
20200301,1,덕정,1869,1918,20200304,3787
20200301,1,지행,2260,2210,20200304,4470
20200301,1,동두천중앙,1174,1217,20200304,2391
20200301,1,보산,694,630,20200304,1324
20200301,1,동두천,762,937,20200304,1699
20200301,1,소요산,1983,1635,20200304,3618
20200302,경원선,이촌,2572,2035,20200305,4607
20200302,경원선,서빙고,1402,1258,20200305,2660
20200302,경원선,한남,3340,3232,20200305,6572
20200302,경원선,옥수,32,18,20200305,50
20200302,경원선,응봉,1301,1108,20200305,2409
20200302,경원선,왕십리,10204,11477,20200305,21681
20200302,경원선,청량리,8380,9010,20200305,17390
20200302,1,외대앞,5887,5815,20200305,11702
20200302,1,신이문,7011,6396,20200305,13407
20200302,1,석계,6549,7676,20200305,14225
20200302,1,광운대,6596,5942,20200305,12538
20200302,1,월계,4583,4322,20200305,8905
20200302,1,녹천,3804,3200,20200305,7004
20200302,1,방학,7628,7359,20200305,14987
20200302,1,도봉,4791,4404,20200305,9195
20200302,1,도봉산,5794,3434,20200305,9228
20200302,1,망월사,5470,5675,20200305,11145
20200302,1,회룡,9835,9443,20200305,19278
20200302,1,의정부,14263,14551,20200305,28814
20200302,1,가능,5169,4979,20200305,10148
20200302,1,녹양,3740,3563,20200305,7303
20200302,1,양주,6081,5680,20200305,11761
20200302,1,덕계,1833,1669,20200305,3502
20200302,1,덕정,4378,4353,20200305,8731
20200302,1,지행,4766,4637,20200305,9403
20200302,1,동두천중앙,2500,2354,20200305,4854
20200302,1,보산,1258,1063,20200305,2321
20200302,1,동두천,1420,1665,20200305,3085
20200302,1,소요산,1774,1425,20200305,3199
20200303,경원선,이촌,2477,2029,20200306,4506
20200303,경원선,서빙고,1336,1222,20200306,2558
20200303,경원선,한남,3362,3166,20200306,6528
20200303,경원선,옥수,24,19,20200306,43
20200303,경원선,응봉,1297,1102,20200306,2399
20200303,경원선,왕십리,10192,11333,20200306,21525
20200303,경원선,청량리,8872,9941,20200306,18813
20200303,1,외대앞,5805,5712,20200306,11517
20200303,1,신이문,7127,6460,20200306,13587
20200303,1,석계,6746,7642,20200306,14388
20200303,1,광운대,6465,5975,20200306,12440
20200303,1,월계,4532,4228,20200306,8760
20200303,1,녹천,3732,3114,20200306,6846
20200303,1,창동,1,0,20200306,1
20200303,1,방학,7472,7272,20200306,14744
20200303,1,도봉,4752,4447,20200306,9199
20200303,1,도봉산,5995,3460,20200306,9455
20200303,1,망월사,5426,5638,20200306,11064
20200303,1,회룡,9762,9654,20200306,19416
20200303,1,의정부,14064,14494,20200306,28558
20200303,1,가능,5176,4991,20200306,10167
20200303,1,녹양,3750,3541,20200306,7291
20200303,1,양주,6023,5586,20200306,11609
20200303,1,덕계,1767,1648,20200306,3415
20200303,1,덕정,4187,4160,20200306,8347
20200303,1,지행,4639,4567,20200306,9206
20200303,1,동두천중앙,2419,2336,20200306,4755
20200303,1,보산,1168,1040,20200306,2208
20200303,1,동두천,1455,1698,20200306,3153
20200303,1,소요산,1840,1489,20200306,3329
20200304,경원선,이촌,2526,2029,20200307,4555
20200304,경원선,서빙고,1285,1157,20200307,2442
20200304,경원선,한남,3331,3140,20200307,6471
20200304,경원선,옥수,19,19,20200307,38
20200304,경원선,응봉,1285,1126,20200307,2411
20200304,경원선,왕십리,9822,11302,20200307,21124
20200304,경원선,청량리,8817,9770,20200307,18587
20200304,1,외대앞,5731,5669,20200307,11400
20200304,1,신이문,6902,6387,20200307,13289
20200304,1,석계,6429,7360,20200307,13789
20200304,1,광운대,6410,5940,20200307,12350
20200304,1,월계,4398,4184,20200307,8582
20200304,1,녹천,3727,3134,20200307,6861
20200304,1,방학,7212,6928,20200307,14140
20200304,1,도봉,4604,4421,20200307,9025
20200304,1,도봉산,5506,3062,20200307,8568
20200304,1,망월사,5392,5557,20200307,10949
20200304,1,회룡,9443,9230,20200307,18673
20200304,1,의정부,13868,14360,20200307,28228
20200304,1,가능,5055,4871,20200307,9926
20200304,1,녹양,3614,3489,20200307,7103
20200304,1,양주,5855,5619,20200307,11474
20200304,1,덕계,1803,1589,20200307,3392
20200304,1,덕정,4205,4106,20200307,8311
20200304,1,지행,4594,4488,20200307,9082
20200304,1,동두천중앙,2293,2241,20200307,4534
20200304,1,보산,1164,1050,20200307,2214
20200304,1,동두천,1423,1574,20200307,2997
20200304,1,소요산,1551,1244,20200307,2795
20200305,경원선,이촌,2577,2052,20200308,4629
20200305,경원선,서빙고,1316,1229,20200308,2545
20200305,경원선,한남,3392,3266,20200308,6658
20200305,경원선,옥수,27,22,20200308,49
20200305,경원선,응봉,1281,1068,20200308,2349
20200305,경원선,왕십리,10378,11477,20200308,21855
20200305,경원선,청량리,8836,9886,20200308,18722
20200305,1,외대앞,5519,5465,20200308,10984
20200305,1,신이문,6886,6277,20200308,13163
20200305,1,석계,6562,7424,20200308,13986
20200305,1,광운대,6450,5996,20200308,12446
20200305,1,월계,4445,4284,20200308,8729
20200305,1,녹천,3740,3169,20200308,6909
20200305,1,방학,7286,7050,20200308,14336
20200305,1,도봉,4620,4398,20200308,9018
20200305,1,도봉산,5794,3319,20200308,9113
20200305,1,망월사,5418,5501,20200308,10919
20200305,1,회룡,9556,9504,20200308,19060
20200305,1,의정부,14367,14613,20200308,28980
20200305,1,가능,5067,4872,20200308,9939
20200305,1,녹양,3680,3523,20200308,7203
20200305,1,양주,6049,5694,20200308,11743
20200305,1,덕계,1863,1622,20200308,3485
20200305,1,덕정,4283,4252,20200308,8535
20200305,1,지행,4659,4549,20200308,9208
20200305,1,동두천중앙,2367,2334,20200308,4701
20200305,1,보산,1179,1040,20200308,2219
20200305,1,동두천,1443,1654,20200308,3097
20200305,1,소요산,1739,1395,20200308,3134
20200306,경원선,이촌,2602,1936,20200309,4538
20200306,경원선,서빙고,1362,1233,20200309,2595
20200306,경원선,한남,3367,3228,20200309,6595
20200306,경원선,옥수,42,24,20200309,66
20200306,경원선,응봉,1301,1115,20200309,2416
20200306,경원선,왕십리,11056,12643,20200309,23699
20200306,경원선,청량리,10183,11252,20200309,21435
20200306,1,외대앞,5853,5706,20200309,11559
20200306,1,신이문,7118,6346,20200309,13464
20200306,1,석계,6880,7808,20200309,14688
20200306,1,광운대,6796,6081,20200309,12877
20200306,1,월계,4656,4379,20200309,9035
20200306,1,녹천,3816,3122,20200309,6938
20200306,1,방학,7484,7275,20200309,14759
20200306,1,도봉,4881,4659,20200309,9540
20200306,1,도봉산,6220,3648,20200309,9868
20200306,1,망월사,5626,5771,20200309,11397
20200306,1,회룡,9925,9554,20200309,19479
20200306,1,의정부,14830,16132,20200309,30962
20200306,1,가능,5239,5002,20200309,10241
20200306,1,녹양,3876,3545,20200309,7421
20200306,1,양주,6275,5705,20200309,11980
20200306,1,덕계,1928,1662,20200309,3590
20200306,1,덕정,4481,4281,20200309,8762
20200306,1,지행,5013,4955,20200309,9968
20200306,1,동두천중앙,2480,2412,20200309,4892
20200306,1,보산,1259,1127,20200309,2386
20200306,1,동두천,1454,1721,20200309,3175
20200306,1,소요산,1888,1562,20200309,3450
20200307,경원선,이촌,1755,1316,20200310,3071
20200307,경원선,서빙고,769,660,20200310,1429
20200307,경원선,한남,2076,2018,20200310,4094
20200307,경원선,옥수,17,15,20200310,32
20200307,경원선,응봉,871,740,20200310,1611
20200307,경원선,왕십리,7993,9264,20200310,17257
20200307,경원선,청량리,7762,8507,20200310,16269
20200307,1,외대앞,4095,3794,20200310,7889
20200307,1,신이문,4382,3922,20200310,8304
20200307,1,석계,4718,5100,20200310,9818
20200307,1,광운대,3933,3857,20200310,7790
20200307,1,월계,3161,2865,20200310,6026
20200307,1,녹천,2413,1984,20200310,4397
20200307,1,방학,5147,5196,20200310,10343
20200307,1,도봉,3173,2977,20200310,6150
20200307,1,도봉산,6243,4168,20200310,10411
20200307,1,망월사,3772,3814,20200310,7586
20200307,1,회룡,6133,6247,20200310,12380
20200307,1,의정부,11842,12798,20200310,24640
20200307,1,가능,3678,3512,20200310,7190
20200307,1,녹양,2521,2385,20200310,4906
20200307,1,양주,4054,3837,20200310,7891
20200307,1,덕계,1246,1145,20200310,2391
20200307,1,덕정,3023,2849,20200310,5872
20200307,1,지행,3400,3507,20200310,6907
20200307,1,동두천중앙,1820,1841,20200310,3661
20200307,1,보산,908,878,20200310,1786
20200307,1,동두천,1042,1280,20200310,2322
20200307,1,소요산,2244,1942,20200310,4186
20200308,경원선,이촌,1196,991,20200311,2187
20200308,경원선,서빙고,555,550,20200311,1105
20200308,경원선,한남,1430,1433,20200311,2863
20200308,경원선,옥수,23,8,20200311,31
20200308,경원선,응봉,672,608,20200311,1280
20200308,경원선,왕십리,5358,6015,20200311,11373
20200308,경원선,청량리,6246,6290,20200311,12536
20200308,1,외대앞,2964,2880,20200311,5844
20200308,1,신이문,3003,2772,20200311,5775
20200308,1,석계,3384,3709,20200311,7093
20200308,1,광운대,2910,2886,20200311,5796
20200308,1,월계,2368,2174,20200311,4542
20200308,1,녹천,1778,1427,20200311,3205
20200308,1,방학,3737,3569,20200311,7306
20200308,1,도봉,2508,2280,20200311,4788
20200308,1,도봉산,6893,4861,20200311,11754
20200308,1,망월사,2919,3031,20200311,5950
20200308,1,회룡,4531,4483,20200311,9014
20200308,1,의정부,9371,9178,20200311,18549
20200308,1,가능,2732,2509,20200311,5241
20200308,1,녹양,1847,1718,20200311,3565
20200308,1,양주,3248,3233,20200311,6481
20200308,1,덕계,931,832,20200311,1763
20200308,1,덕정,2118,2166,20200311,4284
20200308,1,지행,2582,2606,20200311,5188
20200308,1,동두천중앙,1365,1338,20200311,2703
20200308,1,보산,801,689,20200311,1490
20200308,1,동두천,799,1106,20200311,1905
20200308,1,소요산,2650,2229,20200311,4879
20200309,경원선,이촌,2858,2119,20200312,4977
20200309,경원선,서빙고,1388,1270,20200312,2658
20200309,경원선,한남,3518,3448,20200312,6966
20200309,경원선,옥수,28,24,20200312,52
20200309,경원선,응봉,1390,1189,20200312,2579
20200309,경원선,왕십리,10814,12069,20200312,22883
20200309,경원선,청량리,9037,9812,20200312,18849
20200309,1,외대앞,5896,5771,20200312,11667
20200309,1,신이문,7068,6405,20200312,13473
20200309,1,석계,6915,7913,20200312,14828
20200309,1,광운대,6774,6261,20200312,13035
20200309,1,월계,4611,4406,20200312,9017
20200309,1,녹천,3947,3271,20200312,7218
20200309,1,방학,7700,7516,20200312,15216
20200309,1,도봉,5020,4666,20200312,9686
20200309,1,도봉산,6236,3624,20200312,9860
20200309,1,망월사,5738,5839,20200312,11577
20200309,1,회룡,10111,9833,20200312,19944
20200309,1,의정부,14743,15263,20200312,30006
20200309,1,가능,5422,5160,20200312,10582
20200309,1,녹양,3867,3686,20200312,7553
20200309,1,양주,6495,6055,20200312,12550
20200309,1,덕계,2011,1757,20200312,3768
20200309,1,덕정,4607,4546,20200312,9153
20200309,1,지행,5051,4927,20200312,9978
20200309,1,동두천중앙,2592,2477,20200312,5069
20200309,1,보산,1312,1116,20200312,2428
20200309,1,동두천,1532,1881,20200312,3413
20200309,1,소요산,2091,1669,20200312,3760
20200310,경원선,이촌,2532,1976,20200313,4508
20200310,경원선,서빙고,1342,1135,20200313,2477
20200310,경원선,한남,3224,3089,20200313,6313
20200310,경원선,옥수,34,18,20200313,52
20200310,경원선,응봉,1258,1054,20200313,2312
20200310,경원선,왕십리,10219,11610,20200313,21829
20200310,경원선,청량리,8551,9416,20200313,17967
20200310,1,외대앞,5550,5448,20200313,10998
20200310,1,신이문,6811,6190,20200313,13001
20200310,1,석계,6463,7380,20200313,13843
20200310,1,광운대,6332,5816,20200313,12148
20200310,1,월계,4253,4113,20200313,8366
20200310,1,녹천,3660,3071,20200313,6731
20200310,1,방학,7226,7047,20200313,14273
20200310,1,도봉,4532,4238,20200313,8770
20200310,1,도봉산,4708,2516,20200313,7224
20200310,1,망월사,5305,5415,20200313,10720
20200310,1,회룡,9022,8637,20200313,17659
20200310,1,의정부,13323,13534,20200313,26857
20200310,1,가능,4896,4793,20200313,9689
20200310,1,녹양,3545,3407,20200313,6952
20200310,1,양주,5865,5528,20200313,11393
20200310,1,덕계,1764,1559,20200313,3323
20200310,1,덕정,4211,4163,20200313,8374
20200310,1,지행,4578,4498,20200313,9076
20200310,1,동두천중앙,2241,2240,20200313,4481
20200310,1,보산,1101,980,20200313,2081
20200310,1,동두천,1377,1596,20200313,2973
20200310,1,소요산,1336,1067,20200313,2403
20200311,경원선,이촌,2729,2099,20200314,4828
20200311,경원선,서빙고,1301,1193,20200314,2494
20200311,경원선,한남,3425,3278,20200314,6703
20200311,경원선,옥수,32,22,20200314,54
20200311,경원선,응봉,1373,1174,20200314,2547
20200311,경원선,왕십리,10677,12077,20200314,22754
20200311,경원선,청량리,9311,10441,20200314,19752
20200311,1,외대앞,5701,5615,20200314,11316
20200311,1,신이문,6967,6339,20200314,13306
20200311,1,석계,6685,7809,20200314,14494
20200311,1,광운대,6610,6062,20200314,12672
20200311,1,월계,4503,4289,20200314,8792
20200311,1,녹천,3845,3222,20200314,7067
20200311,1,방학,7591,7350,20200314,14941
20200311,1,도봉,4871,4656,20200314,9527
20200311,1,도봉산,6357,3812,20200314,10169
20200311,1,망월사,5444,5561,20200314,11005
20200311,1,회룡,9073,8866,20200314,17939
20200311,1,의정부,13802,14488,20200314,28290
20200311,1,가능,5143,4918,20200314,10061
20200311,1,녹양,3633,3471,20200314,7104
20200311,1,양주,6178,5813,20200314,11991
20200311,1,덕계,1886,1635,20200314,3521
20200311,1,덕정,4348,4234,20200314,8582
20200311,1,지행,4762,4634,20200314,9396
20200311,1,동두천중앙,2446,2371,20200314,4817
20200311,1,보산,1192,1100,20200314,2292
20200311,1,동두천,1491,1743,20200314,3234
20200311,1,소요산,1905,1538,20200314,3443
20200312,경원선,이촌,2692,2058,20200315,4750
20200312,경원선,서빙고,1351,1242,20200315,2593
20200312,경원선,한남,3643,3465,20200315,7108
20200312,경원선,옥수,36,21,20200315,57
20200312,경원선,응봉,1253,1115,20200315,2368
20200312,경원선,왕십리,10572,11715,20200315,22287
20200312,경원선,청량리,9271,10142,20200315,19413
20200312,1,외대앞,5699,5638,20200315,11337
20200312,1,신이문,6885,6282,20200315,13167
20200312,1,석계,6542,7575,20200315,14117
20200312,1,광운대,6488,5892,20200315,12380
20200312,1,월계,4447,4292,20200315,8739
20200312,1,녹천,3726,3083,20200315,6809
20200312,1,방학,7352,7191,20200315,14543
20200312,1,도봉,4720,4500,20200315,9220
20200312,1,도봉산,6117,3692,20200315,9809
20200312,1,망월사,5391,5524,20200315,10915
20200312,1,회룡,9019,8816,20200315,17835
20200312,1,의정부,13665,13974,20200315,27639
20200312,1,가능,5016,4818,20200315,9834
20200312,1,녹양,3591,3489,20200315,7080
20200312,1,양주,6019,5534,20200315,11553
20200312,1,덕계,1824,1615,20200315,3439
20200312,1,덕정,4347,4271,20200315,8618
20200312,1,지행,4615,4638,20200315,9253
20200312,1,동두천중앙,2344,2251,20200315,4595
20200312,1,보산,1143,1028,20200315,2171
20200312,1,동두천,1465,1695,20200315,3160
20200312,1,소요산,1851,1494,20200315,3345
20200313,경원선,이촌,2660,2044,20200316,4704
20200313,경원선,서빙고,1331,1201,20200316,2532
20200313,경원선,한남,3572,3392,20200316,6964
20200313,경원선,옥수,44,19,20200316,63
20200313,경원선,응봉,1314,1084,20200316,2398
20200313,경원선,왕십리,11197,12888,20200316,24085
20200313,경원선,청량리,10429,11308,20200316,21737
20200313,1,외대앞,5855,5630,20200316,11485
20200313,1,신이문,6944,6274,20200316,13218
20200313,1,석계,6724,7526,20200316,14250
20200313,1,광운대,6637,6074,20200316,12711
20200313,1,월계,4591,4339,20200316,8930
20200313,1,녹천,3777,3019,20200316,6796
20200313,1,창동,2,0,20200316,2
20200313,1,방학,7548,7227,20200316,14775
20200313,1,도봉,4816,4571,20200316,9387
20200313,1,도봉산,6173,3465,20200316,9638
20200313,1,망월사,5488,5586,20200316,11074
20200313,1,회룡,9278,8938,20200316,18216
20200313,1,의정부,14204,15215,20200316,29419
20200313,1,가능,5137,4809,20200316,9946
20200313,1,녹양,3637,3399,20200316,7036
20200313,1,양주,6119,5642,20200316,11761
20200313,1,덕계,1894,1673,20200316,3567
20200313,1,덕정,4339,4284,20200316,8623
20200313,1,지행,4845,4815,20200316,9660
20200313,1,동두천중앙,2407,2265,20200316,4672
20200313,1,보산,1128,1114,20200316,2242
20200313,1,동두천,1463,1638,20200316,3101
20200313,1,소요산,1808,1529,20200316,3337
20200314,경원선,이촌,1823,1424,20200317,3247
20200314,경원선,서빙고,754,692,20200317,1446
20200314,경원선,한남,2118,2039,20200317,4157
20200314,경원선,옥수,15,18,20200317,33
20200314,경원선,응봉,913,751,20200317,1664
20200314,경원선,왕십리,8395,9798,20200317,18193
20200314,경원선,청량리,8153,8799,20200317,16952
20200314,1,외대앞,4250,4125,20200317,8375
20200314,1,신이문,4364,3891,20200317,8255
20200314,1,석계,4945,5272,20200317,10217
20200314,1,광운대,4071,3948,20200317,8019
20200314,1,월계,3161,2875,20200317,6036
20200314,1,녹천,2439,1969,20200317,4408
20200314,1,방학,5256,5023,20200317,10279
20200314,1,도봉,3142,2903,20200317,6045
20200314,1,도봉산,6659,4377,20200317,11036
20200314,1,망월사,3828,4081,20200317,7909
20200314,1,회룡,6167,6072,20200317,12239
20200314,1,의정부,11622,12197,20200317,23819
20200314,1,가능,3652,3461,20200317,7113
20200314,1,녹양,2397,2343,20200317,4740
20200314,1,양주,4157,4082,20200317,8239
20200314,1,덕계,1147,1129,20200317,2276
20200314,1,덕정,2987,2924,20200317,5911
20200314,1,지행,3522,3489,20200317,7011
20200314,1,동두천중앙,1736,1731,20200317,3467
20200314,1,보산,961,953,20200317,1914
20200314,1,동두천,1048,1310,20200317,2358
20200314,1,소요산,2185,1869,20200317,4054
20200315,경원선,이촌,1107,890,20200318,1997
20200315,경원선,서빙고,471,504,20200318,975
20200315,경원선,한남,1320,1327,20200318,2647
20200315,경원선,옥수,28,10,20200318,38
20200315,경원선,응봉,638,595,20200318,1233
20200315,경원선,왕십리,5912,6847,20200318,12759
20200315,경원선,청량리,6685,6601,20200318,13286
20200315,1,외대앞,3004,2945,20200318,5949
20200315,1,신이문,3005,2735,20200318,5740
20200315,1,석계,3202,3587,20200318,6789
20200315,1,광운대,2722,2840,20200318,5562
20200315,1,월계,2231,2104,20200318,4335
20200315,1,녹천,1619,1332,20200318,2951
20200315,1,방학,3765,3591,20200318,7356
20200315,1,도봉,2295,2065,20200318,4360
20200315,1,도봉산,6050,4140,20200318,10190
20200315,1,망월사,2699,2827,20200318,5526
20200315,1,회룡,4165,4182,20200318,8347
20200315,1,의정부,8455,8270,20200318,16725
20200315,1,가능,2579,2422,20200318,5001
20200315,1,녹양,1696,1617,20200318,3313
20200315,1,양주,3020,3012,20200318,6032
20200315,1,덕계,878,769,20200318,1647
20200315,1,덕정,2057,2093,20200318,4150
20200315,1,지행,2454,2416,20200318,4870
20200315,1,동두천중앙,1391,1326,20200318,2717
20200315,1,보산,722,671,20200318,1393
20200315,1,동두천,792,987,20200318,1779
20200315,1,소요산,2158,1758,20200318,3916
20200316,경원선,이촌,2722,2130,20200319,4852
20200316,경원선,서빙고,1338,1200,20200319,2538
20200316,경원선,한남,3518,3240,20200319,6758
20200316,경원선,옥수,33,24,20200319,57
20200316,경원선,응봉,1294,1110,20200319,2404
20200316,경원선,왕십리,10422,11733,20200319,22155
20200316,경원선,청량리,9527,10395,20200319,19922
20200316,1,외대앞,5883,5924,20200319,11807
20200316,1,신이문,7212,6487,20200319,13699
20200316,1,석계,6878,7811,20200319,14689
20200316,1,광운대,6720,6202,20200319,12922
20200316,1,월계,4629,4376,20200319,9005
20200316,1,녹천,3793,3167,20200319,6960
20200316,1,방학,7653,7457,20200319,15110
20200316,1,도봉,4837,4570,20200319,9407
20200316,1,도봉산,6195,3679,20200319,9874
20200316,1,망월사,5519,5661,20200319,11180
20200316,1,회룡,9619,9327,20200319,18946
20200316,1,의정부,13479,13859,20200319,27338
20200316,1,가능,5207,4979,20200319,10186
20200316,1,녹양,3697,3569,20200319,7266
20200316,1,양주,6111,5749,20200319,11860
20200316,1,덕계,1903,1643,20200319,3546
20200316,1,덕정,4485,4452,20200319,8937
20200316,1,지행,4880,4715,20200319,9595
20200316,1,동두천중앙,2433,2296,20200319,4729
20200316,1,보산,1253,1091,20200319,2344
20200316,1,동두천,1433,1705,20200319,3138
20200316,1,소요산,1992,1558,20200319,3550
20200317,경원선,이촌,2649,2058,20200320,4707
20200317,경원선,서빙고,1287,1176,20200320,2463
20200317,경원선,한남,3432,3173,20200320,6605
20200317,경원선,옥수,33,18,20200320,51
20200317,경원선,응봉,1312,1110,20200320,2422
20200317,경원선,왕십리,10361,11819,20200320,22180
20200317,경원선,청량리,9307,10082,20200320,19389
20200317,1,외대앞,5869,5838,20200320,11707
20200317,1,신이문,7093,6376,20200320,13469
20200317,1,석계,6737,7646,20200320,14383
20200317,1,광운대,6595,6070,20200320,12665
20200317,1,월계,4576,4370,20200320,8946
20200317,1,녹천,3812,3201,20200320,7013
20200317,1,방학,7532,7226,20200320,14758
20200317,1,도봉,4837,4590,20200320,9427
20200317,1,도봉산,5615,3152,20200320,8767
20200317,1,망월사,5584,5682,20200320,11266
20200317,1,회룡,9459,9407,20200320,18866
20200317,1,의정부,14004,14302,20200320,28306
20200317,1,가능,5130,4988,20200320,10118
20200317,1,녹양,3591,3445,20200320,7036
20200317,1,양주,6037,5626,20200320,11663
20200317,1,덕계,1913,1659,20200320,3572
20200317,1,덕정,4562,4502,20200320,9064
20200317,1,지행,4810,4698,20200320,9508
20200317,1,동두천중앙,2338,2232,20200320,4570
20200317,1,보산,1106,1024,20200320,2130
20200317,1,동두천,1439,1683,20200320,3122
20200317,1,소요산,1716,1369,20200320,3085
20200318,경원선,이촌,2905,2240,20200321,5145
20200318,경원선,서빙고,1303,1190,20200321,2493
20200318,경원선,한남,3510,3259,20200321,6769
20200318,경원선,옥수,36,25,20200321,61
20200318,경원선,응봉,1398,1170,20200321,2568
20200318,경원선,왕십리,10846,12297,20200321,23143
20200318,경원선,청량리,9862,10813,20200321,20675
20200318,1,외대앞,6027,6004,20200321,12031
20200318,1,신이문,7293,6554,20200321,13847
20200318,1,석계,6980,7853,20200321,14833
20200318,1,광운대,6797,6191,20200321,12988
20200318,1,월계,4724,4491,20200321,9215
20200318,1,녹천,3988,3334,20200321,7322
20200318,1,방학,7735,7449,20200321,15184
20200318,1,도봉,5220,4847,20200321,10067
20200318,1,도봉산,6828,4223,20200321,11051
20200318,1,망월사,5831,5945,20200321,11776
20200318,1,회룡,9878,9576,20200321,19454
20200318,1,의정부,14280,14684,20200321,28964
20200318,1,가능,5286,5086,20200321,10372
20200318,1,녹양,3758,3616,20200321,7374
20200318,1,양주,6369,5881,20200321,12250
20200318,1,덕계,1906,1729,20200321,3635
20200318,1,덕정,4538,4456,20200321,8994
20200318,1,지행,4959,4892,20200321,9851
20200318,1,동두천중앙,2574,2389,20200321,4963
20200318,1,보산,1206,1084,20200321,2290
20200318,1,동두천,1517,1816,20200321,3333
20200318,1,소요산,2232,1864,20200321,4096
20200319,경원선,이촌,2586,2033,20200322,4619
20200319,경원선,서빙고,1312,1210,20200322,2522
20200319,경원선,한남,3252,3083,20200322,6335
20200319,경원선,옥수,31,23,20200322,54
20200319,경원선,응봉,1232,1092,20200322,2324
20200319,경원선,왕십리,10590,11596,20200322,22186
20200319,경원선,청량리,8835,9723,20200322,18558
20200319,1,외대앞,5646,5585,20200322,11231
20200319,1,신이문,6878,6262,20200322,13140
20200319,1,석계,6471,7345,20200322,13816
20200319,1,광운대,6338,5908,20200322,12246
20200319,1,월계,4431,4178,20200322,8609
20200319,1,녹천,3727,3071,20200322,6798
20200319,1,방학,7128,6979,20200322,14107
20200319,1,도봉,4719,4497,20200322,9216
20200319,1,도봉산,5136,2787,20200322,7923
20200319,1,망월사,5408,5538,20200322,10946
20200319,1,회룡,9282,8982,20200322,18264
20200319,1,의정부,13359,13659,20200322,27018
20200319,1,가능,4957,4843,20200322,9800
20200319,1,녹양,3518,3403,20200322,6921
20200319,1,양주,5784,5456,20200322,11240
20200319,1,덕계,1783,1557,20200322,3340
20200319,1,덕정,4129,4164,20200322,8293
20200319,1,지행,4642,4501,20200322,9143
20200319,1,동두천중앙,2238,2172,20200322,4410
20200319,1,보산,1083,1004,20200322,2087
20200319,1,동두천,1384,1573,20200322,2957
20200319,1,소요산,1424,1174,20200322,2598
20200320,경원선,이촌,2993,2278,20200323,5271
20200320,경원선,서빙고,1420,1267,20200323,2687
20200320,경원선,한남,3509,3390,20200323,6899
20200320,경원선,옥수,47,17,20200323,64
20200320,경원선,응봉,1444,1178,20200323,2622
20200320,경원선,왕십리,12083,13558,20200323,25641
20200320,경원선,청량리,11319,12531,20200323,23850
20200320,1,외대앞,6575,6285,20200323,12860
20200320,1,신이문,7580,6681,20200323,14261
20200320,1,석계,7252,8077,20200323,15329
20200320,1,광운대,7094,6463,20200323,13557
20200320,1,월계,4963,4699,20200323,9662
20200320,1,녹천,3959,3154,20200323,7113
20200320,1,방학,8082,7695,20200323,15777
20200320,1,도봉,5068,4819,20200323,9887
20200320,1,도봉산,7001,4170,20200323,11171
20200320,1,망월사,5901,5970,20200323,11871
20200320,1,회룡,10222,9826,20200323,20048
20200320,1,의정부,15413,16489,20200323,31902
20200320,1,가능,5436,5260,20200323,10696
20200320,1,녹양,3910,3638,20200323,7548
20200320,1,양주,6638,6184,20200323,12822
20200320,1,덕계,1985,1722,20200323,3707
20200320,1,덕정,4743,4566,20200323,9309
20200320,1,지행,5253,5223,20200323,10476
20200320,1,동두천중앙,2688,2669,20200323,5357
20200320,1,보산,1285,1119,20200323,2404
20200320,1,동두천,1582,1887,20200323,3469
20200320,1,소요산,2172,1825,20200323,3997
20200321,경원선,이촌,2184,1453,20200324,3637
20200321,경원선,서빙고,845,757,20200324,1602
20200321,경원선,한남,2137,1986,20200324,4123
20200321,경원선,옥수,20,26,20200324,46
20200321,경원선,응봉,995,917,20200324,1912
20200321,경원선,왕십리,8705,9751,20200324,18456
20200321,경원선,청량리,9094,9890,20200324,18984
20200321,1,외대앞,4502,4246,20200324,8748
20200321,1,신이문,4687,4247,20200324,8934
20200321,1,석계,5139,5661,20200324,10800
20200321,1,광운대,4419,4198,20200324,8617
20200321,1,월계,3543,3185,20200324,6728
20200321,1,녹천,2563,2104,20200324,4667
20200321,1,방학,5602,5477,20200324,11079
20200321,1,도봉,3407,3131,20200324,6538
20200321,1,도봉산,7262,5092,20200324,12354
20200321,1,망월사,4075,4214,20200324,8289
20200321,1,회룡,6673,6641,20200324,13314
20200321,1,의정부,12033,12978,20200324,25011
20200321,1,가능,4015,3754,20200324,7769
20200321,1,녹양,2638,2618,20200324,5256
20200321,1,양주,4479,4393,20200324,8872
20200321,1,덕계,1307,1176,20200324,2483
20200321,1,덕정,3152,2972,20200324,6124
20200321,1,지행,3816,3714,20200324,7530
20200321,1,동두천중앙,1940,1937,20200324,3877
20200321,1,보산,939,974,20200324,1913
20200321,1,동두천,1056,1357,20200324,2413
20200321,1,소요산,2646,2324,20200324,4970
20200322,경원선,이촌,1432,1044,20200325,2476
20200322,경원선,서빙고,601,591,20200325,1192
20200322,경원선,한남,1420,1411,20200325,2831
20200322,경원선,옥수,32,17,20200325,49
20200322,경원선,응봉,878,839,20200325,1717
20200322,경원선,왕십리,5875,6667,20200325,12542
20200322,경원선,청량리,7420,7209,20200325,14629
20200322,1,외대앞,3185,3153,20200325,6338
20200322,1,신이문,3350,2993,20200325,6343
20200322,1,석계,3507,3866,20200325,7373
20200322,1,광운대,3084,3035,20200325,6119
20200322,1,월계,2401,2150,20200325,4551
20200322,1,녹천,1890,1534,20200325,3424
20200322,1,방학,3924,3764,20200325,7688
20200322,1,도봉,2534,2302,20200325,4836
20200322,1,도봉산,7758,5290,20200325,13048
20200322,1,망월사,2945,3246,20200325,6191
20200322,1,회룡,4618,4607,20200325,9225
20200322,1,의정부,9186,9187,20200325,18373
20200322,1,가능,2871,2685,20200325,5556
20200322,1,녹양,1899,1885,20200325,3784
20200322,1,양주,3455,3352,20200325,6807
20200322,1,덕계,975,854,20200325,1829
20200322,1,덕정,2310,2431,20200325,4741
20200322,1,지행,2830,2705,20200325,5535
20200322,1,동두천중앙,1433,1379,20200325,2812
20200322,1,보산,815,750,20200325,1565
20200322,1,동두천,905,1198,20200325,2103
20200322,1,소요산,2971,2490,20200325,5461
20200323,경원선,이촌,2874,2190,20200326,5064
20200323,경원선,서빙고,1377,1286,20200326,2663
20200323,경원선,한남,3511,3287,20200326,6798
20200323,경원선,옥수,26,18,20200326,44
20200323,경원선,응봉,1503,1367,20200326,2870
20200323,경원선,왕십리,10619,12063,20200326,22682
20200323,경원선,청량리,10044,10809,20200326,20853
20200323,1,외대앞,5974,6024,20200326,11998
20200323,1,신이문,7314,6592,20200326,13906
20200323,1,석계,6921,8043,20200326,14964
20200323,1,광운대,6903,6507,20200326,13410
20200323,1,월계,4851,4467,20200326,9318
20200323,1,녹천,3916,3295,20200326,7211
20200323,1,방학,7901,7757,20200326,15658
20200323,1,도봉,4971,4698,20200326,9669
20200323,1,도봉산,6655,4064,20200326,10719
20200323,1,망월사,5720,5878,20200326,11598
20200323,1,회룡,10051,9644,20200326,19695
20200323,1,의정부,14763,14942,20200326,29705
20200323,1,가능,5323,5064,20200326,10387
20200323,1,녹양,3858,3652,20200326,7510
20200323,1,양주,6565,6085,20200326,12650
20200323,1,덕계,1991,1760,20200326,3751
20200323,1,덕정,4522,4498,20200326,9020
20200323,1,지행,5008,4837,20200326,9845
20200323,1,동두천중앙,2594,2496,20200326,5090
20200323,1,보산,1278,1133,20200326,2411
20200323,1,동두천,1496,1801,20200326,3297
20200323,1,소요산,2178,1740,20200326,3918
20200324,경원선,이촌,2815,2061,20200327,4876
20200324,경원선,서빙고,1412,1293,20200327,2705
20200324,경원선,한남,3473,3208,20200327,6681
20200324,경원선,옥수,31,17,20200327,48
20200324,경원선,응봉,1614,1525,20200327,3139
20200324,경원선,왕십리,10838,12329,20200327,23167
20200324,경원선,청량리,9932,10951,20200327,20883
20200324,1,외대앞,6026,5912,20200327,11938
20200324,1,신이문,7245,6592,20200327,13837
20200324,1,석계,7078,8094,20200327,15172
20200324,1,광운대,6806,6235,20200327,13041
20200324,1,월계,4780,4528,20200327,9308
20200324,1,녹천,3966,3267,20200327,7233
20200324,1,방학,7821,7657,20200327,15478
20200324,1,도봉,5063,4908,20200327,9971
20200324,1,도봉산,6832,4339,20200327,11171
20200324,1,망월사,5722,5869,20200327,11591
20200324,1,회룡,10081,9834,20200327,19915
20200324,1,의정부,14228,14791,20200327,29019
20200324,1,가능,5376,5178,20200327,10554
20200324,1,녹양,3858,3649,20200327,7507
20200324,1,양주,6467,6017,20200327,12484
20200324,1,덕계,1952,1741,20200327,3693
20200324,1,덕정,4561,4414,20200327,8975
20200324,1,지행,4980,4877,20200327,9857
20200324,1,동두천중앙,2564,2484,20200327,5048
20200324,1,보산,1228,1107,20200327,2335
20200324,1,동두천,1517,1782,20200327,3299
20200324,1,소요산,2263,1914,20200327,4177
20200325,경원선,이촌,2994,2223,20200328,5217
20200325,경원선,서빙고,1404,1308,20200328,2712
20200325,경원선,한남,3399,3195,20200328,6594
20200325,경원선,옥수,28,13,20200328,41
20200325,경원선,응봉,1630,1542,20200328,3172
20200325,경원선,왕십리,11291,12617,20200328,23908
20200325,경원선,청량리,10321,11323,20200328,21644
20200325,1,외대앞,6010,5852,20200328,11862
20200325,1,신이문,7514,6805,20200328,14319
20200325,1,석계,7038,8200,20200328,15238
20200325,1,광운대,6916,6534,20200328,13450
20200325,1,월계,4973,4572,20200328,9545
20200325,1,녹천,3930,3289,20200328,7219
20200325,1,방학,7959,7851,20200328,15810
20200325,1,도봉,5133,4877,20200328,10010
20200325,1,도봉산,7035,4265,20200328,11300
20200325,1,망월사,5819,5943,20200328,11762
20200325,1,회룡,10372,10044,20200328,20416
20200325,1,의정부,14645,15286,20200328,29931
20200325,1,가능,5492,5276,20200328,10768
20200325,1,녹양,3894,3714,20200328,7608
20200325,1,양주,6439,5982,20200328,12421
20200325,1,덕계,2041,1757,20200328,3798
20200325,1,덕정,4573,4452,20200328,9025
20200325,1,지행,5088,4914,20200328,10002
20200325,1,동두천중앙,2670,2572,20200328,5242
20200325,1,보산,1259,1124,20200328,2383
20200325,1,동두천,1542,1870,20200328,3412
20200325,1,소요산,2370,1949,20200328,4319
20200326,경원선,이촌,2818,2141,20200329,4959
20200326,경원선,서빙고,1346,1212,20200329,2558
20200326,경원선,한남,3418,3191,20200329,6609
20200326,경원선,옥수,36,12,20200329,48
20200326,경원선,응봉,1476,1414,20200329,2890
20200326,경원선,왕십리,11236,12372,20200329,23608
20200326,경원선,청량리,9907,10817,20200329,20724
20200326,1,외대앞,5963,5895,20200329,11858
20200326,1,신이문,7211,6613,20200329,13824
20200326,1,석계,6881,7943,20200329,14824
20200326,1,광운대,6826,6252,20200329,13078
20200326,1,월계,4765,4606,20200329,9371
20200326,1,녹천,3810,3221,20200329,7031
20200326,1,창동,1,0,20200329,1
20200326,1,방학,7856,7642,20200329,15498
20200326,1,도봉,4921,4754,20200329,9675
20200326,1,도봉산,6398,3959,20200329,10357
20200326,1,망월사,5611,5803,20200329,11414
20200326,1,회룡,10015,9716,20200329,19731
20200326,1,의정부,14274,14731,20200329,29005
20200326,1,가능,5308,5094,20200329,10402
20200326,1,녹양,3783,3609,20200329,7392
20200326,1,양주,6296,5918,20200329,12214
20200326,1,덕계,1903,1726,20200329,3629
20200326,1,덕정,4422,4294,20200329,8716
20200326,1,지행,4919,4722,20200329,9641
20200326,1,동두천중앙,2423,2384,20200329,4807
20200326,1,보산,1208,1060,20200329,2268
20200326,1,동두천,1471,1798,20200329,3269
20200326,1,소요산,2055,1668,20200329,3723
20200327,경원선,이촌,3004,2227,20200330,5231
20200327,경원선,서빙고,1372,1238,20200330,2610
20200327,경원선,한남,3483,3324,20200330,6807
20200327,경원선,옥수,44,19,20200330,63
20200327,경원선,응봉,1618,1427,20200330,3045
20200327,경원선,왕십리,12470,13853,20200330,26323
20200327,경원선,청량리,11150,12316,20200330,23466
20200327,1,외대앞,6289,5995,20200330,12284
20200327,1,신이문,7346,6515,20200330,13861
20200327,1,석계,7230,8140,20200330,15370
20200327,1,광운대,7004,6443,20200330,13447
20200327,1,월계,4881,4472,20200330,9353
20200327,1,녹천,3895,3177,20200330,7072
20200327,1,방학,7935,7689,20200330,15624
20200327,1,도봉,5035,4753,20200330,9788
20200327,1,도봉산,6365,3778,20200330,10143
20200327,1,망월사,5750,5801,20200330,11551
20200327,1,회룡,10249,9947,20200330,20196
20200327,1,의정부,15290,16580,20200330,31870
20200327,1,가능,5371,5109,20200330,10480
20200327,1,녹양,3986,3684,20200330,7670
20200327,1,양주,6427,5845,20200330,12272
20200327,1,덕계,2031,1816,20200330,3847
20200327,1,덕정,4623,4455,20200330,9078
20200327,1,지행,5167,5123,20200330,10290
20200327,1,동두천중앙,2586,2466,20200330,5052
20200327,1,보산,1211,1158,20200330,2369
20200327,1,동두천,1476,1738,20200330,3214
20200327,1,소요산,2076,1778,20200330,3854
20200328,경원선,이촌,1998,1459,20200331,3457
20200328,경원선,서빙고,889,750,20200331,1639
20200328,경원선,한남,2104,2061,20200331,4165
20200328,경원선,옥수,16,18,20200331,34
20200328,경원선,응봉,1360,1650,20200331,3010
20200328,경원선,왕십리,9182,10346,20200331,19528
20200328,경원선,청량리,9368,10481,20200331,19849
20200328,1,외대앞,4712,4478,20200331,9190
20200328,1,신이문,4853,4355,20200331,9208
20200328,1,석계,5219,5571,20200331,10790
20200328,1,광운대,4501,4269,20200331,8770
20200328,1,월계,3454,3117,20200331,6571
20200328,1,녹천,2542,2100,20200331,4642
20200328,1,방학,5603,5451,20200331,11054
20200328,1,도봉,3324,3171,20200331,6495
20200328,1,도봉산,7638,5224,20200331,12862
20200328,1,망월사,4224,4354,20200331,8578
20200328,1,회룡,6768,6781,20200331,13549
20200328,1,의정부,12519,13461,20200331,25980
20200328,1,가능,3935,3769,20200331,7704
20200328,1,녹양,2689,2646,20200331,5335
20200328,1,양주,4623,4425,20200331,9048
20200328,1,덕계,1326,1263,20200331,2589
20200328,1,덕정,3291,3119,20200331,6410
20200328,1,지행,3758,3879,20200331,7637
20200328,1,동두천중앙,1981,1936,20200331,3917
20200328,1,보산,938,954,20200331,1892
20200328,1,동두천,1172,1501,20200331,2673
20200328,1,소요산,2797,2406,20200331,5203
20200329,경원선,이촌,1385,1064,20200401,2449
20200329,경원선,서빙고,558,552,20200401,1110
20200329,경원선,한남,1510,1407,20200401,2917
20200329,경원선,옥수,28,13,20200401,41
20200329,경원선,응봉,1168,1445,20200401,2613
20200329,경원선,왕십리,6616,7267,20200401,13883
20200329,경원선,청량리,7763,7721,20200401,15484
20200329,1,외대앞,3359,3255,20200401,6614
20200329,1,신이문,3389,3110,20200401,6499
20200329,1,석계,3563,4031,20200401,7594
20200329,1,광운대,3129,3149,20200401,6278
20200329,1,월계,2632,2416,20200401,5048
20200329,1,녹천,1937,1615,20200401,3552
20200329,1,방학,4195,3898,20200401,8093
20200329,1,도봉,2611,2293,20200401,4904
20200329,1,도봉산,7824,5662,20200401,13486
20200329,1,망월사,3093,3301,20200401,6394
20200329,1,회룡,4888,4872,20200401,9760
20200329,1,의정부,9287,9157,20200401,18444
20200329,1,가능,2921,2695,20200401,5616
20200329,1,녹양,1893,1861,20200401,3754
20200329,1,양주,3611,3490,20200401,7101
20200329,1,덕계,980,913,20200401,1893
20200329,1,덕정,2316,2356,20200401,4672
20200329,1,지행,2883,2788,20200401,5671
20200329,1,동두천중앙,1541,1456,20200401,2997
20200329,1,보산,821,713,20200401,1534
20200329,1,동두천,854,1215,20200401,2069
20200329,1,소요산,3173,2567,20200401,5740
20200330,경원선,이촌,2942,2279,20200402,5221
20200330,경원선,서빙고,1419,1330,20200402,2749
20200330,경원선,한남,3475,3279,20200402,6754
20200330,경원선,옥수,30,23,20200402,53
20200330,경원선,응봉,1604,1572,20200402,3176
20200330,경원선,왕십리,11111,12384,20200402,23495
20200330,경원선,청량리,10363,11092,20200402,21455
20200330,1,외대앞,5972,6028,20200402,12000
20200330,1,신이문,7504,6841,20200402,14345
20200330,1,석계,7000,8157,20200402,15157
20200330,1,광운대,6896,6377,20200402,13273
20200330,1,월계,4986,4664,20200402,9650
20200330,1,녹천,4046,3385,20200402,7431
20200330,1,방학,8001,7774,20200402,15775
20200330,1,도봉,4943,4785,20200402,9728
20200330,1,도봉산,6798,4143,20200402,10941
20200330,1,망월사,5804,5963,20200402,11767
20200330,1,회룡,10362,10139,20200402,20501
20200330,1,의정부,14665,15020,20200402,29685
20200330,1,가능,5495,5203,20200402,10698
20200330,1,녹양,3987,3765,20200402,7752
20200330,1,양주,6572,6125,20200402,12697
20200330,1,덕계,2068,1810,20200402,3878
20200330,1,덕정,4570,4511,20200402,9081
20200330,1,지행,5123,4948,20200402,10071
20200330,1,동두천중앙,2726,2645,20200402,5371
20200330,1,보산,1226,1096,20200402,2322
20200330,1,동두천,1549,1859,20200402,3408
20200330,1,소요산,2344,1898,20200402,4242
20200331,경원선,이촌,2944,2174,20200403,5118
20200331,경원선,서빙고,1373,1285,20200403,2658
20200331,경원선,한남,3355,3212,20200403,6567
20200331,경원선,옥수,34,22,20200403,56
20200331,경원선,응봉,1621,1490,20200403,3111
20200331,경원선,왕십리,11268,12474,20200403,23742
20200331,경원선,청량리,10120,11128,20200403,21248
20200331,1,외대앞,5989,5984,20200403,11973
20200331,1,신이문,7413,6801,20200403,14214
20200331,1,석계,7160,8158,20200403,15318
20200331,1,광운대,6922,6450,20200403,13372
20200331,1,월계,4952,4613,20200403,9565
20200331,1,녹천,3988,3316,20200403,7304
20200331,1,방학,7937,7790,20200403,15727
20200331,1,도봉,5211,4939,20200403,10150
20200331,1,도봉산,7018,4229,20200403,11247
20200331,1,망월사,5717,5907,20200403,11624
20200331,1,회룡,10327,10074,20200403,20401
20200331,1,의정부,14398,14900,20200403,29298
20200331,1,가능,5488,5281,20200403,10769
20200331,1,녹양,3879,3660,20200403,7539
20200331,1,양주,6540,6063,20200403,12603
20200331,1,덕계,2049,1753,20200403,3802
20200331,1,덕정,4530,4492,20200403,9022
20200331,1,지행,4941,4858,20200403,9799
20200331,1,동두천중앙,2592,2580,20200403,5172
20200331,1,보산,1167,1041,20200403,2208
20200331,1,동두천,1536,1818,20200403,3354
20200331,1,소요산,2431,2008,20200403,4439
20200401,경원선,이촌,3000,2264,20200404,5264
20200401,경원선,서빙고,1407,1272,20200404,2679
20200401,경원선,한남,3364,3178,20200404,6542
20200401,경원선,옥수,21,18,20200404,39
20200401,경원선,응봉,1519,1441,20200404,2960
20200401,경원선,왕십리,11271,13079,20200404,24350
20200401,경원선,청량리,10104,11035,20200404,21139
20200401,1,외대앞,5997,5787,20200404,11784
20200401,1,신이문,7401,6668,20200404,14069
20200401,1,석계,7084,8034,20200404,15118
20200401,1,광운대,6823,6403,20200404,13226
20200401,1,월계,4852,4530,20200404,9382
20200401,1,녹천,3951,3328,20200404,7279
20200401,1,방학,7863,7594,20200404,15457
20200401,1,도봉,4983,4893,20200404,9876
20200401,1,도봉산,6779,4087,20200404,10866
20200401,1,망월사,5675,5902,20200404,11577
20200401,1,회룡,9940,9722,20200404,19662
20200401,1,의정부,13814,14149,20200404,27963
20200401,1,가능,5230,5031,20200404,10261
20200401,1,녹양,3839,3522,20200404,7361
20200401,1,양주,6104,5761,20200404,11865
20200401,1,덕계,1935,1776,20200404,3711
20200401,1,덕정,4419,4352,20200404,8771
20200401,1,지행,4668,4671,20200404,9339
20200401,1,동두천중앙,2414,2293,20200404,4707
20200401,1,보산,1175,1020,20200404,2195
20200401,1,동두천,1386,1661,20200404,3047
20200401,1,소요산,2154,1753,20200404,3907
20200402,경원선,이촌,2943,2264,20200405,5207
20200402,경원선,서빙고,1438,1288,20200405,2726
20200402,경원선,한남,3380,3238,20200405,6618
20200402,경원선,옥수,26,16,20200405,42
20200402,경원선,응봉,1588,1425,20200405,3013
20200402,경원선,왕십리,11185,12732,20200405,23917
20200402,경원선,청량리,10483,11353,20200405,21836
20200402,1,외대앞,6034,5866,20200405,11900
20200402,1,신이문,7435,6739,20200405,14174
20200402,1,석계,7089,8042,20200405,15131
20200402,1,광운대,6915,6430,20200405,13345
20200402,1,월계,4944,4569,20200405,9513
20200402,1,녹천,3942,3331,20200405,7273
20200402,1,창동,1,0,20200405,1
20200402,1,방학,7950,7824,20200405,15774
20200402,1,도봉,5155,4900,20200405,10055
20200402,1,도봉산,6847,4184,20200405,11031
20200402,1,망월사,5607,5677,20200405,11284
20200402,1,회룡,9765,9611,20200405,19376
20200402,1,의정부,13472,13718,20200405,27190
20200402,1,가능,5069,4898,20200405,9967
20200402,1,녹양,3699,3500,20200405,7199
20200402,1,양주,6147,5682,20200405,11829
20200402,1,덕계,1922,1648,20200405,3570
20200402,1,덕정,4252,4197,20200405,8449
20200402,1,지행,4501,4467,20200405,8968
20200402,1,동두천중앙,2361,2265,20200405,4626
20200402,1,보산,1111,983,20200405,2094
20200402,1,동두천,1344,1592,20200405,2936
20200402,1,소요산,2118,1794,20200405,3912
20200403,경원선,이촌,3107,2410,20200406,5517
20200403,경원선,서빙고,1517,1349,20200406,2866
20200403,경원선,한남,3442,3341,20200406,6783
20200403,경원선,옥수,41,21,20200406,62
20200403,경원선,응봉,1611,1388,20200406,2999
20200403,경원선,왕십리,12257,13969,20200406,26226
20200403,경원선,청량리,11760,13189,20200406,24949
20200403,1,외대앞,6416,6032,20200406,12448
20200403,1,신이문,7586,6770,20200406,14356
20200403,1,석계,7414,8223,20200406,15637
20200403,1,광운대,7129,6566,20200406,13695
20200403,1,월계,5189,4812,20200406,10001
20200403,1,녹천,3974,3238,20200406,7212
20200403,1,방학,8169,8040,20200406,16209
20200403,1,도봉,5072,4840,20200406,9912
20200403,1,도봉산,7033,4240,20200406,11273
20200403,1,망월사,5707,5841,20200406,11548
20200403,1,회룡,10278,9987,20200406,20265
20200403,1,의정부,13698,14470,20200406,28168
20200403,1,가능,5222,4899,20200406,10121
20200403,1,녹양,3793,3553,20200406,7346
20200403,1,양주,6323,5821,20200406,12144
20200403,1,덕계,1885,1757,20200406,3642
20200403,1,덕정,4430,4205,20200406,8635
20200403,1,지행,4628,4552,20200406,9180
20200403,1,동두천중앙,2444,2363,20200406,4807
20200403,1,보산,1162,1076,20200406,2238
20200403,1,동두천,1340,1675,20200406,3015
20200403,1,소요산,2151,1788,20200406,3939
20200404,경원선,이촌,2168,1614,20200407,3782
20200404,경원선,서빙고,854,799,20200407,1653
20200404,경원선,한남,2258,2099,20200407,4357
20200404,경원선,옥수,16,17,20200407,33
20200404,경원선,응봉,1215,1182,20200407,2397
20200404,경원선,왕십리,9477,10472,20200407,19949
20200404,경원선,청량리,9431,10635,20200407,20066
20200404,1,외대앞,4720,4322,20200407,9042
20200404,1,신이문,4872,4422,20200407,9294
20200404,1,석계,5278,5608,20200407,10886
20200404,1,광운대,4367,4137,20200407,8504
20200404,1,월계,3444,3204,20200407,6648
20200404,1,녹천,2652,2154,20200407,4806
20200404,1,방학,5534,5460,20200407,10994
20200404,1,도봉,3338,3160,20200407,6498
20200404,1,도봉산,7251,4987,20200407,12238
20200404,1,망월사,3910,4116,20200407,8026
20200404,1,회룡,6615,6593,20200407,13208
20200404,1,의정부,10661,11102,20200407,21763
20200404,1,가능,3567,3473,20200407,7040
20200404,1,녹양,2472,2350,20200407,4822
20200404,1,양주,4218,4111,20200407,8329
20200404,1,덕계,1284,1260,20200407,2544
20200404,1,덕정,2955,2821,20200407,5776
20200404,1,지행,3251,3208,20200407,6459
20200404,1,동두천중앙,1686,1672,20200407,3358
20200404,1,보산,902,885,20200407,1787
20200404,1,동두천,964,1300,20200407,2264
20200404,1,소요산,2575,2277,20200407,4852
20200405,경원선,이촌,1431,1062,20200408,2493
20200405,경원선,서빙고,615,575,20200408,1190
20200405,경원선,한남,1407,1451,20200408,2858
20200405,경원선,옥수,22,13,20200408,35
20200405,경원선,응봉,884,958,20200408,1842
20200405,경원선,왕십리,6742,7546,20200408,14288
20200405,경원선,청량리,8129,7801,20200408,15930
20200405,1,외대앞,3400,3329,20200408,6729
20200405,1,신이문,3477,3191,20200408,6668
20200405,1,석계,3666,3964,20200408,7630
20200405,1,광운대,3082,3162,20200408,6244
20200405,1,월계,2581,2406,20200408,4987
20200405,1,녹천,1780,1450,20200408,3230
20200405,1,방학,4128,3910,20200408,8038
20200405,1,도봉,2640,2316,20200408,4956
20200405,1,도봉산,7091,4999,20200408,12090
20200405,1,망월사,2846,3005,20200408,5851
20200405,1,회룡,4446,4499,20200408,8945
20200405,1,의정부,8154,8071,20200408,16225
20200405,1,가능,2753,2479,20200408,5232
20200405,1,녹양,1790,1713,20200408,3503
20200405,1,양주,3263,3344,20200408,6607
20200405,1,덕계,895,808,20200408,1703
20200405,1,덕정,2076,2050,20200408,4126
20200405,1,지행,2442,2440,20200408,4882
20200405,1,동두천중앙,1396,1392,20200408,2788
20200405,1,보산,735,643,20200408,1378
20200405,1,동두천,768,1082,20200408,1850
20200405,1,소요산,2798,2296,20200408,5094
20200406,경원선,이촌,3038,2375,20200409,5413
20200406,경원선,서빙고,1457,1374,20200409,2831
20200406,경원선,한남,3633,3367,20200409,7000
20200406,경원선,옥수,32,25,20200409,57
20200406,경원선,응봉,1550,1323,20200409,2873
20200406,경원선,왕십리,11105,12723,20200409,23828
20200406,경원선,청량리,10655,11487,20200409,22142
20200406,1,외대앞,6013,6152,20200409,12165
20200406,1,신이문,7616,6985,20200409,14601
20200406,1,석계,7260,8290,20200409,15550
20200406,1,광운대,7020,6656,20200409,13676
20200406,1,월계,5002,4821,20200409,9823
20200406,1,녹천,4038,3432,20200409,7470
20200406,1,방학,8129,7950,20200409,16079
20200406,1,도봉,5065,4837,20200409,9902
20200406,1,도봉산,6810,4149,20200409,10959
20200406,1,망월사,5887,6057,20200409,11944
20200406,1,회룡,10161,10058,20200409,20219
20200406,1,의정부,13858,14060,20200409,27918
20200406,1,가능,5210,5016,20200409,10226
20200406,1,녹양,3832,3591,20200409,7423
20200406,1,양주,6434,6034,20200409,12468
20200406,1,덕계,2010,1791,20200409,3801
20200406,1,덕정,4453,4402,20200409,8855
20200406,1,지행,4903,4660,20200409,9563
20200406,1,동두천중앙,2546,2413,20200409,4959
20200406,1,보산,1172,984,20200409,2156
20200406,1,동두천,1367,1667,20200409,3034
20200406,1,소요산,2214,1797,20200409,4011
20200407,경원선,이촌,3064,2372,20200410,5436
20200407,경원선,서빙고,1481,1337,20200410,2818
20200407,경원선,한남,3493,3299,20200410,6792
20200407,경원선,옥수,34,23,20200410,57
20200407,경원선,응봉,1538,1339,20200410,2877
20200407,경원선,왕십리,11348,12799,20200410,24147
20200407,경원선,청량리,10290,11480,20200410,21770
20200407,1,외대앞,6061,6128,20200410,12189
20200407,1,신이문,7697,6996,20200410,14693
20200407,1,석계,7218,8249,20200410,15467
20200407,1,광운대,7092,6648,20200410,13740
20200407,1,월계,5146,4859,20200410,10005
20200407,1,녹천,4145,3424,20200410,7569
20200407,1,창동,1,0,20200410,1
20200407,1,방학,8123,7921,20200410,16044
20200407,1,도봉,5220,5000,20200410,10220
20200407,1,도봉산,6944,4298,20200410,11242
20200407,1,망월사,5898,6074,20200410,11972
20200407,1,회룡,10180,9972,20200410,20152
20200407,1,의정부,13950,14319,20200410,28269
20200407,1,가능,5290,5129,20200410,10419
20200407,1,녹양,3893,3641,20200410,7534
20200407,1,양주,6368,5924,20200410,12292
20200407,1,덕계,1973,1785,20200410,3758
20200407,1,덕정,4375,4386,20200410,8761
20200407,1,지행,4718,4633,20200410,9351
20200407,1,동두천중앙,2443,2432,20200410,4875
20200407,1,보산,1127,984,20200410,2111
20200407,1,동두천,1368,1602,20200410,2970
20200407,1,소요산,2270,1924,20200410,4194
20200408,경원선,이촌,3059,2370,20200411,5429
20200408,경원선,서빙고,1453,1349,20200411,2802
20200408,경원선,한남,3485,3326,20200411,6811
20200408,경원선,옥수,37,24,20200411,61
20200408,경원선,응봉,1538,1372,20200411,2910
20200408,경원선,왕십리,11513,12991,20200411,24504
20200408,경원선,청량리,10570,11570,20200411,22140
20200408,1,외대앞,6112,5993,20200411,12105
20200408,1,신이문,7674,7052,20200411,14726
20200408,1,석계,7290,8349,20200411,15639
20200408,1,광운대,6965,6592,20200411,13557
20200408,1,월계,5231,4823,20200411,10054
20200408,1,녹천,4019,3426,20200411,7445
20200408,1,방학,8191,7991,20200411,16182
20200408,1,도봉,5226,5028,20200411,10254
20200408,1,도봉산,7157,4378,20200411,11535
20200408,1,망월사,5964,6020,20200411,11984
20200408,1,회룡,10361,10231,20200411,20592
20200408,1,의정부,14151,14322,20200411,28473
20200408,1,가능,5242,5062,20200411,10304
20200408,1,녹양,3835,3698,20200411,7533
20200408,1,양주,6380,6003,20200411,12383
20200408,1,덕계,1991,1759,20200411,3750
20200408,1,덕정,4457,4323,20200411,8780
20200408,1,지행,4807,4704,20200411,9511
20200408,1,동두천중앙,2452,2402,20200411,4854
20200408,1,보산,1165,1030,20200411,2195
20200408,1,동두천,1388,1741,20200411,3129
20200408,1,소요산,2237,1868,20200411,4105
20200409,경원선,이촌,3091,2400,20200412,5491
20200409,경원선,서빙고,1449,1378,20200412,2827
20200409,경원선,한남,3646,3387,20200412,7033
20200409,경원선,옥수,32,13,20200412,45
20200409,경원선,응봉,1521,1337,20200412,2858
20200409,경원선,왕십리,11533,12954,20200412,24487
20200409,경원선,청량리,10663,11896,20200412,22559
20200409,1,외대앞,6200,6068,20200412,12268
20200409,1,신이문,7667,7036,20200412,14703
20200409,1,석계,7264,8320,20200412,15584
20200409,1,광운대,7027,6510,20200412,13537
20200409,1,월계,5086,4788,20200412,9874
20200409,1,녹천,4068,3377,20200412,7445
20200409,1,방학,8073,7965,20200412,16038
20200409,1,도봉,5411,5081,20200412,10492
20200409,1,도봉산,6958,4413,20200412,11371
20200409,1,망월사,5816,6064,20200412,11880
20200409,1,회룡,10346,10132,20200412,20478
20200409,1,의정부,13969,14319,20200412,28288
20200409,1,가능,5372,5089,20200412,10461
20200409,1,녹양,3824,3749,20200412,7573
20200409,1,양주,6455,5967,20200412,12422
20200409,1,덕계,1931,1772,20200412,3703
20200409,1,덕정,4420,4384,20200412,8804
20200409,1,지행,4764,4670,20200412,9434
20200409,1,동두천중앙,2472,2360,20200412,4832
20200409,1,보산,1133,1019,20200412,2152
20200409,1,동두천,1395,1667,20200412,3062
20200409,1,소요산,2257,1890,20200412,4147
20200410,경원선,이촌,3258,2382,20200413,5640
20200410,경원선,서빙고,1498,1392,20200413,2890
20200410,경원선,한남,3661,3460,20200413,7121
20200410,경원선,옥수,43,21,20200413,64
20200410,경원선,응봉,1536,1266,20200413,2802
20200410,경원선,왕십리,12555,14347,20200413,26902
20200410,경원선,청량리,12381,13736,20200413,26117
20200410,1,외대앞,6683,6259,20200413,12942
20200410,1,신이문,7748,6920,20200413,14668
20200410,1,석계,7610,8734,20200413,16344
20200410,1,광운대,7294,6816,20200413,14110
20200410,1,월계,5196,4736,20200413,9932
20200410,1,녹천,4103,3366,20200413,7469
20200410,1,방학,8400,8256,20200413,16656
20200410,1,도봉,5361,5048,20200413,10409
20200410,1,도봉산,7164,4422,20200413,11586
20200410,1,망월사,6033,6180,20200413,12213
20200410,1,회룡,10513,10136,20200413,20649
20200410,1,의정부,14601,15596,20200413,30197
20200410,1,가능,5513,5173,20200413,10686
20200410,1,녹양,3982,3705,20200413,7687
20200410,1,양주,6760,6274,20200413,13034
20200410,1,덕계,1982,1753,20200413,3735
20200410,1,덕정,4638,4393,20200413,9031
20200410,1,지행,5079,5035,20200413,10114
20200410,1,동두천중앙,2626,2533,20200413,5159
20200410,1,보산,1206,1082,20200413,2288
20200410,1,동두천,1489,1846,20200413,3335
20200410,1,소요산,2452,2058,20200413,4510
20200411,경원선,이촌,2224,1643,20200414,3867
20200411,경원선,서빙고,926,836,20200414,1762
20200411,경원선,한남,2266,2174,20200414,4440
20200411,경원선,옥수,21,20,20200414,41
20200411,경원선,응봉,1120,1013,20200414,2133
20200411,경원선,왕십리,9586,10703,20200414,20289
20200411,경원선,청량리,10225,11408,20200414,21633
20200411,1,외대앞,4916,4592,20200414,9508
20200411,1,신이문,4983,4593,20200414,9576
20200411,1,석계,5473,5884,20200414,11357
20200411,1,광운대,4639,4348,20200414,8987
20200411,1,월계,3625,3298,20200414,6923
20200411,1,녹천,2633,2178,20200414,4811
20200411,1,창동,1,0,20200414,1
20200411,1,방학,5935,5718,20200414,11653
20200411,1,도봉,3470,3376,20200414,6846
20200411,1,도봉산,7978,5444,20200414,13422
20200411,1,망월사,4217,4282,20200414,8499
20200411,1,회룡,6946,7018,20200414,13964
20200411,1,의정부,12056,12800,20200414,24856
20200411,1,가능,3936,3772,20200414,7708
20200411,1,녹양,2570,2458,20200414,5028
20200411,1,양주,4765,4559,20200414,9324
20200411,1,덕계,1367,1294,20200414,2661
20200411,1,덕정,3292,3138,20200414,6430
20200411,1,지행,3637,3680,20200414,7317
20200411,1,동두천중앙,1911,1937,20200414,3848
20200411,1,보산,926,959,20200414,1885
20200411,1,동두천,1091,1405,20200414,2496
20200411,1,소요산,2897,2608,20200414,5505
20200412,경원선,이촌,1403,1084,20200415,2487
20200412,경원선,서빙고,599,591,20200415,1190
20200412,경원선,한남,1448,1478,20200415,2926
20200412,경원선,옥수,27,13,20200415,40
20200412,경원선,응봉,811,727,20200415,1538
20200412,경원선,왕십리,6110,7048,20200415,13158
20200412,경원선,청량리,8462,7973,20200415,16435
20200412,1,외대앞,3565,3519,20200415,7084
20200412,1,신이문,3569,3316,20200415,6885
20200412,1,석계,3748,4215,20200415,7963
20200412,1,광운대,3200,3228,20200415,6428
20200412,1,월계,2621,2343,20200415,4964
20200412,1,녹천,1866,1655,20200415,3521
20200412,1,방학,4123,4043,20200415,8166
20200412,1,도봉,2816,2573,20200415,5389
20200412,1,도봉산,7748,5583,20200415,13331
20200412,1,망월사,3275,3442,20200415,6717
20200412,1,회룡,4942,4975,20200415,9917
20200412,1,의정부,9204,9262,20200415,18466
20200412,1,가능,2952,2664,20200415,5616
20200412,1,녹양,1873,1826,20200415,3699
20200412,1,양주,3544,3628,20200415,7172
20200412,1,덕계,1020,980,20200415,2000
20200412,1,덕정,2439,2480,20200415,4919
20200412,1,지행,2747,2678,20200415,5425
20200412,1,동두천중앙,1486,1356,20200415,2842
20200412,1,보산,767,633,20200415,1400
20200412,1,동두천,919,1137,20200415,2056
20200412,1,소요산,2980,2521,20200415,5501
20200413,경원선,이촌,3122,2412,20200416,5534
20200413,경원선,서빙고,1479,1355,20200416,2834
20200413,경원선,한남,3633,3412,20200416,7045
20200413,경원선,옥수,33,17,20200416,50
20200413,경원선,응봉,1576,1371,20200416,2947
20200413,경원선,왕십리,11485,13074,20200416,24559
20200413,경원선,청량리,11375,12203,20200416,23578
20200413,1,외대앞,6289,6223,20200416,12512
20200413,1,신이문,7789,7070,20200416,14859
20200413,1,석계,7552,8581,20200416,16133
20200413,1,광운대,6996,6688,20200416,13684
20200413,1,월계,5208,4858,20200416,10066
20200413,1,녹천,4178,3417,20200416,7595
20200413,1,방학,8352,8175,20200416,16527
20200413,1,도봉,5241,5006,20200416,10247
20200413,1,도봉산,7091,4274,20200416,11365
20200413,1,망월사,6068,6200,20200416,12268
20200413,1,회룡,10678,10439,20200416,21117
20200413,1,의정부,14606,14939,20200416,29545
20200413,1,가능,5579,5358,20200416,10937
20200413,1,녹양,3970,3779,20200416,7749
20200413,1,양주,6696,6201,20200416,12897
20200413,1,덕계,2073,1931,20200416,4004
20200413,1,덕정,4678,4598,20200416,9276
20200413,1,지행,5037,4902,20200416,9939
20200413,1,동두천중앙,2576,2496,20200416,5072
20200413,1,보산,1266,1062,20200416,2328
20200413,1,동두천,1436,1787,20200416,3223
20200413,1,소요산,2392,1957,20200416,4349
20200414,경원선,이촌,3331,2496,20200417,5827
20200414,경원선,서빙고,1555,1408,20200417,2963
20200414,경원선,한남,3621,3480,20200417,7101
20200414,경원선,옥수,41,26,20200417,67
20200414,경원선,응봉,1683,1395,20200417,3078
20200414,경원선,왕십리,12404,14304,20200417,26708
20200414,경원선,청량리,11729,12501,20200417,24230
20200414,1,외대앞,5926,7030,20200417,12956
20200414,1,신이문,7427,7693,20200417,15120
20200414,1,석계,5788,8694,20200417,14482
20200414,1,광운대,5067,7766,20200417,12833
20200414,1,월계,5028,5639,20200417,10667
20200414,1,녹천,3622,3685,20200417,7307
20200414,1,방학,7992,8674,20200417,16666
20200414,1,도봉,4947,5843,20200417,10790
20200414,1,도봉산,8616,5655,20200417,14271
20200414,1,망월사,5941,7389,20200417,13330
20200414,1,회룡,10545,11103,20200417,21648
20200414,1,의정부,14366,15020,20200417,29386
20200414,1,가능,5280,5129,20200417,10409
20200414,1,녹양,3715,3596,20200417,7311
20200414,1,양주,6653,6360,20200417,13013
20200414,1,덕계,1975,1667,20200417,3642
20200414,1,덕정,4483,4222,20200417,8705
20200414,1,지행,4961,4608,20200417,9569
20200414,1,동두천중앙,2438,2336,20200417,4774
20200414,1,보산,1109,1071,20200417,2180
20200414,1,동두천,1367,1844,20200417,3211
20200414,1,소요산,2263,1895,20200417,4158
20200415,경원선,이촌,2019,1538,20200418,3557
20200415,경원선,서빙고,817,701,20200418,1518
20200415,경원선,한남,2004,1971,20200418,3975
20200415,경원선,옥수,18,21,20200418,39
20200415,경원선,응봉,1043,914,20200418,1957
20200415,경원선,왕십리,7863,9057,20200418,16920
20200415,경원선,청량리,8748,9590,20200418,18338
20200415,1,외대앞,4461,4307,20200418,8768
20200415,1,신이문,4859,4503,20200418,9362
20200415,1,석계,4952,5417,20200418,10369
20200415,1,광운대,4195,4029,20200418,8224
20200415,1,월계,3426,3198,20200418,6624
20200415,1,녹천,2562,2239,20200418,4801
20200415,1,방학,5488,5336,20200418,10824
20200415,1,도봉,3292,2991,20200418,6283
20200415,1,도봉산,7390,5173,20200418,12563
20200415,1,망월사,3810,3951,20200418,7761
20200415,1,회룡,6451,6501,20200418,12952
20200415,1,의정부,10502,10536,20200418,21038
20200415,1,가능,3678,3531,20200418,7209
20200415,1,녹양,2443,2382,20200418,4825
20200415,1,양주,4284,4390,20200418,8674
20200415,1,덕계,1214,1218,20200418,2432
20200415,1,덕정,2945,2972,20200418,5917
20200415,1,지행,3466,3426,20200418,6892
20200415,1,동두천중앙,1934,1849,20200418,3783
20200415,1,보산,911,821,20200418,1732
20200415,1,동두천,1200,1589,20200418,2789
20200415,1,소요산,3014,2560,20200418,5574
20200416,경원선,이촌,3202,2423,20200419,5625
20200416,경원선,서빙고,1498,1422,20200419,2920
20200416,경원선,한남,3655,3451,20200419,7106
20200416,경원선,옥수,36,27,20200419,63
20200416,경원선,응봉,1585,1357,20200419,2942
20200416,경원선,왕십리,11796,13283,20200419,25079
20200416,경원선,청량리,11436,12547,20200419,23983
20200416,1,외대앞,6378,6311,20200419,12689
20200416,1,신이문,7778,7036,20200419,14814
20200416,1,석계,7590,8678,20200419,16268
20200416,1,광운대,7134,6877,20200419,14011
20200416,1,월계,5209,4733,20200419,9942
20200416,1,녹천,4104,3416,20200419,7520
20200416,1,창동,1,0,20200419,1
20200416,1,방학,8392,8140,20200419,16532
20200416,1,도봉,5324,5037,20200419,10361
20200416,1,도봉산,7476,4575,20200419,12051
20200416,1,망월사,6157,6338,20200419,12495
20200416,1,회룡,10697,10486,20200419,21183
20200416,1,의정부,14697,15110,20200419,29807
20200416,1,가능,5650,5343,20200419,10993
20200416,1,녹양,3983,3785,20200419,7768
20200416,1,양주,6967,6308,20200419,13275
20200416,1,덕계,2134,1952,20200419,4086
20200416,1,덕정,4821,4670,20200419,9491
20200416,1,지행,5059,4969,20200419,10028
20200416,1,동두천중앙,2747,2620,20200419,5367
20200416,1,보산,1218,1088,20200419,2306
20200416,1,동두천,1581,1939,20200419,3520
20200416,1,소요산,2718,2206,20200419,4924
20200417,경원선,이촌,3196,2433,20200420,5629
20200417,경원선,서빙고,1537,1348,20200420,2885
20200417,경원선,한남,3542,3385,20200420,6927
20200417,경원선,옥수,51,20,20200420,71
20200417,경원선,응봉,1416,1141,20200420,2557
20200417,경원선,왕십리,12268,14156,20200420,26424
20200417,경원선,청량리,11862,12935,20200420,24797
20200417,1,외대앞,6313,6140,20200420,12453
20200417,1,신이문,7775,6844,20200420,14619
20200417,1,석계,7339,8339,20200420,15678
20200417,1,광운대,7081,6441,20200420,13522
20200417,1,월계,4863,4530,20200420,9393
20200417,1,녹천,4051,3212,20200420,7263
20200417,1,방학,7906,7872,20200420,15778
20200417,1,도봉,5113,4927,20200420,10040
20200417,1,도봉산,5470,3141,20200420,8611
20200417,1,망월사,5834,5879,20200420,11713
20200417,1,회룡,10085,9982,20200420,20067
20200417,1,의정부,14269,15382,20200420,29651
20200417,1,가능,5340,5037,20200420,10377
20200417,1,녹양,3817,3449,20200420,7266
20200417,1,양주,6333,5809,20200420,12142
20200417,1,덕계,2008,1758,20200420,3766
20200417,1,덕정,4580,4327,20200420,8907
20200417,1,지행,4925,4881,20200420,9806
20200417,1,동두천중앙,2444,2456,20200420,4900
20200417,1,보산,1161,1035,20200420,2196
20200417,1,동두천,1375,1605,20200420,2980
20200417,1,소요산,1656,1398,20200420,3054
20200418,경원선,이촌,2578,1844,20200421,4422
20200418,경원선,서빙고,1055,909,20200421,1964
20200418,경원선,한남,2444,2361,20200421,4805
20200418,경원선,옥수,23,31,20200421,54
20200418,경원선,응봉,1302,1035,20200421,2337
20200418,경원선,왕십리,10465,11847,20200421,22312
20200418,경원선,청량리,11109,12444,20200421,23553
20200418,1,외대앞,5270,4827,20200421,10097
20200418,1,신이문,5576,4982,20200421,10558
20200418,1,석계,6009,6504,20200421,12513
20200418,1,광운대,4864,4645,20200421,9509
20200418,1,월계,3981,3541,20200421,7522
20200418,1,녹천,2960,2399,20200421,5359
20200418,1,창동,1,0,20200421,1
20200418,1,방학,6449,6228,20200421,12677
20200418,1,도봉,3836,3629,20200421,7465
20200418,1,도봉산,9158,6337,20200421,15495
20200418,1,망월사,4535,4719,20200421,9254
20200418,1,회룡,7751,7692,20200421,15443
20200418,1,의정부,13167,13979,20200421,27146
20200418,1,가능,4411,4003,20200421,8414
20200418,1,녹양,2935,2921,20200421,5856
20200418,1,양주,5282,5157,20200421,10439
20200418,1,덕계,1457,1371,20200421,2828
20200418,1,덕정,3672,3434,20200421,7106
20200418,1,지행,4156,4134,20200421,8290
20200418,1,동두천중앙,2087,2172,20200421,4259
20200418,1,보산,1036,1065,20200421,2101
20200418,1,동두천,1166,1696,20200421,2862
20200418,1,소요산,3668,3241,20200421,6909
20200419,경원선,이촌,1322,1071,20200422,2393
20200419,경원선,서빙고,556,572,20200422,1128
20200419,경원선,한남,1470,1461,20200422,2931
20200419,경원선,옥수,32,19,20200422,51
20200419,경원선,응봉,744,700,20200422,1444
20200419,경원선,왕십리,6854,7753,20200422,14607
20200419,경원선,청량리,9091,8595,20200422,17686
20200419,1,외대앞,3437,3389,20200422,6826
20200419,1,신이문,3588,3349,20200422,6937
20200419,1,석계,3962,4246,20200422,8208
20200419,1,광운대,3269,3306,20200422,6575
20200419,1,월계,2715,2569,20200422,5284
20200419,1,녹천,1912,1648,20200422,3560
20200419,1,방학,4351,4268,20200422,8619
20200419,1,도봉,2693,2520,20200422,5213
20200419,1,도봉산,7366,5026,20200422,12392
20200419,1,망월사,3256,3391,20200422,6647
20200419,1,회룡,5024,5203,20200422,10227
20200419,1,의정부,9540,9364,20200422,18904
20200419,1,가능,2912,2784,20200422,5696
20200419,1,녹양,1970,1871,20200422,3841
20200419,1,양주,3520,3488,20200422,7008
20200419,1,덕계,1025,943,20200422,1968
20200419,1,덕정,2350,2483,20200422,4833
20200419,1,지행,2911,2835,20200422,5746
20200419,1,동두천중앙,1539,1416,20200422,2955
20200419,1,보산,846,701,20200422,1547
20200419,1,동두천,892,1375,20200422,2267
20200419,1,소요산,3192,2473,20200422,5665
20200420,경원선,이촌,3082,2480,20200423,5562
20200420,경원선,서빙고,1460,1346,20200423,2806
20200420,경원선,한남,3749,3456,20200423,7205
20200420,경원선,옥수,35,30,20200423,65
20200420,경원선,응봉,1542,1313,20200423,2855
20200420,경원선,왕십리,11722,13411,20200423,25133
20200420,경원선,청량리,11349,12196,20200423,23545
20200420,1,외대앞,6196,6129,20200423,12325
20200420,1,신이문,7897,7235,20200423,15132
20200420,1,석계,7485,8577,20200423,16062
20200420,1,광운대,7163,6689,20200423,13852
20200420,1,월계,5213,4914,20200423,10127
20200420,1,녹천,4248,3566,20200423,7814
20200420,1,방학,8445,8279,20200423,16724
20200420,1,도봉,5464,5201,20200423,10665
20200420,1,도봉산,6378,3721,20200423,10099
20200420,1,망월사,6152,6206,20200423,12358
20200420,1,회룡,10817,10587,20200423,21404
20200420,1,의정부,14866,15394,20200423,30260
20200420,1,가능,5597,5380,20200423,10977
20200420,1,녹양,4055,3813,20200423,7868
20200420,1,양주,6693,6287,20200423,12980
20200420,1,덕계,2085,1817,20200423,3902
20200420,1,덕정,4751,4616,20200423,9367
20200420,1,지행,5167,5043,20200423,10210
20200420,1,동두천중앙,2745,2661,20200423,5406
20200420,1,보산,1283,1104,20200423,2387
20200420,1,동두천,1549,1869,20200423,3418
20200420,1,소요산,2184,1666,20200423,3850
20200421,경원선,이촌,3252,2513,20200424,5765
20200421,경원선,서빙고,1535,1407,20200424,2942
20200421,경원선,한남,3834,3662,20200424,7496
20200421,경원선,옥수,37,28,20200424,65
20200421,경원선,응봉,1632,1409,20200424,3041
20200421,경원선,왕십리,11747,13452,20200424,25199
20200421,경원선,청량리,11481,12583,20200424,24064
20200421,1,외대앞,6560,6365,20200424,12925
20200421,1,신이문,8003,7274,20200424,15277
20200421,1,석계,7660,8827,20200424,16487
20200421,1,광운대,7133,6820,20200424,13953
20200421,1,월계,5322,4982,20200424,10304
20200421,1,녹천,4275,3594,20200424,7869
20200421,1,방학,8695,8385,20200424,17080
20200421,1,도봉,5547,5279,20200424,10826
20200421,1,도봉산,7052,4317,20200424,11369
20200421,1,망월사,6191,6381,20200424,12572
20200421,1,회룡,10968,10731,20200424,21699
20200421,1,의정부,14965,15310,20200424,30275
20200421,1,가능,5718,5516,20200424,11234
20200421,1,녹양,4060,3825,20200424,7885
20200421,1,양주,6772,6431,20200424,13203
20200421,1,덕계,2095,1856,20200424,3951
20200421,1,덕정,4743,4614,20200424,9357
20200421,1,지행,5227,5085,20200424,10312
20200421,1,동두천중앙,2687,2580,20200424,5267
20200421,1,보산,1195,1080,20200424,2275
20200421,1,동두천,1573,1973,20200424,3546
20200421,1,소요산,2451,1977,20200424,4428
20200422,경원선,이촌,3242,2568,20200425,5810
20200422,경원선,서빙고,1469,1345,20200425,2814
20200422,경원선,한남,3715,3567,20200425,7282
20200422,경원선,옥수,40,33,20200425,73
20200422,경원선,응봉,1581,1348,20200425,2929
20200422,경원선,왕십리,11900,13652,20200425,25552
20200422,경원선,청량리,10939,12184,20200425,23123
20200422,1,외대앞,6454,6223,20200425,12677
20200422,1,신이문,7804,7171,20200425,14975
20200422,1,석계,7618,8543,20200425,16161
20200422,1,광운대,7145,6719,20200425,13864
20200422,1,월계,5254,4792,20200425,10046
20200422,1,녹천,4161,3595,20200425,7756
20200422,1,방학,8424,8187,20200425,16611
20200422,1,도봉,5393,5203,20200425,10596
20200422,1,도봉산,6661,3943,20200425,10604
20200422,1,망월사,6193,6359,20200425,12552
20200422,1,회룡,10620,10384,20200425,21004
20200422,1,의정부,14872,15301,20200425,30173
20200422,1,가능,5594,5371,20200425,10965
20200422,1,녹양,3975,3824,20200425,7799
20200422,1,양주,6666,6274,20200425,12940
20200422,1,덕계,2090,1815,20200425,3905
20200422,1,덕정,4832,4669,20200425,9501
20200422,1,지행,5075,4983,20200425,10058
20200422,1,동두천중앙,2596,2506,20200425,5102
20200422,1,보산,1170,1082,20200425,2252
20200422,1,동두천,1478,1799,20200425,3277
20200422,1,소요산,2129,1742,20200425,3871
20200423,경원선,이촌,3273,2611,20200426,5884
20200423,경원선,서빙고,1548,1390,20200426,2938
20200423,경원선,한남,3873,3652,20200426,7525
20200423,경원선,옥수,31,22,20200426,53
20200423,경원선,응봉,1640,1393,20200426,3033
20200423,경원선,왕십리,12178,13918,20200426,26096
20200423,경원선,청량리,11682,12650,20200426,24332
20200423,1,외대앞,6431,6296,20200426,12727
20200423,1,신이문,8144,7358,20200426,15502
20200423,1,석계,7854,8911,20200426,16765
20200423,1,광운대,7468,7016,20200426,14484
20200423,1,월계,5332,4944,20200426,10276
20200423,1,녹천,4268,3607,20200426,7875
20200423,1,방학,8657,8483,20200426,17140
20200423,1,도봉,5606,5358,20200426,10964
20200423,1,도봉산,7050,4303,20200426,11353
20200423,1,망월사,6291,6437,20200426,12728
20200423,1,회룡,10993,10901,20200426,21894
20200423,1,의정부,15217,15819,20200426,31036
20200423,1,가능,5759,5476,20200426,11235
20200423,1,녹양,4144,3830,20200426,7974
20200423,1,양주,6834,6442,20200426,13276
20200423,1,덕계,2090,1828,20200426,3918
20200423,1,덕정,4789,4727,20200426,9516
20200423,1,지행,5187,5118,20200426,10305
20200423,1,동두천중앙,2695,2570,20200426,5265
20200423,1,보산,1244,1094,20200426,2338
20200423,1,동두천,1548,1898,20200426,3446
20200423,1,소요산,2335,1925,20200426,4260
20200424,경원선,이촌,3457,2643,20200427,6100
20200424,경원선,서빙고,1658,1409,20200427,3067
20200424,경원선,한남,3881,3696,20200427,7577
20200424,경원선,옥수,54,30,20200427,84
20200424,경원선,응봉,1715,1415,20200427,3130
20200424,경원선,왕십리,13525,15480,20200427,29005
20200424,경원선,청량리,13660,14873,20200427,28533
20200424,1,외대앞,7092,6679,20200427,13771
20200424,1,신이문,8346,7528,20200427,15874
20200424,1,석계,8007,9241,20200427,17248
20200424,1,광운대,7811,7103,20200427,14914
20200424,1,월계,5555,5128,20200427,10683
20200424,1,녹천,4486,3653,20200427,8139
20200424,1,창동,1,0,20200427,1
20200424,1,방학,9080,8843,20200427,17923
20200424,1,도봉,5846,5500,20200427,11346
20200424,1,도봉산,7493,4520,20200427,12013
20200424,1,망월사,6614,6578,20200427,13192
20200424,1,회룡,11303,11048,20200427,22351
20200424,1,의정부,16369,17494,20200427,33863
20200424,1,가능,6033,5821,20200427,11854
20200424,1,녹양,4305,4125,20200427,8430
20200424,1,양주,7230,6599,20200427,13829
20200424,1,덕계,2204,1900,20200427,4104
20200424,1,덕정,5069,4795,20200427,9864
20200424,1,지행,5668,5575,20200427,11243
20200424,1,동두천중앙,2756,2700,20200427,5456
20200424,1,보산,1329,1233,20200427,2562
20200424,1,동두천,1715,2150,20200427,3865
20200424,1,소요산,2717,2211,20200427,4928
20200425,경원선,이촌,2474,1776,20200428,4250
20200425,경원선,서빙고,1111,928,20200428,2039
20200425,경원선,한남,2473,2367,20200428,4840
20200425,경원선,옥수,28,51,20200428,79
20200425,경원선,응봉,1268,1088,20200428,2356
20200425,경원선,왕십리,10734,11923,20200428,22657
20200425,경원선,청량리,12210,13690,20200428,25900
20200425,1,외대앞,5320,4969,20200428,10289
20200425,1,신이문,5693,5034,20200428,10727
20200425,1,석계,6327,6773,20200428,13100
20200425,1,광운대,5050,4711,20200428,9761
20200425,1,월계,4052,3670,20200428,7722
20200425,1,녹천,2931,2409,20200428,5340
20200425,1,방학,6703,6459,20200428,13162
20200425,1,도봉,4024,3792,20200428,7816
20200425,1,도봉산,8680,5892,20200428,14572
20200425,1,망월사,4836,4845,20200428,9681
20200425,1,회룡,8249,8211,20200428,16460
20200425,1,의정부,14099,15162,20200428,29261
20200425,1,가능,4515,4236,20200428,8751
20200425,1,녹양,3054,2941,20200428,5995
20200425,1,양주,5599,5327,20200428,10926
20200425,1,덕계,1604,1471,20200428,3075
20200425,1,덕정,3799,3538,20200428,7337
20200425,1,지행,4276,4236,20200428,8512
20200425,1,동두천중앙,2289,2295,20200428,4584
20200425,1,보산,1067,1097,20200428,2164
20200425,1,동두천,1284,1848,20200428,3132
20200425,1,소요산,3497,2846,20200428,6343
20200426,경원선,이촌,1843,1374,20200429,3217
20200426,경원선,서빙고,919,930,20200429,1849
20200426,경원선,한남,1727,1799,20200429,3526
20200426,경원선,옥수,43,25,20200429,68
20200426,경원선,응봉,967,921,20200429,1888
20200426,경원선,왕십리,7122,8167,20200429,15289
20200426,경원선,청량리,9856,9523,20200429,19379
20200426,1,외대앞,3858,3813,20200429,7671
20200426,1,신이문,4295,3857,20200429,8152
20200426,1,석계,4561,4970,20200429,9531
20200426,1,광운대,3768,3831,20200429,7599
20200426,1,월계,3084,2831,20200429,5915
20200426,1,녹천,2367,2038,20200429,4405
20200426,1,방학,5068,4836,20200429,9904
20200426,1,도봉,3164,2884,20200429,6048
20200426,1,도봉산,9258,6705,20200429,15963
20200426,1,망월사,3846,3979,20200429,7825
20200426,1,회룡,5934,5904,20200429,11838
20200426,1,의정부,11119,11275,20200429,22394
20200426,1,가능,3511,3294,20200429,6805
20200426,1,녹양,2274,2247,20200429,4521
20200426,1,양주,4321,4270,20200429,8591
20200426,1,덕계,1250,1146,20200429,2396
20200426,1,덕정,2903,2999,20200429,5902
20200426,1,지행,3569,3397,20200429,6966
20200426,1,동두천중앙,1744,1694,20200429,3438
20200426,1,보산,943,858,20200429,1801
20200426,1,동두천,1053,1592,20200429,2645
20200426,1,소요산,4205,3543,20200429,7748
20200427,경원선,이촌,3355,2669,20200430,6024
20200427,경원선,서빙고,1612,1404,20200430,3016
20200427,경원선,한남,4058,3785,20200430,7843
20200427,경원선,옥수,37,21,20200430,58
20200427,경원선,응봉,1708,1415,20200430,3123
20200427,경원선,왕십리,12259,14033,20200430,26292
20200427,경원선,청량리,12457,13431,20200430,25888
20200427,1,외대앞,6607,6628,20200430,13235
20200427,1,신이문,8327,7535,20200430,15862
20200427,1,석계,8065,9269,20200430,17334
20200427,1,광운대,7601,7217,20200430,14818
20200427,1,월계,5548,5215,20200430,10763
20200427,1,녹천,4383,3644,20200430,8027
20200427,1,방학,9101,8909,20200430,18010
20200427,1,도봉,5740,5574,20200430,11314
20200427,1,도봉산,7469,4538,20200430,12007
20200427,1,망월사,6437,6616,20200430,13053
20200427,1,회룡,11501,11304,20200430,22805
20200427,1,의정부,15887,16337,20200430,32224
20200427,1,가능,5947,5660,20200430,11607
20200427,1,녹양,4351,4094,20200430,8445
20200427,1,양주,7139,6665,20200430,13804
20200427,1,덕계,2268,1968,20200430,4236
20200427,1,덕정,5123,5018,20200430,10141
20200427,1,지행,5663,5518,20200430,11181
20200427,1,동두천중앙,2946,2743,20200430,5689
20200427,1,보산,1305,1110,20200430,2415
20200427,1,동두천,1704,2189,20200430,3893
20200427,1,소요산,2864,2219,20200430,5083
20200428,경원선,이촌,3550,2646,20200501,6196
20200428,경원선,서빙고,1622,1470,20200501,3092
20200428,경원선,한남,4095,3872,20200501,7967
20200428,경원선,옥수,36,25,20200501,61
20200428,경원선,응봉,1678,1413,20200501,3091
20200428,경원선,왕십리,12583,14279,20200501,26862
20200428,경원선,청량리,12856,13786,20200501,26642
20200428,1,외대앞,6802,6583,20200501,13385
20200428,1,신이문,8319,7408,20200501,15727
20200428,1,석계,8202,9357,20200501,17559
20200428,1,광운대,7922,7434,20200501,15356
20200428,1,월계,5675,5290,20200501,10965
20200428,1,녹천,4502,3663,20200501,8165
20200428,1,방학,9188,8970,20200501,18158
20200428,1,도봉,5890,5609,20200501,11499
20200428,1,도봉산,7888,5029,20200501,12917
20200428,1,망월사,6790,6866,20200501,13656
20200428,1,회룡,11794,11576,20200501,23370
20200428,1,의정부,16090,16528,20200501,32618
20200428,1,가능,6027,5841,20200501,11868
20200428,1,녹양,4406,4123,20200501,8529
20200428,1,양주,7255,6759,20200501,14014
20200428,1,덕계,2265,2000,20200501,4265
20200428,1,덕정,5134,5069,20200501,10203
20200428,1,지행,5663,5569,20200501,11232
20200428,1,동두천중앙,2958,2875,20200501,5833
20200428,1,보산,1323,1187,20200501,2510
20200428,1,동두천,1721,2175,20200501,3896
20200428,1,소요산,3123,2536,20200501,5659
20200429,경원선,이촌,3727,2823,20200502,6550
20200429,경원선,서빙고,1705,1501,20200502,3206
20200429,경원선,한남,4234,4054,20200502,8288
20200429,경원선,옥수,55,26,20200502,81
20200429,경원선,응봉,1818,1461,20200502,3279
20200429,경원선,왕십리,13824,15733,20200502,29557
20200429,경원선,청량리,14040,15665,20200502,29705
20200429,1,외대앞,7128,6864,20200502,13992
20200429,1,신이문,8748,7723,20200502,16471
20200429,1,석계,8560,9593,20200502,18153
20200429,1,광운대,8115,7391,20200502,15506
20200429,1,월계,5839,5369,20200502,11208
20200429,1,녹천,4606,3675,20200502,8281
20200429,1,방학,9615,9128,20200502,18743
20200429,1,도봉,5872,5634,20200502,11506
20200429,1,도봉산,8110,5147,20200502,13257
20200429,1,망월사,6766,6913,20200502,13679
20200429,1,회룡,12138,11703,20200502,23841
20200429,1,의정부,17254,18300,20200502,35554
20200429,1,가능,6317,5967,20200502,12284
20200429,1,녹양,4494,4205,20200502,8699
20200429,1,양주,7593,7064,20200502,14657
20200429,1,덕계,2422,2128,20200502,4550
20200429,1,덕정,5500,5227,20200502,10727
20200429,1,지행,5951,5880,20200502,11831
20200429,1,동두천중앙,3051,2962,20200502,6013
20200429,1,보산,1341,1236,20200502,2577
20200429,1,동두천,1753,2255,20200502,4008
20200429,1,소요산,3070,2526,20200502,5596
20200430,경원선,이촌,2384,1683,20200503,4067
20200430,경원선,서빙고,993,905,20200503,1898
20200430,경원선,한남,2356,2159,20200503,4515
20200430,경원선,옥수,23,23,20200503,46
20200430,경원선,응봉,1339,1220,20200503,2559
20200430,경원선,왕십리,9328,10400,20200503,19728
20200430,경원선,청량리,11973,13400,20200503,25373
20200430,1,외대앞,5048,4577,20200503,9625
20200430,1,신이문,5572,4883,20200503,10455
20200430,1,석계,6166,6421,20200503,12587
20200430,1,광운대,4920,4683,20200503,9603
20200430,1,월계,4049,3608,20200503,7657
20200430,1,녹천,2937,2348,20200503,5285
20200430,1,창동,1,0,20200503,1
20200430,1,방학,6267,6174,20200503,12441
20200430,1,도봉,3879,3504,20200503,7383
20200430,1,도봉산,9850,7054,20200503,16904
20200430,1,망월사,4954,5087,20200503,10041
20200430,1,회룡,7918,7700,20200503,15618
20200430,1,의정부,13212,13814,20200503,27026
20200430,1,가능,4505,4188,20200503,8693
20200430,1,녹양,3022,2908,20200503,5930
20200430,1,양주,5262,5239,20200503,10501
20200430,1,덕계,1534,1411,20200503,2945
20200430,1,덕정,3853,3704,20200503,7557
20200430,1,지행,4176,4160,20200503,8336
20200430,1,동두천중앙,2344,2469,20200503,4813
20200430,1,보산,1017,1078,20200503,2095
20200430,1,동두천,1364,1968,20200503,3332
20200430,1,소요산,4531,3939,20200503,8470
20200501,1,소요산,3777,3194,20200504,6971
20200501,1,동두천,1487,1936,20200504,3423
20200501,1,보산,1177,1078,20200504,2255
20200501,1,동두천중앙,2364,2261,20200504,4625
20200501,1,지행,4687,4666,20200504,9353
20200501,1,덕정,4090,3841,20200504,7931
20200501,1,덕계,1685,1560,20200504,3245
20200501,1,양주,5907,5501,20200504,11408
20200501,1,녹양,3231,3090,20200504,6321
20200501,1,가능,4846,4460,20200504,9306
20200501,1,의정부,14517,15358,20200504,29875
20200501,1,회룡,8366,8243,20200504,16609
20200501,1,망월사,5039,4904,20200504,9943
20200501,1,도봉산,7940,5480,20200504,13420
20200501,1,도봉,4343,4058,20200504,8401
20200501,1,방학,6901,6612,20200504,13513
20200501,1,녹천,3040,2462,20200504,5502
20200501,1,월계,4086,3644,20200504,7730
20200501,1,광운대,5635,5301,20200504,10936
20200501,1,석계,6367,6860,20200504,13227
20200501,1,신이문,5961,5317,20200504,11278
20200501,1,외대앞,5507,5005,20200504,10512
20200501,경원선,청량리,13192,14388,20200504,27580
20200501,경원선,왕십리,9818,10898,20200504,20716
20200501,경원선,응봉,1278,1100,20200504,2378
20200501,경원선,옥수,39,22,20200504,61
20200501,경원선,한남,2553,2504,20200504,5057
20200501,경원선,서빙고,1056,930,20200504,1986
20200501,경원선,이촌,2693,1908,20200504,4601
20200502,1,소요산,3726,3114,20200505,6840
20200502,1,동두천,1243,1784,20200505,3027
20200502,1,보산,1068,1055,20200505,2123
20200502,1,동두천중앙,2229,2242,20200505,4471
20200502,1,지행,4370,4420,20200505,8790
20200502,1,덕정,3869,3662,20200505,7531
20200502,1,덕계,1559,1469,20200505,3028
20200502,1,양주,5288,4938,20200505,10226
20200502,1,녹양,3002,2821,20200505,5823
20200502,1,가능,4391,4114,20200505,8505
20200502,1,의정부,13929,14949,20200505,28878
20200502,1,회룡,7801,7848,20200505,15649
20200502,1,망월사,4597,4590,20200505,9187
20200502,1,도봉산,8237,5705,20200505,13942
20200502,1,도봉,3653,3360,20200505,7013
20200502,1,방학,6252,6153,20200505,12405
20200502,1,녹천,2865,2383,20200505,5248
20200502,1,월계,3941,3435,20200505,7376
20200502,1,광운대,4943,4659,20200505,9602
20200502,1,석계,5979,6536,20200505,12515
20200502,1,신이문,5385,4766,20200505,10151
20200502,1,외대앞,5021,4881,20200505,9902
20200502,경원선,청량리,12791,13682,20200505,26473
20200502,경원선,왕십리,9804,11170,20200505,20974
20200502,경원선,응봉,1238,1038,20200505,2276
20200502,경원선,옥수,48,40,20200505,88
20200502,경원선,한남,2399,2329,20200505,4728
20200502,경원선,서빙고,1057,949,20200505,2006
20200502,경원선,이촌,2512,1778,20200505,4290
20200503,1,소요산,4028,3190,20200506,7218
20200503,1,동두천,1031,1504,20200506,2535
20200503,1,보산,1061,885,20200506,1946
20200503,1,동두천중앙,1898,1813,20200506,3711
20200503,1,지행,3674,3618,20200506,7292
20200503,1,덕정,2981,3067,20200506,6048
20200503,1,덕계,1234,1161,20200506,2395
20200503,1,양주,4327,4343,20200506,8670
20200503,1,녹양,2344,2353,20200506,4697
20200503,1,가능,3591,3289,20200506,6880
20200503,1,의정부,11803,12362,20200506,24165
20200503,1,회룡,6235,6199,20200506,12434
20200503,1,망월사,3730,3871,20200506,7601
20200503,1,도봉산,7792,5726,20200506,13518
20200503,1,도봉,2945,2848,20200506,5793
20200503,1,방학,5199,4920,20200506,10119
20200503,1,창동,1,0,20200506,1
20200503,1,녹천,2368,2051,20200506,4419
20200503,1,월계,3151,2984,20200506,6135
20200503,1,광운대,3927,3992,20200506,7919
20200503,1,석계,4585,5137,20200506,9722
20200503,1,신이문,4329,3983,20200506,8312
20200503,1,외대앞,4116,3942,20200506,8058
20200503,경원선,청량리,11831,10935,20200506,22766
20200503,경원선,왕십리,7338,8745,20200506,16083
20200503,경원선,응봉,997,928,20200506,1925
20200503,경원선,옥수,52,39,20200506,91
20200503,경원선,한남,1755,1744,20200506,3499
20200503,경원선,서빙고,958,994,20200506,1952
20200503,경원선,이촌,1995,1554,20200506,3549
20200504,1,소요산,3143,2485,20200507,5628
20200504,1,동두천,1733,2227,20200507,3960
20200504,1,보산,1353,1180,20200507,2533
20200504,1,동두천중앙,3001,2764,20200507,5765
20200504,1,지행,5708,5511,20200507,11219
20200504,1,덕정,5004,4903,20200507,9907
20200504,1,덕계,2210,1929,20200507,4139
20200504,1,양주,7169,6600,20200507,13769
20200504,1,녹양,4062,3734,20200507,7796
20200504,1,가능,5752,5452,20200507,11204
20200504,1,의정부,16756,17926,20200507,34682
20200504,1,회룡,11020,10717,20200507,21737
20200504,1,망월사,6201,6249,20200507,12450
20200504,1,도봉산,7620,4882,20200507,12502
20200504,1,도봉,5445,5191,20200507,10636
20200504,1,방학,8758,8466,20200507,17224
20200504,1,창동,1,0,20200507,1
20200504,1,녹천,4167,3318,20200507,7485
20200504,1,월계,5181,4733,20200507,9914
20200504,1,광운대,7246,6843,20200507,14089
20200504,1,석계,7729,8823,20200507,16552
20200504,1,신이문,7794,6991,20200507,14785
20200504,1,외대앞,6606,6461,20200507,13067
20200504,경원선,청량리,13134,13799,20200507,26933
20200504,경원선,왕십리,11846,13870,20200507,25716
20200504,경원선,응봉,1576,1353,20200507,2929
20200504,경원선,옥수,48,31,20200507,79
20200504,경원선,한남,3775,3646,20200507,7421
20200504,경원선,서빙고,1451,1269,20200507,2720
20200504,경원선,이촌,3444,2616,20200507,6060
20200505,경원선,청량리,11238,11331,20200508,22569
20200505,1,외대앞,4486,4321,20200508,8807
20200505,1,신이문,4997,4638,20200508,9635
20200505,1,석계,5385,5744,20200508,11129
20200505,1,광운대,4332,4281,20200508,8613
20200505,1,월계,3503,3283,20200508,6786
20200505,1,녹천,2521,2088,20200508,4609
20200505,1,창동,1,0,20200508,1
20200505,1,방학,5745,5600,20200508,11345
20200505,1,도봉,3508,3250,20200508,6758
20200505,경원선,이촌,2079,1565,20200508,3644
20200505,경원선,서빙고,909,825,20200508,1734
20200505,경원선,한남,2138,2009,20200508,4147
20200505,경원선,옥수,53,28,20200508,81
20200505,경원선,응봉,1142,974,20200508,2116
20200505,경원선,왕십리,8335,9418,20200508,17753
20200505,1,도봉산,7519,5338,20200508,12857
20200505,1,망월사,4124,4350,20200508,8474
20200505,1,회룡,6944,7015,20200508,13959
20200505,1,의정부,12433,12476,20200508,24909
20200505,1,가능,3905,3752,20200508,7657
20200505,1,녹양,2659,2475,20200508,5134
20200505,1,양주,4767,4644,20200508,9411
20200505,1,덕계,1385,1295,20200508,2680
20200505,1,덕정,3365,3400,20200508,6765
20200505,1,지행,3921,3871,20200508,7792
20200505,1,동두천중앙,2197,2265,20200508,4462
20200505,1,보산,1017,857,20200508,1874
20200505,1,동두천,1328,1877,20200508,3205
20200505,1,소요산,3778,2975,20200508,6753
20200506,경원선,이촌,3699,2838,20200509,6537
20200506,경원선,서빙고,1776,1605,20200509,3381
20200506,경원선,한남,4117,3869,20200509,7986
20200506,경원선,옥수,44,28,20200509,72
20200506,경원선,응봉,1844,1524,20200509,3368
20200506,경원선,왕십리,12769,14597,20200509,27366
20200506,경원선,청량리,13395,14330,20200509,27725
20200506,1,외대앞,7044,6955,20200509,13999
20200506,1,신이문,8680,7937,20200509,16617
20200506,1,석계,8449,9650,20200509,18099
20200506,1,광운대,8084,7728,20200509,15812
20200506,1,월계,6251,5793,20200509,12044
20200506,1,녹천,4561,3888,20200509,8449
20200506,1,창동,1,0,20200509,1
20200506,1,방학,9596,9348,20200509,18944
20200506,1,도봉,5936,5702,20200509,11638
20200506,1,도봉산,8095,4922,20200509,13017
20200506,1,망월사,7028,7214,20200509,14242
20200506,1,회룡,12513,12215,20200509,24728
20200506,1,의정부,17642,18191,20200509,35833
20200506,1,가능,6408,6064,20200509,12472
20200506,1,녹양,4559,4323,20200509,8882
20200506,1,양주,7700,7057,20200509,14757
20200506,1,덕계,2471,2126,20200509,4597
20200506,1,덕정,5691,5593,20200509,11284
20200506,1,지행,6074,6005,20200509,12079
20200506,1,동두천중앙,3191,2949,20200509,6140
20200506,1,보산,1331,1223,20200509,2554
20200506,1,동두천,1855,2265,20200509,4120
20200506,1,소요산,3175,2528,20200509,5703
20200507,경원선,이촌,3817,2920,20200510,6737
20200507,경원선,서빙고,1750,1572,20200510,3322
20200507,경원선,한남,4280,4030,20200510,8310
20200507,경원선,옥수,35,31,20200510,66
20200507,경원선,응봉,1869,1612,20200510,3481
20200507,경원선,왕십리,13389,15263,20200510,28652
20200507,경원선,청량리,13581,14796,20200510,28377
20200507,1,외대앞,7089,6931,20200510,14020
20200507,1,신이문,8737,7910,20200510,16647
20200507,1,석계,8578,9669,20200510,18247
20200507,1,광운대,8370,7874,20200510,16244
20200507,1,월계,6184,5723,20200510,11907
20200507,1,녹천,4705,3904,20200510,8609
20200507,1,방학,9515,9314,20200510,18829
20200507,1,도봉,6063,5827,20200510,11890
20200507,1,도봉산,8098,5066,20200510,13164
20200507,1,망월사,6969,7174,20200510,14143
20200507,1,회룡,12550,12260,20200510,24810
20200507,1,의정부,17577,18399,20200510,35976
20200507,1,가능,6541,6137,20200510,12678
20200507,1,녹양,4497,4291,20200510,8788
20200507,1,양주,7811,7259,20200510,15070
20200507,1,덕계,2429,2184,20200510,4613
20200507,1,덕정,5785,5559,20200510,11344
20200507,1,지행,6009,5989,20200510,11998
20200507,1,동두천중앙,3147,3018,20200510,6165
20200507,1,보산,1356,1268,20200510,2624
20200507,1,동두천,1784,2241,20200510,4025
20200507,1,소요산,3218,2648,20200510,5866
20200508,경원선,이촌,3826,3064,20200511,6890
20200508,경원선,서빙고,1842,1646,20200511,3488
20200508,경원선,한남,4336,4035,20200511,8371
20200508,경원선,옥수,58,28,20200511,86
20200508,경원선,응봉,1824,1582,20200511,3406
20200508,경원선,왕십리,13744,16197,20200511,29941
20200508,경원선,청량리,15242,16890,20200511,32132
20200508,1,외대앞,7764,7330,20200511,15094
20200508,1,신이문,9010,8408,20200511,17418
20200508,1,석계,8620,9843,20200511,18463
20200508,1,광운대,8590,7929,20200511,16519
20200508,1,월계,6394,5907,20200511,12301
20200508,1,녹천,4696,3852,20200511,8548
20200508,1,방학,9717,9741,20200511,19458
20200508,1,도봉,6221,5922,20200511,12143
20200508,1,도봉산,7948,4983,20200511,12931
20200508,1,망월사,7071,7050,20200511,14121
20200508,1,회룡,12283,12482,20200511,24765
20200508,1,의정부,18218,19445,20200511,37663
20200508,1,가능,6403,6257,20200511,12660
20200508,1,녹양,4691,4519,20200511,9210
20200508,1,양주,8118,7556,20200511,15674
20200508,1,덕계,2448,2137,20200511,4585
20200508,1,덕정,6063,5498,20200511,11561
20200508,1,지행,6412,6313,20200511,12725
20200508,1,동두천중앙,3175,3108,20200511,6283
20200508,1,보산,1351,1273,20200511,2624
20200508,1,동두천,1858,2272,20200511,4130
20200508,1,소요산,3550,2528,20200511,6078
20200509,경원선,이촌,2211,1629,20200512,3840
20200509,경원선,서빙고,942,840,20200512,1782
20200509,경원선,한남,2189,2064,20200512,4253
20200509,경원선,옥수,24,30,20200512,54
20200509,경원선,응봉,1058,852,20200512,1910
20200509,경원선,왕십리,10069,11876,20200512,21945
20200509,경원선,청량리,11231,12299,20200512,23530
20200509,1,외대앞,4902,4755,20200512,9657
20200509,1,신이문,5276,4687,20200512,9963
20200509,1,석계,5716,6125,20200512,11841
20200509,1,광운대,4745,4523,20200512,9268
20200509,1,월계,3497,3195,20200512,6692
20200509,1,녹천,2732,2202,20200512,4934
20200509,1,방학,5899,5779,20200512,11678
20200509,1,도봉,3448,3279,20200512,6727
20200509,1,도봉산,4658,2987,20200512,7645
20200509,1,망월사,4467,4481,20200512,8948
20200509,1,회룡,7338,7252,20200512,14590
20200509,1,의정부,13767,14926,20200512,28693
20200509,1,가능,4253,4015,20200512,8268
20200509,1,녹양,2824,2669,20200512,5493
20200509,1,양주,4948,4628,20200512,9576
20200509,1,덕계,1474,1296,20200512,2770
20200509,1,덕정,4050,3841,20200512,7891
20200509,1,지행,4374,4261,20200512,8635
20200509,1,동두천중앙,2065,2022,20200512,4087
20200509,1,보산,938,984,20200512,1922
20200509,1,동두천,1133,1361,20200512,2494
20200509,1,소요산,2142,1614,20200512,3756
20200510,경원선,이촌,1994,1541,20200513,3535
20200510,경원선,서빙고,929,1044,20200513,1973
20200510,경원선,한남,1701,1731,20200513,3432
20200510,경원선,옥수,63,20,20200513,83
20200510,경원선,응봉,945,865,20200513,1810
20200510,경원선,왕십리,7703,8611,20200513,16314
20200510,경원선,청량리,10963,10455,20200513,21418
20200510,1,외대앞,4221,4218,20200513,8439
20200510,1,신이문,4383,4033,20200513,8416
20200510,1,석계,4807,5334,20200513,10141
20200510,1,광운대,3952,3979,20200513,7931
20200510,1,월계,3162,2896,20200513,6058
20200510,1,녹천,2447,2061,20200513,4508
20200510,1,방학,5332,5031,20200513,10363
20200510,1,도봉,3303,3099,20200513,6402
20200510,1,도봉산,8180,5838,20200513,14018
20200510,1,망월사,4053,4121,20200513,8174
20200510,1,회룡,6568,6603,20200513,13171
20200510,1,의정부,12760,12895,20200513,25655
20200510,1,가능,3640,3459,20200513,7099
20200510,1,녹양,2740,2526,20200513,5266
20200510,1,양주,4765,4631,20200513,9396
20200510,1,덕계,1367,1248,20200513,2615
20200510,1,덕정,3385,3381,20200513,6766
20200510,1,지행,3952,3905,20200513,7857
20200510,1,동두천중앙,2058,1943,20200513,4001
20200510,1,보산,1043,877,20200513,1920
20200510,1,동두천,1218,1740,20200513,2958
20200510,1,소요산,3778,2906,20200513,6684
20200511,1,소요산,3348,2450,20200514,5798
20200511,1,동두천,2014,2474,20200514,4488
20200511,1,보산,1432,1204,20200514,2636
20200511,1,동두천중앙,3234,3007,20200514,6241
20200511,1,지행,6121,5928,20200514,12049
20200511,1,덕정,5881,5758,20200514,11639
20200511,1,덕계,2419,2229,20200514,4648
20200511,1,양주,7904,7224,20200514,15128
20200511,1,녹양,4579,4191,20200514,8770
20200511,1,가능,6372,6082,20200514,12454
20200511,1,의정부,17703,18305,20200514,36008
20200511,1,회룡,12389,11932,20200514,24321
20200511,1,망월사,7233,7406,20200514,14639
20200511,1,도봉산,7791,4884,20200514,12675
20200511,1,도봉,6110,5939,20200514,12049
20200511,1,방학,9738,9435,20200514,19173
20200511,1,녹천,4616,3911,20200514,8527
20200511,1,월계,6084,5647,20200514,11731
20200511,1,광운대,8070,7723,20200514,15793
20200511,1,석계,8514,9645,20200514,18159
20200511,1,신이문,8581,7806,20200514,16387
20200511,1,외대앞,7149,7161,20200514,14310
20200511,경원선,청량리,13074,14079,20200514,27153
20200511,경원선,왕십리,12800,14531,20200514,27331
20200511,경원선,응봉,1707,1531,20200514,3238
20200511,경원선,옥수,43,32,20200514,75
20200511,경원선,한남,4037,3781,20200514,7818
20200511,경원선,서빙고,1707,1545,20200514,3252
20200511,경원선,이촌,3625,2873,20200514,6498
20200512,경원선,이촌,3484,2646,20200515,6130
20200512,경원선,서빙고,1705,1534,20200515,3239
20200512,경원선,한남,3930,3713,20200515,7643
20200512,경원선,옥수,39,26,20200515,65
20200512,경원선,응봉,1700,1472,20200515,3172
20200512,경원선,왕십리,12615,14404,20200515,27019
20200512,경원선,청량리,12304,13530,20200515,25834
20200512,1,외대앞,6850,6713,20200515,13563
20200512,1,신이문,8548,7711,20200515,16259
20200512,1,석계,8568,9690,20200515,18258
20200512,1,광운대,8083,7582,20200515,15665
20200512,1,월계,5795,5372,20200515,11167
20200512,1,녹천,4483,3758,20200515,8241
20200512,1,방학,9307,9133,20200515,18440
20200512,1,도봉,5858,5683,20200515,11541
20200512,1,도봉산,7696,4742,20200515,12438
20200512,1,망월사,7013,7210,20200515,14223
20200512,1,회룡,11975,11777,20200515,23752
20200512,1,의정부,17289,17873,20200515,35162
20200512,1,가능,6259,6012,20200515,12271
20200512,1,녹양,4500,4242,20200515,8742
20200512,1,양주,7530,6891,20200515,14421
20200512,1,덕계,2321,2057,20200515,4378
20200512,1,덕정,5929,5726,20200515,11655
20200512,1,지행,6015,5823,20200515,11838
20200512,1,동두천중앙,3137,3009,20200515,6146
20200512,1,보산,1305,1217,20200515,2522
20200512,1,동두천,1989,2341,20200515,4330
20200512,1,소요산,3136,2282,20200515,5418
20200513,경원선,이촌,3680,2794,20200516,6474
20200513,경원선,서빙고,1729,1556,20200516,3285
20200513,경원선,한남,4059,3786,20200516,7845
20200513,경원선,옥수,44,26,20200516,70
20200513,경원선,응봉,1788,1504,20200516,3292
20200513,경원선,왕십리,12977,14936,20200516,27913
20200513,경원선,청량리,12543,13767,20200516,26310
20200513,1,외대앞,7053,6939,20200516,13992
20200513,1,신이문,8612,7837,20200516,16449
20200513,1,석계,8491,9530,20200516,18021
20200513,1,광운대,8015,7569,20200516,15584
20200513,1,월계,5789,5290,20200516,11079
20200513,1,녹천,4517,3717,20200516,8234
20200513,1,방학,9343,9134,20200516,18477
20200513,1,도봉,5940,5666,20200516,11606
20200513,1,도봉산,8149,5146,20200516,13295
20200513,1,망월사,7111,7278,20200516,14389
20200513,1,회룡,12104,11795,20200516,23899
20200513,1,의정부,17191,17953,20200516,35144
20200513,1,가능,6404,6144,20200516,12548
20200513,1,녹양,4519,4258,20200516,8777
20200513,1,양주,7625,6974,20200516,14599
20200513,1,덕계,2419,2179,20200516,4598
20200513,1,덕정,5735,5610,20200516,11345
20200513,1,지행,5996,5917,20200516,11913
20200513,1,동두천중앙,3006,2854,20200516,5860
20200513,1,보산,1347,1160,20200516,2507
20200513,1,동두천,1844,2343,20200516,4187
20200513,1,소요산,3296,2549,20200516,5845
20200514,경원선,왕십리,12966,14766,20200517,27732
20200514,경원선,청량리,12661,13853,20200517,26514
20200514,1,외대앞,6915,6813,20200517,13728
20200514,1,신이문,8461,7558,20200517,16019
20200514,1,석계,8341,9457,20200517,17798
20200514,1,광운대,8122,7558,20200517,15680
20200514,1,월계,5760,5347,20200517,11107
20200514,1,녹천,4580,3730,20200517,8310
20200514,1,창동,1,0,20200517,1
20200514,1,방학,9247,9127,20200517,18374
20200514,1,도봉,6045,5682,20200517,11727
20200514,1,도봉산,7995,5120,20200517,13115
20200514,1,망월사,6907,7105,20200517,14012
20200514,1,회룡,12001,11811,20200517,23812
20200514,1,의정부,16798,17601,20200517,34399
20200514,1,가능,6205,6046,20200517,12251
20200514,1,녹양,4421,4272,20200517,8693
20200514,1,양주,7485,6970,20200517,14455
20200514,1,덕계,2377,2100,20200517,4477
20200514,1,덕정,5518,5444,20200517,10962
20200514,1,지행,5877,5886,20200517,11763
20200514,1,동두천중앙,3003,2845,20200517,5848
20200514,1,보산,1301,1200,20200517,2501
20200514,1,동두천,1873,2219,20200517,4092
20200514,1,소요산,3156,2539,20200517,5695
20200514,경원선,이촌,3667,2801,20200517,6468
20200514,경원선,서빙고,1706,1573,20200517,3279
20200514,경원선,한남,4093,3743,20200517,7836
20200514,경원선,옥수,41,24,20200517,65
20200514,경원선,응봉,1802,1568,20200517,3370
20200515,1,소요산,2146,1654,20200518,3800
20200515,1,동두천,1715,1942,20200518,3657
20200515,1,보산,1254,1146,20200518,2400
20200515,1,동두천중앙,2858,2818,20200518,5676
20200515,1,지행,5805,5722,20200518,11527
20200515,1,덕정,5381,5027,20200518,10408
20200515,1,덕계,2151,1912,20200518,4063
20200515,1,양주,7114,6471,20200518,13585
20200515,1,녹양,4334,3963,20200518,8297
20200515,1,가능,5885,5789,20200518,11674
20200515,1,의정부,16444,17563,20200518,34007
20200515,1,회룡,11284,11023,20200518,22307
20200515,1,망월사,6698,6693,20200518,13391
20200515,1,도봉산,5950,3449,20200518,9399
20200515,1,도봉,5644,5348,20200518,10992
20200515,1,방학,8735,8699,20200518,17434
20200515,1,녹천,4273,3483,20200518,7756
20200515,1,월계,5299,4960,20200518,10259
20200515,1,광운대,7831,7151,20200518,14982
20200515,1,석계,7922,9079,20200518,17001
20200515,1,신이문,8123,7350,20200518,15473
20200515,1,외대앞,6900,6680,20200518,13580
20200515,경원선,청량리,13390,14417,20200518,27807
20200515,경원선,왕십리,13064,15486,20200518,28550
20200515,경원선,응봉,1639,1345,20200518,2984
20200515,경원선,옥수,54,24,20200518,78
20200515,경원선,한남,3866,3585,20200518,7451
20200515,경원선,서빙고,1662,1460,20200518,3122
20200515,경원선,이촌,3451,2604,20200518,6055
20200516,경원선,왕십리,10788,12647,20200519,23435
20200516,경원선,응봉,1380,1166,20200519,2546
20200516,경원선,옥수,20,39,20200519,59
20200516,경원선,한남,2347,2219,20200519,4566
20200516,경원선,서빙고,1089,972,20200519,2061
20200516,경원선,이촌,2555,1797,20200519,4352
20200516,1,소요산,3418,2822,20200519,6240
20200516,1,동두천,1437,1816,20200519,3253
20200516,1,보산,1090,1164,20200519,2254
20200516,1,동두천중앙,2464,2356,20200519,4820
20200516,1,지행,4903,4889,20200519,9792
20200516,1,덕정,4200,3985,20200519,8185
20200516,1,덕계,1703,1543,20200519,3246
20200516,1,양주,5459,5318,20200519,10777
20200516,1,녹양,3188,3093,20200519,6281
20200516,1,가능,4634,4384,20200519,9018
20200516,1,의정부,14999,16345,20200519,31344
20200516,1,회룡,8251,8298,20200519,16549
20200516,1,망월사,5001,5067,20200519,10068
20200516,1,도봉산,7607,4976,20200519,12583
20200516,1,도봉,4023,3724,20200519,7747
20200516,1,방학,6671,6513,20200519,13184
20200516,1,창동,2,0,20200519,2
20200516,1,녹천,3095,2570,20200519,5665
20200516,1,월계,4163,3707,20200519,7870
20200516,1,광운대,5340,5030,20200519,10370
20200516,1,석계,6479,7086,20200519,13565
20200516,1,신이문,5888,5175,20200519,11063
20200516,1,외대앞,5447,5201,20200519,10648
20200516,경원선,청량리,11820,12938,20200519,24758
20200517,1,소요산,4496,3725,20200520,8221
20200517,1,동두천,1149,1819,20200520,2968
20200517,1,보산,986,830,20200520,1816
20200517,1,동두천중앙,2024,1949,20200520,3973
20200517,1,지행,3844,3750,20200520,7594
20200517,1,덕정,3368,3198,20200520,6566
20200517,1,덕계,1373,1250,20200520,2623
20200517,1,양주,4602,4481,20200520,9083
20200517,1,녹양,2470,2485,20200520,4955
20200517,1,가능,3844,3505,20200520,7349
20200517,1,의정부,12247,12482,20200520,24729
20200517,1,회룡,6725,6564,20200520,13289
20200517,1,망월사,4087,4273,20200520,8360
20200517,1,도봉산,9508,6907,20200520,16415
20200517,1,도봉,3249,2989,20200520,6238
20200517,1,방학,5430,5236,20200520,10666
20200517,1,창동,1,0,20200520,1
20200517,1,녹천,2408,1998,20200520,4406
20200517,1,월계,3339,3197,20200520,6536
20200517,1,광운대,4047,4031,20200520,8078
20200517,1,석계,4820,5170,20200520,9990
20200517,1,신이문,4465,3999,20200520,8464
20200517,1,외대앞,4358,4243,20200520,8601
20200517,경원선,청량리,10608,10459,20200520,21067
20200517,경원선,왕십리,8144,9247,20200520,17391
20200517,경원선,응봉,1011,896,20200520,1907
20200517,경원선,옥수,47,26,20200520,73
20200517,경원선,한남,1734,1723,20200520,3457
20200517,경원선,서빙고,1044,1050,20200520,2094
20200517,경원선,이촌,2079,1664,20200520,3743
20200518,경원선,이촌,3401,2620,20200521,6021
20200518,경원선,서빙고,1561,1446,20200521,3007
20200518,경원선,한남,3856,3646,20200521,7502
20200518,경원선,옥수,37,23,20200521,60
20200518,경원선,응봉,1606,1391,20200521,2997
20200518,경원선,왕십리,12162,13849,20200521,26011
20200518,경원선,청량리,12139,13013,20200521,25152
20200518,1,외대앞,6679,6731,20200521,13410
20200518,1,신이문,8403,7898,20200521,16301
20200518,1,석계,7870,9117,20200521,16987
20200518,1,광운대,7848,7604,20200521,15452
20200518,1,월계,5506,5117,20200521,10623
20200518,1,녹천,4374,3743,20200521,8117
20200518,1,방학,8894,8795,20200521,17689
20200518,1,도봉,5742,5510,20200521,11252
20200518,1,도봉산,6574,4018,20200521,10592
20200518,1,망월사,6790,6979,20200521,13769
20200518,1,회룡,11412,11182,20200521,22594
20200518,1,의정부,16236,16380,20200521,32616
20200518,1,가능,5987,5823,20200521,11810
20200518,1,녹양,4158,3899,20200521,8057
20200518,1,양주,7220,6630,20200521,13850
20200518,1,덕계,2304,1998,20200521,4302
20200518,1,덕정,5072,5110,20200521,10182
20200518,1,지행,5643,5519,20200521,11162
20200518,1,동두천중앙,2905,2769,20200521,5674
20200518,1,보산,1314,1095,20200521,2409
20200518,1,동두천,1670,2047,20200521,3717
20200518,1,소요산,2502,2139,20200521,4641
20200519,1,소요산,2138,1829,20200522,3967
20200519,1,동두천,1710,1963,20200522,3673
20200519,1,보산,1187,1067,20200522,2254
20200519,1,동두천중앙,2778,2698,20200522,5476
20200519,1,지행,5593,5432,20200522,11025
20200519,1,덕정,5230,5081,20200522,10311
20200519,1,덕계,2139,1892,20200522,4031
20200519,1,양주,6990,6359,20200522,13349
20200519,1,녹양,4200,4004,20200522,8204
20200519,1,가능,5954,5678,20200522,11632
20200519,1,의정부,16158,16705,20200522,32863
20200519,1,회룡,11278,11048,20200522,22326
20200519,1,망월사,6829,7017,20200522,13846
20200519,1,도봉산,6320,3781,20200522,10101
20200519,1,도봉,5691,5309,20200522,11000
20200519,1,방학,8997,8862,20200522,17859
20200519,1,녹천,4372,3645,20200522,8017
20200519,1,월계,5394,5207,20200522,10601
20200519,1,광운대,7984,7555,20200522,15539
20200519,1,석계,8032,9018,20200522,17050
20200519,1,신이문,8322,7614,20200522,15936
20200519,1,외대앞,6591,6562,20200522,13153
20200519,경원선,청량리,11666,12649,20200522,24315
20200519,경원선,왕십리,12592,14201,20200522,26793
20200519,경원선,응봉,1594,1401,20200522,2995
20200519,경원선,옥수,34,27,20200522,61
20200519,경원선,한남,3861,3590,20200522,7451
20200519,경원선,서빙고,1626,1456,20200522,3082
20200519,경원선,이촌,3344,2619,20200522,5963
20200520,1,소요산,3252,2607,20200523,5859
20200520,1,동두천,2021,2491,20200523,4512
20200520,1,보산,1565,1388,20200523,2953
20200520,1,동두천중앙,3302,3292,20200523,6594
20200520,1,지행,6279,6137,20200523,12416
20200520,1,덕정,5549,5431,20200523,10980
20200520,1,덕계,2576,2223,20200523,4799
20200520,1,양주,7787,7251,20200523,15038
20200520,1,녹양,4685,4335,20200523,9020
20200520,1,가능,6653,6315,20200523,12968
20200520,1,의정부,17580,18365,20200523,35945
20200520,1,회룡,12493,12240,20200523,24733
20200520,1,망월사,7385,7443,20200523,14828
20200520,1,도봉산,8478,5410,20200523,13888
20200520,1,도봉,6239,5956,20200523,12195
20200520,1,방학,9742,9584,20200523,19326
20200520,1,창동,1,0,20200523,1
20200520,1,녹천,4719,3920,20200523,8639
20200520,1,월계,6153,5628,20200523,11781
20200520,1,광운대,8051,7591,20200523,15642
20200520,1,석계,8719,9905,20200523,18624
20200520,1,신이문,8872,8078,20200523,16950
20200520,1,외대앞,7379,7205,20200523,14584
20200520,경원선,청량리,12924,14236,20200523,27160
20200520,경원선,왕십리,13530,15497,20200523,29027
20200520,경원선,응봉,1831,1504,20200523,3335
20200520,경원선,옥수,35,28,20200523,63
20200520,경원선,한남,4160,3913,20200523,8073
20200520,경원선,서빙고,1732,1534,20200523,3266
20200520,경원선,이촌,3800,2922,20200523,6722
20200521,1,소요산,3335,2837,20200524,6172
20200521,1,동두천,1916,2381,20200524,4297
20200521,1,보산,1743,1445,20200524,3188
20200521,1,동두천중앙,3139,3112,20200524,6251
20200521,1,지행,6300,6256,20200524,12556
20200521,1,덕정,5679,5759,20200524,11438
20200521,1,덕계,2454,2236,20200524,4690
20200521,1,양주,7604,7237,20200524,14841
20200521,1,녹양,4586,4348,20200524,8934
20200521,1,가능,6442,6369,20200524,12811
20200521,1,의정부,17369,18406,20200524,35775
20200521,1,회룡,12240,11922,20200524,24162
20200521,1,망월사,7266,7375,20200524,14641
20200521,1,도봉산,8472,5454,20200524,13926
20200521,1,도봉,6178,5950,20200524,12128
20200521,1,방학,9695,9496,20200524,19191
20200521,1,녹천,4788,3960,20200524,8748
20200521,1,월계,6117,5698,20200524,11815
20200521,1,광운대,8523,7943,20200524,16466
20200521,1,석계,8872,9966,20200524,18838
20200521,1,신이문,8968,8035,20200524,17003
20200521,1,외대앞,7340,7204,20200524,14544
20200521,경원선,청량리,13206,14356,20200524,27562
20200521,경원선,왕십리,13415,15165,20200524,28580
20200521,경원선,응봉,1931,1679,20200524,3610
20200521,경원선,옥수,33,22,20200524,55
20200521,경원선,한남,4281,3894,20200524,8175
20200521,경원선,서빙고,1809,1590,20200524,3399
20200521,경원선,이촌,3756,2859,20200524,6615
20200522,경원선,이촌,3916,2914,20200525,6830
20200522,경원선,서빙고,1810,1570,20200525,3380
20200522,경원선,한남,4154,3883,20200525,8037
20200522,경원선,옥수,57,24,20200525,81
20200522,경원선,응봉,1820,1500,20200525,3320
20200522,경원선,왕십리,14279,16531,20200525,30810
20200522,경원선,청량리,15166,16301,20200525,31467
20200522,1,외대앞,7985,7508,20200525,15493
20200522,1,신이문,8986,7890,20200525,16876
20200522,1,석계,8949,10088,20200525,19037
20200522,1,광운대,8350,7795,20200525,16145
20200522,1,월계,6146,5583,20200525,11729
20200522,1,녹천,4692,3878,20200525,8570
20200522,1,방학,9781,9592,20200525,19373
20200522,1,도봉,6204,5772,20200525,11976
20200522,1,도봉산,8289,5173,20200525,13462
20200522,1,망월사,7344,7366,20200525,14710
20200522,1,회룡,12477,12053,20200525,24530
20200522,1,의정부,18444,19801,20200525,38245
20200522,1,가능,6524,6241,20200525,12765
20200522,1,녹양,4628,4367,20200525,8995
20200522,1,양주,7948,7118,20200525,15066
20200522,1,덕계,2468,2159,20200525,4627
20200522,1,덕정,6251,5775,20200525,12026
20200522,1,지행,6857,6845,20200525,13702
20200522,1,동두천중앙,3217,3190,20200525,6407
20200522,1,보산,1960,1771,20200525,3731
20200522,1,동두천,2014,2469,20200525,4483
20200522,1,소요산,3289,2925,20200525,6214
20200523,경원선,이촌,3109,2216,20200526,5325
20200523,경원선,서빙고,1198,1011,20200526,2209
20200523,경원선,한남,2664,2526,20200526,5190
20200523,경원선,옥수,41,38,20200526,79
20200523,경원선,응봉,1732,1599,20200526,3331
20200523,경원선,왕십리,11925,13693,20200526,25618
20200523,경원선,청량리,13519,15216,20200526,28735
20200523,1,외대앞,6250,5906,20200526,12156
20200523,1,신이문,6340,5617,20200526,11957
20200523,1,석계,7162,7618,20200526,14780
20200523,1,광운대,5825,5500,20200526,11325
20200523,1,월계,4405,3961,20200526,8366
20200523,1,녹천,3389,2855,20200526,6244
20200523,1,창동,1,0,20200526,1
20200523,1,방학,7304,6997,20200526,14301
20200523,1,도봉,4407,4094,20200526,8501
20200523,1,도봉산,9973,7031,20200526,17004
20200523,1,망월사,5456,5678,20200526,11134
20200523,1,회룡,9445,9292,20200526,18737
20200523,1,의정부,16259,17441,20200526,33700
20200523,1,가능,5158,4829,20200526,9987
20200523,1,녹양,3598,3413,20200526,7011
20200523,1,양주,6061,5755,20200526,11816
20200523,1,덕계,1787,1687,20200526,3474
20200523,1,덕정,4644,4215,20200526,8859
20200523,1,지행,5597,5516,20200526,11113
20200523,1,동두천중앙,2607,2555,20200526,5162
20200523,1,보산,1757,1735,20200526,3492
20200523,1,동두천,1605,2049,20200526,3654
20200523,1,소요산,4610,3862,20200526,8472
20200524,1,소요산,3236,2788,20200527,6024
20200524,1,동두천,1091,1444,20200527,2535
20200524,1,보산,1360,1220,20200527,2580
20200524,1,동두천중앙,1848,1800,20200527,3648
20200524,1,지행,3991,3999,20200527,7990
20200524,1,덕정,3050,3237,20200527,6287
20200524,1,덕계,1282,1163,20200527,2445
20200524,1,양주,4147,4082,20200527,8229
20200524,1,녹양,2477,2359,20200527,4836
20200524,1,가능,3491,3242,20200527,6733
20200524,1,의정부,12273,12526,20200527,24799
20200524,1,회룡,6188,6016,20200527,12204
20200524,1,망월사,3744,3820,20200527,7564
20200524,1,도봉산,6337,4657,20200527,10994
20200524,1,도봉,3047,2756,20200527,5803
20200524,1,방학,5013,4861,20200527,9874
20200524,1,녹천,2292,1926,20200527,4218
20200524,1,월계,3461,3053,20200527,6514
20200524,1,광운대,3927,3995,20200527,7922
20200524,1,석계,4610,5108,20200527,9718
20200524,1,신이문,4235,3927,20200527,8162
20200524,1,외대앞,5031,4800,20200527,9831
20200524,경원선,청량리,10123,9683,20200527,19806
20200524,경원선,왕십리,7336,8513,20200527,15849
20200524,경원선,응봉,967,867,20200527,1834
20200524,경원선,옥수,44,19,20200527,63
20200524,경원선,한남,1729,1680,20200527,3409
20200524,경원선,서빙고,1039,1068,20200527,2107
20200524,경원선,이촌,2000,1530,20200527,3530
20200525,1,소요산,3238,2679,20200528,5917
20200525,1,동두천,2115,2588,20200528,4703
20200525,1,보산,1739,1722,20200528,3461
20200525,1,동두천중앙,3427,3309,20200528,6736
20200525,1,지행,6560,6488,20200528,13048
20200525,1,덕정,5901,5837,20200528,11738
20200525,1,덕계,2450,2243,20200528,4693
20200525,1,양주,7899,7260,20200528,15159
20200525,1,녹양,4549,4257,20200528,8806
20200525,1,가능,6292,6091,20200528,12383
20200525,1,의정부,17439,17976,20200528,35415
20200525,1,회룡,12579,12115,20200528,24694
20200525,1,망월사,7641,7845,20200528,15486
20200525,1,도봉산,7982,5031,20200528,13013
20200525,1,도봉,6143,5752,20200528,11895
20200525,1,방학,9807,9578,20200528,19385
20200525,1,녹천,4688,3946,20200528,8634
20200525,1,월계,6067,5656,20200528,11723
20200525,1,광운대,8384,8011,20200528,16395
20200525,1,석계,8649,9758,20200528,18407
20200525,1,신이문,8786,7910,20200528,16696
20200525,1,외대앞,7177,7307,20200528,14484
20200525,경원선,청량리,13125,14352,20200528,27477
20200525,경원선,왕십리,13372,14892,20200528,28264
20200525,경원선,응봉,1829,1519,20200528,3348
20200525,경원선,옥수,49,33,20200528,82
20200525,경원선,한남,4087,3736,20200528,7823
20200525,경원선,서빙고,1660,1537,20200528,3197
20200525,경원선,이촌,3759,2879,20200528,6638
20200526,1,소요산,3112,2353,20200529,5465
20200526,1,동두천,1994,2401,20200529,4395
20200526,1,보산,1341,1218,20200529,2559
20200526,1,동두천중앙,3141,3057,20200529,6198
20200526,1,지행,6158,5899,20200529,12057
20200526,1,덕정,5882,5664,20200529,11546
20200526,1,덕계,2374,2083,20200529,4457
20200526,1,양주,7840,7212,20200529,15052
20200526,1,녹양,4510,4303,20200529,8813
20200526,1,가능,6382,6109,20200529,12491
20200526,1,의정부,17005,17509,20200529,34514
20200526,1,회룡,12254,12013,20200529,24267
20200526,1,망월사,7655,7807,20200529,15462
20200526,1,도봉산,7927,4971,20200529,12898
20200526,1,도봉,6075,5771,20200529,11846
20200526,1,방학,9460,9167,20200529,18627
20200526,1,녹천,4665,3944,20200529,8609
20200526,1,월계,6006,5584,20200529,11590
20200526,1,광운대,8528,7991,20200529,16519
20200526,1,석계,8515,9608,20200529,18123
20200526,1,신이문,8848,8173,20200529,17021
20200526,1,외대앞,7170,7049,20200529,14219
20200526,경원선,청량리,12844,13920,20200529,26764
20200526,경원선,왕십리,13141,14765,20200529,27906
20200526,경원선,응봉,1769,1494,20200529,3263
20200526,경원선,옥수,39,25,20200529,64
20200526,경원선,한남,4112,3921,20200529,8033
20200526,경원선,서빙고,1778,1634,20200529,3412
20200526,경원선,이촌,3625,2824,20200529,6449
20200527,1,소요산,3276,2731,20200530,6007
20200527,1,동두천,2227,2537,20200530,4764
20200527,1,보산,1509,1424,20200530,2933
20200527,1,동두천중앙,3300,3125,20200530,6425
20200527,1,지행,6345,6296,20200530,12641
20200527,1,덕정,6153,5922,20200530,12075
20200527,1,덕계,2530,2216,20200530,4746
20200527,1,양주,7885,7281,20200530,15166
20200527,1,녹양,4681,4443,20200530,9124
20200527,1,가능,6725,6451,20200530,13176
20200527,1,의정부,17735,18447,20200530,36182
20200527,1,회룡,12703,12330,20200530,25033
20200527,1,망월사,8031,8171,20200530,16202
20200527,1,도봉산,8564,5458,20200530,14022
20200527,1,도봉,6055,5822,20200530,11877
20200527,1,방학,9606,9313,20200530,18919
20200527,1,창동,1,0,20200530,1
20200527,1,녹천,4757,3963,20200530,8720
20200527,1,월계,6157,5762,20200530,11919
20200527,1,광운대,8635,8083,20200530,16718
20200527,1,석계,8721,9951,20200530,18672
20200527,1,신이문,8990,8101,20200530,17091
20200527,1,외대앞,7440,7317,20200530,14757
20200527,경원선,청량리,13212,14427,20200530,27639
20200527,경원선,왕십리,13267,15117,20200530,28384
20200527,경원선,응봉,1829,1558,20200530,3387
20200527,경원선,옥수,40,28,20200530,68
20200527,경원선,한남,4276,3983,20200530,8259
20200527,경원선,서빙고,1858,1634,20200530,3492
20200527,경원선,이촌,3866,3041,20200530,6907
20200528,1,소요산,3090,2593,20200531,5683
20200528,1,동두천,2213,2508,20200531,4721
20200528,1,보산,1398,1328,20200531,2726
20200528,1,동두천중앙,3214,3101,20200531,6315
20200528,1,지행,6226,6212,20200531,12438
20200528,1,덕정,5930,5882,20200531,11812
20200528,1,덕계,2456,2185,20200531,4641
20200528,1,양주,7626,7072,20200531,14698
20200528,1,녹양,4557,4318,20200531,8875
20200528,1,가능,6525,6328,20200531,12853
20200528,1,의정부,17538,18275,20200531,35813
20200528,1,회룡,12357,12119,20200531,24476
20200528,1,망월사,7666,7862,20200531,15528
20200528,1,도봉산,8129,5171,20200531,13300
20200528,1,도봉,6089,5740,20200531,11829
20200528,1,방학,9522,9313,20200531,18835
20200528,1,녹천,4732,4007,20200531,8739
20200528,1,월계,6164,5773,20200531,11937
20200528,1,광운대,8494,8052,20200531,16546
20200528,1,석계,8633,9674,20200531,18307
20200528,1,신이문,8860,7994,20200531,16854
20200528,1,외대앞,7230,7145,20200531,14375
20200528,경원선,청량리,13211,14273,20200531,27484
20200528,경원선,왕십리,13295,14859,20200531,28154
20200528,경원선,응봉,1825,1565,20200531,3390
20200528,경원선,옥수,40,32,20200531,72
20200528,경원선,한남,4213,3882,20200531,8095
20200528,경원선,서빙고,1824,1628,20200531,3452
20200528,경원선,이촌,3740,2866,20200531,6606
20200529,경원선,이촌,4010,2947,20200601,6957
20200529,경원선,서빙고,1869,1628,20200601,3497
20200529,경원선,한남,4226,3914,20200601,8140
20200529,경원선,옥수,75,24,20200601,99
20200529,경원선,응봉,1799,1487,20200601,3286
20200529,경원선,왕십리,13949,15846,20200601,29795
20200529,경원선,청량리,14699,15918,20200601,30617
20200529,1,외대앞,7665,7468,20200601,15133
20200529,1,신이문,9010,7951,20200601,16961
20200529,1,석계,8847,9992,20200601,18839
20200529,1,광운대,8481,7872,20200601,16353
20200529,1,월계,6254,5826,20200601,12080
20200529,1,녹천,4768,3858,20200601,8626
20200529,1,방학,9571,9285,20200601,18856
20200529,1,도봉,5981,5628,20200601,11609
20200529,1,도봉산,8464,5310,20200601,13774
20200529,1,망월사,7531,7518,20200601,15049
20200529,1,회룡,12620,12370,20200601,24990
20200529,1,의정부,17964,19868,20200601,37832
20200529,1,가능,6577,6352,20200601,12929
20200529,1,녹양,4878,4537,20200601,9415
20200529,1,양주,8003,7341,20200601,15344
20200529,1,덕계,2544,2226,20200601,4770
20200529,1,덕정,6168,5742,20200601,11910
20200529,1,지행,6945,6751,20200601,13696
20200529,1,동두천중앙,3319,3238,20200601,6557
20200529,1,보산,1862,1570,20200601,3432
20200529,1,동두천,2219,2456,20200601,4675
20200529,1,소요산,3378,2836,20200601,6214
20200530,경원선,이촌,3078,2126,20200602,5204
20200530,경원선,서빙고,1182,963,20200602,2145
20200530,경원선,한남,2646,2428,20200602,5074
20200530,경원선,옥수,36,41,20200602,77
20200530,경원선,응봉,1338,1141,20200602,2479
20200530,경원선,왕십리,10820,12391,20200602,23211
20200530,경원선,청량리,12719,14210,20200602,26929
20200530,1,외대앞,5881,5408,20200602,11289
20200530,1,신이문,6160,5461,20200602,11621
20200530,1,석계,6903,7409,20200602,14312
20200530,1,광운대,5530,5294,20200602,10824
20200530,1,월계,4613,4071,20200602,8684
20200530,1,녹천,3097,2580,20200602,5677
20200530,1,방학,7109,6804,20200602,13913
20200530,1,도봉,4360,4022,20200602,8382
20200530,1,도봉산,9946,6893,20200602,16839
20200530,1,망월사,5651,5726,20200602,11377
20200530,1,회룡,9202,9057,20200602,18259
20200530,1,의정부,16571,17609,20200602,34180
20200530,1,가능,5030,4802,20200602,9832
20200530,1,녹양,3446,3325,20200602,6771
20200530,1,양주,6077,5721,20200602,11798
20200530,1,덕계,1784,1576,20200602,3360
20200530,1,덕정,4754,4468,20200602,9222
20200530,1,지행,5372,5446,20200602,10818
20200530,1,동두천중앙,2801,2820,20200602,5621
20200530,1,보산,2025,1911,20200602,3936
20200530,1,동두천,1563,1978,20200602,3541
20200530,1,소요산,4459,3789,20200602,8248
20200531,1,소요산,4406,3605,20200603,8011
20200531,1,동두천,1136,1743,20200603,2879
20200531,1,보산,1446,1472,20200603,2918
20200531,1,동두천중앙,2043,1895,20200603,3938
20200531,1,지행,3896,3991,20200603,7887
20200531,1,덕정,3026,3176,20200603,6202
20200531,1,덕계,1382,1230,20200603,2612
20200531,1,양주,4522,4429,20200603,8951
20200531,1,녹양,2468,2500,20200603,4968
20200531,1,가능,3709,3436,20200603,7145
20200531,1,의정부,12390,12406,20200603,24796
20200531,1,회룡,6570,6595,20200603,13165
20200531,1,망월사,4070,4185,20200603,8255
20200531,1,도봉산,9340,6753,20200603,16093
20200531,1,도봉,3130,2966,20200603,6096
20200531,1,방학,5285,5087,20200603,10372
20200531,1,녹천,2531,2095,20200603,4626
20200531,1,월계,3284,3039,20200603,6323
20200531,1,광운대,4023,4088,20200603,8111
20200531,1,석계,4676,5138,20200603,9814
20200531,1,신이문,4338,4093,20200603,8431
20200531,1,외대앞,4269,4096,20200603,8365
20200531,경원선,청량리,10888,10450,20200603,21338
20200531,경원선,왕십리,7782,8706,20200603,16488
20200531,경원선,응봉,884,881,20200603,1765
20200531,경원선,옥수,50,17,20200603,67
20200531,경원선,한남,1751,1780,20200603,3531
20200531,경원선,서빙고,1101,1076,20200603,2177
20200531,경원선,이촌,2163,1612,20200603,3775
20200101,K,문산,3627,3821,20200104,7448
20200101,K,파주,628,567,20200104,1195
20200101,K,월롱,728,1270,20200104,1998
20200101,K,금촌,4193,4651,20200104,8844
20200101,K,금릉,2379,2499,20200104,4878
20200101,K,운정,2877,2868,20200104,5745
20200101,K,야당,2843,2891,20200104,5734
20200101,K,탄현,3467,3472,20200104,6939
20200101,K,일산,3764,3709,20200104,7473
20200101,K,풍산,2744,2656,20200104,5400
20200101,K,백마,2713,2709,20200104,5422
20200101,K,곡산,220,212,20200104,432
20200101,K,능곡,1756,1721,20200104,3477
20200101,K,행신,3588,3480,20200104,7068
20200101,K,강매,1143,1120,20200104,2263
20200101,K,화전,784,927,20200104,1711
20200101,K,수색,722,760,20200104,1482
20200101,K,디지털미디어시티,1127,1092,20200104,2219
20200101,K,가좌,2310,2377,20200104,4687
20200101,K,홍대입구,1582,1959,20200104,3541
20200101,K,서강대,1199,1160,20200104,2359
20200101,K,공덕,1580,1318,20200104,2898
20200101,K,효창공원앞,1087,1288,20200104,2375
20200101,K,신촌,344,332,20200104,676
20200101,K,서울역,1309,969,20200104,2278
20200102,K,서울역,4770,6230,20200105,11000
20200102,K,신촌,1053,1408,20200105,2461
20200102,K,효창공원앞,3137,3442,20200105,6579
20200102,K,공덕,4154,3537,20200105,7691
20200102,K,서강대,2347,2327,20200105,4674
20200102,K,홍대입구,2107,2536,20200105,4643
20200102,K,가좌,5615,5162,20200105,10777
20200102,K,디지털미디어시티,2521,2411,20200105,4932
20200102,K,수색,2558,2608,20200105,5166
20200102,K,화전,1960,1758,20200105,3718
20200102,K,강매,3294,2773,20200105,6067
20200102,K,행신,8504,8389,20200105,16893
20200102,K,능곡,3891,3468,20200105,7359
20200102,K,곡산,569,587,20200105,1156
20200102,K,백마,7540,6908,20200105,14448
20200102,K,풍산,5668,5204,20200105,10872
20200102,K,일산,9835,9397,20200105,19232
20200102,K,탄현,8226,7961,20200105,16187
20200102,K,야당,5947,5648,20200105,11595
20200102,K,운정,6584,5893,20200105,12477
20200102,K,금릉,4857,4687,20200105,9544
20200102,K,금촌,7165,6838,20200105,14003
20200102,K,월롱,1967,1931,20200105,3898
20200102,K,파주,1397,915,20200105,2312
20200102,K,문산,5871,5612,20200105,11483
20200102,K,서울역,1,0,20200105,1
20200103,K,서울역,5170,6674,20200106,11844
20200103,K,신촌,1062,1422,20200106,2484
20200103,K,효창공원앞,3242,3702,20200106,6944
20200103,K,공덕,4262,3720,20200106,7982
20200103,K,서강대,2487,2366,20200106,4853
20200103,K,홍대입구,2376,3012,20200106,5388
20200103,K,가좌,6008,5509,20200106,11517
20200103,K,디지털미디어시티,2678,2527,20200106,5205
20200103,K,수색,2576,2688,20200106,5264
20200103,K,화전,1824,1712,20200106,3536
20200103,K,강매,3330,2696,20200106,6026
20200103,K,행신,9273,8782,20200106,18055
20200103,K,능곡,4062,3636,20200106,7698
20200103,K,곡산,632,632,20200106,1264
20200103,K,백마,7949,7271,20200106,15220
20200103,K,풍산,6161,5533,20200106,11694
20200103,K,일산,11153,10902,20200106,22055
20200103,K,탄현,8574,8364,20200106,16938
20200103,K,야당,6309,6009,20200106,12318
20200103,K,운정,6831,6347,20200106,13178
20200103,K,금릉,5225,5076,20200106,10301
20200103,K,금촌,7601,7575,20200106,15176
20200103,K,월롱,2447,2012,20200106,4459
20200103,K,파주,1538,975,20200106,2513
20200103,K,문산,6326,6535,20200106,12861
20200103,K,서울역,1,0,20200106,1
20200103,K,계양,1,0,20200106,1
20200103,K,검암,2,0,20200106,2
20200104,K,서울역,1768,1893,20200107,3661
20200104,K,신촌,500,536,20200107,1036
20200104,K,효창공원앞,1899,2019,20200107,3918
20200104,K,공덕,3488,2419,20200107,5907
20200104,K,서강대,1975,1926,20200107,3901
20200104,K,홍대입구,2517,3111,20200107,5628
20200104,K,가좌,4368,4092,20200107,8460
20200104,K,디지털미디어시티,1975,1825,20200107,3800
20200104,K,수색,1559,1542,20200107,3101
20200104,K,화전,1510,1150,20200107,2660
20200104,K,강매,2075,1852,20200107,3927
20200104,K,행신,6113,5954,20200107,12067
20200104,K,능곡,2793,2726,20200107,5519
20200104,K,곡산,404,396,20200107,800
20200104,K,백마,4901,4594,20200107,9495
20200104,K,풍산,4501,4148,20200107,8649
20200104,K,일산,6790,6416,20200107,13206
20200104,K,탄현,6097,5734,20200107,11831
20200104,K,야당,4779,4512,20200107,9291
20200104,K,운정,5061,4584,20200107,9645
20200104,K,금릉,4101,3947,20200107,8048
20200104,K,금촌,6591,5935,20200107,12526
20200104,K,월롱,1366,1177,20200107,2543
20200104,K,파주,1156,759,20200107,1915
20200104,K,문산,6358,5825,20200107,12183
20200105,K,서울역,1383,1269,20200108,2652
20200105,K,신촌,322,354,20200108,676
20200105,K,효창공원앞,1402,1566,20200108,2968
20200105,K,공덕,1844,1557,20200108,3401
20200105,K,서강대,1511,1411,20200108,2922
20200105,K,홍대입구,1972,2370,20200108,4342
20200105,K,가좌,3220,3102,20200108,6322
20200105,K,디지털미디어시티,1436,1428,20200108,2864
20200105,K,수색,912,1022,20200108,1934
20200105,K,화전,1027,1184,20200108,2211
20200105,K,강매,1507,1373,20200108,2880
20200105,K,행신,4672,4468,20200108,9140
20200105,K,능곡,2349,2175,20200108,4524
20200105,K,곡산,339,317,20200108,656
20200105,K,백마,3630,3573,20200108,7203
20200105,K,풍산,3534,3332,20200108,6866
20200105,K,일산,4767,4510,20200108,9277
20200105,K,탄현,4590,4293,20200108,8883
20200105,K,야당,3536,3393,20200108,6929
20200105,K,운정,3582,3443,20200108,7025
20200105,K,금릉,2992,3005,20200108,5997
20200105,K,금촌,4766,5328,20200108,10094
20200105,K,월롱,794,1475,20200108,2269
20200105,K,파주,791,675,20200108,1466
20200105,K,문산,3927,4653,20200108,8580
20200106,K,서울역,4858,6400,20200109,11258
20200106,K,신촌,1055,1366,20200109,2421
20200106,K,효창공원앞,3301,3655,20200109,6956
20200106,K,공덕,4070,3601,20200109,7671
20200106,K,서강대,2334,2326,20200109,4660
20200106,K,홍대입구,1877,2309,20200109,4186
20200106,K,가좌,5794,5322,20200109,11116
20200106,K,디지털미디어시티,2682,2486,20200109,5168
20200106,K,수색,2616,2671,20200109,5287
20200106,K,화전,2139,2000,20200109,4139
20200106,K,강매,3242,2741,20200109,5983
20200106,K,행신,8881,8688,20200109,17569
20200106,K,능곡,3961,3562,20200109,7523
20200106,K,곡산,616,636,20200109,1252
20200106,K,백마,7700,7114,20200109,14814
20200106,K,풍산,5831,5346,20200109,11177
20200106,K,일산,10021,9695,20200109,19716
20200106,K,탄현,8376,8089,20200109,16465
20200106,K,야당,5947,5589,20200109,11536
20200106,K,운정,6672,6097,20200109,12769
20200106,K,금릉,4863,4682,20200109,9545
20200106,K,금촌,7442,7136,20200109,14578
20200106,K,월롱,2187,2029,20200109,4216
20200106,K,파주,1260,969,20200109,2229
20200106,K,문산,6024,5783,20200109,11807
20200106,K,서울역,1,0,20200109,1
20200107,K,서울역,4601,5779,20200110,10380
20200107,K,신촌,1002,1248,20200110,2250
20200107,K,효창공원앞,3202,3581,20200110,6783
20200107,K,공덕,4031,3309,20200110,7340
20200107,K,서강대,2352,2272,20200110,4624
20200107,K,홍대입구,1788,2075,20200110,3863
20200107,K,가좌,5630,5213,20200110,10843
20200107,K,디지털미디어시티,2568,2346,20200110,4914
20200107,K,수색,2586,2666,20200110,5252
20200107,K,화전,1950,1731,20200110,3681
20200107,K,강매,3095,2642,20200110,5737
20200107,K,행신,8681,8363,20200110,17044
20200107,K,능곡,3804,3447,20200110,7251
20200107,K,곡산,561,568,20200110,1129
20200107,K,백마,7204,6849,20200110,14053
20200107,K,풍산,5617,5144,20200110,10761
20200107,K,일산,9413,9385,20200110,18798
20200107,K,탄현,8010,7901,20200110,15911
20200107,K,야당,5729,5364,20200110,11093
20200107,K,운정,6305,5781,20200110,12086
20200107,K,금릉,4503,4469,20200110,8972
20200107,K,금촌,6613,6478,20200110,13091
20200107,K,월롱,2073,1876,20200110,3949
20200107,K,파주,1152,836,20200110,1988
20200107,K,문산,5327,5336,20200110,10663
20200107,K,홍대입구,1,0,20200110,1
20200108,K,서울역,4833,6342,20200111,11175
20200108,K,신촌,1144,1424,20200111,2568
20200108,K,효창공원앞,3289,3666,20200111,6955
20200108,K,공덕,4131,3500,20200111,7631
20200108,K,서강대,2489,2463,20200111,4952
20200108,K,홍대입구,2021,2454,20200111,4475
20200108,K,가좌,5916,5455,20200111,11371
20200108,K,디지털미디어시티,2657,2452,20200111,5109
20200108,K,수색,2621,2720,20200111,5341
20200108,K,화전,2078,1783,20200111,3861
20200108,K,강매,3305,2722,20200111,6027
20200108,K,행신,9002,8587,20200111,17589
20200108,K,능곡,3965,3597,20200111,7562
20200108,K,곡산,627,634,20200111,1261
20200108,K,백마,7732,7163,20200111,14895
20200108,K,풍산,5897,5423,20200111,11320
20200108,K,일산,10828,10811,20200111,21639
20200108,K,탄현,8369,8159,20200111,16528
20200108,K,야당,6160,5957,20200111,12117
20200108,K,운정,6672,6137,20200111,12809
20200108,K,금릉,5023,4846,20200111,9869
20200108,K,금촌,7196,7090,20200111,14286
20200108,K,월롱,2315,2038,20200111,4353
20200108,K,파주,1270,933,20200111,2203
20200108,K,문산,5782,5619,20200111,11401
20200108,K,계양,1,0,20200111,1
20200109,K,서울역,4892,6351,20200112,11243
20200109,K,신촌,1030,1389,20200112,2419
20200109,K,효창공원앞,3321,3607,20200112,6928
20200109,K,공덕,4341,3670,20200112,8011
20200109,K,서강대,2512,2424,20200112,4936
20200109,K,홍대입구,2130,2600,20200112,4730
20200109,K,가좌,6113,5605,20200112,11718
20200109,K,디지털미디어시티,2695,2582,20200112,5277
20200109,K,수색,2767,2890,20200112,5657
20200109,K,화전,2061,1851,20200112,3912
20200109,K,강매,3376,2813,20200112,6189
20200109,K,행신,9075,8710,20200112,17785
20200109,K,능곡,4106,3651,20200112,7757
20200109,K,곡산,605,627,20200112,1232
20200109,K,백마,7751,7165,20200112,14916
20200109,K,풍산,6155,5701,20200112,11856
20200109,K,일산,10326,9743,20200112,20069
20200109,K,탄현,8496,8258,20200112,16754
20200109,K,야당,6284,6048,20200112,12332
20200109,K,운정,6798,6252,20200112,13050
20200109,K,금릉,5050,4886,20200112,9936
20200109,K,금촌,7165,7010,20200112,14175
20200109,K,월롱,2335,2006,20200112,4341
20200109,K,파주,1298,914,20200112,2212
20200109,K,문산,6195,6157,20200112,12352
20200109,K,서울역,1,0,20200112,1
20200109,K,홍대입구,1,0,20200112,1
20200109,K,검암,1,0,20200112,1
20200110,K,서울역,5170,6715,20200113,11885
20200110,K,신촌,980,1396,20200113,2376
20200110,K,효창공원앞,3362,3653,20200113,7015
20200110,K,공덕,4302,3748,20200113,8050
20200110,K,서강대,2578,2616,20200113,5194
20200110,K,홍대입구,2119,2813,20200113,4932
20200110,K,가좌,6377,5707,20200113,12084
20200110,K,디지털미디어시티,2822,2605,20200113,5427
20200110,K,수색,2656,2624,20200113,5280
20200110,K,화전,2014,1727,20200113,3741
20200110,K,강매,3421,2801,20200113,6222
20200110,K,행신,9480,9054,20200113,18534
20200110,K,능곡,4063,3613,20200113,7676
20200110,K,곡산,619,625,20200113,1244
20200110,K,백마,8098,7451,20200113,15549
20200110,K,풍산,6282,5689,20200113,11971
20200110,K,일산,10306,10209,20200113,20515
20200110,K,탄현,8881,8411,20200113,17292
20200110,K,야당,6516,6153,20200113,12669
20200110,K,운정,6844,6282,20200113,13126
20200110,K,금릉,5361,5071,20200113,10432
20200110,K,금촌,7777,7563,20200113,15340
20200110,K,월롱,2730,2078,20200113,4808
20200110,K,파주,1417,965,20200113,2382
20200110,K,문산,6397,6301,20200113,12698
20200111,K,서울역,1922,2198,20200114,4120
20200111,K,신촌,547,592,20200114,1139
20200111,K,효창공원앞,1994,2108,20200114,4102
20200111,K,공덕,3678,2497,20200114,6175
20200111,K,서강대,2405,2348,20200114,4753
20200111,K,홍대입구,2475,3310,20200114,5785
20200111,K,가좌,4651,4432,20200114,9083
20200111,K,디지털미디어시티,2187,2035,20200114,4222
20200111,K,수색,1413,1400,20200114,2813
20200111,K,화전,1645,1379,20200114,3024
20200111,K,강매,2177,1959,20200114,4136
20200111,K,행신,6398,6050,20200114,12448
20200111,K,능곡,3042,3004,20200114,6046
20200111,K,곡산,403,420,20200114,823
20200111,K,백마,5214,4825,20200114,10039
20200111,K,풍산,4772,4634,20200114,9406
20200111,K,일산,7253,6889,20200114,14142
20200111,K,탄현,6413,6007,20200114,12420
20200111,K,야당,4927,4692,20200114,9619
20200111,K,운정,5482,4844,20200114,10326
20200111,K,금릉,4214,4044,20200114,8258
20200111,K,금촌,7749,6999,20200114,14748
20200111,K,월롱,1473,1263,20200114,2736
20200111,K,파주,1264,850,20200114,2114
20200111,K,문산,6611,5641,20200114,12252
20200111,K,서울역,1,0,20200114,1
20200112,K,서울역,1421,1326,20200115,2747
20200112,K,신촌,442,405,20200115,847
20200112,K,효창공원앞,1421,1566,20200115,2987
20200112,K,공덕,2128,1687,20200115,3815
20200112,K,서강대,1549,1437,20200115,2986
20200112,K,홍대입구,1960,2415,20200115,4375
20200112,K,가좌,3291,3104,20200115,6395
20200112,K,디지털미디어시티,1666,1476,20200115,3142
20200112,K,수색,897,921,20200115,1818
20200112,K,화전,1005,1244,20200115,2249
20200112,K,강매,1571,1502,20200115,3073
20200112,K,행신,4832,4480,20200115,9312
20200112,K,능곡,2417,2333,20200115,4750
20200112,K,곡산,312,288,20200115,600
20200112,K,백마,3829,3697,20200115,7526
20200112,K,풍산,3680,3445,20200115,7125
20200112,K,일산,4996,4879,20200115,9875
20200112,K,탄현,4661,4447,20200115,9108
20200112,K,야당,3442,3462,20200115,6904
20200112,K,운정,3663,3732,20200115,7395
20200112,K,금릉,3064,3101,20200115,6165
20200112,K,금촌,5060,5815,20200115,10875
20200112,K,월롱,822,1540,20200115,2362
20200112,K,파주,837,709,20200115,1546
20200112,K,문산,4158,5004,20200115,9162
20200113,K,서울역,4976,6535,20200116,11511
20200113,K,신촌,1008,1380,20200116,2388
20200113,K,효창공원앞,3262,3572,20200116,6834
20200113,K,공덕,4240,3565,20200116,7805
20200113,K,서강대,2508,2377,20200116,4885
20200113,K,홍대입구,1938,2367,20200116,4305
20200113,K,가좌,5903,5492,20200116,11395
20200113,K,디지털미디어시티,2660,2523,20200116,5183
20200113,K,수색,2657,2719,20200116,5376
20200113,K,화전,2186,1960,20200116,4146
20200113,K,강매,3222,2712,20200116,5934
20200113,K,행신,8962,8886,20200116,17848
20200113,K,능곡,3956,3599,20200116,7555
20200113,K,곡산,599,630,20200116,1229
20200113,K,백마,7874,7305,20200116,15179
20200113,K,풍산,6052,5486,20200116,11538
20200113,K,일산,11282,11032,20200116,22314
20200113,K,탄현,8644,8136,20200116,16780
20200113,K,야당,6192,5894,20200116,12086
20200113,K,운정,6834,6179,20200116,13013
20200113,K,금릉,4971,4849,20200116,9820
20200113,K,금촌,7166,7033,20200116,14199
20200113,K,월롱,2257,2082,20200116,4339
20200113,K,파주,1369,920,20200116,2289
20200113,K,문산,6077,5757,20200116,11834
20200114,K,문산,6133,6014,20200117,12147
20200114,K,파주,1213,838,20200117,2051
20200114,K,월롱,2108,1955,20200117,4063
20200114,K,금촌,7190,6951,20200117,14141
20200114,K,금릉,4975,4851,20200117,9826
20200114,K,운정,6720,6185,20200117,12905
20200114,K,야당,6151,5872,20200117,12023
20200114,K,탄현,8355,8095,20200117,16450
20200114,K,일산,9916,9723,20200117,19639
20200114,K,풍산,5922,5435,20200117,11357
20200114,K,백마,7786,7235,20200117,15021
20200114,K,곡산,608,629,20200117,1237
20200114,K,능곡,3953,3592,20200117,7545
20200114,K,행신,8836,8538,20200117,17374
20200114,K,강매,3333,2842,20200117,6175
20200114,K,화전,2320,2169,20200117,4489
20200114,K,수색,2650,2729,20200117,5379
20200114,K,디지털미디어시티,2658,2533,20200117,5191
20200114,K,가좌,6089,5511,20200117,11600
20200114,K,홍대입구,2148,2512,20200117,4660
20200114,K,서강대,2377,2333,20200117,4710
20200114,K,공덕,4214,3682,20200117,7896
20200114,K,효창공원앞,3263,3575,20200117,6838
20200114,K,신촌,996,1464,20200117,2460
20200114,K,서울역,4949,6427,20200117,11376
20200115,K,서울역,4932,6327,20200118,11259
20200115,K,신촌,1022,1416,20200118,2438
20200115,K,효창공원앞,3174,3644,20200118,6818
20200115,K,공덕,4247,3548,20200118,7795
20200115,K,서강대,2583,2507,20200118,5090
20200115,K,홍대입구,2143,2571,20200118,4714
20200115,K,가좌,6097,5599,20200118,11696
20200115,K,디지털미디어시티,2574,2505,20200118,5079
20200115,K,수색,2681,2719,20200118,5400
20200115,K,화전,2162,1938,20200118,4100
20200115,K,강매,3356,2736,20200118,6092
20200115,K,행신,9084,8675,20200118,17759
20200115,K,능곡,3969,3754,20200118,7723
20200115,K,곡산,568,640,20200118,1208
20200115,K,백마,7855,7307,20200118,15162
20200115,K,풍산,6120,5545,20200118,11665
20200115,K,일산,9969,9806,20200118,19775
20200115,K,탄현,8705,8376,20200118,17081
20200115,K,야당,6247,5879,20200118,12126
20200115,K,운정,6824,6394,20200118,13218
20200115,K,금릉,4988,4798,20200118,9786
20200115,K,금촌,6968,6901,20200118,13869
20200115,K,월롱,2401,2059,20200118,4460
20200115,K,파주,1230,900,20200118,2130
20200115,K,문산,5763,5639,20200118,11402
20200115,K,계양,1,0,20200118,1
20200116,K,서울역,1,0,20200119,1
20200116,K,문산,5887,5814,20200119,11701
20200116,K,파주,1281,919,20200119,2200
20200116,K,월롱,2355,2057,20200119,4412
20200116,K,금촌,7786,7559,20200119,15345
20200116,K,금릉,5035,4975,20200119,10010
20200116,K,운정,6829,6341,20200119,13170
20200116,K,야당,6317,5945,20200119,12262
20200116,K,탄현,8625,8440,20200119,17065
20200116,K,일산,10183,9870,20200119,20053
20200116,K,풍산,6025,5639,20200119,11664
20200116,K,백마,7779,7138,20200119,14917
20200116,K,곡산,619,608,20200119,1227
20200116,K,능곡,4019,3706,20200119,7725
20200116,K,행신,9198,8577,20200119,17775
20200116,K,강매,3342,2771,20200119,6113
20200116,K,화전,1998,1800,20200119,3798
20200116,K,수색,2816,2981,20200119,5797
20200116,K,디지털미디어시티,2700,2565,20200119,5265
20200116,K,가좌,5964,5424,20200119,11388
20200116,K,홍대입구,2151,2634,20200119,4785
20200116,K,서강대,2510,2490,20200119,5000
20200116,K,공덕,4221,3588,20200119,7809
20200116,K,효창공원앞,3139,3560,20200119,6699
20200116,K,신촌,1074,1409,20200119,2483
20200116,K,서울역,4829,6423,20200119,11252
20200117,K,서울역,5214,6814,20200120,12028
20200117,K,신촌,1041,1469,20200120,2510
20200117,K,효창공원앞,3217,3593,20200120,6810
20200117,K,공덕,4456,3882,20200120,8338
20200117,K,서강대,2579,2666,20200120,5245
20200117,K,홍대입구,2270,2945,20200120,5215
20200117,K,가좌,6315,5751,20200120,12066
20200117,K,디지털미디어시티,2762,2565,20200120,5327
20200117,K,수색,2674,2722,20200120,5396
20200117,K,화전,2095,1779,20200120,3874
20200117,K,강매,3383,2797,20200120,6180
20200117,K,행신,9330,8900,20200120,18230
20200117,K,능곡,4182,3844,20200120,8026
20200117,K,곡산,624,654,20200120,1278
20200117,K,백마,7889,7169,20200120,15058
20200117,K,풍산,6219,5522,20200120,11741
20200117,K,일산,10290,10065,20200120,20355
20200117,K,탄현,8714,8290,20200120,17004
20200117,K,야당,6439,6080,20200120,12519
20200117,K,운정,6859,6307,20200120,13166
20200117,K,금릉,5294,5128,20200120,10422
20200117,K,금촌,7630,7426,20200120,15056
20200117,K,월롱,2708,2026,20200120,4734
20200117,K,파주,1286,915,20200120,2201
20200117,K,문산,6219,6387,20200120,12606
20200118,K,서울역,1807,2078,20200121,3885
20200118,K,신촌,560,597,20200121,1157
20200118,K,효창공원앞,2005,2118,20200121,4123
20200118,K,공덕,3508,2460,20200121,5968
20200118,K,서강대,2078,2014,20200121,4092
20200118,K,홍대입구,2602,3386,20200121,5988
20200118,K,가좌,4762,4545,20200121,9307
20200118,K,디지털미디어시티,2251,1982,20200121,4233
20200118,K,수색,1572,1607,20200121,3179
20200118,K,화전,1652,1373,20200121,3025
20200118,K,강매,2278,2010,20200121,4288
20200118,K,행신,6339,6078,20200121,12417
20200118,K,능곡,3120,2933,20200121,6053
20200118,K,곡산,424,422,20200121,846
20200118,K,백마,5232,4866,20200121,10098
20200118,K,풍산,4885,4556,20200121,9441
20200118,K,일산,8934,8790,20200121,17724
20200118,K,탄현,6720,6387,20200121,13107
20200118,K,야당,5159,4855,20200121,10014
20200118,K,운정,5260,4817,20200121,10077
20200118,K,금릉,4333,4140,20200121,8473
20200118,K,금촌,7051,6579,20200121,13630
20200118,K,월롱,1422,1295,20200121,2717
20200118,K,파주,1259,754,20200121,2013
20200118,K,문산,6533,5573,20200121,12106
20200118,K,검암,1,0,20200121,1
20200119,K,서울역,1365,1327,20200122,2692
20200119,K,신촌,381,412,20200122,793
20200119,K,효창공원앞,1414,1579,20200122,2993
20200119,K,공덕,2068,1691,20200122,3759
20200119,K,서강대,1553,1447,20200122,3000
20200119,K,홍대입구,2081,2347,20200122,4428
20200119,K,가좌,3505,3448,20200122,6953
20200119,K,디지털미디어시티,1485,1432,20200122,2917
20200119,K,수색,973,975,20200122,1948
20200119,K,화전,1014,1163,20200122,2177
20200119,K,강매,1489,1459,20200122,2948
20200119,K,행신,4719,4503,20200122,9222
20200119,K,능곡,2206,2193,20200122,4399
20200119,K,곡산,282,289,20200122,571
20200119,K,백마,3664,3623,20200122,7287
20200119,K,풍산,3551,3323,20200122,6874
20200119,K,일산,5038,4844,20200122,9882
20200119,K,탄현,4787,4576,20200122,9363
20200119,K,야당,3563,3397,20200122,6960
20200119,K,운정,3521,3406,20200122,6927
20200119,K,금릉,3038,3100,20200122,6138
20200119,K,금촌,4756,5416,20200122,10172
20200119,K,월롱,766,1467,20200122,2233
20200119,K,파주,790,714,20200122,1504
20200119,K,문산,4396,5238,20200122,9634
20200119,K,서울역,1,0,20200122,1
20200120,K,문산,5889,5637,20200123,11526
20200120,K,파주,1319,908,20200123,2227
20200120,K,월롱,2238,2071,20200123,4309
20200120,K,금촌,7301,7082,20200123,14383
20200120,K,금릉,4999,4804,20200123,9803
20200120,K,운정,6825,6225,20200123,13050
20200120,K,야당,6262,5840,20200123,12102
20200120,K,탄현,8536,8254,20200123,16790
20200120,K,일산,10195,9852,20200123,20047
20200120,K,풍산,6105,5614,20200123,11719
20200120,K,백마,7815,7192,20200123,15007
20200120,K,곡산,608,626,20200123,1234
20200120,K,능곡,4004,3626,20200123,7630
20200120,K,행신,8828,8695,20200123,17523
20200120,K,강매,3287,2694,20200123,5981
20200120,K,화전,2070,1840,20200123,3910
20200120,K,수색,2607,2562,20200123,5169
20200120,K,디지털미디어시티,2682,2491,20200123,5173
20200120,K,가좌,6045,5471,20200123,11516
20200120,K,홍대입구,2043,2335,20200123,4378
20200120,K,서강대,2442,2440,20200123,4882
20200120,K,공덕,4383,3740,20200123,8123
20200120,K,효창공원앞,3188,3601,20200123,6789
20200120,K,신촌,1085,1423,20200123,2508
20200120,K,서울역,4963,6569,20200123,11532
20200121,K,서울역,4796,6269,20200124,11065
20200121,K,신촌,1000,1355,20200124,2355
20200121,K,효창공원앞,3163,3570,20200124,6733
20200121,K,공덕,4261,3704,20200124,7965
20200121,K,서강대,2437,2330,20200124,4767
20200121,K,홍대입구,2101,2527,20200124,4628
20200121,K,가좌,5998,5582,20200124,11580
20200121,K,디지털미디어시티,2632,2485,20200124,5117
20200121,K,수색,2702,2727,20200124,5429
20200121,K,화전,1899,1690,20200124,3589
20200121,K,강매,3381,2813,20200124,6194
20200121,K,행신,8906,8450,20200124,17356
20200121,K,능곡,3968,3569,20200124,7537
20200121,K,곡산,554,619,20200124,1173
20200121,K,백마,7776,7163,20200124,14939
20200121,K,풍산,6124,5549,20200124,11673
20200121,K,일산,10028,9801,20200124,19829
20200121,K,탄현,8549,8243,20200124,16792
20200121,K,야당,6208,5836,20200124,12044
20200121,K,운정,6901,6246,20200124,13147
20200121,K,금릉,5032,4970,20200124,10002
20200121,K,금촌,7659,7564,20200124,15223
20200121,K,월롱,2282,1989,20200124,4271
20200121,K,파주,1200,824,20200124,2024
20200121,K,문산,5891,5761,20200124,11652
20200121,K,서울역,1,0,20200124,1
20200122,K,서울역,4825,6555,20200125,11380
20200122,K,신촌,1050,1389,20200125,2439
20200122,K,효창공원앞,3140,3537,20200125,6677
20200122,K,공덕,4157,3540,20200125,7697
20200122,K,서강대,2479,2449,20200125,4928
20200122,K,홍대입구,2194,2487,20200125,4681
20200122,K,가좌,6149,5519,20200125,11668
20200122,K,디지털미디어시티,2628,2435,20200125,5063
20200122,K,수색,2780,2697,20200125,5477
20200122,K,화전,1900,1640,20200125,3540
20200122,K,강매,3365,2746,20200125,6111
20200122,K,행신,8970,8737,20200125,17707
20200122,K,능곡,4128,3729,20200125,7857
20200122,K,곡산,629,637,20200125,1266
20200122,K,백마,7752,7238,20200125,14990
20200122,K,풍산,6019,5465,20200125,11484
20200122,K,일산,10158,9821,20200125,19979
20200122,K,탄현,8517,8112,20200125,16629
20200122,K,야당,6378,5821,20200125,12199
20200122,K,운정,6775,6171,20200125,12946
20200122,K,금릉,5054,4846,20200125,9900
20200122,K,금촌,7219,7018,20200125,14237
20200122,K,월롱,2522,1960,20200125,4482
20200122,K,파주,1171,817,20200125,1988
20200122,K,문산,5924,5741,20200125,11665
20200122,K,계양,1,0,20200125,1
20200123,K,서울역,4278,6315,20200126,10593
20200123,K,신촌,981,1226,20200126,2207
20200123,K,효창공원앞,2960,3133,20200126,6093
20200123,K,공덕,3903,3271,20200126,7174
20200123,K,서강대,2422,2168,20200126,4590
20200123,K,홍대입구,2105,2442,20200126,4547
20200123,K,가좌,5751,5025,20200126,10776
20200123,K,디지털미디어시티,2581,2335,20200126,4916
20200123,K,수색,2428,2360,20200126,4788
20200123,K,화전,1632,1390,20200126,3022
20200123,K,강매,3074,2522,20200126,5596
20200123,K,행신,8627,8082,20200126,16709
20200123,K,능곡,3897,3426,20200126,7323
20200123,K,곡산,552,609,20200126,1161
20200123,K,백마,7386,6683,20200126,14069
20200123,K,풍산,5807,5481,20200126,11288
20200123,K,일산,10756,10680,20200126,21436
20200123,K,탄현,8209,7842,20200126,16051
20200123,K,야당,6017,5690,20200126,11707
20200123,K,운정,6539,5940,20200126,12479
20200123,K,금릉,4911,4836,20200126,9747
20200123,K,금촌,7576,7265,20200126,14841
20200123,K,월롱,2622,1653,20200126,4275
20200123,K,파주,1281,911,20200126,2192
20200123,K,문산,5959,6234,20200126,12193
20200124,K,문산,4558,4703,20200127,9261
20200124,K,파주,878,670,20200127,1548
20200124,K,월롱,1030,902,20200127,1932
20200124,K,금촌,5451,5097,20200127,10548
20200124,K,금릉,2434,2489,20200127,4923
20200124,K,운정,2976,2945,20200127,5921
20200124,K,야당,2792,2575,20200127,5367
20200124,K,탄현,3529,3400,20200127,6929
20200124,K,일산,4208,4233,20200127,8441
20200124,K,풍산,2744,2728,20200127,5472
20200124,K,백마,2775,2604,20200127,5379
20200124,K,곡산,236,183,20200127,419
20200124,K,능곡,1784,1812,20200127,3596
20200124,K,행신,3794,3629,20200127,7423
20200124,K,강매,1198,1043,20200127,2241
20200124,K,화전,916,644,20200127,1560
20200124,K,수색,715,596,20200127,1311
20200124,K,디지털미디어시티,1303,1047,20200127,2350
20200124,K,가좌,2761,2181,20200127,4942
20200124,K,홍대입구,1319,1456,20200127,2775
20200124,K,서강대,1230,850,20200127,2080
20200124,K,공덕,1573,1210,20200127,2783
20200124,K,효창공원앞,1071,1030,20200127,2101
20200124,K,신촌,251,259,20200127,510
20200124,K,서울역,1320,1422,20200127,2742
20200125,K,서울역,1323,1355,20200128,2678
20200125,K,신촌,245,230,20200128,475
20200125,K,효창공원앞,897,1097,20200128,1994
20200125,K,공덕,1459,1222,20200128,2681
20200125,K,서강대,894,955,20200128,1849
20200125,K,홍대입구,867,1324,20200128,2191
20200125,K,가좌,2348,2297,20200128,4645
20200125,K,디지털미디어시티,1292,1064,20200128,2356
20200125,K,수색,651,620,20200128,1271
20200125,K,화전,726,686,20200128,1412
20200125,K,강매,1083,1062,20200128,2145
20200125,K,행신,3630,3601,20200128,7231
20200125,K,능곡,1855,1810,20200128,3665
20200125,K,곡산,234,205,20200128,439
20200125,K,백마,2570,2464,20200128,5034
20200125,K,풍산,2448,2381,20200128,4829
20200125,K,일산,3790,3701,20200128,7491
20200125,K,탄현,3116,3148,20200128,6264
20200125,K,야당,2433,2277,20200128,4710
20200125,K,운정,2778,2567,20200128,5345
20200125,K,금릉,2430,2358,20200128,4788
20200125,K,금촌,4916,4848,20200128,9764
20200125,K,월롱,787,750,20200128,1537
20200125,K,파주,949,712,20200128,1661
20200125,K,문산,4545,4282,20200128,8827
20200126,K,서울역,1474,1118,20200129,2592
20200126,K,신촌,296,329,20200129,625
20200126,K,효창공원앞,1082,1278,20200129,2360
20200126,K,공덕,1667,1548,20200129,3215
20200126,K,서강대,1054,1178,20200129,2232
20200126,K,홍대입구,1423,2048,20200129,3471
20200126,K,가좌,2656,2810,20200129,5466
20200126,K,디지털미디어시티,1297,1210,20200129,2507
20200126,K,수색,664,758,20200129,1422
20200126,K,화전,778,780,20200129,1558
20200126,K,강매,1298,1180,20200129,2478
20200126,K,행신,4227,3964,20200129,8191
20200126,K,능곡,2025,1994,20200129,4019
20200126,K,곡산,282,268,20200129,550
20200126,K,백마,3079,2856,20200129,5935
20200126,K,풍산,3031,2701,20200129,5732
20200126,K,일산,4272,4239,20200129,8511
20200126,K,탄현,3909,3708,20200129,7617
20200126,K,야당,2996,2979,20200129,5975
20200126,K,운정,3188,3009,20200129,6197
20200126,K,금릉,2716,2547,20200129,5263
20200126,K,금촌,5000,5336,20200129,10336
20200126,K,월롱,687,970,20200129,1657
20200126,K,파주,886,657,20200129,1543
20200126,K,문산,4534,4216,20200129,8750
20200126,K,검암,1,0,20200129,1
20200127,K,서울역,1492,1079,20200130,2571
20200127,K,신촌,299,324,20200130,623
20200127,K,효창공원앞,1097,1392,20200130,2489
20200127,K,공덕,1662,1486,20200130,3148
20200127,K,서강대,1127,1333,20200130,2460
20200127,K,홍대입구,1434,1883,20200130,3317
20200127,K,가좌,2755,2843,20200130,5598
20200127,K,디지털미디어시티,1220,1285,20200130,2505
20200127,K,수색,731,800,20200130,1531
20200127,K,화전,738,895,20200130,1633
20200127,K,강매,1228,1197,20200130,2425
20200127,K,행신,4099,4193,20200130,8292
20200127,K,능곡,1942,1878,20200130,3820
20200127,K,곡산,245,236,20200130,481
20200127,K,백마,3132,2820,20200130,5952
20200127,K,풍산,2968,2838,20200130,5806
20200127,K,일산,4237,3938,20200130,8175
20200127,K,탄현,4037,3696,20200130,7733
20200127,K,야당,3097,3049,20200130,6146
20200127,K,운정,3195,3186,20200130,6381
20200127,K,금릉,2747,2774,20200130,5521
20200127,K,금촌,4563,5041,20200130,9604
20200127,K,월롱,729,1348,20200130,2077
20200127,K,파주,786,680,20200130,1466
20200127,K,문산,4068,4214,20200130,8282
20200127,K,검암,1,0,20200130,1
20200128,K,서울역,4588,5490,20200131,10078
20200128,K,신촌,878,1154,20200131,2032
20200128,K,효창공원앞,2897,3263,20200131,6160
20200128,K,공덕,3649,3175,20200131,6824
20200128,K,서강대,2128,2256,20200131,4384
20200128,K,홍대입구,1906,2133,20200131,4039
20200128,K,가좌,5221,5012,20200131,10233
20200128,K,디지털미디어시티,2318,2217,20200131,4535
20200128,K,수색,2373,2511,20200131,4884
20200128,K,화전,1406,1301,20200131,2707
20200128,K,강매,2965,2460,20200131,5425
20200128,K,행신,8298,7916,20200131,16214
20200128,K,능곡,3685,3318,20200131,7003
20200128,K,곡산,537,551,20200131,1088
20200128,K,백마,6962,6407,20200131,13369
20200128,K,풍산,5330,4884,20200131,10214
20200128,K,일산,9271,9043,20200131,18314
20200128,K,탄현,7683,7427,20200131,15110
20200128,K,야당,5480,5344,20200131,10824
20200128,K,운정,6040,5763,20200131,11803
20200128,K,금릉,4683,4526,20200131,9209
20200128,K,금촌,6914,6869,20200131,13783
20200128,K,월롱,1751,1984,20200131,3735
20200128,K,파주,1224,844,20200131,2068
20200128,K,문산,5568,5457,20200131,11025
20200128,K,검암,1,0,20200131,1
20200129,K,서울역,4612,5861,20200201,10473
20200129,K,신촌,949,1239,20200201,2188
20200129,K,효창공원앞,3074,3470,20200201,6544
20200129,K,공덕,3939,3447,20200201,7386
20200129,K,서강대,2423,2307,20200201,4730
20200129,K,홍대입구,1878,2262,20200201,4140
20200129,K,가좌,5396,5073,20200201,10469
20200129,K,디지털미디어시티,2474,2299,20200201,4773
20200129,K,수색,2578,2617,20200201,5195
20200129,K,화전,1501,1400,20200201,2901
20200129,K,강매,3168,2659,20200201,5827
20200129,K,행신,8406,8087,20200201,16493
20200129,K,능곡,3844,3469,20200201,7313
20200129,K,곡산,550,603,20200201,1153
20200129,K,백마,7273,6822,20200201,14095
20200129,K,풍산,5638,5100,20200201,10738
20200129,K,일산,9291,9051,20200201,18342
20200129,K,탄현,7990,7797,20200201,15787
20200129,K,야당,5813,5563,20200201,11376
20200129,K,운정,6173,5811,20200201,11984
20200129,K,금릉,4681,4612,20200201,9293
20200129,K,금촌,6739,6624,20200201,13363
20200129,K,월롱,2182,1943,20200201,4125
20200129,K,파주,1199,873,20200201,2072
20200129,K,문산,5577,5650,20200201,11227
20200129,K,검암,1,0,20200201,1
20200130,K,계양,1,0,20200202,1
20200130,K,문산,5380,5513,20200202,10893
20200130,K,파주,1082,814,20200202,1896
20200130,K,월롱,2096,1795,20200202,3891
20200130,K,금촌,6608,6514,20200202,13122
20200130,K,금릉,4627,4607,20200202,9234
20200130,K,운정,6408,5922,20200202,12330
20200130,K,야당,5787,5611,20200202,11398
20200130,K,탄현,7857,7551,20200202,15408
20200130,K,일산,9403,9306,20200202,18709
20200130,K,풍산,5572,5106,20200202,10678
20200130,K,백마,7307,6749,20200202,14056
20200130,K,곡산,540,629,20200202,1169
20200130,K,능곡,3826,3395,20200202,7221
20200130,K,행신,8363,8057,20200202,16420
20200130,K,강매,3132,2597,20200202,5729
20200130,K,화전,1580,1471,20200202,3051
20200130,K,수색,2692,2811,20200202,5503
20200130,K,디지털미디어시티,2518,2413,20200202,4931
20200130,K,가좌,5600,5140,20200202,10740
20200130,K,홍대입구,1959,2215,20200202,4174
20200130,K,서강대,2289,2272,20200202,4561
20200130,K,공덕,3925,3386,20200202,7311
20200130,K,효창공원앞,3060,3460,20200202,6520
20200130,K,신촌,956,1222,20200202,2178
20200130,K,서울역,4662,5803,20200202,10465
20200131,K,서울역,4791,6070,20200203,10861
20200131,K,신촌,894,1214,20200203,2108
20200131,K,효창공원앞,3051,3421,20200203,6472
20200131,K,공덕,4025,3523,20200203,7548
20200131,K,서강대,2357,2355,20200203,4712
20200131,K,홍대입구,1933,2446,20200203,4379
20200131,K,가좌,5644,5114,20200203,10758
20200131,K,디지털미디어시티,2524,2347,20200203,4871
20200131,K,수색,2539,2611,20200203,5150
20200131,K,화전,1553,1365,20200203,2918
20200131,K,강매,3193,2618,20200203,5811
20200131,K,행신,8636,8150,20200203,16786
20200131,K,능곡,3821,3503,20200203,7324
20200131,K,곡산,513,559,20200203,1072
20200131,K,백마,7218,6556,20200203,13774
20200131,K,풍산,5532,5032,20200203,10564
20200131,K,일산,9353,9135,20200203,18488
20200131,K,탄현,8140,7704,20200203,15844
20200131,K,야당,5892,5673,20200203,11565
20200131,K,운정,6269,5871,20200203,12140
20200131,K,금릉,4789,4678,20200203,9467
20200131,K,금촌,6982,6990,20200203,13972
20200131,K,월롱,2481,1809,20200203,4290
20200131,K,파주,1161,793,20200203,1954
20200131,K,문산,5659,5952,20200203,11611
20200201,K,서울역,1244,1494,20200204,2738
20200201,K,신촌,421,396,20200204,817
20200201,K,효창공원앞,1678,1817,20200204,3495
20200201,K,공덕,2953,2088,20200204,5041
20200201,K,서강대,1756,1779,20200204,3535
20200201,K,홍대입구,1816,2183,20200204,3999
20200201,K,가좌,3552,3428,20200204,6980
20200201,K,디지털미디어시티,1688,1536,20200204,3224
20200201,K,수색,1033,1032,20200204,2065
20200201,K,화전,1023,885,20200204,1908
20200201,K,강매,1737,1516,20200204,3253
20200201,K,행신,4950,4809,20200204,9759
20200201,K,능곡,2424,2419,20200204,4843
20200201,K,곡산,344,317,20200204,661
20200201,K,백마,4113,3666,20200204,7779
20200201,K,풍산,3615,3446,20200204,7061
20200201,K,일산,5527,5165,20200204,10692
20200201,K,탄현,4990,4832,20200204,9822
20200201,K,야당,3893,3736,20200204,7629
20200201,K,운정,4044,3700,20200204,7744
20200201,K,금릉,3422,3165,20200204,6587
20200201,K,금촌,5655,5537,20200204,11192
20200201,K,월롱,1144,1051,20200204,2195
20200201,K,파주,871,613,20200204,1484
20200201,K,문산,4976,4377,20200204,9353
20200202,K,서울역,949,944,20200205,1893
20200202,K,신촌,267,269,20200205,536
20200202,K,효창공원앞,1247,1372,20200205,2619
20200202,K,공덕,1643,1250,20200205,2893
20200202,K,서강대,1336,1314,20200205,2650
20200202,K,홍대입구,1486,1717,20200205,3203
20200202,K,가좌,2630,2551,20200205,5181
20200202,K,디지털미디어시티,1209,1190,20200205,2399
20200202,K,수색,757,825,20200205,1582
20200202,K,화전,768,748,20200205,1516
20200202,K,강매,1223,1133,20200205,2356
20200202,K,행신,3789,3572,20200205,7361
20200202,K,능곡,1921,1879,20200205,3800
20200202,K,곡산,235,221,20200205,456
20200202,K,백마,2932,2793,20200205,5725
20200202,K,풍산,2767,2685,20200205,5452
20200202,K,일산,3878,3738,20200205,7616
20200202,K,탄현,3737,3631,20200205,7368
20200202,K,야당,2973,2915,20200205,5888
20200202,K,운정,2839,2914,20200205,5753
20200202,K,금릉,2358,2375,20200205,4733
20200202,K,금촌,3991,4221,20200205,8212
20200202,K,월롱,740,1245,20200205,1985
20200202,K,파주,655,561,20200205,1216
20200202,K,문산,3332,3599,20200205,6931
20200202,K,서울역,2,0,20200205,2
20200203,K,서울역,4334,5510,20200206,9844
20200203,K,신촌,884,1156,20200206,2040
20200203,K,효창공원앞,2894,3242,20200206,6136
20200203,K,공덕,3618,3254,20200206,6872
20200203,K,서강대,2103,2081,20200206,4184
20200203,K,홍대입구,1549,1851,20200206,3400
20200203,K,가좌,5357,4857,20200206,10214
20200203,K,디지털미디어시티,2302,2297,20200206,4599
20200203,K,수색,2453,2437,20200206,4890
20200203,K,화전,1545,1343,20200206,2888
20200203,K,강매,3039,2460,20200206,5499
20200203,K,행신,7741,7653,20200206,15394
20200203,K,능곡,3600,3195,20200206,6795
20200203,K,곡산,510,523,20200206,1033
20200203,K,백마,6998,6360,20200206,13358
20200203,K,풍산,5254,4819,20200206,10073
20200203,K,일산,9414,9213,20200206,18627
20200203,K,탄현,7606,7445,20200206,15051
20200203,K,야당,5537,5254,20200206,10791
20200203,K,운정,5998,5647,20200206,11645
20200203,K,금릉,4522,4372,20200206,8894
20200203,K,금촌,6487,6291,20200206,12778
20200203,K,월롱,1979,1846,20200206,3825
20200203,K,파주,1066,783,20200206,1849
20200203,K,문산,5319,4999,20200206,10318
20200204,K,서울역,4297,5500,20200207,9797
20200204,K,신촌,911,1204,20200207,2115
20200204,K,효창공원앞,2897,3302,20200207,6199
20200204,K,공덕,3799,3202,20200207,7001
20200204,K,서강대,2078,2084,20200207,4162
20200204,K,홍대입구,1638,1853,20200207,3491
20200204,K,가좌,5254,4864,20200207,10118
20200204,K,디지털미디어시티,2468,2309,20200207,4777
20200204,K,수색,2496,2536,20200207,5032
20200204,K,화전,1450,1342,20200207,2792
20200204,K,강매,2997,2495,20200207,5492
20200204,K,행신,7813,7635,20200207,15448
20200204,K,능곡,3445,3242,20200207,6687
20200204,K,곡산,498,538,20200207,1036
20200204,K,백마,6680,6366,20200207,13046
20200204,K,풍산,5199,4809,20200207,10008
20200204,K,일산,8627,8537,20200207,17164
20200204,K,탄현,7528,7398,20200207,14926
20200204,K,야당,5438,5261,20200207,10699
20200204,K,운정,5906,5551,20200207,11457
20200204,K,금릉,4362,4284,20200207,8646
20200204,K,금촌,6166,6076,20200207,12242
20200204,K,월롱,2089,1756,20200207,3845
20200204,K,파주,1054,743,20200207,1797
20200204,K,문산,5017,5079,20200207,10096
20200204,K,서울역,1,0,20200207,1
20200205,K,서울역,4273,5402,20200208,9675
20200205,K,신촌,836,1189,20200208,2025
20200205,K,효창공원앞,2833,3180,20200208,6013
20200205,K,공덕,3646,3155,20200208,6801
20200205,K,서강대,2001,1984,20200208,3985
20200205,K,홍대입구,1527,1965,20200208,3492
20200205,K,가좌,4989,4611,20200208,9600
20200205,K,디지털미디어시티,2328,2274,20200208,4602
20200205,K,수색,2301,2373,20200208,4674
20200205,K,화전,1375,1256,20200208,2631
20200205,K,강매,2920,2407,20200208,5327
20200205,K,행신,7702,7522,20200208,15224
20200205,K,능곡,3495,3097,20200208,6592
20200205,K,곡산,495,522,20200208,1017
20200205,K,백마,6578,6154,20200208,12732
20200205,K,풍산,4901,4538,20200208,9439
20200205,K,일산,8486,8256,20200208,16742
20200205,K,탄현,7457,7068,20200208,14525
20200205,K,야당,5380,5105,20200208,10485
20200205,K,운정,5587,5341,20200208,10928
20200205,K,금릉,4136,4138,20200208,8274
20200205,K,금촌,5939,5890,20200208,11829
20200205,K,월롱,2099,1812,20200208,3911
20200205,K,파주,1007,720,20200208,1727
20200205,K,문산,4688,4738,20200208,9426
20200206,K,서울역,4153,5378,20200209,9531
20200206,K,신촌,878,1064,20200209,1942
20200206,K,효창공원앞,2806,3139,20200209,5945
20200206,K,공덕,3701,3153,20200209,6854
20200206,K,서강대,2029,2063,20200209,4092
20200206,K,홍대입구,1702,1917,20200209,3619
20200206,K,가좌,5081,4592,20200209,9673
20200206,K,디지털미디어시티,2255,2071,20200209,4326
20200206,K,수색,2420,2437,20200209,4857
20200206,K,화전,1417,1264,20200209,2681
20200206,K,강매,2878,2440,20200209,5318
20200206,K,행신,7579,7198,20200209,14777
20200206,K,능곡,3423,3010,20200209,6433
20200206,K,곡산,461,484,20200209,945
20200206,K,백마,6534,6055,20200209,12589
20200206,K,풍산,4945,4494,20200209,9439
20200206,K,일산,8351,8128,20200209,16479
20200206,K,탄현,7145,7014,20200209,14159
20200206,K,야당,5341,5200,20200209,10541
20200206,K,운정,5708,5368,20200209,11076
20200206,K,금릉,4169,4196,20200209,8365
20200206,K,금촌,5958,5913,20200209,11871
20200206,K,월롱,2020,1721,20200209,3741
20200206,K,파주,988,714,20200209,1702
20200206,K,문산,4680,4721,20200209,9401
20200207,K,서울역,4479,5610,20200210,10089
20200207,K,신촌,840,1150,20200210,1990
20200207,K,효창공원앞,2885,3242,20200210,6127
20200207,K,공덕,3711,3348,20200210,7059
20200207,K,서강대,2149,2134,20200210,4283
20200207,K,홍대입구,1849,2196,20200210,4045
20200207,K,가좌,5339,4787,20200210,10126
20200207,K,디지털미디어시티,2482,2306,20200210,4788
20200207,K,수색,2454,2416,20200210,4870
20200207,K,화전,1527,1340,20200210,2867
20200207,K,강매,2993,2393,20200210,5386
20200207,K,행신,8082,7927,20200210,16009
20200207,K,능곡,3593,3300,20200210,6893
20200207,K,곡산,508,535,20200210,1043
20200207,K,백마,6915,6485,20200210,13400
20200207,K,풍산,5178,4792,20200210,9970
20200207,K,일산,8793,8751,20200210,17544
20200207,K,탄현,7627,7404,20200210,15031
20200207,K,야당,5758,5528,20200210,11286
20200207,K,운정,6107,5559,20200210,11666
20200207,K,금릉,4565,4481,20200210,9046
20200207,K,금촌,6500,6349,20200210,12849
20200207,K,월롱,2458,1798,20200210,4256
20200207,K,파주,1187,746,20200210,1933
20200207,K,문산,5308,5281,20200210,10589
20200208,K,서울역,1121,1210,20200211,2331
20200208,K,신촌,371,386,20200211,757
20200208,K,효창공원앞,1606,1704,20200211,3310
20200208,K,공덕,2463,1732,20200211,4195
20200208,K,서강대,1501,1534,20200211,3035
20200208,K,홍대입구,1688,2095,20200211,3783
20200208,K,가좌,3345,3232,20200211,6577
20200208,K,디지털미디어시티,1690,1584,20200211,3274
20200208,K,수색,1039,1048,20200211,2087
20200208,K,화전,966,873,20200211,1839
20200208,K,강매,1624,1445,20200211,3069
20200208,K,행신,4798,4618,20200211,9416
20200208,K,능곡,2372,2389,20200211,4761
20200208,K,곡산,310,316,20200211,626
20200208,K,백마,4008,3619,20200211,7627
20200208,K,풍산,3535,3345,20200211,6880
20200208,K,일산,5900,5695,20200211,11595
20200208,K,탄현,4804,4561,20200211,9365
20200208,K,야당,3869,3677,20200211,7546
20200208,K,운정,3868,3565,20200211,7433
20200208,K,금릉,3313,3204,20200211,6517
20200208,K,금촌,5169,4977,20200211,10146
20200208,K,월롱,1108,999,20200211,2107
20200208,K,파주,864,607,20200211,1471
20200208,K,문산,4694,4096,20200211,8790
20200209,K,서울역,923,874,20200212,1797
20200209,K,신촌,257,296,20200212,553
20200209,K,효창공원앞,1182,1268,20200212,2450
20200209,K,공덕,1520,1198,20200212,2718
20200209,K,서강대,1225,1185,20200212,2410
20200209,K,홍대입구,1560,1730,20200212,3290
20200209,K,가좌,2659,2564,20200212,5223
20200209,K,디지털미디어시티,1178,1111,20200212,2289
20200209,K,수색,712,819,20200212,1531
20200209,K,화전,745,742,20200212,1487
20200209,K,강매,1192,1122,20200212,2314
20200209,K,행신,3875,3687,20200212,7562
20200209,K,능곡,1867,1862,20200212,3729
20200209,K,곡산,238,245,20200212,483
20200209,K,백마,2918,2888,20200212,5806
20200209,K,풍산,2914,2625,20200212,5539
20200209,K,일산,3920,3786,20200212,7706
20200209,K,탄현,3879,3562,20200212,7441
20200209,K,야당,2936,2792,20200212,5728
20200209,K,운정,2847,2780,20200212,5627
20200209,K,금릉,2328,2325,20200212,4653
20200209,K,금촌,3877,4084,20200212,7961
20200209,K,월롱,603,1226,20200212,1829
20200209,K,파주,669,554,20200212,1223
20200209,K,문산,3310,3608,20200212,6918
20200210,K,서울역,4458,5670,20200213,10128
20200210,K,신촌,843,1184,20200213,2027
20200210,K,효창공원앞,2945,3243,20200213,6188
20200210,K,공덕,3554,3244,20200213,6798
20200210,K,서강대,2225,2081,20200213,4306
20200210,K,홍대입구,1698,1994,20200213,3692
20200210,K,가좌,5230,4753,20200213,9983
20200210,K,디지털미디어시티,2380,2192,20200213,4572
20200210,K,수색,2530,2573,20200213,5103
20200210,K,화전,1632,1450,20200213,3082
20200210,K,강매,3003,2504,20200213,5507
20200210,K,행신,8094,7859,20200213,15953
20200210,K,능곡,3602,3214,20200213,6816
20200210,K,곡산,545,567,20200213,1112
20200210,K,백마,7121,6518,20200213,13639
20200210,K,풍산,5367,4852,20200213,10219
20200210,K,일산,9064,8791,20200213,17855
20200210,K,탄현,7798,7444,20200213,15242
20200210,K,야당,5667,5447,20200213,11114
20200210,K,운정,6054,5748,20200213,11802
20200210,K,금릉,4571,4431,20200213,9002
20200210,K,금촌,6429,6254,20200213,12683
20200210,K,월롱,2124,1975,20200213,4099
20200210,K,파주,1261,817,20200213,2078
20200210,K,문산,5340,5100,20200213,10440
20200211,K,서울역,4401,5652,20200214,10053
20200211,K,신촌,914,1242,20200214,2156
20200211,K,효창공원앞,2967,3340,20200214,6307
20200211,K,공덕,3582,3275,20200214,6857
20200211,K,서강대,2194,2118,20200214,4312
20200211,K,홍대입구,1886,2145,20200214,4031
20200211,K,가좌,5428,4893,20200214,10321
20200211,K,디지털미디어시티,2448,2337,20200214,4785
20200211,K,수색,2630,2757,20200214,5387
20200211,K,화전,1535,1353,20200214,2888
20200211,K,강매,3067,2516,20200214,5583
20200211,K,행신,8149,7808,20200214,15957
20200211,K,능곡,3633,3313,20200214,6946
20200211,K,곡산,524,555,20200214,1079
20200211,K,백마,7173,6627,20200214,13800
20200211,K,풍산,5520,5027,20200214,10547
20200211,K,일산,9070,8955,20200214,18025
20200211,K,탄현,7814,7574,20200214,15388
20200211,K,야당,5933,5873,20200214,11806
20200211,K,운정,6125,5759,20200214,11884
20200211,K,금릉,4647,4512,20200214,9159
20200211,K,금촌,6727,6644,20200214,13371
20200211,K,월롱,2336,2098,20200214,4434
20200211,K,파주,1240,822,20200214,2062
20200211,K,문산,5344,5251,20200214,10595
20200211,K,계양,1,0,20200214,1
20200212,K,서울역,4199,5356,20200215,9555
20200212,K,신촌,834,1130,20200215,1964
20200212,K,효창공원앞,2907,3234,20200215,6141
20200212,K,공덕,3674,3159,20200215,6833
20200212,K,서강대,2052,2109,20200215,4161
20200212,K,홍대입구,1671,2042,20200215,3713
20200212,K,가좌,5174,4648,20200215,9822
20200212,K,디지털미디어시티,2365,2236,20200215,4601
20200212,K,수색,2434,2524,20200215,4958
20200212,K,화전,1458,1369,20200215,2827
20200212,K,강매,2911,2467,20200215,5378
20200212,K,행신,7880,7567,20200215,15447
20200212,K,능곡,3511,3125,20200215,6636
20200212,K,곡산,516,529,20200215,1045
20200212,K,백마,6762,6290,20200215,13052
20200212,K,풍산,5155,4633,20200215,9788
20200212,K,일산,8737,8545,20200215,17282
20200212,K,탄현,7691,7335,20200215,15026
20200212,K,야당,5667,5381,20200215,11048
20200212,K,운정,5889,5448,20200215,11337
20200212,K,금릉,4369,4316,20200215,8685
20200212,K,금촌,6122,6074,20200215,12196
20200212,K,월롱,2101,1915,20200215,4016
20200212,K,파주,1132,835,20200215,1967
20200212,K,문산,4938,4853,20200215,9791
20200212,K,검암,1,0,20200215,1
20200213,K,서울역,4339,5674,20200216,10013
20200213,K,신촌,893,1262,20200216,2155
20200213,K,효창공원앞,2953,3275,20200216,6228
20200213,K,공덕,3694,3325,20200216,7019
20200213,K,서강대,2127,2078,20200216,4205
20200213,K,홍대입구,1869,2210,20200216,4079
20200213,K,가좌,5485,4990,20200216,10475
20200213,K,디지털미디어시티,2475,2379,20200216,4854
20200213,K,수색,2514,2597,20200216,5111
20200213,K,화전,1514,1384,20200216,2898
20200213,K,강매,3174,2611,20200216,5785
20200213,K,행신,8301,7859,20200216,16160
20200213,K,능곡,3705,3305,20200216,7010
20200213,K,곡산,537,577,20200216,1114
20200213,K,백마,7247,6639,20200216,13886
20200213,K,풍산,5625,5230,20200216,10855
20200213,K,일산,9944,9801,20200216,19745
20200213,K,탄현,7973,7539,20200216,15512
20200213,K,야당,6064,5797,20200216,11861
20200213,K,운정,6243,5781,20200216,12024
20200213,K,금릉,4667,4592,20200216,9259
20200213,K,금촌,6571,6418,20200216,12989
20200213,K,월롱,2249,1995,20200216,4244
20200213,K,파주,1291,849,20200216,2140
20200213,K,문산,5244,5244,20200216,10488
20200214,K,서울역,4589,6127,20200217,10716
20200214,K,신촌,910,1290,20200217,2200
20200214,K,효창공원앞,2984,3382,20200217,6366
20200214,K,공덕,3951,3546,20200217,7497
20200214,K,서강대,2301,2227,20200217,4528
20200214,K,홍대입구,2130,2751,20200217,4881
20200214,K,가좌,5784,5213,20200217,10997
20200214,K,디지털미디어시티,2482,2430,20200217,4912
20200214,K,수색,2674,2603,20200217,5277
20200214,K,화전,1690,1474,20200217,3164
20200214,K,강매,3205,2688,20200217,5893
20200214,K,행신,8766,8413,20200217,17179
20200214,K,능곡,3832,3476,20200217,7308
20200214,K,곡산,586,577,20200217,1163
20200214,K,백마,7446,6923,20200217,14369
20200214,K,풍산,5826,5233,20200217,11059
20200214,K,일산,9529,9128,20200217,18657
20200214,K,탄현,8359,7924,20200217,16283
20200214,K,야당,6231,5983,20200217,12214
20200214,K,운정,6477,5958,20200217,12435
20200214,K,금릉,4973,4944,20200217,9917
20200214,K,금촌,7465,7175,20200217,14640
20200214,K,월롱,2458,1888,20200217,4346
20200214,K,파주,1346,924,20200217,2270
20200214,K,문산,6290,6325,20200217,12615
20200214,K,계양,1,0,20200217,1
20200215,K,서울역,1358,1501,20200218,2859
20200215,K,신촌,404,452,20200218,856
20200215,K,효창공원앞,1770,1876,20200218,3646
20200215,K,공덕,2893,2264,20200218,5157
20200215,K,서강대,1682,1767,20200218,3449
20200215,K,홍대입구,2015,2532,20200218,4547
20200215,K,가좌,3863,3673,20200218,7536
20200215,K,디지털미디어시티,1860,1775,20200218,3635
20200215,K,수색,1193,1222,20200218,2415
20200215,K,화전,1111,969,20200218,2080
20200215,K,강매,1859,1676,20200218,3535
20200215,K,행신,5332,5260,20200218,10592
20200215,K,능곡,2678,2608,20200218,5286
20200215,K,곡산,398,390,20200218,788
20200215,K,백마,4529,4150,20200218,8679
20200215,K,풍산,4030,3929,20200218,7959
20200215,K,일산,6119,5773,20200218,11892
20200215,K,탄현,5473,5155,20200218,10628
20200215,K,야당,4314,4132,20200218,8446
20200215,K,운정,4468,4017,20200218,8485
20200215,K,금릉,3807,3669,20200218,7476
20200215,K,금촌,5947,5667,20200218,11614
20200215,K,월롱,1229,1132,20200218,2361
20200215,K,파주,1021,682,20200218,1703
20200215,K,문산,5081,4679,20200218,9760
20200215,K,서울역,1,0,20200218,1
20200216,K,서울역,994,886,20200219,1880
20200216,K,신촌,258,266,20200219,524
20200216,K,효창공원앞,1265,1431,20200219,2696
20200216,K,공덕,1810,1395,20200219,3205
20200216,K,서강대,1297,1273,20200219,2570
20200216,K,홍대입구,1551,1805,20200219,3356
20200216,K,가좌,2605,2633,20200219,5238
20200216,K,디지털미디어시티,1271,1279,20200219,2550
20200216,K,수색,708,837,20200219,1545
20200216,K,화전,780,802,20200219,1582
20200216,K,강매,1282,1187,20200219,2469
20200216,K,행신,4267,3896,20200219,8163
20200216,K,능곡,1952,1894,20200219,3846
20200216,K,곡산,266,255,20200219,521
20200216,K,백마,3134,3031,20200219,6165
20200216,K,풍산,3036,2837,20200219,5873
20200216,K,일산,4070,3948,20200219,8018
20200216,K,탄현,4036,3800,20200219,7836
20200216,K,야당,3034,2905,20200219,5939
20200216,K,운정,3184,3005,20200219,6189
20200216,K,금릉,2437,2478,20200219,4915
20200216,K,금촌,4322,4752,20200219,9074
20200216,K,월롱,706,1308,20200219,2014
20200216,K,파주,671,560,20200219,1231
20200216,K,문산,3510,3654,20200219,7164
20200217,K,서울역,4583,6010,20200220,10593
20200217,K,신촌,870,1179,20200220,2049
20200217,K,효창공원앞,3107,3401,20200220,6508
20200217,K,공덕,3791,3310,20200220,7101
20200217,K,서강대,2212,2139,20200220,4351
20200217,K,홍대입구,1585,2021,20200220,3606
20200217,K,가좌,5416,4913,20200220,10329
20200217,K,디지털미디어시티,2419,2298,20200220,4717
20200217,K,수색,2516,2597,20200220,5113
20200217,K,화전,1626,1392,20200220,3018
20200217,K,강매,3085,2593,20200220,5678
20200217,K,행신,8323,8046,20200220,16369
20200217,K,능곡,3823,3379,20200220,7202
20200217,K,곡산,547,526,20200220,1073
20200217,K,백마,7378,6809,20200220,14187
20200217,K,풍산,5645,5026,20200220,10671
20200217,K,일산,9460,9031,20200220,18491
20200217,K,탄현,8174,7702,20200220,15876
20200217,K,야당,5900,5628,20200220,11528
20200217,K,운정,6204,5795,20200220,11999
20200217,K,금릉,4567,4419,20200220,8986
20200217,K,금촌,6608,6445,20200220,13053
20200217,K,월롱,2210,2037,20200220,4247
20200217,K,파주,1152,831,20200220,1983
20200217,K,문산,5601,5377,20200220,10978
20200218,K,서울역,4384,5579,20200221,9963
20200218,K,신촌,899,1159,20200221,2058
20200218,K,효창공원앞,2938,3311,20200221,6249
20200218,K,공덕,3756,3257,20200221,7013
20200218,K,서강대,2270,2225,20200221,4495
20200218,K,홍대입구,1853,2168,20200221,4021
20200218,K,가좌,5363,4894,20200221,10257
20200218,K,디지털미디어시티,2461,2293,20200221,4754
20200218,K,수색,2526,2597,20200221,5123
20200218,K,화전,1496,1364,20200221,2860
20200218,K,강매,3095,2600,20200221,5695
20200218,K,행신,8264,7863,20200221,16127
20200218,K,능곡,3685,3438,20200221,7123
20200218,K,곡산,551,600,20200221,1151
20200218,K,백마,7248,6722,20200221,13970
20200218,K,풍산,5450,5049,20200221,10499
20200218,K,일산,9882,9797,20200221,19679
20200218,K,탄현,8003,7662,20200221,15665
20200218,K,야당,5911,5657,20200221,11568
20200218,K,운정,6188,5743,20200221,11931
20200218,K,금릉,4548,4481,20200221,9029
20200218,K,금촌,6628,6398,20200221,13026
20200218,K,월롱,2016,1868,20200221,3884
20200218,K,파주,1122,802,20200221,1924
20200218,K,문산,5217,5179,20200221,10396
20200219,K,서울역,4475,5730,20200222,10205
20200219,K,신촌,879,1190,20200222,2069
20200219,K,효창공원앞,2980,3309,20200222,6289
20200219,K,공덕,3808,3420,20200222,7228
20200219,K,서강대,2298,2249,20200222,4547
20200219,K,홍대입구,1967,2230,20200222,4197
20200219,K,가좌,5554,5052,20200222,10606
20200219,K,디지털미디어시티,2563,2420,20200222,4983
20200219,K,수색,2587,2624,20200222,5211
20200219,K,화전,1564,1408,20200222,2972
20200219,K,강매,3135,2655,20200222,5790
20200219,K,행신,8338,7972,20200222,16310
20200219,K,능곡,3776,3427,20200222,7203
20200219,K,곡산,579,606,20200222,1185
20200219,K,백마,7201,6813,20200222,14014
20200219,K,풍산,5510,5136,20200222,10646
20200219,K,일산,9372,9260,20200222,18632
20200219,K,탄현,8120,7894,20200222,16014
20200219,K,야당,6042,5703,20200222,11745
20200219,K,운정,6279,5885,20200222,12164
20200219,K,금릉,4763,4704,20200222,9467
20200219,K,금촌,6664,6462,20200222,13126
20200219,K,월롱,2242,1959,20200222,4201
20200219,K,파주,1125,811,20200222,1936
20200219,K,문산,5560,5564,20200222,11124
20200219,K,김포공항,1,0,20200222,1
20200220,K,서울역,4460,5752,20200223,10212
20200220,K,신촌,881,1183,20200223,2064
20200220,K,효창공원앞,2889,3263,20200223,6152
20200220,K,공덕,3725,3322,20200223,7047
20200220,K,서강대,2176,2142,20200223,4318
20200220,K,홍대입구,1888,2244,20200223,4132
20200220,K,가좌,5415,4940,20200223,10355
20200220,K,디지털미디어시티,2362,2297,20200223,4659
20200220,K,수색,2540,2543,20200223,5083
20200220,K,화전,1614,1536,20200223,3150
20200220,K,강매,3114,2704,20200223,5818
20200220,K,행신,8096,7763,20200223,15859
20200220,K,능곡,3753,3421,20200223,7174
20200220,K,곡산,569,595,20200223,1164
20200220,K,백마,7081,6537,20200223,13618
20200220,K,풍산,5571,5142,20200223,10713
20200220,K,일산,9246,9023,20200223,18269
20200220,K,탄현,7862,7490,20200223,15352
20200220,K,야당,5914,5628,20200223,11542
20200220,K,운정,6176,5664,20200223,11840
20200220,K,금릉,4516,4424,20200223,8940
20200220,K,금촌,6528,6428,20200223,12956
20200220,K,월롱,2164,1905,20200223,4069
20200220,K,파주,1054,779,20200223,1833
20200220,K,문산,5178,5379,20200223,10557
20200221,K,서울역,4884,6518,20200224,11402
20200221,K,신촌,844,1270,20200224,2114
20200221,K,효창공원앞,2731,2881,20200224,5612
20200221,K,공덕,3649,2294,20200224,5943
20200221,K,서강대,1818,1756,20200224,3574
20200221,K,홍대입구,1640,1914,20200224,3554
20200221,K,가좌,4408,4808,20200224,9216
20200221,K,디지털미디어시티,2348,2894,20200224,5242
20200221,K,수색,2352,1951,20200224,4303
20200221,K,화전,1799,1673,20200224,3472
20200221,K,강매,2949,2475,20200224,5424
20200221,K,행신,7985,7478,20200224,15463
20200221,K,능곡,3523,3122,20200224,6645
20200221,K,곡산,516,502,20200224,1018
20200221,K,백마,6757,6213,20200224,12970
20200221,K,풍산,5257,4827,20200224,10084
20200221,K,일산,8722,8377,20200224,17099
20200221,K,탄현,7419,7108,20200224,14527
20200221,K,야당,5548,5250,20200224,10798
20200221,K,운정,5854,5415,20200224,11269
20200221,K,금릉,4345,4277,20200224,8622
20200221,K,금촌,6552,6512,20200224,13064
20200221,K,월롱,2362,1842,20200224,4204
20200221,K,파주,1120,818,20200224,1938
20200221,K,문산,5166,5394,20200224,10560
20200222,K,서울역,917,1035,20200225,1952
20200222,K,신촌,345,326,20200225,671
20200222,K,효창공원앞,1426,1486,20200225,2912
20200222,K,공덕,2419,1657,20200225,4076
20200222,K,서강대,1389,1343,20200225,2732
20200222,K,홍대입구,1477,1718,20200225,3195
20200222,K,가좌,3013,2859,20200225,5872
20200222,K,디지털미디어시티,1421,1370,20200225,2791
20200222,K,수색,917,894,20200225,1811
20200222,K,화전,880,741,20200225,1621
20200222,K,강매,1436,1306,20200225,2742
20200222,K,행신,4064,3881,20200225,7945
20200222,K,능곡,2115,2087,20200225,4202
20200222,K,곡산,263,278,20200225,541
20200222,K,백마,3424,3236,20200225,6660
20200222,K,풍산,3017,2833,20200225,5850
20200222,K,일산,4532,4456,20200225,8988
20200222,K,탄현,4053,3932,20200225,7985
20200222,K,야당,3350,3195,20200225,6545
20200222,K,운정,3382,3126,20200225,6508
20200222,K,금릉,2685,2670,20200225,5355
20200222,K,금촌,4236,4214,20200225,8450
20200222,K,월롱,1021,961,20200225,1982
20200222,K,파주,683,516,20200225,1199
20200222,K,문산,3657,3434,20200225,7091
20200222,K,계양,1,0,20200225,1
20200223,K,서울역,678,603,20200226,1281
20200223,K,신촌,248,252,20200226,500
20200223,K,효창공원앞,945,1047,20200226,1992
20200223,K,공덕,1371,1029,20200226,2400
20200223,K,서강대,977,965,20200226,1942
20200223,K,홍대입구,1230,1379,20200226,2609
20200223,K,가좌,1905,1960,20200226,3865
20200223,K,디지털미디어시티,904,897,20200226,1801
20200223,K,수색,652,689,20200226,1341
20200223,K,화전,536,528,20200226,1064
20200223,K,강매,1025,890,20200226,1915
20200223,K,행신,3012,2803,20200226,5815
20200223,K,능곡,1550,1519,20200226,3069
20200223,K,곡산,222,197,20200226,419
20200223,K,백마,2369,2307,20200226,4676
20200223,K,풍산,2376,2314,20200226,4690
20200223,K,일산,3671,3470,20200226,7141
20200223,K,탄현,3127,2876,20200226,6003
20200223,K,야당,2382,2302,20200226,4684
20200223,K,운정,2320,2246,20200226,4566
20200223,K,금릉,1891,1946,20200226,3837
20200223,K,금촌,2969,3158,20200226,6127
20200223,K,월롱,580,1092,20200226,1672
20200223,K,파주,496,424,20200226,920
20200223,K,문산,2355,2542,20200226,4897
20200224,K,서울역,3931,4634,20200227,8565
20200224,K,신촌,745,936,20200227,1681
20200224,K,효창공원앞,2526,2832,20200227,5358
20200224,K,공덕,3065,2754,20200227,5819
20200224,K,서강대,1763,1714,20200227,3477
20200224,K,홍대입구,1358,1493,20200227,2851
20200224,K,가좌,4431,4097,20200227,8528
20200224,K,디지털미디어시티,1912,1857,20200227,3769
20200224,K,수색,2168,2168,20200227,4336
20200224,K,화전,1193,1090,20200227,2283
20200224,K,강매,2627,2253,20200227,4880
20200224,K,행신,6620,6599,20200227,13219
20200224,K,능곡,3158,2799,20200227,5957
20200224,K,곡산,468,486,20200227,954
20200224,K,백마,5946,5551,20200227,11497
20200224,K,풍산,4399,4075,20200227,8474
20200224,K,일산,7605,7526,20200227,15131
20200224,K,탄현,6348,6172,20200227,12520
20200224,K,야당,4633,4473,20200227,9106
20200224,K,운정,4961,4683,20200227,9644
20200224,K,금릉,3496,3438,20200227,6934
20200224,K,금촌,5205,5220,20200227,10425
20200224,K,월롱,1870,1627,20200227,3497
20200224,K,파주,877,629,20200227,1506
20200224,K,문산,3970,4023,20200227,7993
20200224,K,검암,2,0,20200227,2
20200225,K,서울역,3490,4340,20200228,7830
20200225,K,신촌,614,810,20200228,1424
20200225,K,효창공원앞,2241,2580,20200228,4821
20200225,K,공덕,2838,2473,20200228,5311
20200225,K,서강대,1568,1464,20200228,3032
20200225,K,홍대입구,1173,1324,20200228,2497
20200225,K,가좌,3979,3559,20200228,7538
20200225,K,디지털미디어시티,1740,1706,20200228,3446
20200225,K,수색,2072,2068,20200228,4140
20200225,K,화전,1086,937,20200228,2023
20200225,K,강매,2428,2083,20200228,4511
20200225,K,행신,6250,6045,20200228,12295
20200225,K,능곡,2875,2558,20200228,5433
20200225,K,곡산,418,443,20200228,861
20200225,K,백마,5304,4951,20200228,10255
20200225,K,풍산,3962,3738,20200228,7700
20200225,K,일산,6799,6794,20200228,13593
20200225,K,탄현,5856,5708,20200228,11564
20200225,K,야당,4186,3984,20200228,8170
20200225,K,운정,4399,4156,20200228,8555
20200225,K,금릉,3168,3178,20200228,6346
20200225,K,금촌,4583,4473,20200228,9056
20200225,K,월롱,1597,1452,20200228,3049
20200225,K,파주,785,593,20200228,1378
20200225,K,문산,3311,3322,20200228,6633
20200225,K,계양,2,0,20200228,2
20200226,K,서울역,3432,4219,20200229,7651
20200226,K,신촌,630,811,20200229,1441
20200226,K,효창공원앞,2319,2591,20200229,4910
20200226,K,공덕,2867,2565,20200229,5432
20200226,K,서강대,1565,1533,20200229,3098
20200226,K,홍대입구,1206,1312,20200229,2518
20200226,K,가좌,3889,3615,20200229,7504
20200226,K,디지털미디어시티,1770,1749,20200229,3519
20200226,K,수색,2044,2130,20200229,4174
20200226,K,화전,1127,1029,20200229,2156
20200226,K,강매,2419,2102,20200229,4521
20200226,K,행신,5838,5637,20200229,11475
20200226,K,능곡,2948,2645,20200229,5593
20200226,K,곡산,441,422,20200229,863
20200226,K,백마,5308,5022,20200229,10330
20200226,K,풍산,3993,3634,20200229,7627
20200226,K,일산,6947,6902,20200229,13849
20200226,K,탄현,5947,5771,20200229,11718
20200226,K,야당,4270,4146,20200229,8416
20200226,K,운정,4596,4341,20200229,8937
20200226,K,금릉,3285,3264,20200229,6549
20200226,K,금촌,4912,4874,20200229,9786
20200226,K,월롱,1729,1536,20200229,3265
20200226,K,파주,804,590,20200229,1394
20200226,K,문산,3470,3446,20200229,6916
20200227,K,서울역,3259,4110,20200301,7369
20200227,K,신촌,615,803,20200301,1418
20200227,K,효창공원앞,2193,2599,20200301,4792
20200227,K,공덕,2783,2548,20200301,5331
20200227,K,서강대,1505,1477,20200301,2982
20200227,K,홍대입구,1188,1316,20200301,2504
20200227,K,가좌,3912,3506,20200301,7418
20200227,K,디지털미디어시티,1742,1731,20200301,3473
20200227,K,수색,1982,1917,20200301,3899
20200227,K,화전,1108,965,20200301,2073
20200227,K,강매,2370,2023,20200301,4393
20200227,K,행신,5765,5586,20200301,11351
20200227,K,능곡,2784,2494,20200301,5278
20200227,K,곡산,424,425,20200301,849
20200227,K,백마,5183,4838,20200301,10021
20200227,K,풍산,4038,3925,20200301,7963
20200227,K,일산,6791,6606,20200301,13397
20200227,K,탄현,5757,5620,20200301,11377
20200227,K,야당,4106,3968,20200301,8074
20200227,K,운정,4325,4093,20200301,8418
20200227,K,금릉,3283,3204,20200301,6487
20200227,K,금촌,4660,4522,20200301,9182
20200227,K,월롱,1673,1455,20200301,3128
20200227,K,파주,776,579,20200301,1355
20200227,K,문산,3471,3468,20200301,6939
20200228,K,서울역,3178,3948,20200302,7126
20200228,K,신촌,517,695,20200302,1212
20200228,K,효창공원앞,2188,2435,20200302,4623
20200228,K,공덕,2710,2508,20200302,5218
20200228,K,서강대,1459,1442,20200302,2901
20200228,K,홍대입구,1017,1178,20200302,2195
20200228,K,가좌,3666,3439,20200302,7105
20200228,K,디지털미디어시티,1713,1603,20200302,3316
20200228,K,수색,1728,1805,20200302,3533
20200228,K,화전,1001,889,20200302,1890
20200228,K,강매,2250,1876,20200302,4126
20200228,K,행신,5568,5426,20200302,10994
20200228,K,능곡,2686,2413,20200302,5099
20200228,K,곡산,391,408,20200302,799
20200228,K,백마,4879,4610,20200302,9489
20200228,K,풍산,3815,3616,20200302,7431
20200228,K,일산,6547,6510,20200302,13057
20200228,K,탄현,5561,5427,20200302,10988
20200228,K,야당,3961,3777,20200302,7738
20200228,K,운정,4218,3884,20200302,8102
20200228,K,금릉,3054,3094,20200302,6148
20200228,K,금촌,4530,4485,20200302,9015
20200228,K,월롱,1727,1368,20200302,3095
20200228,K,파주,717,531,20200302,1248
20200228,K,문산,3431,3465,20200302,6896
20200229,K,서울역,581,648,20200303,1229
20200229,K,신촌,228,207,20200303,435
20200229,K,효창공원앞,1044,1098,20200303,2142
20200229,K,공덕,1463,1124,20200303,2587
20200229,K,서강대,952,953,20200303,1905
20200229,K,홍대입구,932,1054,20200303,1986
20200229,K,가좌,2094,2035,20200303,4129
20200229,K,디지털미디어시티,975,872,20200303,1847
20200229,K,수색,722,696,20200303,1418
20200229,K,화전,588,583,20200303,1171
20200229,K,강매,1102,942,20200303,2044
20200229,K,행신,2656,2627,20200303,5283
20200229,K,능곡,1579,1555,20200303,3134
20200229,K,곡산,231,226,20200303,457
20200229,K,백마,2430,2228,20200303,4658
20200229,K,풍산,2230,2151,20200303,4381
20200229,K,일산,3172,3149,20200303,6321
20200229,K,탄현,2999,3022,20200303,6021
20200229,K,야당,2477,2371,20200303,4848
20200229,K,운정,2200,2154,20200303,4354
20200229,K,금릉,1959,1951,20200303,3910
20200229,K,금촌,3092,2982,20200303,6074
20200229,K,월롱,773,740,20200303,1513
20200229,K,파주,532,383,20200303,915
20200229,K,문산,2346,2412,20200303,4758
20200301,K,서울역,402,433,20200304,835
20200301,K,신촌,115,127,20200304,242
20200301,K,효창공원앞,672,768,20200304,1440
20200301,K,공덕,816,691,20200304,1507
20200301,K,서강대,626,559,20200304,1185
20200301,K,홍대입구,675,738,20200304,1413
20200301,K,가좌,1461,1454,20200304,2915
20200301,K,디지털미디어시티,660,619,20200304,1279
20200301,K,수색,401,430,20200304,831
20200301,K,화전,409,381,20200304,790
20200301,K,강매,680,622,20200304,1302
20200301,K,행신,1959,1895,20200304,3854
20200301,K,능곡,1145,1101,20200304,2246
20200301,K,곡산,142,154,20200304,296
20200301,K,백마,1581,1522,20200304,3103
20200301,K,풍산,1616,1566,20200304,3182
20200301,K,일산,2214,2078,20200304,4292
20200301,K,탄현,2136,1979,20200304,4115
20200301,K,야당,1725,1595,20200304,3320
20200301,K,운정,1553,1477,20200304,3030
20200301,K,금릉,1334,1310,20200304,2644
20200301,K,금촌,2047,2238,20200304,4285
20200301,K,월롱,437,799,20200304,1236
20200301,K,파주,349,310,20200304,659
20200301,K,문산,1666,1660,20200304,3326
20200302,K,서울역,3085,3911,20200305,6996
20200302,K,신촌,555,703,20200305,1258
20200302,K,효창공원앞,2182,2501,20200305,4683
20200302,K,공덕,2616,2472,20200305,5088
20200302,K,서강대,1387,1365,20200305,2752
20200302,K,홍대입구,1059,1220,20200305,2279
20200302,K,가좌,3833,3458,20200305,7291
20200302,K,디지털미디어시티,1703,1621,20200305,3324
20200302,K,수색,1892,1907,20200305,3799
20200302,K,화전,1120,1051,20200305,2171
20200302,K,강매,2323,1949,20200305,4272
20200302,K,행신,5670,5628,20200305,11298
20200302,K,능곡,2808,2516,20200305,5324
20200302,K,곡산,429,423,20200305,852
20200302,K,백마,5093,4828,20200305,9921
20200302,K,풍산,3845,3513,20200305,7358
20200302,K,일산,6739,6685,20200305,13424
20200302,K,탄현,5681,5494,20200305,11175
20200302,K,야당,4145,3982,20200305,8127
20200302,K,운정,4436,4149,20200305,8585
20200302,K,금릉,3246,3188,20200305,6434
20200302,K,금촌,4842,4714,20200305,9556
20200302,K,월롱,1621,1491,20200305,3112
20200302,K,파주,780,552,20200305,1332
20200302,K,문산,3767,3695,20200305,7462
20200303,K,서울역,2947,3958,20200306,6905
20200303,K,신촌,547,726,20200306,1273
20200303,K,효창공원앞,2195,2530,20200306,4725
20200303,K,공덕,2740,2447,20200306,5187
20200303,K,서강대,1388,1290,20200306,2678
20200303,K,홍대입구,1088,1190,20200306,2278
20200303,K,가좌,3821,3519,20200306,7340
20200303,K,디지털미디어시티,1681,1616,20200306,3297
20200303,K,수색,1910,1917,20200306,3827
20200303,K,화전,1085,995,20200306,2080
20200303,K,강매,2333,2042,20200306,4375
20200303,K,행신,5641,5498,20200306,11139
20200303,K,능곡,2820,2546,20200306,5366
20200303,K,곡산,431,436,20200306,867
20200303,K,백마,5144,4870,20200306,10014
20200303,K,풍산,3992,3639,20200306,7631
20200303,K,일산,6832,6880,20200306,13712
20200303,K,탄현,5623,5549,20200306,11172
20200303,K,야당,4139,4033,20200306,8172
20200303,K,운정,4384,4101,20200306,8485
20200303,K,금릉,3201,3139,20200306,6340
20200303,K,금촌,4625,4544,20200306,9169
20200303,K,월롱,1646,1458,20200306,3104
20200303,K,파주,765,586,20200306,1351
20200303,K,문산,3627,3570,20200306,7197
20200304,K,서울역,2924,3897,20200307,6821
20200304,K,신촌,540,702,20200307,1242
20200304,K,효창공원앞,2229,2528,20200307,4757
20200304,K,공덕,2667,2339,20200307,5006
20200304,K,서강대,1322,1340,20200307,2662
20200304,K,홍대입구,1097,1237,20200307,2334
20200304,K,가좌,3838,3423,20200307,7261
20200304,K,디지털미디어시티,1781,1648,20200307,3429
20200304,K,수색,1824,1886,20200307,3710
20200304,K,화전,1040,982,20200307,2022
20200304,K,강매,2248,1845,20200307,4093
20200304,K,행신,5537,5457,20200307,10994
20200304,K,능곡,2676,2445,20200307,5121
20200304,K,곡산,389,415,20200307,804
20200304,K,백마,4997,4774,20200307,9771
20200304,K,풍산,3829,3590,20200307,7419
20200304,K,일산,6367,6443,20200307,12810
20200304,K,탄현,5525,5350,20200307,10875
20200304,K,야당,3981,3895,20200307,7876
20200304,K,운정,4327,4086,20200307,8413
20200304,K,금릉,3134,3073,20200307,6207
20200304,K,금촌,4500,4468,20200307,8968
20200304,K,월롱,1617,1468,20200307,3085
20200304,K,파주,750,553,20200307,1303
20200304,K,문산,3499,3436,20200307,6935
20200305,K,서울역,2897,3889,20200308,6786
20200305,K,신촌,528,685,20200308,1213
20200305,K,효창공원앞,2185,2483,20200308,4668
20200305,K,공덕,2689,2388,20200308,5077
20200305,K,서강대,1401,1337,20200308,2738
20200305,K,홍대입구,1189,1308,20200308,2497
20200305,K,가좌,3782,3531,20200308,7313
20200305,K,디지털미디어시티,1725,1632,20200308,3357
20200305,K,수색,1844,1884,20200308,3728
20200305,K,화전,1076,965,20200308,2041
20200305,K,강매,2279,1982,20200308,4261
20200305,K,행신,5550,5425,20200308,10975
20200305,K,능곡,2751,2467,20200308,5218
20200305,K,곡산,385,422,20200308,807
20200305,K,백마,5115,4793,20200308,9908
20200305,K,풍산,3892,3619,20200308,7511
20200305,K,일산,6600,6560,20200308,13160
20200305,K,탄현,5694,5434,20200308,11128
20200305,K,야당,4154,3939,20200308,8093
20200305,K,운정,4376,4101,20200308,8477
20200305,K,금릉,3220,3224,20200308,6444
20200305,K,금촌,4470,4419,20200308,8889
20200305,K,월롱,1671,1502,20200308,3173
20200305,K,파주,745,594,20200308,1339
20200305,K,문산,3497,3441,20200308,6938
20200306,K,서울역,3070,4089,20200309,7159
20200306,K,신촌,577,794,20200309,1371
20200306,K,효창공원앞,2256,2566,20200309,4822
20200306,K,공덕,2841,2561,20200309,5402
20200306,K,서강대,1456,1387,20200309,2843
20200306,K,홍대입구,1244,1399,20200309,2643
20200306,K,가좌,4016,3674,20200309,7690
20200306,K,디지털미디어시티,1781,1658,20200309,3439
20200306,K,수색,1780,1848,20200309,3628
20200306,K,화전,993,937,20200309,1930
20200306,K,강매,2373,1934,20200309,4307
20200306,K,행신,5958,5743,20200309,11701
20200306,K,능곡,2777,2536,20200309,5313
20200306,K,곡산,410,447,20200309,857
20200306,K,백마,5302,4904,20200309,10206
20200306,K,풍산,4029,3682,20200309,7711
20200306,K,일산,6714,6636,20200309,13350
20200306,K,탄현,5706,5601,20200309,11307
20200306,K,야당,4287,4155,20200309,8442
20200306,K,운정,4522,4123,20200309,8645
20200306,K,금릉,3458,3363,20200309,6821
20200306,K,금촌,4874,4810,20200309,9684
20200306,K,월롱,1967,1537,20200309,3504
20200306,K,파주,820,587,20200309,1407
20200306,K,문산,3751,3736,20200309,7487
20200307,K,서울역,615,663,20200310,1278
20200307,K,신촌,225,222,20200310,447
20200307,K,효창공원앞,1125,1214,20200310,2339
20200307,K,공덕,1482,1208,20200310,2690
20200307,K,서강대,1020,987,20200310,2007
20200307,K,홍대입구,1118,1279,20200310,2397
20200307,K,가좌,2357,2174,20200310,4531
20200307,K,디지털미디어시티,1058,1000,20200310,2058
20200307,K,수색,726,705,20200310,1431
20200307,K,화전,589,576,20200310,1165
20200307,K,강매,1182,1030,20200310,2212
20200307,K,행신,2972,2894,20200310,5866
20200307,K,능곡,1800,1778,20200310,3578
20200307,K,곡산,229,253,20200310,482
20200307,K,백마,2636,2540,20200310,5176
20200307,K,풍산,2423,2364,20200310,4787
20200307,K,일산,3657,3496,20200310,7153
20200307,K,탄현,3332,3225,20200310,6557
20200307,K,야당,2782,2688,20200310,5470
20200307,K,운정,2742,2530,20200310,5272
20200307,K,금릉,2177,2142,20200310,4319
20200307,K,금촌,3350,3322,20200310,6672
20200307,K,월롱,958,840,20200310,1798
20200307,K,파주,542,427,20200310,969
20200307,K,문산,2664,2689,20200310,5353
20200308,K,서울역,501,467,20200311,968
20200308,K,신촌,154,174,20200311,328
20200308,K,효창공원앞,847,934,20200311,1781
20200308,K,공덕,940,741,20200311,1681
20200308,K,서강대,740,734,20200311,1474
20200308,K,홍대입구,889,985,20200311,1874
20200308,K,가좌,1716,1570,20200311,3286
20200308,K,디지털미디어시티,755,665,20200311,1420
20200308,K,수색,462,485,20200311,947
20200308,K,화전,444,477,20200311,921
20200308,K,강매,840,718,20200311,1558
20200308,K,행신,2322,2205,20200311,4527
20200308,K,능곡,1328,1249,20200311,2577
20200308,K,곡산,229,225,20200311,454
20200308,K,백마,1956,1781,20200311,3737
20200308,K,풍산,1901,1831,20200311,3732
20200308,K,일산,2951,2836,20200311,5787
20200308,K,탄현,2527,2375,20200311,4902
20200308,K,야당,2118,1960,20200311,4078
20200308,K,운정,1997,1887,20200311,3884
20200308,K,금릉,1635,1538,20200311,3173
20200308,K,금촌,2502,2565,20200311,5067
20200308,K,월롱,537,984,20200311,1521
20200308,K,파주,460,371,20200311,831
20200308,K,문산,2062,2043,20200311,4105
20200309,K,서울역,3127,4062,20200312,7189
20200309,K,신촌,609,776,20200312,1385
20200309,K,효창공원앞,2242,2590,20200312,4832
20200309,K,공덕,2811,2474,20200312,5285
20200309,K,서강대,1479,1443,20200312,2922
20200309,K,홍대입구,1258,1330,20200312,2588
20200309,K,가좌,4029,3705,20200312,7734
20200309,K,디지털미디어시티,1779,1612,20200312,3391
20200309,K,수색,1943,2019,20200312,3962
20200309,K,화전,1120,1086,20200312,2206
20200309,K,강매,2423,2095,20200312,4518
20200309,K,행신,5934,5854,20200312,11788
20200309,K,능곡,2933,2656,20200312,5589
20200309,K,곡산,441,467,20200312,908
20200309,K,백마,5454,5141,20200312,10595
20200309,K,풍산,4091,3736,20200312,7827
20200309,K,일산,7202,7036,20200312,14238
20200309,K,탄현,6037,5865,20200312,11902
20200309,K,야당,4479,4281,20200312,8760
20200309,K,운정,4729,4277,20200312,9006
20200309,K,금릉,3431,3412,20200312,6843
20200309,K,금촌,5024,4937,20200312,9961
20200309,K,월롱,1590,1579,20200312,3169
20200309,K,파주,902,649,20200312,1551
20200309,K,문산,3991,3919,20200312,7910
20200310,K,서울역,3018,3886,20200313,6904
20200310,K,신촌,589,687,20200313,1276
20200310,K,효창공원앞,2217,2566,20200313,4783
20200310,K,공덕,2731,2311,20200313,5042
20200310,K,서강대,1402,1367,20200313,2769
20200310,K,홍대입구,1088,1214,20200313,2302
20200310,K,가좌,3843,3526,20200313,7369
20200310,K,디지털미디어시티,1634,1542,20200313,3176
20200310,K,수색,1776,1851,20200313,3627
20200310,K,화전,1018,935,20200313,1953
20200310,K,강매,2252,1937,20200313,4189
20200310,K,행신,5675,5474,20200313,11149
20200310,K,능곡,2698,2435,20200313,5133
20200310,K,곡산,382,408,20200313,790
20200310,K,백마,5124,4840,20200313,9964
20200310,K,풍산,3827,3513,20200313,7340
20200310,K,일산,6526,6624,20200313,13150
20200310,K,탄현,5621,5475,20200313,11096
20200310,K,야당,4113,3949,20200313,8062
20200310,K,운정,4454,4118,20200313,8572
20200310,K,금릉,3341,3242,20200313,6583
20200310,K,금촌,4580,4468,20200313,9048
20200310,K,월롱,1542,1451,20200313,2993
20200310,K,파주,768,557,20200313,1325
20200310,K,문산,3471,3365,20200313,6836
20200311,K,서울역,3064,3950,20200314,7014
20200311,K,신촌,557,795,20200314,1352
20200311,K,효창공원앞,2286,2528,20200314,4814
20200311,K,공덕,2751,2497,20200314,5248
20200311,K,서강대,1492,1422,20200314,2914
20200311,K,홍대입구,1267,1319,20200314,2586
20200311,K,가좌,4004,3710,20200314,7714
20200311,K,디지털미디어시티,1740,1698,20200314,3438
20200311,K,수색,1899,1928,20200314,3827
20200311,K,화전,1102,992,20200314,2094
20200311,K,강매,2389,2092,20200314,4481
20200311,K,행신,5946,5915,20200314,11861
20200311,K,능곡,2853,2558,20200314,5411
20200311,K,곡산,447,457,20200314,904
20200311,K,백마,5304,5018,20200314,10322
20200311,K,풍산,3935,3622,20200314,7557
20200311,K,일산,6863,6854,20200314,13717
20200311,K,탄현,5845,5716,20200314,11561
20200311,K,야당,4376,4268,20200314,8644
20200311,K,운정,4697,4304,20200314,9001
20200311,K,금릉,3433,3384,20200314,6817
20200311,K,금촌,4924,4875,20200314,9799
20200311,K,월롱,1676,1487,20200314,3163
20200311,K,파주,834,630,20200314,1464
20200311,K,문산,3789,3727,20200314,7516
20200312,K,서울역,2971,3961,20200315,6932
20200312,K,신촌,565,774,20200315,1339
20200312,K,효창공원앞,2227,2532,20200315,4759
20200312,K,공덕,2663,2392,20200315,5055
20200312,K,서강대,1487,1409,20200315,2896
20200312,K,홍대입구,1218,1411,20200315,2629
20200312,K,가좌,3889,3551,20200315,7440
20200312,K,디지털미디어시티,1683,1666,20200315,3349
20200312,K,수색,1911,1920,20200315,3831
20200312,K,화전,1071,976,20200315,2047
20200312,K,강매,2349,1943,20200315,4292
20200312,K,행신,5818,5706,20200315,11524
20200312,K,능곡,2787,2455,20200315,5242
20200312,K,곡산,409,416,20200315,825
20200312,K,백마,5168,4803,20200315,9971
20200312,K,풍산,3989,3716,20200315,7705
20200312,K,일산,6782,6799,20200315,13581
20200312,K,탄현,5800,5574,20200315,11374
20200312,K,야당,4324,4084,20200315,8408
20200312,K,운정,4502,4187,20200315,8689
20200312,K,금릉,3391,3343,20200315,6734
20200312,K,금촌,4699,4629,20200315,9328
20200312,K,월롱,1586,1471,20200315,3057
20200312,K,파주,832,598,20200315,1430
20200312,K,문산,3734,3678,20200315,7412
20200313,K,서울역,2924,3921,20200316,6845
20200313,K,신촌,556,802,20200316,1358
20200313,K,효창공원앞,2272,2580,20200316,4852
20200313,K,공덕,2619,2441,20200316,5060
20200313,K,서강대,1463,1406,20200316,2869
20200313,K,홍대입구,1341,1506,20200316,2847
20200313,K,가좌,3944,3610,20200316,7554
20200313,K,디지털미디어시티,1698,1593,20200316,3291
20200313,K,수색,1810,1834,20200316,3644
20200313,K,화전,1117,1028,20200316,2145
20200313,K,강매,2391,2002,20200316,4393
20200313,K,행신,5901,5639,20200316,11540
20200313,K,능곡,2854,2578,20200316,5432
20200313,K,곡산,427,437,20200316,864
20200313,K,백마,5273,4935,20200316,10208
20200313,K,풍산,4060,3798,20200316,7858
20200313,K,일산,7123,7130,20200316,14253
20200313,K,탄현,5879,5769,20200316,11648
20200313,K,야당,4426,4173,20200316,8599
20200313,K,운정,4610,4245,20200316,8855
20200313,K,금릉,3511,3443,20200316,6954
20200313,K,금촌,4938,4860,20200316,9798
20200313,K,월롱,1936,1521,20200316,3457
20200313,K,파주,896,614,20200316,1510
20200313,K,문산,3831,3864,20200316,7695
20200313,K,계양,1,0,20200316,1
20200314,K,서울역,647,691,20200317,1338
20200314,K,신촌,226,233,20200317,459
20200314,K,효창공원앞,1206,1253,20200317,2459
20200314,K,공덕,1408,1154,20200317,2562
20200314,K,서강대,1015,1027,20200317,2042
20200314,K,홍대입구,1169,1383,20200317,2552
20200314,K,가좌,2321,2231,20200317,4552
20200314,K,디지털미디어시티,1137,1015,20200317,2152
20200314,K,수색,770,753,20200317,1523
20200314,K,화전,691,706,20200317,1397
20200314,K,강매,1164,1091,20200317,2255
20200314,K,행신,3162,3118,20200317,6280
20200314,K,능곡,1839,1823,20200317,3662
20200314,K,곡산,237,249,20200317,486
20200314,K,백마,2787,2639,20200317,5426
20200314,K,풍산,2571,2510,20200317,5081
20200314,K,일산,3757,3671,20200317,7428
20200314,K,탄현,3453,3385,20200317,6838
20200314,K,야당,2928,2861,20200317,5789
20200314,K,운정,2639,2431,20200317,5070
20200314,K,금릉,2386,2360,20200317,4746
20200314,K,금촌,3600,3553,20200317,7153
20200314,K,월롱,1001,922,20200317,1923
20200314,K,파주,553,446,20200317,999
20200314,K,문산,2911,2868,20200317,5779
20200314,K,계양,1,0,20200317,1
20200315,K,서울역,497,509,20200318,1006
20200315,K,신촌,160,154,20200318,314
20200315,K,효창공원앞,756,908,20200318,1664
20200315,K,공덕,1036,841,20200318,1877
20200315,K,서강대,684,701,20200318,1385
20200315,K,홍대입구,803,886,20200318,1689
20200315,K,가좌,1556,1586,20200318,3142
20200315,K,디지털미디어시티,764,672,20200318,1436
20200315,K,수색,472,472,20200318,944
20200315,K,화전,509,496,20200318,1005
20200315,K,강매,777,735,20200318,1512
20200315,K,행신,2427,2332,20200318,4759
20200315,K,능곡,1295,1241,20200318,2536
20200315,K,곡산,202,182,20200318,384
20200315,K,백마,1963,1865,20200318,3828
20200315,K,풍산,1931,1841,20200318,3772
20200315,K,일산,2573,2459,20200318,5032
20200315,K,탄현,2582,2340,20200318,4922
20200315,K,야당,2050,1903,20200318,3953
20200315,K,운정,1808,1709,20200318,3517
20200315,K,금릉,1562,1578,20200318,3140
20200315,K,금촌,2533,2545,20200318,5078
20200315,K,월롱,528,970,20200318,1498
20200315,K,파주,435,371,20200318,806
20200315,K,문산,2078,2005,20200318,4083
20200316,K,서울역,3093,4093,20200319,7186
20200316,K,신촌,589,828,20200319,1417
20200316,K,효창공원앞,2249,2573,20200319,4822
20200316,K,공덕,2612,2396,20200319,5008
20200316,K,서강대,1503,1489,20200319,2992
20200316,K,홍대입구,1160,1286,20200319,2446
20200316,K,가좌,4030,3643,20200319,7673
20200316,K,디지털미디어시티,1699,1621,20200319,3320
20200316,K,수색,1851,1941,20200319,3792
20200316,K,화전,1267,1170,20200319,2437
20200316,K,강매,2470,2146,20200319,4616
20200316,K,행신,5839,5837,20200319,11676
20200316,K,능곡,2892,2586,20200319,5478
20200316,K,곡산,448,459,20200319,907
20200316,K,백마,5342,5137,20200319,10479
20200316,K,풍산,4003,3716,20200319,7719
20200316,K,일산,6958,6858,20200319,13816
20200316,K,탄현,6012,5725,20200319,11737
20200316,K,야당,4366,4147,20200319,8513
20200316,K,운정,4662,4294,20200319,8956
20200316,K,금릉,3486,3438,20200319,6924
20200316,K,금촌,5111,5035,20200319,10146
20200316,K,월롱,1644,1560,20200319,3204
20200316,K,파주,894,623,20200319,1517
20200316,K,문산,3952,3846,20200319,7798
20200317,K,서울역,3101,4005,20200320,7106
20200317,K,신촌,608,799,20200320,1407
20200317,K,효창공원앞,2270,2580,20200320,4850
20200317,K,공덕,2631,2400,20200320,5031
20200317,K,서강대,1472,1415,20200320,2887
20200317,K,홍대입구,1194,1273,20200320,2467
20200317,K,가좌,3994,3570,20200320,7564
20200317,K,디지털미디어시티,1678,1628,20200320,3306
20200317,K,수색,1883,1972,20200320,3855
20200317,K,화전,1244,1128,20200320,2372
20200317,K,강매,2376,2040,20200320,4416
20200317,K,행신,5853,5764,20200320,11617
20200317,K,능곡,2848,2622,20200320,5470
20200317,K,곡산,432,461,20200320,893
20200317,K,백마,5282,5007,20200320,10289
20200317,K,풍산,3968,3680,20200320,7648
20200317,K,일산,6827,6771,20200320,13598
20200317,K,탄현,5853,5762,20200320,11615
20200317,K,야당,4376,4140,20200320,8516
20200317,K,운정,4568,4235,20200320,8803
20200317,K,금릉,3400,3340,20200320,6740
20200317,K,금촌,4778,4705,20200320,9483
20200317,K,월롱,1678,1539,20200320,3217
20200317,K,파주,845,606,20200320,1451
20200317,K,문산,3715,3764,20200320,7479
20200318,K,서울역,3159,4119,20200321,7278
20200318,K,신촌,652,806,20200321,1458
20200318,K,효창공원앞,2277,2597,20200321,4874
20200318,K,공덕,2703,2425,20200321,5128
20200318,K,서강대,1521,1485,20200321,3006
20200318,K,홍대입구,1268,1406,20200321,2674
20200318,K,가좌,4030,3658,20200321,7688
20200318,K,디지털미디어시티,1778,1729,20200321,3507
20200318,K,수색,1890,2016,20200321,3906
20200318,K,화전,1257,1142,20200321,2399
20200318,K,강매,2506,2193,20200321,4699
20200318,K,행신,6173,6003,20200321,12176
20200318,K,능곡,2897,2702,20200321,5599
20200318,K,곡산,447,492,20200321,939
20200318,K,백마,5663,5389,20200321,11052
20200318,K,풍산,4135,3851,20200321,7986
20200318,K,일산,7641,7496,20200321,15137
20200318,K,탄현,6048,5831,20200321,11879
20200318,K,야당,4552,4286,20200321,8838
20200318,K,운정,4686,4407,20200321,9093
20200318,K,금릉,3513,3467,20200321,6980
20200318,K,금촌,4951,4942,20200321,9893
20200318,K,월롱,1830,1561,20200321,3391
20200318,K,파주,880,685,20200321,1565
20200318,K,문산,3942,3879,20200321,7821
20200319,K,서울역,3018,4042,20200322,7060
20200319,K,신촌,600,797,20200322,1397
20200319,K,효창공원앞,2216,2469,20200322,4685
20200319,K,공덕,2614,2392,20200322,5006
20200319,K,서강대,1490,1433,20200322,2923
20200319,K,홍대입구,1188,1324,20200322,2512
20200319,K,가좌,3890,3468,20200322,7358
20200319,K,디지털미디어시티,1631,1671,20200322,3302
20200319,K,수색,1794,1863,20200322,3657
20200319,K,화전,1178,1039,20200322,2217
20200319,K,강매,2347,1984,20200322,4331
20200319,K,행신,5839,5673,20200322,11512
20200319,K,능곡,2703,2463,20200322,5166
20200319,K,곡산,403,426,20200322,829
20200319,K,백마,5135,4820,20200322,9955
20200319,K,풍산,3930,3594,20200322,7524
20200319,K,일산,6632,6643,20200322,13275
20200319,K,탄현,5682,5476,20200322,11158
20200319,K,야당,4155,4033,20200322,8188
20200319,K,운정,4318,3998,20200322,8316
20200319,K,금릉,3302,3228,20200322,6530
20200319,K,금촌,4413,4472,20200322,8885
20200319,K,월롱,1718,1481,20200322,3199
20200319,K,파주,793,574,20200322,1367
20200319,K,문산,3657,3629,20200322,7286
20200319,K,홍대입구,1,0,20200322,1
20200320,K,서울역,3098,4099,20200323,7197
20200320,K,신촌,636,827,20200323,1463
20200320,K,효창공원앞,2392,2660,20200323,5052
20200320,K,공덕,2736,2579,20200323,5315
20200320,K,서강대,1653,1670,20200323,3323
20200320,K,홍대입구,1489,1691,20200323,3180
20200320,K,가좌,4221,3956,20200323,8177
20200320,K,디지털미디어시티,1895,1754,20200323,3649
20200320,K,수색,1886,1922,20200323,3808
20200320,K,화전,1271,1164,20200323,2435
20200320,K,강매,2501,2166,20200323,4667
20200320,K,행신,6303,6110,20200323,12413
20200320,K,능곡,2934,2724,20200323,5658
20200320,K,곡산,463,470,20200323,933
20200320,K,백마,5706,5354,20200323,11060
20200320,K,풍산,4243,3939,20200323,8182
20200320,K,일산,7249,7176,20200323,14425
20200320,K,탄현,6132,5965,20200323,12097
20200320,K,야당,4762,4634,20200323,9396
20200320,K,운정,4938,4544,20200323,9482
20200320,K,금릉,3776,3709,20200323,7485
20200320,K,금촌,5368,5190,20200323,10558
20200320,K,월롱,2054,1609,20200323,3663
20200320,K,파주,940,686,20200323,1626
20200320,K,문산,4173,4086,20200323,8259
20200321,K,서울역,735,782,20200324,1517
20200321,K,신촌,221,244,20200324,465
20200321,K,효창공원앞,1213,1372,20200324,2585
20200321,K,공덕,1430,1292,20200324,2722
20200321,K,서강대,1143,1113,20200324,2256
20200321,K,홍대입구,1272,1459,20200324,2731
20200321,K,가좌,2591,2435,20200324,5026
20200321,K,디지털미디어시티,1165,1054,20200324,2219
20200321,K,수색,786,809,20200324,1595
20200321,K,화전,789,729,20200324,1518
20200321,K,강매,1336,1214,20200324,2550
20200321,K,행신,3426,3336,20200324,6762
20200321,K,능곡,1907,1849,20200324,3756
20200321,K,곡산,257,282,20200324,539
20200321,K,백마,3105,2851,20200324,5956
20200321,K,풍산,2653,2622,20200324,5275
20200321,K,일산,4021,3924,20200324,7945
20200321,K,탄현,3812,3745,20200324,7557
20200321,K,야당,3118,2950,20200324,6068
20200321,K,운정,2907,2671,20200324,5578
20200321,K,금릉,2477,2393,20200324,4870
20200321,K,금촌,3982,3878,20200324,7860
20200321,K,월롱,1014,952,20200324,1966
20200321,K,파주,607,490,20200324,1097
20200321,K,문산,3078,3145,20200324,6223
20200321,K,김포공항,1,0,20200324,1
20200322,K,서울역,533,494,20200325,1027
20200322,K,신촌,136,156,20200325,292
20200322,K,효창공원앞,844,998,20200325,1842
20200322,K,공덕,1027,798,20200325,1825
20200322,K,서강대,794,748,20200325,1542
20200322,K,홍대입구,963,1109,20200325,2072
20200322,K,가좌,1749,1746,20200325,3495
20200322,K,디지털미디어시티,824,774,20200325,1598
20200322,K,수색,539,560,20200325,1099
20200322,K,화전,544,536,20200325,1080
20200322,K,강매,902,859,20200325,1761
20200322,K,행신,2646,2542,20200325,5188
20200322,K,능곡,1499,1423,20200325,2922
20200322,K,곡산,221,206,20200325,427
20200322,K,백마,2144,2023,20200325,4167
20200322,K,풍산,2106,2022,20200325,4128
20200322,K,일산,2838,2703,20200325,5541
20200322,K,탄현,2640,2435,20200325,5075
20200322,K,야당,2221,2099,20200325,4320
20200322,K,운정,2030,1932,20200325,3962
20200322,K,금릉,1723,1724,20200325,3447
20200322,K,금촌,2606,2762,20200325,5368
20200322,K,월롱,627,1178,20200325,1805
20200322,K,파주,480,409,20200325,889
20200322,K,문산,2214,2190,20200325,4404
20200323,K,서울역,3270,4241,20200326,7511
20200323,K,신촌,686,846,20200326,1532
20200323,K,효창공원앞,2347,2710,20200326,5057
20200323,K,공덕,2662,2482,20200326,5144
20200323,K,서강대,1549,1502,20200326,3051
20200323,K,홍대입구,1290,1398,20200326,2688
20200323,K,가좌,4164,3823,20200326,7987
20200323,K,디지털미디어시티,1668,1720,20200326,3388
20200323,K,수색,1964,2077,20200326,4041
20200323,K,화전,1243,1161,20200326,2404
20200323,K,강매,2466,2132,20200326,4598
20200323,K,행신,6093,6081,20200326,12174
20200323,K,능곡,2968,2717,20200326,5685
20200323,K,곡산,458,498,20200326,956
20200323,K,백마,5462,5239,20200326,10701
20200323,K,풍산,4195,3799,20200326,7994
20200323,K,일산,7566,7515,20200326,15081
20200323,K,탄현,6000,5745,20200326,11745
20200323,K,야당,4592,4298,20200326,8890
20200323,K,운정,4832,4448,20200326,9280
20200323,K,금릉,3523,3525,20200326,7048
20200323,K,금촌,5078,4909,20200326,9987
20200323,K,월롱,1729,1596,20200326,3325
20200323,K,파주,910,675,20200326,1585
20200323,K,문산,4038,3993,20200326,8031
20200324,K,서울역,3098,4041,20200327,7139
20200324,K,신촌,669,851,20200327,1520
20200324,K,효창공원앞,2335,2609,20200327,4944
20200324,K,공덕,2648,2489,20200327,5137
20200324,K,서강대,1591,1514,20200327,3105
20200324,K,홍대입구,1293,1378,20200327,2671
20200324,K,가좌,4145,3841,20200327,7986
20200324,K,디지털미디어시티,1812,1674,20200327,3486
20200324,K,수색,1981,2064,20200327,4045
20200324,K,화전,1309,1206,20200327,2515
20200324,K,강매,2523,2169,20200327,4692
20200324,K,행신,6019,6010,20200327,12029
20200324,K,능곡,2968,2665,20200327,5633
20200324,K,곡산,447,483,20200327,930
20200324,K,백마,5504,5220,20200327,10724
20200324,K,풍산,4199,3972,20200327,8171
20200324,K,일산,7191,7160,20200327,14351
20200324,K,탄현,5869,5778,20200327,11647
20200324,K,야당,4581,4437,20200327,9018
20200324,K,운정,4723,4391,20200327,9114
20200324,K,금릉,3499,3473,20200327,6972
20200324,K,금촌,4980,4772,20200327,9752
20200324,K,월롱,1770,1565,20200327,3335
20200324,K,파주,836,604,20200327,1440
20200324,K,문산,4094,4143,20200327,8237
20200325,K,서울역,3190,4257,20200328,7447
20200325,K,신촌,657,888,20200328,1545
20200325,K,효창공원앞,2419,2681,20200328,5100
20200325,K,공덕,2735,2437,20200328,5172
20200325,K,서강대,1567,1508,20200328,3075
20200325,K,홍대입구,1350,1473,20200328,2823
20200325,K,가좌,4177,3809,20200328,7986
20200325,K,디지털미디어시티,1777,1753,20200328,3530
20200325,K,수색,1947,2036,20200328,3983
20200325,K,화전,1304,1164,20200328,2468
20200325,K,강매,2540,2211,20200328,4751
20200325,K,행신,6204,6108,20200328,12312
20200325,K,능곡,3003,2777,20200328,5780
20200325,K,곡산,458,475,20200328,933
20200325,K,백마,5581,5169,20200328,10750
20200325,K,풍산,4099,3840,20200328,7939
20200325,K,일산,7232,7232,20200328,14464
20200325,K,탄현,6087,5769,20200328,11856
20200325,K,야당,4538,4437,20200328,8975
20200325,K,운정,4790,4382,20200328,9172
20200325,K,금릉,3590,3507,20200328,7097
20200325,K,금촌,4958,4852,20200328,9810
20200325,K,월롱,1869,1571,20200328,3440
20200325,K,파주,902,673,20200328,1575
20200325,K,문산,3995,4011,20200328,8006
20200326,K,서울역,3112,4098,20200329,7210
20200326,K,신촌,608,839,20200329,1447
20200326,K,효창공원앞,2328,2602,20200329,4930
20200326,K,공덕,2753,2549,20200329,5302
20200326,K,서강대,1585,1509,20200329,3094
20200326,K,홍대입구,1245,1438,20200329,2683
20200326,K,가좌,3967,3785,20200329,7752
20200326,K,디지털미디어시티,1748,1721,20200329,3469
20200326,K,수색,1940,1999,20200329,3939
20200326,K,화전,1242,1118,20200329,2360
20200326,K,강매,2496,2136,20200329,4632
20200326,K,행신,6047,5884,20200329,11931
20200326,K,능곡,2908,2646,20200329,5554
20200326,K,곡산,443,455,20200329,898
20200326,K,백마,5478,5057,20200329,10535
20200326,K,풍산,4129,3931,20200329,8060
20200326,K,일산,7025,7032,20200329,14057
20200326,K,탄현,5948,5836,20200329,11784
20200326,K,야당,4440,4258,20200329,8698
20200326,K,운정,4730,4368,20200329,9098
20200326,K,금릉,3477,3370,20200329,6847
20200326,K,금촌,4918,4923,20200329,9841
20200326,K,월롱,1724,1535,20200329,3259
20200326,K,파주,830,639,20200329,1469
20200326,K,문산,3883,3814,20200329,7697
20200326,K,계양,1,0,20200329,1
20200327,K,서울역,3104,4173,20200330,7277
20200327,K,신촌,629,848,20200330,1477
20200327,K,효창공원앞,2356,2648,20200330,5004
20200327,K,공덕,2809,2606,20200330,5415
20200327,K,서강대,1652,1615,20200330,3267
20200327,K,홍대입구,1381,1636,20200330,3017
20200327,K,가좌,4097,3879,20200330,7976
20200327,K,디지털미디어시티,1927,1797,20200330,3724
20200327,K,수색,1874,1956,20200330,3830
20200327,K,화전,1285,1135,20200330,2420
20200327,K,강매,2539,2090,20200330,4629
20200327,K,행신,6401,6225,20200330,12626
20200327,K,능곡,3036,2815,20200330,5851
20200327,K,곡산,445,451,20200330,896
20200327,K,백마,5543,5204,20200330,10747
20200327,K,풍산,4318,4005,20200330,8323
20200327,K,일산,7221,7215,20200330,14436
20200327,K,탄현,6042,5853,20200330,11895
20200327,K,야당,4624,4555,20200330,9179
20200327,K,운정,4764,4350,20200330,9114
20200327,K,금릉,3656,3583,20200330,7239
20200327,K,금촌,5149,4978,20200330,10127
20200327,K,월롱,2005,1556,20200330,3561
20200327,K,파주,853,599,20200330,1452
20200327,K,문산,4014,4013,20200330,8027
20200328,K,서울역,729,767,20200331,1496
20200328,K,신촌,218,242,20200331,460
20200328,K,효창공원앞,1166,1317,20200331,2483
20200328,K,공덕,1589,1315,20200331,2904
20200328,K,서강대,1142,1145,20200331,2287
20200328,K,홍대입구,1220,1447,20200331,2667
20200328,K,가좌,2590,2474,20200331,5064
20200328,K,디지털미디어시티,1244,1178,20200331,2422
20200328,K,수색,825,866,20200331,1691
20200328,K,화전,702,664,20200331,1366
20200328,K,강매,1413,1252,20200331,2665
20200328,K,행신,3557,3429,20200331,6986
20200328,K,능곡,2006,1971,20200331,3977
20200328,K,곡산,277,277,20200331,554
20200328,K,백마,3095,2921,20200331,6016
20200328,K,풍산,2735,2657,20200331,5392
20200328,K,일산,4601,4558,20200331,9159
20200328,K,탄현,3716,3576,20200331,7292
20200328,K,야당,3235,3104,20200331,6339
20200328,K,운정,3008,2833,20200331,5841
20200328,K,금릉,2483,2506,20200331,4989
20200328,K,금촌,3906,3706,20200331,7612
20200328,K,월롱,957,922,20200331,1879
20200328,K,파주,672,504,20200331,1176
20200328,K,문산,3327,3405,20200331,6732
20200328,K,임진강,285,305,20200331,590
20200329,K,서울역,531,506,20200401,1037
20200329,K,신촌,169,176,20200401,345
20200329,K,효창공원앞,835,999,20200401,1834
20200329,K,공덕,1029,903,20200401,1932
20200329,K,서강대,785,836,20200401,1621
20200329,K,홍대입구,946,1005,20200401,1951
20200329,K,가좌,1839,1792,20200401,3631
20200329,K,디지털미디어시티,875,788,20200401,1663
20200329,K,수색,500,523,20200401,1023
20200329,K,화전,549,592,20200401,1141
20200329,K,강매,1002,902,20200401,1904
20200329,K,행신,2770,2596,20200401,5366
20200329,K,능곡,1538,1456,20200401,2994
20200329,K,곡산,229,220,20200401,449
20200329,K,백마,2146,2047,20200401,4193
20200329,K,풍산,2186,2015,20200401,4201
20200329,K,일산,2926,2697,20200401,5623
20200329,K,탄현,2653,2450,20200401,5103
20200329,K,야당,2329,2210,20200401,4539
20200329,K,운정,2140,1991,20200401,4131
20200329,K,금릉,1777,1749,20200401,3526
20200329,K,금촌,2643,2734,20200401,5377
20200329,K,월롱,675,1097,20200401,1772
20200329,K,파주,493,417,20200401,910
20200329,K,문산,2625,2618,20200401,5243
20200329,K,임진강,127,133,20200401,260
20200330,K,서울역,3264,4294,20200402,7558
20200330,K,신촌,628,825,20200402,1453
20200330,K,효창공원앞,2379,2753,20200402,5132
20200330,K,공덕,2774,2579,20200402,5353
20200330,K,서강대,1663,1515,20200402,3178
20200330,K,홍대입구,1242,1397,20200402,2639
20200330,K,가좌,4161,3860,20200402,8021
20200330,K,디지털미디어시티,1751,1747,20200402,3498
20200330,K,수색,1947,1983,20200402,3930
20200330,K,화전,1273,1213,20200402,2486
20200330,K,강매,2560,2254,20200402,4814
20200330,K,행신,6167,6092,20200402,12259
20200330,K,능곡,3016,2702,20200402,5718
20200330,K,곡산,454,493,20200402,947
20200330,K,백마,5634,5304,20200402,10938
20200330,K,풍산,4223,3910,20200402,8133
20200330,K,일산,7303,7292,20200402,14595
20200330,K,탄현,6154,5841,20200402,11995
20200330,K,야당,4553,4315,20200402,8868
20200330,K,운정,4815,4515,20200402,9330
20200330,K,금릉,3683,3662,20200402,7345
20200330,K,금촌,5109,4966,20200402,10075
20200330,K,월롱,1720,1639,20200402,3359
20200330,K,파주,936,670,20200402,1606
20200330,K,문산,4231,4168,20200402,8399
20200330,K,임진강,25,23,20200402,48
20200331,K,서울역,3058,4192,20200403,7250
20200331,K,신촌,660,883,20200403,1543
20200331,K,효창공원앞,2393,2710,20200403,5103
20200331,K,공덕,2830,2622,20200403,5452
20200331,K,서강대,1545,1514,20200403,3059
20200331,K,홍대입구,1285,1419,20200403,2704
20200331,K,가좌,4187,3860,20200403,8047
20200331,K,디지털미디어시티,1766,1719,20200403,3485
20200331,K,수색,1971,2036,20200403,4007
20200331,K,화전,1166,1084,20200403,2250
20200331,K,강매,2566,2226,20200403,4792
20200331,K,행신,6097,6028,20200403,12125
20200331,K,능곡,3032,2760,20200403,5792
20200331,K,곡산,457,533,20200403,990
20200331,K,백마,5543,5178,20200403,10721
20200331,K,풍산,4204,3957,20200403,8161
20200331,K,일산,7191,7078,20200403,14269
20200331,K,탄현,6095,5846,20200403,11941
20200331,K,야당,4632,4411,20200403,9043
20200331,K,운정,4758,4429,20200403,9187
20200331,K,금릉,3530,3484,20200403,7014
20200331,K,금촌,4990,4880,20200403,9870
20200331,K,월롱,1776,1638,20200403,3414
20200331,K,파주,886,671,20200403,1557
20200331,K,문산,4112,4077,20200403,8189
20200331,K,임진강,23,14,20200403,37
20200401,K,서울역,3233,4227,20200404,7460
20200401,K,신촌,662,866,20200404,1528
20200401,K,효창공원앞,2369,2676,20200404,5045
20200401,K,공덕,2821,2554,20200404,5375
20200401,K,서강대,1578,1547,20200404,3125
20200401,K,홍대입구,1288,1478,20200404,2766
20200401,K,가좌,4166,3843,20200404,8009
20200401,K,디지털미디어시티,1780,1765,20200404,3545
20200401,K,수색,1933,1955,20200404,3888
20200401,K,화전,1210,1140,20200404,2350
20200401,K,강매,2595,2201,20200404,4796
20200401,K,행신,6135,5975,20200404,12110
20200401,K,능곡,3009,2760,20200404,5769
20200401,K,곡산,441,493,20200404,934
20200401,K,백마,5612,5345,20200404,10957
20200401,K,풍산,4241,3964,20200404,8205
20200401,K,일산,7182,7299,20200404,14481
20200401,K,탄현,6117,5859,20200404,11976
20200401,K,야당,4658,4483,20200404,9141
20200401,K,운정,4804,4502,20200404,9306
20200401,K,금릉,3620,3519,20200404,7139
20200401,K,금촌,5101,4972,20200404,10073
20200401,K,월롱,1825,1681,20200404,3506
20200401,K,파주,907,687,20200404,1594
20200401,K,문산,4051,3982,20200404,8033
20200401,K,임진강,13,19,20200404,32
20200401,K,계양,1,0,20200404,1
20200402,K,서울역,3166,4291,20200405,7457
20200402,K,신촌,681,893,20200405,1574
20200402,K,효창공원앞,2338,2626,20200405,4964
20200402,K,공덕,2820,2552,20200405,5372
20200402,K,서강대,1617,1548,20200405,3165
20200402,K,홍대입구,1390,1409,20200405,2799
20200402,K,가좌,4130,3791,20200405,7921
20200402,K,디지털미디어시티,1847,1740,20200405,3587
20200402,K,수색,1890,2024,20200405,3914
20200402,K,화전,1242,1143,20200405,2385
20200402,K,강매,2604,2236,20200405,4840
20200402,K,행신,6186,6020,20200405,12206
20200402,K,능곡,3037,2738,20200405,5775
20200402,K,곡산,463,492,20200405,955
20200402,K,백마,5588,5282,20200405,10870
20200402,K,풍산,4254,3867,20200405,8121
20200402,K,일산,7260,7156,20200405,14416
20200402,K,탄현,5983,5844,20200405,11827
20200402,K,야당,4622,4444,20200405,9066
20200402,K,운정,4757,4452,20200405,9209
20200402,K,금릉,3591,3534,20200405,7125
20200402,K,금촌,4947,4819,20200405,9766
20200402,K,월롱,1863,1600,20200405,3463
20200402,K,파주,857,638,20200405,1495
20200402,K,문산,4003,4017,20200405,8020
20200402,K,임진강,29,25,20200405,54
20200403,K,서울역,3289,4403,20200406,7692
20200403,K,신촌,642,886,20200406,1528
20200403,K,효창공원앞,2394,2672,20200406,5066
20200403,K,공덕,2781,2652,20200406,5433
20200403,K,서강대,1686,1599,20200406,3285
20200403,K,홍대입구,1453,1641,20200406,3094
20200403,K,가좌,4405,4049,20200406,8454
20200403,K,디지털미디어시티,1976,1832,20200406,3808
20200403,K,수색,1896,1965,20200406,3861
20200403,K,화전,1281,1154,20200406,2435
20200403,K,강매,2606,2207,20200406,4813
20200403,K,행신,6619,6352,20200406,12971
20200403,K,능곡,3136,2789,20200406,5925
20200403,K,곡산,474,516,20200406,990
20200403,K,백마,5919,5550,20200406,11469
20200403,K,풍산,4433,4216,20200406,8649
20200403,K,일산,8011,8015,20200406,16026
20200403,K,탄현,6258,6123,20200406,12381
20200403,K,야당,4902,4833,20200406,9735
20200403,K,운정,5014,4671,20200406,9685
20200403,K,금릉,3828,3808,20200406,7636
20200403,K,금촌,5407,5196,20200406,10603
20200403,K,월롱,2170,1577,20200406,3747
20200403,K,파주,929,729,20200406,1658
20200403,K,문산,4411,4391,20200406,8802
20200403,K,임진강,14,28,20200406,42
20200403,K,서울역,1,0,20200406,1
20200404,K,서울역,725,795,20200407,1520
20200404,K,신촌,233,229,20200407,462
20200404,K,효창공원앞,1232,1399,20200407,2631
20200404,K,공덕,1741,1274,20200407,3015
20200404,K,서강대,1271,1157,20200407,2428
20200404,K,홍대입구,1318,1438,20200407,2756
20200404,K,가좌,2615,2561,20200407,5176
20200404,K,디지털미디어시티,1187,1161,20200407,2348
20200404,K,수색,812,761,20200407,1573
20200404,K,화전,965,897,20200407,1862
20200404,K,강매,1357,1229,20200407,2586
20200404,K,행신,3523,3544,20200407,7067
20200404,K,능곡,2030,2067,20200407,4097
20200404,K,곡산,275,280,20200407,555
20200404,K,백마,3117,2923,20200407,6040
20200404,K,풍산,2882,2762,20200407,5644
20200404,K,일산,4230,4039,20200407,8269
20200404,K,탄현,3753,3650,20200407,7403
20200404,K,야당,3198,2989,20200407,6187
20200404,K,운정,3016,2747,20200407,5763
20200404,K,금릉,2540,2607,20200407,5147
20200404,K,금촌,3842,3839,20200407,7681
20200404,K,월롱,1013,899,20200407,1912
20200404,K,파주,664,509,20200407,1173
20200404,K,문산,3428,3472,20200407,6900
20200404,K,임진강,125,121,20200407,246
20200405,K,서울역,564,527,20200408,1091
20200405,K,신촌,167,158,20200408,325
20200405,K,효창공원앞,865,1039,20200408,1904
20200405,K,공덕,950,876,20200408,1826
20200405,K,서강대,763,838,20200408,1601
20200405,K,홍대입구,979,1110,20200408,2089
20200405,K,가좌,1808,1827,20200408,3635
20200405,K,디지털미디어시티,849,853,20200408,1702
20200405,K,수색,541,577,20200408,1118
20200405,K,화전,606,610,20200408,1216
20200405,K,강매,933,851,20200408,1784
20200405,K,행신,2823,2639,20200408,5462
20200405,K,능곡,1546,1487,20200408,3033
20200405,K,곡산,195,224,20200408,419
20200405,K,백마,2125,2167,20200408,4292
20200405,K,풍산,2197,2042,20200408,4239
20200405,K,일산,3098,2912,20200408,6010
20200405,K,탄현,2671,2528,20200408,5199
20200405,K,야당,2357,2227,20200408,4584
20200405,K,운정,2086,2032,20200408,4118
20200405,K,금릉,1811,1771,20200408,3582
20200405,K,금촌,2891,3037,20200408,5928
20200405,K,월롱,653,1135,20200408,1788
20200405,K,파주,527,433,20200408,960
20200405,K,문산,2388,2337,20200408,4725
20200405,K,임진강,85,103,20200408,188
20200405,K,검암,1,0,20200408,1
20200406,K,서울역,3448,4473,20200409,7921
20200406,K,신촌,641,897,20200409,1538
20200406,K,효창공원앞,2379,2780,20200409,5159
20200406,K,공덕,2735,2624,20200409,5359
20200406,K,서강대,1609,1601,20200409,3210
20200406,K,홍대입구,1254,1367,20200409,2621
20200406,K,가좌,4342,4031,20200409,8373
20200406,K,디지털미디어시티,1866,1851,20200409,3717
20200406,K,수색,2025,2170,20200409,4195
20200406,K,화전,1261,1235,20200409,2496
20200406,K,강매,2641,2275,20200409,4916
20200406,K,행신,6412,6388,20200409,12800
20200406,K,능곡,3160,2807,20200409,5967
20200406,K,곡산,478,508,20200409,986
20200406,K,백마,5724,5419,20200409,11143
20200406,K,풍산,4385,4032,20200409,8417
20200406,K,일산,7576,7416,20200409,14992
20200406,K,탄현,6363,6059,20200409,12422
20200406,K,야당,4806,4596,20200409,9402
20200406,K,운정,5003,4704,20200409,9707
20200406,K,금릉,3777,3723,20200409,7500
20200406,K,금촌,5328,5245,20200409,10573
20200406,K,월롱,1783,1662,20200409,3445
20200406,K,파주,959,720,20200409,1679
20200406,K,문산,4327,4218,20200409,8545
20200406,K,임진강,14,14,20200409,28
20200407,K,서울역,3349,4478,20200410,7827
20200407,K,신촌,667,898,20200410,1565
20200407,K,효창공원앞,2389,2709,20200410,5098
20200407,K,공덕,2846,2540,20200410,5386
20200407,K,서강대,1623,1574,20200410,3197
20200407,K,홍대입구,1304,1365,20200410,2669
20200407,K,가좌,4446,3984,20200410,8430
20200407,K,디지털미디어시티,1891,1815,20200410,3706
20200407,K,수색,2034,2097,20200410,4131
20200407,K,화전,1301,1214,20200410,2515
20200407,K,강매,2612,2247,20200410,4859
20200407,K,행신,6456,6243,20200410,12699
20200407,K,능곡,3136,2872,20200410,6008
20200407,K,곡산,485,509,20200410,994
20200407,K,백마,5732,5378,20200410,11110
20200407,K,풍산,4383,4122,20200410,8505
20200407,K,일산,7507,7409,20200410,14916
20200407,K,탄현,6288,6126,20200410,12414
20200407,K,야당,4816,4680,20200410,9496
20200407,K,운정,4878,4603,20200410,9481
20200407,K,금릉,3736,3633,20200410,7369
20200407,K,금촌,5231,5015,20200410,10246
20200407,K,월롱,1808,1622,20200410,3430
20200407,K,파주,894,663,20200410,1557
20200407,K,문산,4174,4206,20200410,8380
20200407,K,임진강,19,29,20200410,48
20200408,K,서울역,3340,4452,20200411,7792
20200408,K,신촌,661,930,20200411,1591
20200408,K,효창공원앞,2463,2769,20200411,5232
20200408,K,공덕,2838,2686,20200411,5524
20200408,K,서강대,1675,1634,20200411,3309
20200408,K,홍대입구,1358,1464,20200411,2822
20200408,K,가좌,4211,3906,20200411,8117
20200408,K,디지털미디어시티,1854,1888,20200411,3742
20200408,K,수색,2002,2166,20200411,4168
20200408,K,화전,1356,1252,20200411,2608
20200408,K,강매,2642,2261,20200411,4903
20200408,K,행신,6392,6370,20200411,12762
20200408,K,능곡,3123,2794,20200411,5917
20200408,K,곡산,502,504,20200411,1006
20200408,K,백마,5836,5599,20200411,11435
20200408,K,풍산,4465,4124,20200411,8589
20200408,K,일산,8054,7966,20200411,16020
20200408,K,탄현,6470,6152,20200411,12622
20200408,K,야당,4930,4729,20200411,9659
20200408,K,운정,4996,4629,20200411,9625
20200408,K,금릉,3699,3695,20200411,7394
20200408,K,금촌,5133,5093,20200411,10226
20200408,K,월롱,1949,1645,20200411,3594
20200408,K,파주,941,703,20200411,1644
20200408,K,문산,4168,4109,20200411,8277
20200408,K,임진강,15,17,20200411,32
20200409,K,서울역,3363,4440,20200412,7803
20200409,K,신촌,630,844,20200412,1474
20200409,K,효창공원앞,2457,2769,20200412,5226
20200409,K,공덕,2850,2642,20200412,5492
20200409,K,서강대,1642,1553,20200412,3195
20200409,K,홍대입구,1317,1466,20200412,2783
20200409,K,가좌,4286,3981,20200412,8267
20200409,K,디지털미디어시티,1941,1893,20200412,3834
20200409,K,수색,2035,2143,20200412,4178
20200409,K,화전,1294,1180,20200412,2474
20200409,K,강매,2662,2225,20200412,4887
20200409,K,행신,6361,6320,20200412,12681
20200409,K,능곡,3093,2785,20200412,5878
20200409,K,곡산,465,513,20200412,978
20200409,K,백마,5865,5498,20200412,11363
20200409,K,풍산,4428,4068,20200412,8496
20200409,K,일산,7552,7497,20200412,15049
20200409,K,탄현,6366,6107,20200412,12473
20200409,K,야당,4757,4608,20200412,9365
20200409,K,운정,4866,4547,20200412,9413
20200409,K,금릉,3673,3615,20200412,7288
20200409,K,금촌,5086,5065,20200412,10151
20200409,K,월롱,2035,1670,20200412,3705
20200409,K,파주,904,709,20200412,1613
20200409,K,문산,4387,4300,20200412,8687
20200409,K,임진강,15,14,20200412,29
20200410,K,서울역,3438,4549,20200413,7987
20200410,K,신촌,708,944,20200413,1652
20200410,K,효창공원앞,2513,2773,20200413,5286
20200410,K,공덕,2930,2764,20200413,5694
20200410,K,서강대,1693,1597,20200413,3290
20200410,K,홍대입구,1556,1725,20200413,3281
20200410,K,가좌,4475,4177,20200413,8652
20200410,K,디지털미디어시티,1911,1854,20200413,3765
20200410,K,수색,1918,1974,20200413,3892
20200410,K,화전,1362,1200,20200413,2562
20200410,K,강매,2635,2189,20200413,4824
20200410,K,행신,6788,6507,20200413,13295
20200410,K,능곡,3208,2940,20200413,6148
20200410,K,곡산,490,553,20200413,1043
20200410,K,백마,6036,5529,20200413,11565
20200410,K,풍산,4490,4278,20200413,8768
20200410,K,일산,7650,7423,20200413,15073
20200410,K,탄현,6423,6163,20200413,12586
20200410,K,야당,4944,4703,20200413,9647
20200410,K,운정,5089,4726,20200413,9815
20200410,K,금릉,3901,3785,20200413,7686
20200410,K,금촌,5512,5349,20200413,10861
20200410,K,월롱,1653,1525,20200413,3178
20200410,K,파주,973,762,20200413,1735
20200410,K,문산,4412,4404,20200413,8816
20200410,K,임진강,16,9,20200413,25
20200411,K,서울역,825,862,20200414,1687
20200411,K,신촌,254,263,20200414,517
20200411,K,효창공원앞,1248,1461,20200414,2709
20200411,K,공덕,1842,1469,20200414,3311
20200411,K,서강대,1230,1152,20200414,2382
20200411,K,홍대입구,1322,1569,20200414,2891
20200411,K,가좌,2774,2664,20200414,5438
20200411,K,디지털미디어시티,1343,1201,20200414,2544
20200411,K,수색,910,832,20200414,1742
20200411,K,화전,829,739,20200414,1568
20200411,K,강매,1440,1327,20200414,2767
20200411,K,행신,3748,3742,20200414,7490
20200411,K,능곡,2162,2084,20200414,4246
20200411,K,곡산,310,316,20200414,626
20200411,K,백마,3239,3007,20200414,6246
20200411,K,풍산,2902,2870,20200414,5772
20200411,K,일산,4443,4347,20200414,8790
20200411,K,탄현,4001,3895,20200414,7896
20200411,K,야당,3370,3254,20200414,6624
20200411,K,운정,3279,2986,20200414,6265
20200411,K,금릉,2717,2689,20200414,5406
20200411,K,금촌,4288,4251,20200414,8539
20200411,K,월롱,1035,998,20200414,2033
20200411,K,파주,759,570,20200414,1329
20200411,K,문산,3575,3558,20200414,7133
20200411,K,임진강,106,107,20200414,213
20200411,K,김포공항,1,0,20200414,1
20200412,K,서울역,584,612,20200415,1196
20200412,K,신촌,153,174,20200415,327
20200412,K,효창공원앞,933,1081,20200415,2014
20200412,K,공덕,1216,1066,20200415,2282
20200412,K,서강대,894,919,20200415,1813
20200412,K,홍대입구,983,1129,20200415,2112
20200412,K,가좌,1922,1945,20200415,3867
20200412,K,디지털미디어시티,875,825,20200415,1700
20200412,K,수색,595,622,20200415,1217
20200412,K,화전,641,712,20200415,1353
20200412,K,강매,980,964,20200415,1944
20200412,K,행신,2873,2689,20200415,5562
20200412,K,능곡,1605,1592,20200415,3197
20200412,K,곡산,229,243,20200415,472
20200412,K,백마,2317,2203,20200415,4520
20200412,K,풍산,2403,2317,20200415,4720
20200412,K,일산,3285,3082,20200415,6367
20200412,K,탄현,2941,2702,20200415,5643
20200412,K,야당,2275,2234,20200415,4509
20200412,K,운정,2221,2083,20200415,4304
20200412,K,금릉,1928,1971,20200415,3899
20200412,K,금촌,2855,2973,20200415,5828
20200412,K,월롱,690,1130,20200415,1820
20200412,K,파주,539,455,20200415,994
20200412,K,문산,2696,2569,20200415,5265
20200412,K,임진강,70,71,20200415,141
20200413,K,서울역,3545,4620,20200416,8165
20200413,K,신촌,703,916,20200416,1619
20200413,K,효창공원앞,2458,2817,20200416,5275
20200413,K,공덕,2828,2725,20200416,5553
20200413,K,서강대,1654,1629,20200416,3283
20200413,K,홍대입구,1265,1464,20200416,2729
20200413,K,가좌,4604,4217,20200416,8821
20200413,K,디지털미디어시티,1860,1863,20200416,3723
20200413,K,수색,2147,2196,20200416,4343
20200413,K,화전,1360,1262,20200416,2622
20200413,K,강매,2673,2288,20200416,4961
20200413,K,행신,6594,6442,20200416,13036
20200413,K,능곡,3259,2929,20200416,6188
20200413,K,곡산,480,516,20200416,996
20200413,K,백마,5871,5616,20200416,11487
20200413,K,풍산,4502,4200,20200416,8702
20200413,K,일산,8191,8131,20200416,16322
20200413,K,탄현,6454,6162,20200416,12616
20200413,K,야당,5002,4656,20200416,9658
20200413,K,운정,5178,4833,20200416,10011
20200413,K,금릉,3826,3764,20200416,7590
20200413,K,금촌,5351,5269,20200416,10620
20200413,K,월롱,1804,1640,20200416,3444
20200413,K,파주,954,763,20200416,1717
20200413,K,문산,4391,4271,20200416,8662
20200413,K,임진강,12,11,20200416,23
20200414,K,서울역,3424,4558,20200417,7982
20200414,K,신촌,687,935,20200417,1622
20200414,K,효창공원앞,2482,2832,20200417,5314
20200414,K,공덕,2961,2793,20200417,5754
20200414,K,서강대,1712,1671,20200417,3383
20200414,K,홍대입구,1535,1607,20200417,3142
20200414,K,가좌,4574,4147,20200417,8721
20200414,K,디지털미디어시티,2024,1873,20200417,3897
20200414,K,수색,2069,2218,20200417,4287
20200414,K,화전,1428,1252,20200417,2680
20200414,K,강매,2736,2273,20200417,5009
20200414,K,행신,6831,6513,20200417,13344
20200414,K,능곡,3236,2847,20200417,6083
20200414,K,곡산,473,548,20200417,1021
20200414,K,백마,6050,5589,20200417,11639
20200414,K,풍산,4678,4265,20200417,8943
20200414,K,일산,7943,7665,20200417,15608
20200414,K,탄현,6689,6456,20200417,13145
20200414,K,야당,5188,4947,20200417,10135
20200414,K,운정,5190,4731,20200417,9921
20200414,K,금릉,3885,3864,20200417,7749
20200414,K,금촌,5460,5345,20200417,10805
20200414,K,월롱,2008,1701,20200417,3709
20200414,K,파주,992,736,20200417,1728
20200414,K,문산,4546,4582,20200417,9128
20200414,K,임진강,23,19,20200417,42
20200414,K,계양,1,0,20200417,1
20200415,K,서울역,759,722,20200418,1481
20200415,K,신촌,240,211,20200418,451
20200415,K,효창공원앞,1223,1436,20200418,2659
20200415,K,공덕,1325,1075,20200418,2400
20200415,K,서강대,1045,1052,20200418,2097
20200415,K,홍대입구,1134,1240,20200418,2374
20200415,K,가좌,2574,2427,20200418,5001
20200415,K,디지털미디어시티,1084,1059,20200418,2143
20200415,K,수색,844,861,20200418,1705
20200415,K,화전,826,854,20200418,1680
20200415,K,강매,1295,1228,20200418,2523
20200415,K,행신,3288,3180,20200418,6468
20200415,K,능곡,1982,2008,20200418,3990
20200415,K,곡산,265,261,20200418,526
20200415,K,백마,2830,2771,20200418,5601
20200415,K,풍산,2641,2657,20200418,5298
20200415,K,일산,3944,3831,20200418,7775
20200415,K,탄현,3620,3414,20200418,7034
20200415,K,야당,2887,2906,20200418,5793
20200415,K,운정,2863,2765,20200418,5628
20200415,K,금릉,2363,2304,20200418,4667
20200415,K,금촌,3705,3644,20200418,7349
20200415,K,월롱,1047,1278,20200418,2325
20200415,K,파주,694,569,20200418,1263
20200415,K,문산,3007,2983,20200418,5990
20200415,K,임진강,83,74,20200418,157
20200416,K,서울역,3377,4598,20200419,7975
20200416,K,신촌,653,922,20200419,1575
20200416,K,효창공원앞,2517,2816,20200419,5333
20200416,K,공덕,2917,2677,20200419,5594
20200416,K,서강대,1769,1705,20200419,3474
20200416,K,홍대입구,1440,1492,20200419,2932
20200416,K,가좌,4568,4220,20200419,8788
20200416,K,디지털미디어시티,1972,1885,20200419,3857
20200416,K,수색,2050,2175,20200419,4225
20200416,K,화전,1389,1287,20200419,2676
20200416,K,강매,2781,2356,20200419,5137
20200416,K,행신,6617,6490,20200419,13107
20200416,K,능곡,3200,2930,20200419,6130
20200416,K,곡산,510,558,20200419,1068
20200416,K,백마,5893,5571,20200419,11464
20200416,K,풍산,4642,4217,20200419,8859
20200416,K,일산,7821,7721,20200419,15542
20200416,K,탄현,6660,6259,20200419,12919
20200416,K,야당,4968,4751,20200419,9719
20200416,K,운정,5137,4766,20200419,9903
20200416,K,금릉,3773,3724,20200419,7497
20200416,K,금촌,5501,5342,20200419,10843
20200416,K,월롱,1902,1673,20200419,3575
20200416,K,파주,962,734,20200419,1696
20200416,K,문산,4391,4287,20200419,8678
20200416,K,임진강,14,16,20200419,30
20200417,K,서울역,3416,4487,20200420,7903
20200417,K,신촌,634,893,20200420,1527
20200417,K,효창공원앞,2452,2807,20200420,5259
20200417,K,공덕,2965,2648,20200420,5613
20200417,K,서강대,1646,1637,20200420,3283
20200417,K,홍대입구,1413,1628,20200420,3041
20200417,K,가좌,4441,3955,20200420,8396
20200417,K,디지털미디어시티,1969,1880,20200420,3849
20200417,K,수색,1934,2064,20200420,3998
20200417,K,화전,1300,1155,20200420,2455
20200417,K,강매,2523,2147,20200420,4670
20200417,K,행신,6621,6502,20200420,13123
20200417,K,능곡,3102,2812,20200420,5914
20200417,K,곡산,488,474,20200420,962
20200417,K,백마,5886,5508,20200420,11394
20200417,K,풍산,4361,4118,20200420,8479
20200417,K,일산,7387,7339,20200420,14726
20200417,K,탄현,6327,6136,20200420,12463
20200417,K,야당,4720,4605,20200420,9325
20200417,K,운정,4804,4455,20200420,9259
20200417,K,금릉,3680,3563,20200420,7243
20200417,K,금촌,5195,5040,20200420,10235
20200417,K,월롱,1967,1547,20200420,3514
20200417,K,파주,895,661,20200420,1556
20200417,K,문산,4188,4198,20200420,8386
20200417,K,임진강,12,7,20200420,19
20200418,K,서울역,904,951,20200421,1855
20200418,K,신촌,275,274,20200421,549
20200418,K,효창공원앞,1389,1514,20200421,2903
20200418,K,공덕,1836,1437,20200421,3273
20200418,K,서강대,1408,1296,20200421,2704
20200418,K,홍대입구,1455,1742,20200421,3197
20200418,K,가좌,3112,2864,20200421,5976
20200418,K,디지털미디어시티,1440,1340,20200421,2780
20200418,K,수색,951,891,20200421,1842
20200418,K,화전,934,887,20200421,1821
20200418,K,강매,1542,1418,20200421,2960
20200418,K,행신,3991,3994,20200421,7985
20200418,K,능곡,2381,2385,20200421,4766
20200418,K,곡산,368,388,20200421,756
20200418,K,백마,3663,3349,20200421,7012
20200418,K,풍산,3272,3163,20200421,6435
20200418,K,일산,5576,5259,20200421,10835
20200418,K,탄현,4283,4191,20200421,8474
20200418,K,야당,3751,3634,20200421,7385
20200418,K,운정,3433,3277,20200421,6710
20200418,K,금릉,2950,2859,20200421,5809
20200418,K,금촌,4400,4390,20200421,8790
20200418,K,월롱,1174,1058,20200421,2232
20200418,K,파주,819,675,20200421,1494
20200418,K,문산,3957,3918,20200421,7875
20200418,K,임진강,102,94,20200421,196
20200419,K,서울역,612,591,20200422,1203
20200419,K,신촌,171,171,20200422,342
20200419,K,효창공원앞,902,1069,20200422,1971
20200419,K,공덕,1239,970,20200422,2209
20200419,K,서강대,883,861,20200422,1744
20200419,K,홍대입구,971,1060,20200422,2031
20200419,K,가좌,1935,1953,20200422,3888
20200419,K,디지털미디어시티,942,855,20200422,1797
20200419,K,수색,516,596,20200422,1112
20200419,K,화전,613,604,20200422,1217
20200419,K,강매,965,907,20200422,1872
20200419,K,행신,2932,2774,20200422,5706
20200419,K,능곡,1536,1574,20200422,3110
20200419,K,곡산,216,216,20200422,432
20200419,K,백마,2308,2245,20200422,4553
20200419,K,풍산,2290,2203,20200422,4493
20200419,K,일산,3091,3051,20200422,6142
20200419,K,탄현,2888,2650,20200422,5538
20200419,K,야당,2420,2281,20200422,4701
20200419,K,운정,2154,2096,20200422,4250
20200419,K,금릉,1895,1816,20200422,3711
20200419,K,금촌,2917,2966,20200422,5883
20200419,K,월롱,590,1135,20200422,1725
20200419,K,파주,573,509,20200422,1082
20200419,K,문산,2768,2705,20200422,5473
20200419,K,임진강,46,59,20200422,105
20200420,K,서울역,3691,4735,20200423,8426
20200420,K,신촌,693,945,20200423,1638
20200420,K,효창공원앞,2530,2887,20200423,5417
20200420,K,공덕,2903,2665,20200423,5568
20200420,K,서강대,1724,1689,20200423,3413
20200420,K,홍대입구,1283,1436,20200423,2719
20200420,K,가좌,4548,4212,20200423,8760
20200420,K,디지털미디어시티,2043,1932,20200423,3975
20200420,K,수색,2093,2151,20200423,4244
20200420,K,화전,1310,1240,20200423,2550
20200420,K,강매,2613,2271,20200423,4884
20200420,K,행신,6580,6607,20200423,13187
20200420,K,능곡,3232,2950,20200423,6182
20200420,K,곡산,499,530,20200423,1029
20200420,K,백마,6024,5681,20200423,11705
20200420,K,풍산,4605,4213,20200423,8818
20200420,K,일산,7804,7557,20200423,15361
20200420,K,탄현,6598,6290,20200423,12888
20200420,K,야당,4957,4642,20200423,9599
20200420,K,운정,5104,4680,20200423,9784
20200420,K,금릉,3724,3665,20200423,7389
20200420,K,금촌,5369,5311,20200423,10680
20200420,K,월롱,1765,1675,20200423,3440
20200420,K,파주,932,705,20200423,1637
20200420,K,문산,4376,4246,20200423,8622
20200420,K,임진강,8,9,20200423,17
20200421,K,서울역,3495,4753,20200424,8248
20200421,K,신촌,698,911,20200424,1609
20200421,K,효창공원앞,2581,2923,20200424,5504
20200421,K,공덕,2980,2747,20200424,5727
20200421,K,서강대,1739,1678,20200424,3417
20200421,K,홍대입구,1289,1458,20200424,2747
20200421,K,가좌,4617,4228,20200424,8845
20200421,K,디지털미디어시티,2025,1968,20200424,3993
20200421,K,수색,2157,2227,20200424,4384
20200421,K,화전,1374,1279,20200424,2653
20200421,K,강매,2819,2358,20200424,5177
20200421,K,행신,6686,6760,20200424,13446
20200421,K,능곡,3245,2908,20200424,6153
20200421,K,곡산,497,523,20200424,1020
20200421,K,백마,5925,5678,20200424,11603
20200421,K,풍산,4556,4251,20200424,8807
20200421,K,일산,7809,7824,20200424,15633
20200421,K,탄현,6674,6421,20200424,13095
20200421,K,야당,4972,4834,20200424,9806
20200421,K,운정,5230,4750,20200424,9980
20200421,K,금릉,3846,3719,20200424,7565
20200421,K,금촌,5456,5412,20200424,10868
20200421,K,월롱,1885,1707,20200424,3592
20200421,K,파주,940,737,20200424,1677
20200421,K,문산,4447,4368,20200424,8815
20200421,K,임진강,25,21,20200424,46
20200422,K,서울역,3543,4654,20200425,8197
20200422,K,신촌,673,940,20200425,1613
20200422,K,효창공원앞,2563,2839,20200425,5402
20200422,K,공덕,2930,2735,20200425,5665
20200422,K,서강대,1740,1663,20200425,3403
20200422,K,홍대입구,1371,1539,20200425,2910
20200422,K,가좌,4593,4204,20200425,8797
20200422,K,디지털미디어시티,1989,1931,20200425,3920
20200422,K,수색,2154,2217,20200425,4371
20200422,K,화전,1352,1222,20200425,2574
20200422,K,강매,2710,2268,20200425,4978
20200422,K,행신,6632,6515,20200425,13147
20200422,K,능곡,3135,2897,20200425,6032
20200422,K,곡산,457,510,20200425,967
20200422,K,백마,5879,5516,20200425,11395
20200422,K,풍산,4503,4160,20200425,8663
20200422,K,일산,7774,7622,20200425,15396
20200422,K,탄현,6688,6521,20200425,13209
20200422,K,야당,5008,4754,20200425,9762
20200422,K,운정,4982,4720,20200425,9702
20200422,K,금릉,3772,3702,20200425,7474
20200422,K,금촌,5281,5115,20200425,10396
20200422,K,월롱,1920,1687,20200425,3607
20200422,K,파주,889,697,20200425,1586
20200422,K,문산,4304,4198,20200425,8502
20200422,K,임진강,17,17,20200425,34
20200422,K,계양,1,0,20200425,1
20200423,K,서울역,3563,4769,20200426,8332
20200423,K,신촌,683,907,20200426,1590
20200423,K,효창공원앞,2604,2996,20200426,5600
20200423,K,공덕,2995,2764,20200426,5759
20200423,K,서강대,1776,1722,20200426,3498
20200423,K,홍대입구,1376,1612,20200426,2988
20200423,K,가좌,4654,4321,20200426,8975
20200423,K,디지털미디어시티,1991,1925,20200426,3916
20200423,K,수색,2175,2250,20200426,4425
20200423,K,화전,1423,1342,20200426,2765
20200423,K,강매,2757,2305,20200426,5062
20200423,K,행신,6803,6737,20200426,13540
20200423,K,능곡,3209,2925,20200426,6134
20200423,K,곡산,519,518,20200426,1037
20200423,K,백마,6148,5736,20200426,11884
20200423,K,풍산,4770,4487,20200426,9257
20200423,K,일산,8551,8511,20200426,17062
20200423,K,탄현,6745,6526,20200426,13271
20200423,K,야당,5119,4854,20200426,9973
20200423,K,운정,5215,4743,20200426,9958
20200423,K,금릉,3851,3753,20200426,7604
20200423,K,금촌,5410,5392,20200426,10802
20200423,K,월롱,1940,1709,20200426,3649
20200423,K,파주,960,729,20200426,1689
20200423,K,문산,4281,4354,20200426,8635
20200423,K,임진강,14,10,20200426,24
20200423,K,계양,1,0,20200426,1
20200424,K,서울역,3713,5012,20200427,8725
20200424,K,신촌,701,1013,20200427,1714
20200424,K,효창공원앞,2638,2908,20200427,5546
20200424,K,공덕,3144,2930,20200427,6074
20200424,K,서강대,1860,1796,20200427,3656
20200424,K,홍대입구,1583,1796,20200427,3379
20200424,K,가좌,4880,4391,20200427,9271
20200424,K,디지털미디어시티,2115,2009,20200427,4124
20200424,K,수색,2200,2205,20200427,4405
20200424,K,화전,1494,1369,20200427,2863
20200424,K,강매,2834,2318,20200427,5152
20200424,K,행신,7264,7041,20200427,14305
20200424,K,능곡,3404,3077,20200427,6481
20200424,K,곡산,516,530,20200427,1046
20200424,K,백마,6351,5866,20200427,12217
20200424,K,풍산,4969,4608,20200427,9577
20200424,K,일산,8193,8102,20200427,16295
20200424,K,탄현,7013,6744,20200427,13757
20200424,K,야당,5360,5155,20200427,10515
20200424,K,운정,5353,4953,20200427,10306
20200424,K,금릉,4131,4104,20200427,8235
20200424,K,금촌,5848,5603,20200427,11451
20200424,K,월롱,2191,1684,20200427,3875
20200424,K,파주,953,728,20200427,1681
20200424,K,문산,4922,5037,20200427,9959
20200424,K,임진강,19,13,20200427,32
20200425,K,서울역,964,1043,20200428,2007
20200425,K,신촌,259,277,20200428,536
20200425,K,효창공원앞,1412,1507,20200428,2919
20200425,K,공덕,1991,1712,20200428,3703
20200425,K,서강대,1363,1356,20200428,2719
20200425,K,홍대입구,1566,1888,20200428,3454
20200425,K,가좌,3303,3022,20200428,6325
20200425,K,디지털미디어시티,1463,1393,20200428,2856
20200425,K,수색,908,917,20200428,1825
20200425,K,화전,970,934,20200428,1904
20200425,K,강매,1614,1406,20200428,3020
20200425,K,행신,4166,4077,20200428,8243
20200425,K,능곡,2353,2330,20200428,4683
20200425,K,곡산,362,376,20200428,738
20200425,K,백마,3678,3427,20200428,7105
20200425,K,풍산,3286,3180,20200428,6466
20200425,K,일산,5132,4905,20200428,10037
20200425,K,탄현,4561,4391,20200428,8952
20200425,K,야당,3748,3699,20200428,7447
20200425,K,운정,3562,3286,20200428,6848
20200425,K,금릉,3045,2910,20200428,5955
20200425,K,금촌,4557,4440,20200428,8997
20200425,K,월롱,1189,1105,20200428,2294
20200425,K,파주,779,666,20200428,1445
20200425,K,문산,4021,4000,20200428,8021
20200425,K,임진강,71,97,20200428,168
20200425,K,계양,1,0,20200428,1
20200426,K,서울역,744,760,20200429,1504
20200426,K,신촌,196,184,20200429,380
20200426,K,효창공원앞,1088,1241,20200429,2329
20200426,K,공덕,1308,1164,20200429,2472
20200426,K,서강대,1051,1033,20200429,2084
20200426,K,홍대입구,1256,1449,20200429,2705
20200426,K,가좌,2306,2302,20200429,4608
20200426,K,디지털미디어시티,1114,968,20200429,2082
20200426,K,수색,623,653,20200429,1276
20200426,K,화전,688,703,20200429,1391
20200426,K,강매,1145,1060,20200429,2205
20200426,K,행신,3429,3152,20200429,6581
20200426,K,능곡,1963,1863,20200429,3826
20200426,K,곡산,301,292,20200429,593
20200426,K,백마,2669,2628,20200429,5297
20200426,K,풍산,2726,2609,20200429,5335
20200426,K,일산,3713,3476,20200429,7189
20200426,K,탄현,3478,3174,20200429,6652
20200426,K,야당,2794,2780,20200429,5574
20200426,K,운정,2696,2628,20200429,5324
20200426,K,금릉,2158,2116,20200429,4274
20200426,K,금촌,3721,3780,20200429,7501
20200426,K,월롱,725,1243,20200429,1968
20200426,K,파주,686,570,20200429,1256
20200426,K,문산,3100,3144,20200429,6244
20200426,K,임진강,118,100,20200429,218
20200427,K,서울역,3817,5000,20200430,8817
20200427,K,신촌,731,921,20200430,1652
20200427,K,효창공원앞,2615,2978,20200430,5593
20200427,K,공덕,3105,2898,20200430,6003
20200427,K,서강대,1834,1793,20200430,3627
20200427,K,홍대입구,1368,1510,20200430,2878
20200427,K,가좌,5001,4508,20200430,9509
20200427,K,디지털미디어시티,2124,1956,20200430,4080
20200427,K,수색,2199,2371,20200430,4570
20200427,K,화전,1433,1327,20200430,2760
20200427,K,강매,2851,2384,20200430,5235
20200427,K,행신,6958,6916,20200430,13874
20200427,K,능곡,3490,3172,20200430,6662
20200427,K,곡산,530,552,20200430,1082
20200427,K,백마,6311,5806,20200430,12117
20200427,K,풍산,4831,4477,20200430,9308
20200427,K,일산,8252,8119,20200430,16371
20200427,K,탄현,7008,6699,20200430,13707
20200427,K,야당,5268,5081,20200430,10349
20200427,K,운정,5442,4978,20200430,10420
20200427,K,금릉,3995,3928,20200430,7923
20200427,K,금촌,5645,5469,20200430,11114
20200427,K,월롱,1891,1789,20200430,3680
20200427,K,파주,990,739,20200430,1729
20200427,K,문산,4697,4540,20200430,9237
20200427,K,임진강,11,8,20200430,19
20200428,K,서울역,3785,5012,20200501,8797
20200428,K,신촌,735,1023,20200501,1758
20200428,K,효창공원앞,2636,2953,20200501,5589
20200428,K,공덕,3202,2949,20200501,6151
20200428,K,서강대,1795,1704,20200501,3499
20200428,K,홍대입구,1490,1638,20200501,3128
20200428,K,가좌,4967,4553,20200501,9520
20200428,K,디지털미디어시티,2090,2029,20200501,4119
20200428,K,수색,2320,2441,20200501,4761
20200428,K,화전,1440,1318,20200501,2758
20200428,K,강매,2870,2413,20200501,5283
20200428,K,행신,7151,6899,20200501,14050
20200428,K,능곡,3528,3184,20200501,6712
20200428,K,곡산,534,580,20200501,1114
20200428,K,백마,6444,6114,20200501,12558
20200428,K,풍산,4817,4592,20200501,9409
20200428,K,일산,9213,9053,20200501,18266
20200428,K,탄현,7124,6775,20200501,13899
20200428,K,야당,5403,5127,20200501,10530
20200428,K,운정,5527,5210,20200501,10737
20200428,K,금릉,4159,4063,20200501,8222
20200428,K,금촌,5693,5570,20200501,11263
20200428,K,월롱,2020,1741,20200501,3761
20200428,K,파주,970,755,20200501,1725
20200428,K,문산,4833,4765,20200501,9598
20200428,K,임진강,10,10,20200501,20
20200429,K,서울역,3949,5355,20200502,9304
20200429,K,신촌,792,1115,20200502,1907
20200429,K,효창공원앞,2715,3065,20200502,5780
20200429,K,공덕,3331,3033,20200502,6364
20200429,K,서강대,1843,1802,20200502,3645
20200429,K,홍대입구,1650,1812,20200502,3462
20200429,K,가좌,5202,4702,20200502,9904
20200429,K,디지털미디어시티,2267,2126,20200502,4393
20200429,K,수색,2305,2403,20200502,4708
20200429,K,화전,1476,1342,20200502,2818
20200429,K,강매,2940,2464,20200502,5404
20200429,K,행신,7617,7336,20200502,14953
20200429,K,능곡,3594,3210,20200502,6804
20200429,K,곡산,538,584,20200502,1122
20200429,K,백마,6559,6061,20200502,12620
20200429,K,풍산,5054,4522,20200502,9576
20200429,K,일산,8715,8579,20200502,17294
20200429,K,탄현,7251,6822,20200502,14073
20200429,K,야당,5633,5401,20200502,11034
20200429,K,운정,5620,5224,20200502,10844
20200429,K,금릉,4500,4256,20200502,8756
20200429,K,금촌,6069,5903,20200502,11972
20200429,K,월롱,2330,1746,20200502,4076
20200429,K,파주,1063,791,20200502,1854
20200429,K,문산,5221,5253,20200502,10474
20200429,K,임진강,15,24,20200502,39
20200430,K,서울역,1043,1174,20200503,2217
20200430,K,신촌,321,290,20200503,611
20200430,K,효창공원앞,1280,1382,20200503,2662
20200430,K,공덕,1752,1414,20200503,3166
20200430,K,서강대,1332,1161,20200503,2493
20200430,K,홍대입구,1527,1702,20200503,3229
20200430,K,가좌,3170,2738,20200503,5908
20200430,K,디지털미디어시티,1345,1219,20200503,2564
20200430,K,수색,934,969,20200503,1903
20200430,K,화전,959,904,20200503,1863
20200430,K,강매,1509,1435,20200503,2944
20200430,K,행신,4158,4153,20200503,8311
20200430,K,능곡,2422,2325,20200503,4747
20200430,K,곡산,391,344,20200503,735
20200430,K,백마,3592,3234,20200503,6826
20200430,K,풍산,3198,3063,20200503,6261
20200430,K,일산,4822,4579,20200503,9401
20200430,K,탄현,4067,3918,20200503,7985
20200430,K,야당,3803,3538,20200503,7341
20200430,K,운정,3413,3203,20200503,6616
20200430,K,금릉,2930,2764,20200503,5694
20200430,K,금촌,4457,4236,20200503,8693
20200430,K,월롱,1166,1022,20200503,2188
20200430,K,파주,819,691,20200503,1510
20200430,K,문산,4012,3942,20200503,7954
20200430,K,임진강,138,114,20200503,252
20200501,K,검암,1,0,20200504,1
20200501,K,임진강,30,26,20200504,56
20200501,K,문산,4155,4113,20200504,8268
20200501,K,파주,767,604,20200504,1371
20200501,K,월롱,1044,1006,20200504,2050
20200501,K,금촌,5185,5179,20200504,10364
20200501,K,금릉,3044,2877,20200504,5921
20200501,K,운정,3622,3472,20200504,7094
20200501,K,야당,3808,3651,20200504,7459
20200501,K,탄현,4635,4223,20200504,8858
20200501,K,일산,5244,5116,20200504,10360
20200501,K,풍산,3356,3193,20200504,6549
20200501,K,백마,3711,3499,20200504,7210
20200501,K,곡산,354,340,20200504,694
20200501,K,능곡,2437,2375,20200504,4812
20200501,K,행신,4363,4482,20200504,8845
20200501,K,강매,1609,1388,20200504,2997
20200501,K,화전,1049,969,20200504,2018
20200501,K,수색,1002,973,20200504,1975
20200501,K,디지털미디어시티,1433,1333,20200504,2766
20200501,K,가좌,3370,3113,20200504,6483
20200501,K,홍대입구,1584,1759,20200504,3343
20200501,K,서강대,1409,1267,20200504,2676
20200501,K,공덕,1763,1506,20200504,3269
20200501,K,효창공원앞,1562,1745,20200504,3307
20200501,K,신촌,453,582,20200504,1035
20200501,K,서울역,1677,2500,20200504,4177
20200502,K,임진강,91,70,20200505,161
20200502,K,문산,3861,3918,20200505,7779
20200502,K,파주,788,604,20200505,1392
20200502,K,월롱,923,987,20200505,1910
20200502,K,금촌,4667,4574,20200505,9241
20200502,K,금릉,2821,2847,20200505,5668
20200502,K,운정,3440,3259,20200505,6699
20200502,K,야당,3520,3448,20200505,6968
20200502,K,탄현,4253,4136,20200505,8389
20200502,K,일산,4905,4699,20200505,9604
20200502,K,풍산,3181,3033,20200505,6214
20200502,K,백마,3378,3154,20200505,6532
20200502,K,곡산,339,357,20200505,696
20200502,K,능곡,2372,2320,20200505,4692
20200502,K,행신,4207,4119,20200505,8326
20200502,K,강매,1487,1292,20200505,2779
20200502,K,화전,929,861,20200505,1790
20200502,K,수색,861,849,20200505,1710
20200502,K,디지털미디어시티,1318,1325,20200505,2643
20200502,K,가좌,3075,2985,20200505,6060
20200502,K,홍대입구,1603,1960,20200505,3563
20200502,K,서강대,1467,1298,20200505,2765
20200502,K,공덕,1633,1394,20200505,3027
20200502,K,효창공원앞,1322,1422,20200505,2744
20200502,K,신촌,286,319,20200505,605
20200502,K,서울역,1077,1043,20200505,2120
20200503,K,임진강,86,83,20200506,169
20200503,K,문산,3374,3223,20200506,6597
20200503,K,파주,724,614,20200506,1338
20200503,K,월롱,859,1118,20200506,1977
20200503,K,금촌,3694,3961,20200506,7655
20200503,K,금릉,2238,2320,20200506,4558
20200503,K,운정,2811,2742,20200506,5553
20200503,K,야당,2980,2901,20200506,5881
20200503,K,탄현,3559,3378,20200506,6937
20200503,K,일산,4652,4561,20200506,9213
20200503,K,풍산,2793,2726,20200506,5519
20200503,K,백마,2774,2683,20200506,5457
20200503,K,곡산,274,255,20200506,529
20200503,K,능곡,2055,2051,20200506,4106
20200503,K,행신,3755,3452,20200506,7207
20200503,K,강매,1203,1190,20200506,2393
20200503,K,화전,742,744,20200506,1486
20200503,K,수색,725,732,20200506,1457
20200503,K,디지털미디어시티,1069,1083,20200506,2152
20200503,K,가좌,2477,2504,20200506,4981
20200503,K,홍대입구,1296,1446,20200506,2742
20200503,K,서강대,1051,1144,20200506,2195
20200503,K,공덕,1302,1128,20200506,2430
20200503,K,효창공원앞,1062,1264,20200506,2326
20200503,K,신촌,195,217,20200506,412
20200503,K,서울역,881,749,20200506,1630
20200504,K,임진강,17,22,20200507,39
20200504,K,문산,5005,5064,20200507,10069
20200504,K,파주,1016,759,20200507,1775
20200504,K,월롱,1453,1421,20200507,2874
20200504,K,금촌,5811,5676,20200507,11487
20200504,K,금릉,3977,3880,20200507,7857
20200504,K,운정,4903,4513,20200507,9416
20200504,K,야당,5033,4757,20200507,9790
20200504,K,탄현,6245,5946,20200507,12191
20200504,K,일산,7319,7086,20200507,14405
20200504,K,풍산,4361,3981,20200507,8342
20200504,K,백마,5581,5023,20200507,10604
20200504,K,곡산,435,433,20200507,868
20200504,K,능곡,3179,2896,20200507,6075
20200504,K,행신,6229,6089,20200507,12318
20200504,K,강매,2374,1914,20200507,4288
20200504,K,화전,1283,1228,20200507,2511
20200504,K,수색,1734,1795,20200507,3529
20200504,K,디지털미디어시티,1895,1761,20200507,3656
20200504,K,가좌,4407,4173,20200507,8580
20200504,K,홍대입구,1531,1863,20200507,3394
20200504,K,서강대,1740,1725,20200507,3465
20200504,K,공덕,2551,2390,20200507,4941
20200504,K,효창공원앞,2384,2735,20200507,5119
20200504,K,신촌,723,923,20200507,1646
20200504,K,서울역,3005,4031,20200507,7036
20200505,K,서울역,963,815,20200508,1778
20200505,K,신촌,276,251,20200508,527
20200505,K,효창공원앞,1214,1319,20200508,2533
20200505,K,공덕,1331,1251,20200508,2582
20200505,K,서강대,1104,1099,20200508,2203
20200505,K,홍대입구,1353,1556,20200508,2909
20200505,K,가좌,2627,2537,20200508,5164
20200505,K,디지털미디어시티,1218,1141,20200508,2359
20200505,K,수색,799,837,20200508,1636
20200505,K,화전,808,837,20200508,1645
20200505,K,강매,1355,1293,20200508,2648
20200505,K,행신,3670,3525,20200508,7195
20200505,K,능곡,2085,1938,20200508,4023
20200505,K,곡산,321,322,20200508,643
20200505,K,백마,2987,2892,20200508,5879
20200505,K,풍산,2903,2895,20200508,5798
20200505,K,일산,4341,4120,20200508,8461
20200505,K,탄현,3766,3551,20200508,7317
20200505,K,야당,3362,3218,20200508,6580
20200505,K,운정,3209,3059,20200508,6268
20200505,K,금릉,2614,2551,20200508,5165
20200505,K,금촌,3972,4092,20200508,8064
20200505,K,월롱,827,1357,20200508,2184
20200505,K,파주,711,602,20200508,1313
20200505,K,문산,3430,3403,20200508,6833
20200505,K,임진강,138,150,20200508,288
20200506,K,서울역,4101,5305,20200509,9406
20200506,K,신촌,833,1120,20200509,1953
20200506,K,효창공원앞,2806,3203,20200509,6009
20200506,K,공덕,3199,2933,20200509,6132
20200506,K,서강대,1918,1803,20200509,3721
20200506,K,홍대입구,1603,1775,20200509,3378
20200506,K,가좌,5152,4825,20200509,9977
20200506,K,디지털미디어시티,2185,2045,20200509,4230
20200506,K,수색,2372,2480,20200509,4852
20200506,K,화전,1488,1350,20200509,2838
20200506,K,강매,2965,2517,20200509,5482
20200506,K,행신,7535,7541,20200509,15076
20200506,K,능곡,3656,3283,20200509,6939
20200506,K,곡산,540,552,20200509,1092
20200506,K,백마,6740,6317,20200509,13057
20200506,K,풍산,5068,4652,20200509,9720
20200506,K,일산,8849,8703,20200509,17552
20200506,K,탄현,7410,7041,20200509,14451
20200506,K,야당,5684,5467,20200509,11151
20200506,K,운정,5825,5404,20200509,11229
20200506,K,금릉,4428,4302,20200509,8730
20200506,K,금촌,6574,6446,20200509,13020
20200506,K,월롱,2079,1850,20200509,3929
20200506,K,파주,1032,805,20200509,1837
20200506,K,문산,5083,4976,20200509,10059
20200506,K,임진강,23,21,20200509,44
20200506,K,계양,1,0,20200509,1
20200507,K,서울역,4096,5399,20200510,9495
20200507,K,신촌,818,1125,20200510,1943
20200507,K,효창공원앞,2792,3142,20200510,5934
20200507,K,공덕,3228,3046,20200510,6274
20200507,K,서강대,1955,1823,20200510,3778
20200507,K,홍대입구,1577,1750,20200510,3327
20200507,K,가좌,5288,4854,20200510,10142
20200507,K,디지털미디어시티,2272,2165,20200510,4437
20200507,K,수색,2378,2514,20200510,4892
20200507,K,화전,1528,1370,20200510,2898
20200507,K,강매,3055,2616,20200510,5671
20200507,K,행신,7658,7480,20200510,15138
20200507,K,능곡,3783,3429,20200510,7212
20200507,K,곡산,587,599,20200510,1186
20200507,K,백마,6750,6319,20200510,13069
20200507,K,풍산,5169,4868,20200510,10037
20200507,K,일산,8960,8901,20200510,17861
20200507,K,탄현,7385,7124,20200510,14509
20200507,K,야당,5666,5460,20200510,11126
20200507,K,운정,5838,5304,20200510,11142
20200507,K,금릉,4425,4302,20200510,8727
20200507,K,임진강,21,12,20200510,33
20200507,K,문산,5054,5036,20200510,10090
20200507,K,파주,1080,815,20200510,1895
20200507,K,월롱,2013,1803,20200510,3816
20200507,K,금촌,6100,6028,20200510,12128
20200508,K,서울역,4556,5887,20200511,10443
20200508,K,신촌,906,1112,20200511,2018
20200508,K,효창공원앞,2959,3318,20200511,6277
20200508,K,공덕,3308,3155,20200511,6463
20200508,K,서강대,2004,2032,20200511,4036
20200508,K,홍대입구,1610,1959,20200511,3569
20200508,K,가좌,5478,5080,20200511,10558
20200508,K,디지털미디어시티,2426,2345,20200511,4771
20200508,K,수색,2483,2415,20200511,4898
20200508,K,화전,1751,1399,20200511,3150
20200508,K,강매,3045,2612,20200511,5657
20200508,K,행신,7911,8103,20200511,16014
20200508,K,능곡,3863,3593,20200511,7456
20200508,K,곡산,557,594,20200511,1151
20200508,K,백마,6877,6613,20200511,13490
20200508,K,풍산,5357,5301,20200511,10658
20200508,K,일산,9554,9862,20200511,19416
20200508,K,탄현,7380,7537,20200511,14917
20200508,K,야당,5829,5633,20200511,11462
20200508,K,운정,5925,5808,20200511,11733
20200508,K,금릉,4472,4466,20200511,8938
20200508,K,금촌,6697,6286,20200511,12983
20200508,K,월롱,2540,1861,20200511,4401
20200508,K,파주,1267,888,20200511,2155
20200508,K,문산,6485,5252,20200511,11737
20200508,K,임진강,19,10,20200511,29
20200508,K,서울역,1,0,20200511,1
20200509,K,서울역,898,1034,20200512,1932
20200509,K,신촌,302,286,20200512,588
20200509,K,효창공원앞,1301,1503,20200512,2804
20200509,K,공덕,2048,1505,20200512,3553
20200509,K,서강대,1299,1302,20200512,2601
20200509,K,홍대입구,1355,1669,20200512,3024
20200509,K,가좌,3046,2848,20200512,5894
20200509,K,디지털미디어시티,1345,1173,20200512,2518
20200509,K,수색,855,830,20200512,1685
20200509,K,화전,904,765,20200512,1669
20200509,K,강매,1466,1254,20200512,2720
20200509,K,행신,4162,4119,20200512,8281
20200509,K,능곡,2201,2123,20200512,4324
20200509,K,곡산,267,272,20200512,539
20200509,K,백마,3366,3160,20200512,6526
20200509,K,풍산,3213,3064,20200512,6277
20200509,K,일산,4708,4393,20200512,9101
20200509,K,탄현,4379,4147,20200512,8526
20200509,K,야당,3474,3405,20200512,6879
20200509,K,운정,3246,3007,20200512,6253
20200509,K,금릉,2769,2675,20200512,5444
20200509,K,금촌,4237,4023,20200512,8260
20200509,K,월롱,994,941,20200512,1935
20200509,K,파주,680,519,20200512,1199
20200509,K,문산,3896,3620,20200512,7516
20200509,K,임진강,17,15,20200512,32
20200509,K,계양,1,0,20200512,1
20200510,K,서울역,822,859,20200513,1681
20200510,K,신촌,204,213,20200513,417
20200510,K,효창공원앞,1113,1249,20200513,2362
20200510,K,공덕,1369,1162,20200513,2531
20200510,K,서강대,1059,1064,20200513,2123
20200510,K,홍대입구,1256,1429,20200513,2685
20200510,K,가좌,2469,2384,20200513,4853
20200510,K,디지털미디어시티,1086,1073,20200513,2159
20200510,K,수색,698,799,20200513,1497
20200510,K,화전,815,812,20200513,1627
20200510,K,강매,1281,1164,20200513,2445
20200510,K,행신,3696,3376,20200513,7072
20200510,K,능곡,1988,1925,20200513,3913
20200510,K,곡산,291,322,20200513,613
20200510,K,백마,2742,2748,20200513,5490
20200510,K,풍산,2941,2746,20200513,5687
20200510,K,일산,3979,3764,20200513,7743
20200510,K,탄현,3590,3335,20200513,6925
20200510,K,야당,3073,2828,20200513,5901
20200510,K,운정,2766,2633,20200513,5399
20200510,K,금릉,2460,2411,20200513,4871
20200510,K,금촌,3660,3853,20200513,7513
20200510,K,월롱,773,1297,20200513,2070
20200510,K,파주,737,632,20200513,1369
20200510,K,문산,3447,3290,20200513,6737
20200510,K,임진강,55,60,20200513,115
20200511,K,임진강,11,11,20200514,22
20200511,K,문산,5068,4888,20200514,9956
20200511,K,파주,1910,1578,20200514,3488
20200511,K,월롱,2023,1860,20200514,3883
20200511,K,금촌,6613,6301,20200514,12914
20200511,K,금릉,4225,4268,20200514,8493
20200511,K,운정,5775,5287,20200514,11062
20200511,K,야당,5594,5328,20200514,10922
20200511,K,탄현,7497,7127,20200514,14624
20200511,K,일산,8963,8965,20200514,17928
20200511,K,풍산,5009,4673,20200514,9682
20200511,K,백마,6826,6356,20200514,13182
20200511,K,곡산,569,600,20200514,1169
20200511,K,능곡,3712,3379,20200514,7091
20200511,K,행신,7395,7472,20200514,14867
20200511,K,강매,2930,2456,20200514,5386
20200511,K,화전,1545,1396,20200514,2941
20200511,K,수색,2386,2444,20200514,4830
20200511,K,디지털미디어시티,2183,2150,20200514,4333
20200511,K,가좌,5101,4749,20200514,9850
20200511,K,홍대입구,1452,1602,20200514,3054
20200511,K,서강대,1876,1823,20200514,3699
20200511,K,공덕,3121,2966,20200514,6087
20200511,K,효창공원앞,2678,3111,20200514,5789
20200511,K,신촌,818,1115,20200514,1933
20200511,K,서울역,4151,5259,20200514,9410
20200512,K,백마,6699,6366,20200515,13065
20200512,K,서울역,4050,5156,20200515,9206
20200512,K,신촌,787,1050,20200515,1837
20200512,K,효창공원앞,2668,3010,20200515,5678
20200512,K,공덕,3167,2904,20200515,6071
20200512,K,서강대,1794,1729,20200515,3523
20200512,K,홍대입구,1401,1589,20200515,2990
20200512,K,가좌,5097,4638,20200515,9735
20200512,K,디지털미디어시티,2204,2161,20200515,4365
20200512,K,수색,2311,2508,20200515,4819
20200512,K,화전,1663,1521,20200515,3184
20200512,K,강매,2948,2485,20200515,5433
20200512,K,행신,7290,7279,20200515,14569
20200512,K,능곡,3755,3412,20200515,7167
20200512,K,곡산,569,611,20200515,1180
20200512,K,풍산,5072,4736,20200515,9808
20200512,K,일산,8662,8663,20200515,17325
20200512,K,탄현,7367,6999,20200515,14366
20200512,K,야당,5528,5352,20200515,10880
20200512,K,운정,5670,5314,20200515,10984
20200512,K,금릉,4307,4231,20200515,8538
20200512,K,금촌,6139,6005,20200515,12144
20200512,K,월롱,2040,1830,20200515,3870
20200512,K,파주,1880,1630,20200515,3510
20200512,K,문산,5148,5051,20200515,10199
20200512,K,임진강,20,46,20200515,66
20200513,K,서울역,3992,5137,20200516,9129
20200513,K,신촌,806,1106,20200516,1912
20200513,K,효창공원앞,2699,3078,20200516,5777
20200513,K,공덕,3171,2976,20200516,6147
20200513,K,서강대,1920,1841,20200516,3761
20200513,K,홍대입구,1419,1598,20200516,3017
20200513,K,가좌,5118,4669,20200516,9787
20200513,K,디지털미디어시티,2227,2097,20200516,4324
20200513,K,수색,2302,2392,20200516,4694
20200513,K,화전,1393,1254,20200516,2647
20200513,K,강매,2966,2532,20200516,5498
20200513,K,행신,7573,7403,20200516,14976
20200513,K,능곡,3712,3388,20200516,7100
20200513,K,곡산,568,655,20200516,1223
20200513,K,백마,6676,6415,20200516,13091
20200513,K,풍산,5136,4800,20200516,9936
20200513,K,일산,9795,9771,20200516,19566
20200513,K,탄현,7507,7113,20200516,14620
20200513,K,야당,5723,5492,20200516,11215
20200513,K,운정,5762,5378,20200516,11140
20200513,K,금릉,4361,4278,20200516,8639
20200513,K,금촌,6195,6096,20200516,12291
20200513,K,월롱,2562,2304,20200516,4866
20200513,K,파주,1752,1523,20200516,3275
20200513,K,문산,5099,5305,20200516,10404
20200513,K,임진강,20,15,20200516,35
20200513,K,계양,1,0,20200516,1
20200514,K,서울역,4164,5272,20200517,9436
20200514,K,신촌,780,1053,20200517,1833
20200514,K,효창공원앞,2726,3073,20200517,5799
20200514,K,공덕,3111,2921,20200517,6032
20200514,K,서강대,1838,1798,20200517,3636
20200514,K,홍대입구,1363,1534,20200517,2897
20200514,K,가좌,5028,4634,20200517,9662
20200514,K,디지털미디어시티,2191,2161,20200517,4352
20200514,K,수색,2345,2392,20200517,4737
20200514,K,화전,1479,1399,20200517,2878
20200514,K,강매,2916,2434,20200517,5350
20200514,K,검암,1,0,20200517,1
20200514,K,임진강,9,15,20200517,24
20200514,K,문산,5393,5700,20200517,11093
20200514,K,파주,1822,1512,20200517,3334
20200514,K,월롱,2465,2207,20200517,4672
20200514,K,금촌,6215,6103,20200517,12318
20200514,K,금릉,4229,4292,20200517,8521
20200514,K,운정,5582,5306,20200517,10888
20200514,K,야당,5585,5396,20200517,10981
20200514,K,탄현,7324,7007,20200517,14331
20200514,K,일산,8728,8589,20200517,17317
20200514,K,풍산,5125,4731,20200517,9856
20200514,K,백마,6606,6215,20200517,12821
20200514,K,곡산,575,603,20200517,1178
20200514,K,능곡,3732,3360,20200517,7092
20200514,K,행신,7385,7239,20200517,14624
20200515,K,임진강,2,1,20200518,3
20200515,K,문산,5223,4633,20200518,9856
20200515,K,파주,1386,908,20200518,2294
20200515,K,월롱,2459,1855,20200518,4314
20200515,K,금촌,5896,5628,20200518,11524
20200515,K,금릉,4061,4159,20200518,8220
20200515,K,운정,5349,5047,20200518,10396
20200515,K,야당,5274,5166,20200518,10440
20200515,K,탄현,6955,6970,20200518,13925
20200515,K,일산,8176,8311,20200518,16487
20200515,K,풍산,4861,4556,20200518,9417
20200515,K,백마,6274,5934,20200518,12208
20200515,K,곡산,522,521,20200518,1043
20200515,K,능곡,3531,3240,20200518,6771
20200515,K,행신,7441,7314,20200518,14755
20200515,K,강매,2736,2314,20200518,5050
20200515,K,화전,1543,1254,20200518,2797
20200515,K,수색,2054,2147,20200518,4201
20200515,K,디지털미디어시티,2195,2115,20200518,4310
20200515,K,가좌,4930,4645,20200518,9575
20200515,K,홍대입구,1293,1461,20200518,2754
20200515,K,서강대,1802,1803,20200518,3605
20200515,K,공덕,3226,2940,20200518,6166
20200515,K,효창공원앞,2668,3062,20200518,5730
20200515,K,신촌,741,945,20200518,1686
20200515,K,서울역,3945,5276,20200518,9221
20200516,K,임진강,69,32,20200519,101
20200516,K,문산,4210,3937,20200519,8147
20200516,K,파주,848,649,20200519,1497
20200516,K,월롱,1178,1089,20200519,2267
20200516,K,금촌,5187,5123,20200519,10310
20200516,K,금릉,3042,2987,20200519,6029
20200516,K,운정,3655,3404,20200519,7059
20200516,K,야당,3812,3836,20200519,7648
20200516,K,탄현,4573,4360,20200519,8933
20200516,K,일산,5287,5028,20200519,10315
20200516,K,풍산,3418,3440,20200519,6858
20200516,K,백마,3545,3182,20200519,6727
20200516,K,곡산,314,393,20200519,707
20200516,K,능곡,2506,2494,20200519,5000
20200516,K,행신,4160,4206,20200519,8366
20200516,K,강매,1545,1397,20200519,2942
20200516,K,화전,964,913,20200519,1877
20200516,K,수색,982,1008,20200519,1990
20200516,K,디지털미디어시티,1525,1418,20200519,2943
20200516,K,가좌,3383,3068,20200519,6451
20200516,K,홍대입구,1114,1215,20200519,2329
20200516,K,서강대,1373,1311,20200519,2684
20200516,K,공덕,2141,1624,20200519,3765
20200516,K,효창공원앞,1410,1553,20200519,2963
20200516,K,신촌,321,294,20200519,615
20200516,K,서울역,1047,1204,20200519,2251
20200517,K,임진강,56,63,20200520,119
20200517,K,문산,3369,3205,20200520,6574
20200517,K,파주,727,630,20200520,1357
20200517,K,월롱,695,1255,20200520,1950
20200517,K,금촌,3806,3985,20200520,7791
20200517,K,금릉,2409,2366,20200520,4775
20200517,K,운정,2675,2625,20200520,5300
20200517,K,야당,3004,2873,20200520,5877
20200517,K,탄현,3488,3195,20200520,6683
20200517,K,일산,3857,3622,20200520,7479
20200517,K,풍산,2775,2664,20200520,5439
20200517,K,백마,2634,2541,20200520,5175
20200517,K,곡산,307,265,20200520,572
20200517,K,능곡,2026,1963,20200520,3989
20200517,K,행신,3543,3201,20200520,6744
20200517,K,강매,1232,1154,20200520,2386
20200517,K,화전,793,829,20200520,1622
20200517,K,수색,781,760,20200520,1541
20200517,K,디지털미디어시티,1174,1071,20200520,2245
20200517,K,가좌,2453,2356,20200520,4809
20200517,K,홍대입구,922,1034,20200520,1956
20200517,K,서강대,1050,1046,20200520,2096
20200517,K,공덕,1449,1139,20200520,2588
20200517,K,효창공원앞,1038,1222,20200520,2260
20200517,K,신촌,208,229,20200520,437
20200517,K,서울역,854,828,20200520,1682
20200518,K,서울역,4003,4999,20200521,9002
20200518,K,신촌,742,991,20200521,1733
20200518,K,효창공원앞,2678,3064,20200521,5742
20200518,K,공덕,2984,2778,20200521,5762
20200518,K,서강대,1772,1764,20200521,3536
20200518,K,홍대입구,1156,1356,20200521,2512
20200518,K,가좌,4879,4553,20200521,9432
20200518,K,디지털미디어시티,2051,2097,20200521,4148
20200518,K,수색,2305,2379,20200521,4684
20200518,K,화전,1428,1342,20200521,2770
20200518,K,강매,2743,2339,20200521,5082
20200518,K,행신,7077,7123,20200521,14200
20200518,K,능곡,3450,3166,20200521,6616
20200518,K,곡산,501,508,20200521,1009
20200518,K,백마,6361,5880,20200521,12241
20200518,K,풍산,4759,4396,20200521,9155
20200518,K,일산,8890,8762,20200521,17652
20200518,K,탄현,6956,6671,20200521,13627
20200518,K,야당,5121,4795,20200521,9916
20200518,K,운정,5359,4933,20200521,10292
20200518,K,금릉,3944,3796,20200521,7740
20200518,K,금촌,5499,5546,20200521,11045
20200518,K,월롱,1971,1982,20200521,3953
20200518,K,파주,1490,1330,20200521,2820
20200518,K,문산,4683,4704,20200521,9387
20200518,K,임진강,7,7,20200521,14
20200518,K,계양,1,0,20200521,1
20200519,K,검암,1,0,20200522,1
20200519,K,임진강,11,3,20200522,14
20200519,K,문산,4738,4860,20200522,9598
20200519,K,파주,1494,1232,20200522,2726
20200519,K,월롱,2265,2037,20200522,4302
20200519,K,금촌,5661,5603,20200522,11264
20200519,K,금릉,4041,4010,20200522,8051
20200519,K,운정,5406,4983,20200522,10389
20200519,K,야당,5251,4973,20200522,10224
20200519,K,탄현,6950,6894,20200522,13844
20200519,K,일산,8269,8254,20200522,16523
20200519,K,풍산,4831,4432,20200522,9263
20200519,K,백마,6317,5920,20200522,12237
20200519,K,곡산,512,525,20200522,1037
20200519,K,능곡,3514,3089,20200522,6603
20200519,K,행신,7012,6922,20200522,13934
20200519,K,강매,2775,2323,20200522,5098
20200519,K,화전,1429,1325,20200522,2754
20200519,K,수색,2205,2309,20200522,4514
20200519,K,디지털미디어시티,2112,2051,20200522,4163
20200519,K,가좌,4863,4384,20200522,9247
20200519,K,홍대입구,1240,1359,20200522,2599
20200519,K,서강대,1813,1719,20200522,3532
20200519,K,공덕,3104,2814,20200522,5918
20200519,K,효창공원앞,2718,2999,20200522,5717
20200519,K,신촌,758,921,20200522,1679
20200519,K,서울역,3900,4780,20200522,8680
20200520,K,임진강,11,11,20200523,22
20200520,K,문산,5244,5251,20200523,10495
20200520,K,파주,1577,1263,20200523,2840
20200520,K,월롱,2458,2180,20200523,4638
20200520,K,금촌,6216,6073,20200523,12289
20200520,K,금릉,4390,4409,20200523,8799
20200520,K,운정,5813,5485,20200523,11298
20200520,K,야당,5769,5530,20200523,11299
20200520,K,탄현,7474,7176,20200523,14650
20200520,K,일산,9040,8894,20200523,17934
20200520,K,풍산,5230,4819,20200523,10049
20200520,K,백마,6562,6214,20200523,12776
20200520,K,곡산,620,639,20200523,1259
20200520,K,능곡,3796,3461,20200523,7257
20200520,K,행신,7538,7366,20200523,14904
20200520,K,강매,2958,2468,20200523,5426
20200520,K,화전,1753,1559,20200523,3312
20200520,K,수색,2311,2472,20200523,4783
20200520,K,디지털미디어시티,2273,2165,20200523,4438
20200520,K,가좌,5163,4648,20200523,9811
20200520,K,홍대입구,1400,1504,20200523,2904
20200520,K,서강대,1934,1839,20200523,3773
20200520,K,공덕,3290,3016,20200523,6306
20200520,K,효창공원앞,2729,3110,20200523,5839
20200520,K,신촌,766,1059,20200523,1825
20200520,K,서울역,4071,5216,20200523,9287
20200521,K,임진강,15,12,20200524,27
20200521,K,문산,5312,5615,20200524,10927
20200521,K,파주,1695,1330,20200524,3025
20200521,K,월롱,2057,1853,20200524,3910
20200521,K,금촌,6554,7112,20200524,13666
20200521,K,금릉,4363,4338,20200524,8701
20200521,K,운정,5772,5423,20200524,11195
20200521,K,야당,5809,5676,20200524,11485
20200521,K,탄현,7408,7160,20200524,14568
20200521,K,일산,8908,8856,20200524,17764
20200521,K,풍산,5237,4909,20200524,10146
20200521,K,백마,6729,6273,20200524,13002
20200521,K,곡산,609,622,20200524,1231
20200521,K,능곡,3751,3404,20200524,7155
20200521,K,행신,7445,7373,20200524,14818
20200521,K,강매,3002,2522,20200524,5524
20200521,K,화전,1696,1744,20200524,3440
20200521,K,수색,2486,2533,20200524,5019
20200521,K,디지털미디어시티,2251,2164,20200524,4415
20200521,K,가좌,5279,4783,20200524,10062
20200521,K,홍대입구,1425,1604,20200524,3029
20200521,K,서강대,1964,1832,20200524,3796
20200521,K,공덕,3159,3069,20200524,6228
20200521,K,효창공원앞,2816,3117,20200524,5933
20200521,K,신촌,818,1059,20200524,1877
20200521,K,서울역,4426,5229,20200524,9655
20200522,K,서울역,4284,5455,20200525,9739
20200522,K,신촌,769,1005,20200525,1774
20200522,K,효창공원앞,2638,2989,20200525,5627
20200522,K,공덕,3433,3224,20200525,6657
20200522,K,서강대,1959,1943,20200525,3902
20200522,K,홍대입구,1472,1659,20200525,3131
20200522,K,가좌,5237,4871,20200525,10108
20200522,K,디지털미디어시티,2356,2219,20200525,4575
20200522,K,수색,2464,2575,20200525,5039
20200522,K,화전,1954,1687,20200525,3641
20200522,K,강매,2972,2487,20200525,5459
20200522,K,행신,7817,7722,20200525,15539
20200522,K,능곡,3788,3553,20200525,7341
20200522,K,곡산,591,611,20200525,1202
20200522,K,백마,6810,6355,20200525,13165
20200522,K,풍산,5235,4920,20200525,10155
20200522,K,일산,9007,9023,20200525,18030
20200522,K,탄현,7400,7221,20200525,14621
20200522,K,야당,5879,5756,20200525,11635
20200522,K,운정,5778,5437,20200525,11215
20200522,K,금릉,4461,4448,20200525,8909
20200522,K,금촌,6816,6318,20200525,13134
20200522,K,월롱,2505,1946,20200525,4451
20200522,K,파주,1439,967,20200525,2406
20200522,K,문산,5558,5327,20200525,10885
20200522,K,임진강,19,7,20200525,26
20200522,K,검암,1,0,20200525,1
20200523,K,서울역,1239,1402,20200526,2641
20200523,K,신촌,332,304,20200526,636
20200523,K,효창공원앞,1582,1742,20200526,3324
20200523,K,공덕,2373,1935,20200526,4308
20200523,K,서강대,1581,1475,20200526,3056
20200523,K,홍대입구,1420,1537,20200526,2957
20200523,K,가좌,3642,3459,20200526,7101
20200523,K,디지털미디어시티,1683,1544,20200526,3227
20200523,K,수색,1204,1202,20200526,2406
20200523,K,화전,1181,1068,20200526,2249
20200523,K,강매,1847,1628,20200526,3475
20200523,K,행신,4714,4771,20200526,9485
20200523,K,능곡,2759,2817,20200526,5576
20200523,K,곡산,387,406,20200526,793
20200523,K,백마,4109,3910,20200526,8019
20200523,K,풍산,3761,3699,20200526,7460
20200523,K,일산,6833,6509,20200526,13342
20200523,K,탄현,4919,4750,20200526,9669
20200523,K,야당,4479,4451,20200526,8930
20200523,K,운정,4072,3770,20200526,7842
20200523,K,금릉,3326,3348,20200526,6674
20200523,K,금촌,5463,5156,20200526,10619
20200523,K,월롱,1245,1130,20200526,2375
20200523,K,파주,914,689,20200526,1603
20200523,K,문산,4700,4446,20200526,9146
20200523,K,임진강,86,79,20200526,165
20200524,K,임진강,39,29,20200527,68
20200524,K,문산,3286,3370,20200527,6656
20200524,K,파주,639,602,20200527,1241
20200524,K,월롱,758,1231,20200527,1989
20200524,K,금촌,3595,3743,20200527,7338
20200524,K,금릉,2237,2277,20200527,4514
20200524,K,운정,2622,2537,20200527,5159
20200524,K,야당,2912,2758,20200527,5670
20200524,K,탄현,3408,3177,20200527,6585
20200524,K,일산,3801,3572,20200527,7373
20200524,K,풍산,2698,2615,20200527,5313
20200524,K,백마,2626,2493,20200527,5119
20200524,K,곡산,255,233,20200527,488
20200524,K,능곡,1899,1857,20200527,3756
20200524,K,행신,3492,3304,20200527,6796
20200524,K,강매,1185,1107,20200527,2292
20200524,K,화전,811,850,20200527,1661
20200524,K,수색,771,869,20200527,1640
20200524,K,디지털미디어시티,1109,1038,20200527,2147
20200524,K,가좌,2354,2234,20200527,4588
20200524,K,홍대입구,1021,1133,20200527,2154
20200524,K,서강대,1032,1021,20200527,2053
20200524,K,공덕,1311,1112,20200527,2423
20200524,K,효창공원앞,1016,1182,20200527,2198
20200524,K,신촌,236,249,20200527,485
20200524,K,서울역,862,837,20200527,1699
20200525,K,임진강,15,25,20200528,40
20200525,K,문산,5172,5234,20200528,10406
20200525,K,파주,1619,1306,20200528,2925
20200525,K,월롱,2145,2136,20200528,4281
20200525,K,금촌,6280,6122,20200528,12402
20200525,K,금릉,4397,4247,20200528,8644
20200525,K,운정,5976,5474,20200528,11450
20200525,K,야당,5755,5416,20200528,11171
20200525,K,탄현,7380,7122,20200528,14502
20200525,K,일산,9025,8914,20200528,17939
20200525,K,풍산,5165,4754,20200528,9919
20200525,K,백마,6689,6282,20200528,12971
20200525,K,곡산,568,610,20200528,1178
20200525,K,능곡,3711,3395,20200528,7106
20200525,K,행신,7533,7461,20200528,14994
20200525,K,강매,2983,2606,20200528,5589
20200525,K,화전,1665,1573,20200528,3238
20200525,K,수색,2396,2512,20200528,4908
20200525,K,디지털미디어시티,2207,2117,20200528,4324
20200525,K,가좌,5268,4791,20200528,10059
20200525,K,홍대입구,1446,1563,20200528,3009
20200525,K,서강대,1912,1872,20200528,3784
20200525,K,공덕,3233,3052,20200528,6285
20200525,K,효창공원앞,2738,3113,20200528,5851
20200525,K,신촌,805,1055,20200528,1860
20200525,K,서울역,4410,5410,20200528,9820
20200526,K,임진강,10,9,20200529,19
20200526,K,문산,5161,4907,20200529,10068
20200526,K,파주,1573,1315,20200529,2888
20200526,K,월롱,2386,2232,20200529,4618
20200526,K,금촌,6448,6347,20200529,12795
20200526,K,금릉,4222,4161,20200529,8383
20200526,K,운정,5647,5240,20200529,10887
20200526,K,야당,5480,5412,20200529,10892
20200526,K,탄현,7444,7156,20200529,14600
20200526,K,일산,8769,8770,20200529,17539
20200526,K,풍산,5137,4764,20200529,9901
20200526,K,백마,6547,6223,20200529,12770
20200526,K,곡산,554,575,20200529,1129
20200526,K,능곡,3716,3268,20200529,6984
20200526,K,행신,7468,7399,20200529,14867
20200526,K,강매,2928,2485,20200529,5413
20200526,K,화전,1807,1678,20200529,3485
20200526,K,수색,2307,2412,20200529,4719
20200526,K,디지털미디어시티,2240,2143,20200529,4383
20200526,K,가좌,5182,4829,20200529,10011
20200526,K,홍대입구,1382,1458,20200529,2840
20200526,K,서강대,1907,1829,20200529,3736
20200526,K,공덕,3340,3042,20200529,6382
20200526,K,효창공원앞,2729,3108,20200529,5837
20200526,K,신촌,792,1039,20200529,1831
20200526,K,서울역,4162,5309,20200529,9471
20200527,K,임진강,19,7,20200530,26
20200527,K,문산,5122,5351,20200530,10473
20200527,K,파주,1587,1115,20200530,2702
20200527,K,월롱,2516,2285,20200530,4801
20200527,K,금촌,6469,6327,20200530,12796
20200527,K,금릉,4534,4524,20200530,9058
20200527,K,운정,5891,5548,20200530,11439
20200527,K,야당,5875,5668,20200530,11543
20200527,K,탄현,7534,7251,20200530,14785
20200527,K,일산,9187,9199,20200530,18386
20200527,K,풍산,5271,4863,20200530,10134
20200527,K,백마,6699,6415,20200530,13114
20200527,K,곡산,589,597,20200530,1186
20200527,K,능곡,3835,3474,20200530,7309
20200527,K,행신,7615,7625,20200530,15240
20200527,K,강매,2994,2541,20200530,5535
20200527,K,화전,1782,1515,20200530,3297
20200527,K,수색,2413,2544,20200530,4957
20200527,K,디지털미디어시티,2255,2160,20200530,4415
20200527,K,가좌,5289,4852,20200530,10141
20200527,K,홍대입구,1454,1630,20200530,3084
20200527,K,서강대,1994,1958,20200530,3952
20200527,K,공덕,3340,3064,20200530,6404
20200527,K,효창공원앞,2795,3240,20200530,6035
20200527,K,신촌,827,1087,20200530,1914
20200527,K,서울역,4283,5402,20200530,9685
20200528,K,임진강,15,10,20200531,25
20200528,K,문산,5293,5570,20200531,10863
20200528,K,파주,1568,1216,20200531,2784
20200528,K,월롱,2524,2290,20200531,4814
20200528,K,금촌,6529,6431,20200531,12960
20200528,K,금릉,4427,4448,20200531,8875
20200528,K,운정,5858,5531,20200531,11389
20200528,K,야당,5896,5702,20200531,11598
20200528,K,탄현,7512,7305,20200531,14817
20200528,K,일산,10188,9947,20200531,20135
20200528,K,풍산,5412,5075,20200531,10487
20200528,K,백마,6992,6398,20200531,13390
20200528,K,곡산,574,648,20200531,1222
20200528,K,능곡,3752,3436,20200531,7188
20200528,K,행신,7539,7359,20200531,14898
20200528,K,강매,3051,2570,20200531,5621
20200528,K,화전,1812,1704,20200531,3516
20200528,K,수색,2339,2493,20200531,4832
20200528,K,디지털미디어시티,2259,2211,20200531,4470
20200528,K,가좌,5185,4768,20200531,9953
20200528,K,홍대입구,1468,1628,20200531,3096
20200528,K,서강대,1954,1895,20200531,3849
20200528,K,공덕,3324,3084,20200531,6408
20200528,K,효창공원앞,2756,3206,20200531,5962
20200528,K,신촌,822,1065,20200531,1887
20200528,K,서울역,4295,5406,20200531,9701
20200529,K,서울역,4299,5521,20200601,9820
20200529,K,신촌,744,1092,20200601,1836
20200529,K,효창공원앞,2795,3093,20200601,5888
20200529,K,공덕,3369,3211,20200601,6580
20200529,K,서강대,1971,1937,20200601,3908
20200529,K,홍대입구,1610,1767,20200601,3377
20200529,K,가좌,5330,4862,20200601,10192
20200529,K,디지털미디어시티,2341,2197,20200601,4538
20200529,K,수색,2358,2416,20200601,4774
20200529,K,화전,1961,1750,20200601,3711
20200529,K,강매,2995,2507,20200601,5502
20200529,K,행신,7788,7804,20200601,15592
20200529,K,능곡,3765,3460,20200601,7225
20200529,K,곡산,594,641,20200601,1235
20200529,K,백마,6763,6425,20200601,13188
20200529,K,풍산,5289,4986,20200601,10275
20200529,K,일산,9144,9174,20200601,18318
20200529,K,탄현,7426,7300,20200601,14726
20200529,K,야당,5927,5794,20200601,11721
20200529,K,운정,5898,5639,20200601,11537
20200529,K,금릉,4593,4595,20200601,9188
20200529,K,금촌,6901,6475,20200601,13376
20200529,K,월롱,2526,1947,20200601,4473
20200529,K,파주,1570,976,20200601,2546
20200529,K,문산,5919,5680,20200601,11599
20200529,K,임진강,18,9,20200601,27
20200530,K,서울역,1178,1231,20200602,2409
20200530,K,신촌,305,333,20200602,638
20200530,K,효창공원앞,1576,1701,20200602,3277
20200530,K,공덕,2134,1629,20200602,3763
20200530,K,서강대,1519,1451,20200602,2970
20200530,K,홍대입구,1426,1516,20200602,2942
20200530,K,가좌,3449,3247,20200602,6696
20200530,K,디지털미디어시티,1583,1506,20200602,3089
20200530,K,수색,1052,1052,20200602,2104
20200530,K,화전,1004,948,20200602,1952
20200530,K,강매,1705,1530,20200602,3235
20200530,K,행신,4284,4367,20200602,8651
20200530,K,능곡,2573,2482,20200602,5055
20200530,K,곡산,335,403,20200602,738
20200530,K,백마,3842,3474,20200602,7316
20200530,K,풍산,3576,3543,20200602,7119
20200530,K,일산,5485,5320,20200602,10805
20200530,K,탄현,4668,4476,20200602,9144
20200530,K,야당,4033,3955,20200602,7988
20200530,K,운정,3749,3514,20200602,7263
20200530,K,금릉,3352,3253,20200602,6605
20200530,K,금촌,4979,4869,20200602,9848
20200530,K,월롱,1250,1184,20200602,2434
20200530,K,파주,909,713,20200602,1622
20200530,K,문산,4567,4293,20200602,8860
20200530,K,임진강,88,74,20200602,162
20200531,K,임진강,89,82,20200603,171
20200531,K,문산,3216,3148,20200603,6364
20200531,K,파주,705,612,20200603,1317
20200531,K,월롱,768,1250,20200603,2018
20200531,K,금촌,3711,3813,20200603,7524
20200531,K,금릉,2357,2276,20200603,4633
20200531,K,운정,2683,2576,20200603,5259
20200531,K,야당,2956,2848,20200603,5804
20200531,K,탄현,3412,3210,20200603,6622
20200531,K,일산,3804,3660,20200603,7464
20200531,K,풍산,2744,2552,20200603,5296
20200531,K,백마,2709,2491,20200603,5200
20200531,K,곡산,293,279,20200603,572
20200531,K,능곡,1927,1895,20200603,3822
20200531,K,행신,3459,3287,20200603,6746
20200531,K,강매,1233,1150,20200603,2383
20200531,K,화전,804,789,20200603,1593
20200531,K,수색,737,742,20200603,1479
20200531,K,디지털미디어시티,1199,1079,20200603,2278
20200531,K,가좌,2372,2341,20200603,4713
20200531,K,홍대입구,1114,1137,20200603,2251
20200531,K,서강대,1066,1059,20200603,2125
20200531,K,공덕,1388,1132,20200603,2520
20200531,K,효창공원앞,1061,1244,20200603,2305
20200531,K,신촌,198,240,20200603,438
20200531,K,서울역,862,850,20200603,1712
20200101,1,도화,2189,2151,20200104,4340
20200101,1,중동,4571,4316,20200104,8887
20200101,1,온수,3637,3618,20200104,7255
20200101,1,도원,1547,1703,20200104,3250
20200101,1,간석,3120,3160,20200104,6280
20200101,1,부개,4548,4521,20200104,9069
20200101,1,소사,6058,5870,20200104,11928
20200101,1,구일,2826,2902,20200104,5728
20200101,1,인천,4455,3523,20200104,7978
20200101,1,동인천,10592,10546,20200104,21138
20200101,1,제물포,5095,5193,20200104,10288
20200101,1,주안,12385,11231,20200104,23616
20200101,1,동암,9874,10232,20200104,20106
20200101,1,백운,4217,4164,20200104,8381
20200101,1,부평,25736,25727,20200104,51463
20200101,1,송내,13133,13132,20200104,26265
20200101,1,부천,24839,24883,20200104,49722
20200101,1,역곡,14165,14799,20200104,28964
20200101,1,오류동,7492,7068,20200104,14560
20200101,1,개봉,11584,11858,20200104,23442
20200102,1,개봉,24578,24539,20200105,49117
20200102,1,오류동,13449,12456,20200105,25905
20200102,1,역곡,31198,30536,20200105,61734
20200102,1,부천,38572,38987,20200105,77559
20200102,1,송내,32306,31637,20200105,63943
20200102,1,부평,36454,39448,20200105,75902
20200102,1,백운,8529,8188,20200105,16717
20200102,1,동암,18269,17899,20200105,36168
20200102,1,주안,22538,20495,20200105,43033
20200102,1,제물포,11363,10692,20200105,22055
20200102,1,동인천,17508,16464,20200105,33972
20200102,1,인천,3666,2832,20200105,6498
20200102,1,구일,7152,7084,20200105,14236
20200102,1,소사,10938,10259,20200105,21197
20200102,1,부개,9890,9035,20200105,18925
20200102,1,간석,7029,6465,20200105,13494
20200102,1,도원,4117,4174,20200105,8291
20200102,1,온수,7270,7270,20200105,14540
20200102,1,중동,10285,9581,20200105,19866
20200102,1,도화,4359,3902,20200105,8261
20200103,1,개봉,25616,25305,20200106,50921
20200103,1,오류동,13696,12582,20200106,26278
20200103,1,역곡,32988,32251,20200106,65239
20200103,1,부천,41021,42599,20200106,83620
20200103,1,송내,34124,33471,20200106,67595
20200103,1,부평,39107,44132,20200106,83239
20200103,1,백운,8953,8481,20200106,17434
20200103,1,동암,19031,18974,20200106,38005
20200103,1,주안,24155,21731,20200106,45886
20200103,1,제물포,12163,11070,20200106,23233
20200103,1,동인천,17983,16762,20200106,34745
20200103,1,인천,3936,3068,20200106,7004
20200103,1,구일,7585,7460,20200106,15045
20200103,1,소사,11137,10705,20200106,21842
20200103,1,부개,10201,9362,20200106,19563
20200103,1,간석,7354,6945,20200106,14299
20200103,1,도원,4235,4476,20200106,8711
20200103,1,온수,7447,7424,20200106,14871
20200103,1,중동,10866,10033,20200106,20899
20200103,1,도화,4696,4055,20200106,8751
20200104,1,개봉,20616,20033,20200107,40649
20200104,1,오류동,10784,9798,20200107,20582
20200104,1,역곡,24488,23769,20200107,48257
20200104,1,부천,36913,38295,20200107,75208
20200104,1,송내,23895,23140,20200107,47035
20200104,1,부평,36817,41570,20200107,78387
20200104,1,백운,6916,6749,20200107,13665
20200104,1,동암,15549,15833,20200107,31382
20200104,1,주안,19949,17805,20200107,37754
20200104,1,제물포,8539,8170,20200107,16709
20200104,1,동인천,15200,14746,20200107,29946
20200104,1,인천,4682,4158,20200107,8840
20200104,1,구일,14135,14656,20200107,28791
20200104,1,소사,9892,9662,20200107,19554
20200104,1,부개,7685,7116,20200107,14801
20200104,1,간석,5431,4986,20200107,10417
20200104,1,도원,2691,2664,20200107,5355
20200104,1,온수,6027,5480,20200107,11507
20200104,1,중동,8078,7446,20200107,15524
20200104,1,도화,3447,2960,20200107,6407
20200105,1,개봉,15447,15150,20200108,30597
20200105,1,오류동,9227,8486,20200108,17713
20200105,1,역곡,18778,18455,20200108,37233
20200105,1,부천,29319,29113,20200108,58432
20200105,1,송내,16821,16805,20200108,33626
20200105,1,부평,28665,29359,20200108,58024
20200105,1,백운,5293,5204,20200108,10497
20200105,1,동암,12106,11883,20200108,23989
20200105,1,주안,16181,14439,20200108,30620
20200105,1,제물포,6324,6247,20200108,12571
20200105,1,동인천,12050,11502,20200108,23552
20200105,1,인천,4323,3516,20200108,7839
20200105,1,구일,13660,15184,20200108,28844
20200105,1,소사,7704,6982,20200108,14686
20200105,1,부개,5745,5597,20200108,11342
20200105,1,간석,3765,3664,20200108,7429
20200105,1,도원,2325,2343,20200108,4668
20200105,1,온수,4959,4478,20200108,9437
20200105,1,중동,5673,5286,20200108,10959
20200105,1,도화,2590,2456,20200108,5046
20200106,1,개봉,24820,25219,20200109,50039
20200106,1,오류동,13596,12728,20200109,26324
20200106,1,역곡,31687,31240,20200109,62927
20200106,1,부천,38738,38918,20200109,77656
20200106,1,송내,33193,32819,20200109,66012
20200106,1,부평,36394,38623,20200109,75017
20200106,1,백운,8654,8504,20200109,17158
20200106,1,동암,18240,18126,20200109,36366
20200106,1,주안,22784,20708,20200109,43492
20200106,1,제물포,11902,11012,20200109,22914
20200106,1,동인천,16443,15502,20200109,31945
20200106,1,인천,3175,2465,20200109,5640
20200106,1,구일,7317,7348,20200109,14665
20200106,1,소사,11147,10596,20200109,21743
20200106,1,부개,9919,9336,20200109,19255
20200106,1,간석,6942,6526,20200109,13468
20200106,1,도원,3941,4170,20200109,8111
20200106,1,온수,7474,7388,20200109,14862
20200106,1,중동,10648,9962,20200109,20610
20200106,1,도화,4451,3951,20200109,8402
20200107,1,개봉,23714,24491,20200110,48205
20200107,1,오류동,12979,12192,20200110,25171
20200107,1,역곡,30363,29991,20200110,60354
20200107,1,부천,36508,36564,20200110,73072
20200107,1,송내,32352,32161,20200110,64513
20200107,1,부평,34009,36143,20200110,70152
20200107,1,백운,8278,8049,20200110,16327
20200107,1,동암,17409,17340,20200110,34749
20200107,1,주안,21754,19574,20200110,41328
20200107,1,제물포,10920,10421,20200110,21341
20200107,1,동인천,15474,14857,20200110,30331
20200107,1,인천,2926,1972,20200110,4898
20200107,1,구일,6890,6929,20200110,13819
20200107,1,소사,10502,10107,20200110,20609
20200107,1,부개,9620,9078,20200110,18698
20200107,1,간석,6762,6354,20200110,13116
20200107,1,도원,3510,3593,20200110,7103
20200107,1,온수,7072,7023,20200110,14095
20200107,1,중동,10215,9648,20200110,19863
20200107,1,도화,4090,3737,20200110,7827
20200108,1,개봉,25517,25360,20200111,50877
20200108,1,오류동,13765,12965,20200111,26730
20200108,1,역곡,32028,31527,20200111,63555
20200108,1,부천,39427,39716,20200111,79143
20200108,1,송내,33857,33455,20200111,67312
20200108,1,부평,36874,39816,20200111,76690
20200108,1,백운,8973,8739,20200111,17712
20200108,1,동암,18226,18185,20200111,36411
20200108,1,주안,23308,21218,20200111,44526
20200108,1,제물포,11619,10997,20200111,22616
20200108,1,동인천,17625,16765,20200111,34390
20200108,1,인천,3596,2616,20200111,6212
20200108,1,구일,7201,7122,20200111,14323
20200108,1,소사,11131,10644,20200111,21775
20200108,1,부개,9983,9308,20200111,19291
20200108,1,간석,7073,6708,20200111,13781
20200108,1,도원,4072,4186,20200111,8258
20200108,1,온수,7599,7614,20200111,15213
20200108,1,중동,10634,9922,20200111,20556
20200108,1,도화,4483,4118,20200111,8601
20200109,1,개봉,26006,26184,20200112,52190
20200109,1,오류동,13948,12948,20200112,26896
20200109,1,역곡,32517,32125,20200112,64642
20200109,1,부천,40007,40702,20200112,80709
20200109,1,송내,34575,33988,20200112,68563
20200109,1,부평,37097,39742,20200112,76839
20200109,1,백운,8822,8598,20200112,17420
20200109,1,동암,18582,18455,20200112,37037
20200109,1,주안,23277,21193,20200112,44470
20200109,1,제물포,11833,11213,20200112,23046
20200109,1,동인천,17709,16778,20200112,34487
20200109,1,인천,3981,3030,20200112,7011
20200109,1,구일,7322,7358,20200112,14680
20200109,1,소사,11234,10518,20200112,21752
20200109,1,부개,10029,9302,20200112,19331
20200109,1,간석,7184,6797,20200112,13981
20200109,1,도원,3846,4030,20200112,7876
20200109,1,온수,7737,7584,20200112,15321
20200109,1,중동,10820,10074,20200112,20894
20200109,1,도화,4354,3957,20200112,8311
20200110,1,개봉,26220,26068,20200113,52288
20200110,1,오류동,13951,12871,20200113,26822
20200110,1,역곡,33761,32754,20200113,66515
20200110,1,부천,42309,43944,20200113,86253
20200110,1,송내,35223,34469,20200113,69692
20200110,1,부평,39439,45272,20200113,84711
20200110,1,백운,9367,8862,20200113,18229
20200110,1,동암,19343,19371,20200113,38714
20200110,1,주안,24839,22120,20200113,46959
20200110,1,제물포,12033,11141,20200113,23174
20200110,1,동인천,18212,17041,20200113,35253
20200110,1,인천,4002,3017,20200113,7019
20200110,1,구일,7358,7290,20200113,14648
20200110,1,소사,11394,10675,20200113,22069
20200110,1,부개,10292,9400,20200113,19692
20200110,1,간석,7182,6800,20200113,13982
20200110,1,도원,4154,4152,20200113,8306
20200110,1,온수,7936,7617,20200113,15553
20200110,1,중동,10891,10200,20200113,21091
20200110,1,도화,4624,4029,20200113,8653
20200111,1,개봉,22420,21427,20200114,43847
20200111,1,오류동,11476,10309,20200114,21785
20200111,1,역곡,25982,25231,20200114,51213
20200111,1,부천,39251,40830,20200114,80081
20200111,1,송내,25847,24854,20200114,50701
20200111,1,부평,38357,43776,20200114,82133
20200111,1,백운,7524,7236,20200114,14760
20200111,1,동암,16603,16856,20200114,33459
20200111,1,주안,21190,18759,20200114,39949
20200111,1,제물포,8939,8395,20200114,17334
20200111,1,동인천,16107,15568,20200114,31675
20200111,1,인천,4840,4061,20200114,8901
20200111,1,구일,5692,5299,20200114,10991
20200111,1,소사,11162,10777,20200114,21939
20200111,1,부개,8180,7529,20200114,15709
20200111,1,간석,5701,5341,20200114,11042
20200111,1,도원,3000,3048,20200114,6048
20200111,1,온수,6260,5781,20200114,12041
20200111,1,중동,8450,7864,20200114,16314
20200111,1,도화,3585,3167,20200114,6752
20200112,1,개봉,15482,15426,20200115,30908
20200112,1,오류동,9219,8331,20200115,17550
20200112,1,역곡,18053,17994,20200115,36047
20200112,1,부천,28845,28291,20200115,57136
20200112,1,송내,17550,17574,20200115,35124
20200112,1,부평,29570,30282,20200115,59852
20200112,1,백운,5431,5446,20200115,10877
20200112,1,동암,12287,12307,20200115,24594
20200112,1,주안,15287,13559,20200115,28846
20200112,1,제물포,6421,6182,20200115,12603
20200112,1,동인천,12339,11888,20200115,24227
20200112,1,인천,4231,3427,20200115,7658
20200112,1,구일,3734,3658,20200115,7392
20200112,1,소사,7817,7495,20200115,15312
20200112,1,부개,6038,5802,20200115,11840
20200112,1,간석,3925,3798,20200115,7723
20200112,1,도원,2199,2256,20200115,4455
20200112,1,온수,5083,4765,20200115,9848
20200112,1,중동,5708,5394,20200115,11102
20200112,1,도화,2599,2512,20200115,5111
20200113,1,개봉,25140,25129,20200116,50269
20200113,1,오류동,14031,13075,20200116,27106
20200113,1,역곡,31858,31367,20200116,63225
20200113,1,부천,40126,39980,20200116,80106
20200113,1,송내,33671,32966,20200116,66637
20200113,1,부평,37070,39589,20200116,76659
20200113,1,백운,8890,8635,20200116,17525
20200113,1,동암,18404,18048,20200116,36452
20200113,1,주안,23255,21014,20200116,44269
20200113,1,제물포,11302,10639,20200116,21941
20200113,1,동인천,16702,15717,20200116,32419
20200113,1,인천,3587,2682,20200116,6269
20200113,1,구일,7215,7176,20200116,14391
20200113,1,소사,11441,10838,20200116,22279
20200113,1,부개,9947,9250,20200116,19197
20200113,1,간석,6973,6515,20200116,13488
20200113,1,도원,4093,4185,20200116,8278
20200113,1,온수,7478,7278,20200116,14756
20200113,1,중동,10732,10033,20200116,20765
20200113,1,도화,4363,3934,20200116,8297
20200114,1,도화,4413,4008,20200117,8421
20200114,1,중동,10571,9906,20200117,20477
20200114,1,온수,7514,7411,20200117,14925
20200114,1,도원,3790,3879,20200117,7669
20200114,1,간석,7168,6719,20200117,13887
20200114,1,부개,10006,9356,20200117,19362
20200114,1,소사,11430,10970,20200117,22400
20200114,1,구일,7147,7191,20200117,14338
20200114,1,인천,3930,2901,20200117,6831
20200114,1,동인천,16659,15896,20200117,32555
20200114,1,제물포,11428,10803,20200117,22231
20200114,1,주안,23541,21023,20200117,44564
20200114,1,동암,18706,18433,20200117,37139
20200114,1,백운,8904,8643,20200117,17547
20200114,1,부평,36337,38831,20200117,75168
20200114,1,송내,33951,33595,20200117,67546
20200114,1,부천,39647,40164,20200117,79811
20200114,1,역곡,32097,31693,20200117,63790
20200114,1,오류동,14004,13167,20200117,27171
20200114,1,개봉,25542,25488,20200117,51030
20200115,1,개봉,25551,25776,20200118,51327
20200115,1,오류동,14145,13185,20200118,27330
20200115,1,역곡,32331,31626,20200118,63957
20200115,1,부천,40380,40722,20200118,81102
20200115,1,송내,33884,33264,20200118,67148
20200115,1,부평,36954,39717,20200118,76671
20200115,1,백운,8917,8741,20200118,17658
20200115,1,동암,18515,18503,20200118,37018
20200115,1,주안,23495,21227,20200118,44722
20200115,1,제물포,11517,10912,20200118,22429
20200115,1,동인천,17586,16924,20200118,34510
20200115,1,인천,3816,2923,20200118,6739
20200115,1,구일,7258,7344,20200118,14602
20200115,1,소사,11163,10628,20200118,21791
20200115,1,부개,10040,9389,20200118,19429
20200115,1,간석,7071,6642,20200118,13713
20200115,1,도원,3954,3926,20200118,7880
20200115,1,온수,7485,7380,20200118,14865
20200115,1,중동,10825,10256,20200118,21081
20200115,1,도화,4556,4163,20200118,8719
20200116,1,도화,4346,3979,20200119,8325
20200116,1,중동,10929,10205,20200119,21134
20200116,1,온수,7616,7330,20200119,14946
20200116,1,도원,3628,3688,20200119,7316
20200116,1,간석,7126,6780,20200119,13906
20200116,1,부개,10044,9348,20200119,19392
20200116,1,소사,11236,10739,20200119,21975
20200116,1,구일,7345,7314,20200119,14659
20200116,1,인천,3837,2922,20200119,6759
20200116,1,동인천,17170,16410,20200119,33580
20200116,1,제물포,11306,10616,20200119,21922
20200116,1,주안,23421,21183,20200119,44604
20200116,1,동암,18579,18704,20200119,37283
20200116,1,백운,8865,8665,20200119,17530
20200116,1,부평,36987,40071,20200119,77058
20200116,1,송내,34028,33533,20200119,67561
20200116,1,부천,40438,40416,20200119,80854
20200116,1,역곡,32461,31884,20200119,64345
20200116,1,오류동,14250,13098,20200119,27348
20200116,1,개봉,25050,25318,20200119,50368
20200117,1,개봉,26528,26167,20200120,52695
20200117,1,오류동,14247,13118,20200120,27365
20200117,1,역곡,33571,32553,20200120,66124
20200117,1,부천,42058,43478,20200120,85536
20200117,1,송내,35033,34212,20200120,69245
20200117,1,부평,38919,43893,20200120,82812
20200117,1,백운,8996,8578,20200120,17574
20200117,1,동암,19058,19296,20200120,38354
20200117,1,주안,24320,22094,20200120,46414
20200117,1,제물포,12032,11087,20200120,23119
20200117,1,동인천,17712,17010,20200120,34722
20200117,1,인천,3889,2903,20200120,6792
20200117,1,구일,7670,7558,20200120,15228
20200117,1,소사,11416,10587,20200120,22003
20200117,1,부개,10264,9545,20200120,19809
20200117,1,간석,7366,6851,20200120,14217
20200117,1,도원,3886,3924,20200120,7810
20200117,1,온수,7660,7528,20200120,15188
20200117,1,중동,11137,10321,20200120,21458
20200117,1,도화,4590,4082,20200120,8672
20200118,1,개봉,21814,20421,20200121,42235
20200118,1,오류동,11642,10692,20200121,22334
20200118,1,역곡,25708,24766,20200121,50474
20200118,1,부천,37864,39773,20200121,77637
20200118,1,송내,24973,24035,20200121,49008
20200118,1,부평,37675,42725,20200121,80400
20200118,1,백운,7360,7022,20200121,14382
20200118,1,동암,16251,16520,20200121,32771
20200118,1,주안,20745,18434,20200121,39179
20200118,1,제물포,9099,8452,20200121,17551
20200118,1,동인천,15598,15512,20200121,31110
20200118,1,인천,4680,3851,20200121,8531
20200118,1,구일,13088,16858,20200121,29946
20200118,1,소사,9766,9361,20200121,19127
20200118,1,부개,7971,7315,20200121,15286
20200118,1,간석,5576,5287,20200121,10863
20200118,1,도원,2762,2838,20200121,5600
20200118,1,온수,6120,5651,20200121,11771
20200118,1,중동,8381,7818,20200121,16199
20200118,1,도화,3732,3310,20200121,7042
20200119,1,개봉,15596,14869,20200122,30465
20200119,1,오류동,9291,8371,20200122,17662
20200119,1,역곡,17651,17699,20200122,35350
20200119,1,부천,29312,28774,20200122,58086
20200119,1,송내,17283,16966,20200122,34249
20200119,1,부평,28655,29362,20200122,58017
20200119,1,백운,5430,5237,20200122,10667
20200119,1,동암,11877,11684,20200122,23561
20200119,1,주안,14743,12928,20200122,27671
20200119,1,제물포,6295,6095,20200122,12390
20200119,1,동인천,11655,11181,20200122,22836
20200119,1,인천,3342,2694,20200122,6036
20200119,1,구일,11321,14239,20200122,25560
20200119,1,소사,7144,6676,20200122,13820
20200119,1,부개,5759,5597,20200122,11356
20200119,1,간석,3837,3760,20200122,7597
20200119,1,도원,2255,2227,20200122,4482
20200119,1,온수,4927,4554,20200122,9481
20200119,1,중동,5635,5192,20200122,10827
20200119,1,도화,2569,2397,20200122,4966
20200120,1,도화,4447,3890,20200123,8337
20200120,1,중동,11053,10190,20200123,21243
20200120,1,온수,7587,7282,20200123,14869
20200120,1,도원,3714,3757,20200123,7471
20200120,1,간석,7116,6697,20200123,13813
20200120,1,부개,10055,9325,20200123,19380
20200120,1,소사,11277,10816,20200123,22093
20200120,1,구일,7351,7258,20200123,14609
20200120,1,인천,3678,2730,20200123,6408
20200120,1,동인천,16778,16074,20200123,32852
20200120,1,제물포,11767,11056,20200123,22823
20200120,1,주안,23197,20975,20200123,44172
20200120,1,동암,18717,18332,20200123,37049
20200120,1,백운,8852,8668,20200123,17520
20200120,1,부평,37404,39822,20200123,77226
20200120,1,송내,33823,33086,20200123,66909
20200120,1,부천,40695,40839,20200123,81534
20200120,1,역곡,32402,32013,20200123,64415
20200120,1,오류동,14283,13207,20200123,27490
20200120,1,개봉,25477,25611,20200123,51088
20200121,1,개봉,24949,25287,20200124,50236
20200121,1,오류동,14055,13036,20200124,27091
20200121,1,역곡,32177,31805,20200124,63982
20200121,1,부천,40782,40994,20200124,81776
20200121,1,송내,33809,33367,20200124,67176
20200121,1,부평,36922,39479,20200124,76401
20200121,1,백운,9316,8882,20200124,18198
20200121,1,동암,18539,18668,20200124,37207
20200121,1,주안,23010,20696,20200124,43706
20200121,1,제물포,11646,11147,20200124,22793
20200121,1,동인천,16568,15793,20200124,32361
20200121,1,인천,3579,2824,20200124,6403
20200121,1,구일,7240,7191,20200124,14431
20200121,1,소사,11014,10672,20200124,21686
20200121,1,부개,10124,9519,20200124,19643
20200121,1,간석,7032,6743,20200124,13775
20200121,1,도원,3700,3782,20200124,7482
20200121,1,온수,7583,7377,20200124,14960
20200121,1,중동,11357,10626,20200124,21983
20200121,1,도화,4450,3952,20200124,8402
20200122,1,개봉,25988,25753,20200125,51741
20200122,1,오류동,14269,13351,20200125,27620
20200122,1,역곡,32920,32171,20200125,65091
20200122,1,부천,41663,42361,20200125,84024
20200122,1,송내,34046,33156,20200125,67202
20200122,1,부평,37740,40900,20200125,78640
20200122,1,백운,8890,8719,20200125,17609
20200122,1,동암,18366,18700,20200125,37066
20200122,1,주안,23467,21031,20200125,44498
20200122,1,제물포,11709,10823,20200125,22532
20200122,1,동인천,17683,16875,20200125,34558
20200122,1,인천,3624,2762,20200125,6386
20200122,1,구일,7337,7174,20200125,14511
20200122,1,소사,11488,10976,20200125,22464
20200122,1,부개,10244,9429,20200125,19673
20200122,1,간석,7105,6733,20200125,13838
20200122,1,도원,3888,3966,20200125,7854
20200122,1,온수,7712,7893,20200125,15605
20200122,1,중동,10676,10183,20200125,20859
20200122,1,도화,4516,3996,20200125,8512
20200123,1,개봉,24073,23702,20200126,47775
20200123,1,오류동,13754,12072,20200126,25826
20200123,1,역곡,31220,30282,20200126,61502
20200123,1,부천,41839,43521,20200126,85360
20200123,1,송내,31876,31413,20200126,63289
20200123,1,부평,38548,45083,20200126,83631
20200123,1,백운,8370,7967,20200126,16337
20200123,1,동암,18319,18861,20200126,37180
20200123,1,주안,22780,20706,20200126,43486
20200123,1,제물포,11178,10362,20200126,21540
20200123,1,동인천,17420,16739,20200126,34159
20200123,1,인천,3461,2545,20200126,6006
20200123,1,구일,7005,6714,20200126,13719
20200123,1,소사,10884,10333,20200126,21217
20200123,1,부개,9773,9025,20200126,18798
20200123,1,간석,6631,6316,20200126,12947
20200123,1,도원,3406,3470,20200126,6876
20200123,1,온수,7348,7027,20200126,14375
20200123,1,중동,10116,9545,20200126,19661
20200123,1,도화,4295,3738,20200126,8033
20200124,1,도화,2119,1966,20200127,4085
20200124,1,중동,4570,4761,20200127,9331
20200124,1,온수,3432,3282,20200127,6714
20200124,1,도원,1815,2047,20200127,3862
20200124,1,간석,3043,3060,20200127,6103
20200124,1,부개,4568,4504,20200127,9072
20200124,1,소사,6034,6066,20200127,12100
20200124,1,구일,2919,2555,20200127,5474
20200124,1,인천,2763,2406,20200127,5169
20200124,1,동인천,9576,9900,20200127,19476
20200124,1,제물포,4834,5019,20200127,9853
20200124,1,주안,12135,10806,20200127,22941
20200124,1,동암,9857,10701,20200127,20558
20200124,1,백운,4368,4372,20200127,8740
20200124,1,부평,24199,28789,20200127,52988
20200124,1,송내,12856,12640,20200127,25496
20200124,1,부천,24305,24460,20200127,48765
20200124,1,역곡,14003,13870,20200127,27873
20200124,1,오류동,6636,5645,20200127,12281
20200124,1,개봉,11829,11397,20200127,23226
20200125,1,개봉,12086,12133,20200128,24219
20200125,1,오류동,6117,5800,20200128,11917
20200125,1,역곡,13415,13237,20200128,26652
20200125,1,부천,20552,21872,20200128,42424
20200125,1,송내,12269,11819,20200128,24088
20200125,1,부평,22201,24417,20200128,46618
20200125,1,백운,4775,4542,20200128,9317
20200125,1,동암,10523,10520,20200128,21043
20200125,1,주안,12775,11617,20200128,24392
20200125,1,제물포,5196,4863,20200128,10059
20200125,1,동인천,8248,7962,20200128,16210
20200125,1,인천,3807,3404,20200128,7211
20200125,1,구일,2544,2434,20200128,4978
20200125,1,소사,6466,5986,20200128,12452
20200125,1,부개,4881,4517,20200128,9398
20200125,1,간석,3058,2966,20200128,6024
20200125,1,도원,1686,1616,20200128,3302
20200125,1,온수,3528,3169,20200128,6697
20200125,1,중동,4709,4414,20200128,9123
20200125,1,도화,2039,1811,20200128,3850
20200126,1,개봉,13551,13197,20200129,26748
20200126,1,오류동,7684,7392,20200129,15076
20200126,1,역곡,15698,15319,20200129,31017
20200126,1,부천,25189,26531,20200129,51720
20200126,1,송내,14756,14073,20200129,28829
20200126,1,부평,29267,31798,20200129,61065
20200126,1,백운,4954,4617,20200129,9571
20200126,1,동암,11449,11267,20200129,22716
20200126,1,주안,13715,12319,20200129,26034
20200126,1,제물포,5976,5547,20200129,11523
20200126,1,동인천,11338,10720,20200129,22058
20200126,1,인천,4704,4250,20200129,8954
20200126,1,구일,2985,2997,20200129,5982
20200126,1,소사,6653,6179,20200129,12832
20200126,1,부개,5446,4844,20200129,10290
20200126,1,간석,3581,3283,20200129,6864
20200126,1,도원,1864,1843,20200129,3707
20200126,1,온수,4398,4040,20200129,8438
20200126,1,중동,4947,4653,20200129,9600
20200126,1,도화,2453,2133,20200129,4586
20200127,1,개봉,12905,12877,20200130,25782
20200127,1,오류동,7172,7021,20200130,14193
20200127,1,역곡,16105,16101,20200130,32206
20200127,1,부천,26835,26510,20200130,53345
20200127,1,송내,15161,14770,20200130,29931
20200127,1,부평,29177,29582,20200130,58759
20200127,1,백운,4706,4493,20200130,9199
20200127,1,동암,11156,10859,20200130,22015
20200127,1,주안,14317,12719,20200130,27036
20200127,1,제물포,5618,5388,20200130,11006
20200127,1,동인천,10680,10001,20200130,20681
20200127,1,인천,2995,2388,20200130,5383
20200127,1,구일,3223,3436,20200130,6659
20200127,1,소사,6464,5794,20200130,12258
20200127,1,부개,5358,4911,20200130,10269
20200127,1,간석,3449,3327,20200130,6776
20200127,1,도원,1621,1678,20200130,3299
20200127,1,온수,3780,3659,20200130,7439
20200127,1,중동,5258,4866,20200130,10124
20200127,1,도화,2417,2193,20200130,4610
20200128,1,개봉,22908,23055,20200131,45963
20200128,1,오류동,12671,11956,20200131,24627
20200128,1,역곡,29584,29253,20200131,58837
20200128,1,부천,37320,37195,20200131,74515
20200128,1,송내,30865,30325,20200131,61190
20200128,1,부평,35271,37589,20200131,72860
20200128,1,백운,8091,7913,20200131,16004
20200128,1,동암,17451,17140,20200131,34591
20200128,1,주안,21849,19751,20200131,41600
20200128,1,제물포,10616,9961,20200131,20577
20200128,1,동인천,15223,14618,20200131,29841
20200128,1,인천,3100,2419,20200131,5519
20200128,1,구일,6457,6588,20200131,13045
20200128,1,소사,10228,9792,20200131,20020
20200128,1,부개,9328,8743,20200131,18071
20200128,1,간석,6491,6215,20200131,12706
20200128,1,도원,3683,3651,20200131,7334
20200128,1,온수,6846,6700,20200131,13546
20200128,1,중동,9670,9094,20200131,18764
20200128,1,도화,4137,3685,20200131,7822
20200129,1,개봉,24108,24177,20200201,48285
20200129,1,오류동,13421,12814,20200201,26235
20200129,1,역곡,30629,30253,20200201,60882
20200129,1,부천,38213,38728,20200201,76941
20200129,1,송내,32159,31664,20200201,63823
20200129,1,부평,35788,38320,20200201,74108
20200129,1,백운,8597,8542,20200201,17139
20200129,1,동암,17826,17686,20200201,35512
20200129,1,주안,22543,20456,20200201,42999
20200129,1,제물포,11232,10476,20200201,21708
20200129,1,동인천,16433,15478,20200201,31911
20200129,1,인천,3282,2447,20200201,5729
20200129,1,구일,7134,7219,20200201,14353
20200129,1,소사,10604,10227,20200201,20831
20200129,1,부개,9515,8997,20200201,18512
20200129,1,간석,6981,6550,20200201,13531
20200129,1,도원,3599,3715,20200201,7314
20200129,1,온수,7162,7144,20200201,14306
20200129,1,중동,10188,9566,20200201,19754
20200129,1,도화,4471,3986,20200201,8457
20200130,1,도화,4381,3930,20200202,8311
20200130,1,중동,10166,9558,20200202,19724
20200130,1,온수,7124,7077,20200202,14201
20200130,1,도원,3617,3741,20200202,7358
20200130,1,간석,6835,6451,20200202,13286
20200130,1,부개,9517,8923,20200202,18440
20200130,1,소사,10522,10032,20200202,20554
20200130,1,구일,13502,14580,20200202,28082
20200130,1,인천,3127,2511,20200202,5638
20200130,1,동인천,16232,15310,20200202,31542
20200130,1,제물포,11114,10457,20200202,21571
20200130,1,주안,22629,20399,20200202,43028
20200130,1,동암,17973,17927,20200202,35900
20200130,1,백운,8266,8266,20200202,16532
20200130,1,부평,35388,37712,20200202,73100
20200130,1,송내,32549,31776,20200202,64325
20200130,1,부천,37734,38224,20200202,75958
20200130,1,역곡,30589,30034,20200202,60623
20200130,1,오류동,13337,12651,20200202,25988
20200130,1,개봉,24283,24299,20200202,48582
20200131,1,개봉,24383,24183,20200203,48566
20200131,1,오류동,13029,12069,20200203,25098
20200131,1,역곡,31021,30356,20200203,61377
20200131,1,부천,38425,39586,20200203,78011
20200131,1,송내,32345,31563,20200203,63908
20200131,1,부평,36381,41044,20200203,77425
20200131,1,백운,8365,8055,20200203,16420
20200131,1,동암,18057,18088,20200203,36145
20200131,1,주안,22977,20771,20200203,43748
20200131,1,제물포,11333,10409,20200203,21742
20200131,1,동인천,16337,15429,20200203,31766
20200131,1,인천,3130,2446,20200203,5576
20200131,1,구일,6997,6933,20200203,13930
20200131,1,소사,10593,9925,20200203,20518
20200131,1,부개,9709,9004,20200203,18713
20200131,1,간석,6815,6462,20200203,13277
20200131,1,도원,3703,3788,20200203,7491
20200131,1,온수,7115,7220,20200203,14335
20200131,1,중동,10240,9463,20200203,19703
20200131,1,도화,4378,3910,20200203,8288
20200201,1,개봉,16956,16622,20200204,33578
20200201,1,오류동,9224,8652,20200204,17876
20200201,1,역곡,20851,20131,20200204,40982
20200201,1,부천,30442,31208,20200204,61650
20200201,1,송내,19964,19284,20200204,39248
20200201,1,부평,31065,35131,20200204,66196
20200201,1,백운,6027,5883,20200204,11910
20200201,1,동암,13313,13526,20200204,26839
20200201,1,주안,17405,15672,20200204,33077
20200201,1,제물포,7684,7102,20200204,14786
20200201,1,동인천,12155,11834,20200204,23989
20200201,1,인천,2953,2496,20200204,5449
20200201,1,구일,4205,4026,20200204,8231
20200201,1,소사,8299,8130,20200204,16429
20200201,1,부개,6516,6203,20200204,12719
20200201,1,간석,4580,4352,20200204,8932
20200201,1,도원,2377,2413,20200204,4790
20200201,1,온수,4966,4632,20200204,9598
20200201,1,중동,6465,6244,20200204,12709
20200201,1,도화,3029,2706,20200204,5735
20200202,1,개봉,11850,11872,20200205,23722
20200202,1,오류동,7397,6828,20200205,14225
20200202,1,역곡,13635,13658,20200205,27293
20200202,1,부천,19313,18713,20200205,38026
20200202,1,송내,13188,12865,20200205,26053
20200202,1,부평,22769,23705,20200205,46474
20200202,1,백운,4517,4444,20200205,8961
20200202,1,동암,9741,9657,20200205,19398
20200202,1,주안,12352,10891,20200205,23243
20200202,1,제물포,5376,5298,20200205,10674
20200202,1,동인천,9597,9187,20200205,18784
20200202,1,인천,2251,1923,20200205,4174
20200202,1,구일,2864,2860,20200205,5724
20200202,1,소사,5793,5397,20200205,11190
20200202,1,부개,4606,4353,20200205,8959
20200202,1,간석,3167,3095,20200205,6262
20200202,1,도원,1800,1865,20200205,3665
20200202,1,온수,3931,3710,20200205,7641
20200202,1,중동,4353,4125,20200205,8478
20200202,1,도화,2249,2129,20200205,4378
20200203,1,개봉,22182,22438,20200206,44620
20200203,1,오류동,12220,11668,20200206,23888
20200203,1,역곡,27883,27535,20200206,55418
20200203,1,부천,30496,29922,20200206,60418
20200203,1,송내,29426,29116,20200206,58542
20200203,1,부평,32303,34163,20200206,66466
20200203,1,백운,7828,7695,20200206,15523
20200203,1,동암,16557,16367,20200206,32924
20200203,1,주안,20561,18613,20200206,39174
20200203,1,제물포,10676,10181,20200206,20857
20200203,1,동인천,14620,13630,20200206,28250
20200203,1,인천,2695,1930,20200206,4625
20200203,1,구일,6438,6578,20200206,13016
20200203,1,소사,9391,8947,20200206,18338
20200203,1,부개,8804,8127,20200206,16931
20200203,1,간석,6326,5964,20200206,12290
20200203,1,도원,3056,3115,20200206,6171
20200203,1,온수,6514,6648,20200206,13162
20200203,1,중동,9277,8791,20200206,18068
20200203,1,도화,4014,3551,20200206,7565
20200204,1,개봉,22293,22831,20200207,45124
20200204,1,오류동,12290,11629,20200207,23919
20200204,1,역곡,27695,27807,20200207,55502
20200204,1,부천,30514,29985,20200207,60499
20200204,1,송내,29651,29509,20200207,59160
20200204,1,부평,31424,33427,20200207,64851
20200204,1,백운,7709,7709,20200207,15418
20200204,1,동암,16285,16192,20200207,32477
20200204,1,주안,20504,18509,20200207,39013
20200204,1,제물포,10369,9758,20200207,20127
20200204,1,동인천,14306,13535,20200207,27841
20200204,1,인천,2816,1988,20200207,4804
20200204,1,구일,6537,6663,20200207,13200
20200204,1,소사,9482,9008,20200207,18490
20200204,1,부개,8777,8441,20200207,17218
20200204,1,간석,6207,6014,20200207,12221
20200204,1,도원,3025,3144,20200207,6169
20200204,1,온수,6520,6550,20200207,13070
20200204,1,중동,9185,8620,20200207,17805
20200204,1,도화,3963,3600,20200207,7563
20200205,1,개봉,21406,21977,20200208,43383
20200205,1,오류동,11857,11243,20200208,23100
20200205,1,역곡,26989,26670,20200208,53659
20200205,1,부천,30282,30044,20200208,60326
20200205,1,송내,28743,28461,20200208,57204
20200205,1,부평,31248,33547,20200208,64795
20200205,1,백운,7478,7425,20200208,14903
20200205,1,동암,15336,15492,20200208,30828
20200205,1,주안,19867,17942,20200208,37809
20200205,1,제물포,10226,9671,20200208,19897
20200205,1,동인천,14154,13543,20200208,27697
20200205,1,인천,2521,1784,20200208,4305
20200205,1,구일,6326,6421,20200208,12747
20200205,1,소사,8832,8400,20200208,17232
20200205,1,부개,8486,8050,20200208,16536
20200205,1,간석,5968,5641,20200208,11609
20200205,1,도원,2837,2889,20200208,5726
20200205,1,온수,6377,6363,20200208,12740
20200205,1,중동,8808,8355,20200208,17163
20200205,1,도화,3816,3357,20200208,7173
20200206,1,개봉,21250,21378,20200209,42628
20200206,1,오류동,11979,11262,20200209,23241
20200206,1,역곡,27036,26656,20200209,53692
20200206,1,부천,30503,30250,20200209,60753
20200206,1,송내,28834,28433,20200209,57267
20200206,1,부평,31354,33348,20200209,64702
20200206,1,백운,7353,7232,20200209,14585
20200206,1,동암,15458,15394,20200209,30852
20200206,1,주안,19323,17771,20200209,37094
20200206,1,제물포,9851,9292,20200209,19143
20200206,1,동인천,14103,13457,20200209,27560
20200206,1,인천,2561,1892,20200209,4453
20200206,1,구일,6271,6366,20200209,12637
20200206,1,소사,8962,8492,20200209,17454
20200206,1,부개,8422,7928,20200209,16350
20200206,1,간석,5925,5671,20200209,11596
20200206,1,도원,2725,2698,20200209,5423
20200206,1,온수,6467,6255,20200209,12722
20200206,1,중동,8896,8339,20200209,17235
20200206,1,도화,3659,3320,20200209,6979
20200207,1,개봉,22524,22716,20200210,45240
20200207,1,오류동,12039,11287,20200210,23326
20200207,1,역곡,28359,27827,20200210,56186
20200207,1,부천,32207,32592,20200210,64799
20200207,1,송내,29937,29241,20200210,59178
20200207,1,부평,33301,37857,20200210,71158
20200207,1,백운,7781,7582,20200210,15363
20200207,1,동암,16600,16542,20200210,33142
20200207,1,주안,20804,18837,20200210,39641
20200207,1,제물포,10614,10051,20200210,20665
20200207,1,동인천,15136,14296,20200210,29432
20200207,1,인천,2737,2044,20200210,4781
20200207,1,구일,6377,6392,20200210,12769
20200207,1,소사,9371,8957,20200210,18328
20200207,1,부개,8918,8241,20200210,17159
20200207,1,간석,6192,5780,20200210,11972
20200207,1,도원,2918,2946,20200210,5864
20200207,1,온수,6676,6464,20200210,13140
20200207,1,중동,9377,8679,20200210,18056
20200207,1,도화,3929,3451,20200210,7380
20200208,1,개봉,15884,15421,20200211,31305
20200208,1,오류동,8781,8014,20200211,16795
20200208,1,역곡,19383,19168,20200211,38551
20200208,1,부천,25376,25931,20200211,51307
20200208,1,송내,18608,17995,20200211,36603
20200208,1,부평,29282,33602,20200211,62884
20200208,1,백운,5623,5448,20200211,11071
20200208,1,동암,12540,12747,20200211,25287
20200208,1,주안,16764,14776,20200211,31540
20200208,1,제물포,7172,6781,20200211,13953
20200208,1,동인천,11694,11387,20200211,23081
20200208,1,인천,2319,1915,20200211,4234
20200208,1,구일,4452,4113,20200211,8565
20200208,1,소사,8111,7803,20200211,15914
20200208,1,부개,6216,5850,20200211,12066
20200208,1,간석,4362,4254,20200211,8616
20200208,1,도원,2260,2222,20200211,4482
20200208,1,온수,4477,4220,20200211,8697
20200208,1,중동,6126,5728,20200211,11854
20200208,1,도화,2931,2515,20200211,5446
20200209,1,개봉,11272,11282,20200212,22554
20200209,1,오류동,7005,6426,20200212,13431
20200209,1,역곡,13771,13596,20200212,27367
20200209,1,부천,19130,18587,20200212,37717
20200209,1,송내,13212,12919,20200212,26131
20200209,1,부평,22406,23297,20200212,45703
20200209,1,백운,4316,4090,20200212,8406
20200209,1,동암,9578,9496,20200212,19074
20200209,1,주안,12014,10622,20200212,22636
20200209,1,제물포,5046,4920,20200212,9966
20200209,1,동인천,9459,9081,20200212,18540
20200209,1,인천,2060,1731,20200212,3791
20200209,1,구일,2812,2848,20200212,5660
20200209,1,소사,5607,5258,20200212,10865
20200209,1,부개,4501,4283,20200212,8784
20200209,1,간석,3114,2956,20200212,6070
20200209,1,도원,1830,1796,20200212,3626
20200209,1,온수,3718,3525,20200212,7243
20200209,1,중동,4271,4044,20200212,8315
20200209,1,도화,2085,1855,20200212,3940
20200210,1,개봉,22254,22371,20200213,44625
20200210,1,오류동,12286,11651,20200213,23937
20200210,1,역곡,28688,28432,20200213,57120
20200210,1,부천,33042,32664,20200213,65706
20200210,1,송내,29912,29685,20200213,59597
20200210,1,부평,33268,35667,20200213,68935
20200210,1,백운,7875,7771,20200213,15646
20200210,1,동암,16515,16340,20200213,32855
20200210,1,주안,20667,18744,20200213,39411
20200210,1,제물포,10435,9741,20200213,20176
20200210,1,동인천,15094,14130,20200213,29224
20200210,1,인천,2725,2049,20200213,4774
20200210,1,구일,6432,6403,20200213,12835
20200210,1,소사,9740,9084,20200213,18824
20200210,1,부개,8911,8297,20200213,17208
20200210,1,간석,6197,5889,20200213,12086
20200210,1,도원,2800,2809,20200213,5609
20200210,1,온수,6656,6654,20200213,13310
20200210,1,중동,9508,8956,20200213,18464
20200210,1,도화,3946,3516,20200213,7462
20200211,1,개봉,22818,23023,20200214,45841
20200211,1,오류동,12551,11750,20200214,24301
20200211,1,역곡,29079,28985,20200214,58064
20200211,1,부천,33606,33749,20200214,67355
20200211,1,송내,30960,30654,20200214,61614
20200211,1,부평,33642,36099,20200214,69741
20200211,1,백운,7981,7907,20200214,15888
20200211,1,동암,16778,16702,20200214,33480
20200211,1,주안,21122,19075,20200214,40197
20200211,1,제물포,10792,10182,20200214,20974
20200211,1,동인천,14915,14038,20200214,28953
20200211,1,인천,3076,2380,20200214,5456
20200211,1,구일,6546,6748,20200214,13294
20200211,1,소사,9771,9480,20200214,19251
20200211,1,부개,9149,8481,20200214,17630
20200211,1,간석,6321,6111,20200214,12432
20200211,1,도원,2992,3078,20200214,6070
20200211,1,온수,6721,6602,20200214,13323
20200211,1,중동,9731,9115,20200214,18846
20200211,1,도화,4032,3593,20200214,7625
20200212,1,개봉,22023,22480,20200215,44503
20200212,1,오류동,12057,11496,20200215,23553
20200212,1,역곡,28118,27664,20200215,55782
20200212,1,부천,32328,32469,20200215,64797
20200212,1,송내,29966,29504,20200215,59470
20200212,1,부평,31707,34345,20200215,66052
20200212,1,백운,7671,7638,20200215,15309
20200212,1,동암,15703,15647,20200215,31350
20200212,1,주안,20033,18170,20200215,38203
20200212,1,제물포,10026,9386,20200215,19412
20200212,1,동인천,14528,13853,20200215,28381
20200212,1,인천,2581,1797,20200215,4378
20200212,1,구일,6324,6431,20200215,12755
20200212,1,소사,9370,8838,20200215,18208
20200212,1,부개,8593,8095,20200215,16688
20200212,1,간석,6018,5599,20200215,11617
20200212,1,도원,2738,2830,20200215,5568
20200212,1,온수,6293,6516,20200215,12809
20200212,1,중동,9290,8697,20200215,17987
20200212,1,도화,3832,3521,20200215,7353
20200213,1,개봉,23162,23064,20200216,46226
20200213,1,오류동,12835,12005,20200216,24840
20200213,1,역곡,29739,29100,20200216,58839
20200213,1,부천,34786,34937,20200216,69723
20200213,1,송내,31305,30851,20200216,62156
20200213,1,부평,34618,37587,20200216,72205
20200213,1,백운,7937,7640,20200216,15577
20200213,1,동암,17065,17075,20200216,34140
20200213,1,주안,21381,19337,20200216,40718
20200213,1,제물포,10659,10031,20200216,20690
20200213,1,동인천,15336,14430,20200216,29766
20200213,1,인천,3016,2305,20200216,5321
20200213,1,구일,6637,6617,20200216,13254
20200213,1,소사,9825,9378,20200216,19203
20200213,1,부개,9079,8436,20200216,17515
20200213,1,간석,6416,5968,20200216,12384
20200213,1,도원,2944,2930,20200216,5874
20200213,1,온수,7007,6844,20200216,13851
20200213,1,중동,9742,9212,20200216,18954
20200213,1,도화,4039,3610,20200216,7649
20200214,1,개봉,24049,24019,20200217,48068
20200214,1,오류동,13036,12206,20200217,25242
20200214,1,역곡,30922,30556,20200217,61478
20200214,1,부천,36784,38253,20200217,75037
20200214,1,송내,32721,31815,20200217,64536
20200214,1,부평,36818,42601,20200217,79419
20200214,1,백운,8245,7999,20200217,16244
20200214,1,동암,17879,17883,20200217,35762
20200214,1,주안,23131,20723,20200217,43854
20200214,1,제물포,11361,10514,20200217,21875
20200214,1,동인천,16311,15287,20200217,31598
20200214,1,인천,3524,2736,20200217,6260
20200214,1,구일,6896,6770,20200217,13666
20200214,1,소사,10432,9793,20200217,20225
20200214,1,부개,9510,8676,20200217,18186
20200214,1,간석,6775,6336,20200217,13111
20200214,1,도원,3098,3167,20200217,6265
20200214,1,온수,7041,6961,20200217,14002
20200214,1,중동,10152,9345,20200217,19497
20200214,1,도화,4306,3872,20200217,8178
20200215,1,개봉,18008,17561,20200218,35569
20200215,1,오류동,9969,9289,20200218,19258
20200215,1,역곡,21943,21235,20200218,43178
20200215,1,부천,30596,31588,20200218,62184
20200215,1,송내,21062,20423,20200218,41485
20200215,1,부평,33695,38494,20200218,72189
20200215,1,백운,6180,6008,20200218,12188
20200215,1,동암,14142,14541,20200218,28683
20200215,1,주안,18518,16480,20200218,34998
20200215,1,제물포,7897,7382,20200218,15279
20200215,1,동인천,13211,12887,20200218,26098
20200215,1,인천,2939,2487,20200218,5426
20200215,1,구일,4662,4343,20200218,9005
20200215,1,소사,8921,8861,20200218,17782
20200215,1,부개,6834,6386,20200218,13220
20200215,1,간석,4895,4573,20200218,9468
20200215,1,도원,2244,2332,20200218,4576
20200215,1,온수,5140,4886,20200218,10026
20200215,1,중동,7114,6629,20200218,13743
20200215,1,도화,3136,2796,20200218,5932
20200216,1,개봉,12250,12161,20200219,24411
20200216,1,오류동,7718,7050,20200219,14768
20200216,1,역곡,14778,14627,20200219,29405
20200216,1,부천,22358,22049,20200219,44407
20200216,1,송내,14159,13809,20200219,27968
20200216,1,부평,25100,25325,20200219,50425
20200216,1,백운,4457,4399,20200219,8856
20200216,1,동암,10045,9738,20200219,19783
20200216,1,주안,12675,11239,20200219,23914
20200216,1,제물포,5228,5133,20200219,10361
20200216,1,동인천,9552,9357,20200219,18909
20200216,1,인천,1926,1490,20200219,3416
20200216,1,구일,2853,2920,20200219,5773
20200216,1,소사,6621,6321,20200219,12942
20200216,1,부개,4820,4601,20200219,9421
20200216,1,간석,3239,3082,20200219,6321
20200216,1,도원,1693,1684,20200219,3377
20200216,1,온수,4045,3854,20200219,7899
20200216,1,중동,4618,4299,20200219,8917
20200216,1,도화,2231,2096,20200219,4327
20200217,1,개봉,22560,22786,20200220,45346
20200217,1,오류동,12357,11509,20200220,23866
20200217,1,역곡,29032,28675,20200220,57707
20200217,1,부천,34220,34074,20200220,68294
20200217,1,송내,30863,30799,20200220,61662
20200217,1,부평,33367,35710,20200220,69077
20200217,1,백운,7819,7571,20200220,15390
20200217,1,동암,16203,16286,20200220,32489
20200217,1,주안,20744,18865,20200220,39609
20200217,1,제물포,10301,9658,20200220,19959
20200217,1,동인천,14409,13782,20200220,28191
20200217,1,인천,2575,1903,20200220,4478
20200217,1,구일,6444,6578,20200220,13022
20200217,1,소사,9853,9290,20200220,19143
20200217,1,부개,8975,8406,20200220,17381
20200217,1,간석,6210,5861,20200220,12071
20200217,1,도원,2683,2733,20200220,5416
20200217,1,온수,6465,6457,20200220,12922
20200217,1,중동,9822,9091,20200220,18913
20200217,1,도화,3832,3444,20200220,7276
20200218,1,개봉,22509,22858,20200221,45367
20200218,1,오류동,12437,11723,20200221,24160
20200218,1,역곡,29059,28777,20200221,57836
20200218,1,부천,34277,34496,20200221,68773
20200218,1,송내,31014,30732,20200221,61746
20200218,1,부평,33798,35914,20200221,69712
20200218,1,백운,7758,7688,20200221,15446
20200218,1,동암,16442,16431,20200221,32873
20200218,1,주안,20864,18815,20200221,39679
20200218,1,제물포,10198,9598,20200221,19796
20200218,1,동인천,14797,14084,20200221,28881
20200218,1,인천,2930,2116,20200221,5046
20200218,1,구일,6485,6545,20200221,13030
20200218,1,소사,9618,9337,20200221,18955
20200218,1,부개,8992,8484,20200221,17476
20200218,1,간석,6322,6035,20200221,12357
20200218,1,도원,2723,2824,20200221,5547
20200218,1,온수,6501,6447,20200221,12948
20200218,1,중동,9651,8986,20200221,18637
20200218,1,도화,3887,3506,20200221,7393
20200219,1,개봉,22861,23156,20200222,46017
20200219,1,오류동,12612,11888,20200222,24500
20200219,1,역곡,29538,29149,20200222,58687
20200219,1,부천,35079,35245,20200222,70324
20200219,1,송내,31446,30880,20200222,62326
20200219,1,부평,34430,37009,20200222,71439
20200219,1,백운,7803,7659,20200222,15462
20200219,1,동암,16923,16828,20200222,33751
20200219,1,주안,21453,19462,20200222,40915
20200219,1,제물포,10487,10086,20200222,20573
20200219,1,동인천,15548,14741,20200222,30289
20200219,1,인천,2962,2226,20200222,5188
20200219,1,구일,6754,6739,20200222,13493
20200219,1,소사,10069,9545,20200222,19614
20200219,1,부개,9077,8535,20200222,17612
20200219,1,간석,6364,6029,20200222,12393
20200219,1,도원,3028,3075,20200222,6103
20200219,1,온수,6510,6654,20200222,13164
20200219,1,중동,9726,9247,20200222,18973
20200219,1,도화,4149,3664,20200222,7813
20200220,1,개봉,22467,22613,20200223,45080
20200220,1,오류동,12569,11715,20200223,24284
20200220,1,역곡,30092,29759,20200223,59851
20200220,1,부천,34764,34915,20200223,69679
20200220,1,송내,31368,30860,20200223,62228
20200220,1,부평,33939,36912,20200223,70851
20200220,1,백운,7635,7550,20200223,15185
20200220,1,동암,16810,16638,20200223,33448
20200220,1,주안,21154,19220,20200223,40374
20200220,1,제물포,10539,9722,20200223,20261
20200220,1,동인천,15377,14829,20200223,30206
20200220,1,인천,3152,2383,20200223,5535
20200220,1,구일,6533,6588,20200223,13121
20200220,1,소사,9920,9278,20200223,19198
20200220,1,부개,9059,8441,20200223,17500
20200220,1,간석,6398,6020,20200223,12418
20200220,1,도원,2891,3016,20200223,5907
20200220,1,온수,6566,6586,20200223,13152
20200220,1,중동,9736,9123,20200223,18859
20200220,1,도화,3947,3578,20200223,7525
20200221,1,개봉,21887,22125,20200224,44012
20200221,1,오류동,12056,11278,20200224,23334
20200221,1,역곡,29068,28315,20200224,57383
20200221,1,부천,34400,35134,20200224,69534
20200221,1,송내,30574,30126,20200224,60700
20200221,1,부평,33135,37506,20200224,70641
20200221,1,백운,7307,7153,20200224,14460
20200221,1,동암,16362,16185,20200224,32547
20200221,1,주안,21417,19616,20200224,41033
20200221,1,제물포,10418,9607,20200224,20025
20200221,1,동인천,14969,14074,20200224,29043
20200221,1,인천,2889,2200,20200224,5089
20200221,1,구일,6396,6284,20200224,12680
20200221,1,소사,9469,8982,20200224,18451
20200221,1,부개,8859,8303,20200224,17162
20200221,1,간석,6173,5781,20200224,11954
20200221,1,도원,2923,2965,20200224,5888
20200221,1,온수,6490,6417,20200224,12907
20200221,1,중동,9389,8822,20200224,18211
20200221,1,도화,3906,3451,20200224,7357
20200222,1,개봉,13593,13206,20200225,26799
20200222,1,오류동,8058,7612,20200225,15670
20200222,1,역곡,17671,17570,20200225,35241
20200222,1,부천,25403,26530,20200225,51933
20200222,1,송내,16765,16574,20200225,33339
20200222,1,부평,23930,25457,20200225,49387
20200222,1,백운,4660,4632,20200225,9292
20200222,1,동암,11470,11806,20200225,23276
20200222,1,주안,15347,13741,20200225,29088
20200222,1,제물포,6465,6282,20200225,12747
20200222,1,동인천,10482,10102,20200225,20584
20200222,1,인천,1965,1606,20200225,3571
20200222,1,구일,3456,3339,20200225,6795
20200222,1,소사,7380,7167,20200225,14547
20200222,1,부개,5552,5223,20200225,10775
20200222,1,간석,3747,3558,20200225,7305
20200222,1,도원,2075,2142,20200225,4217
20200222,1,온수,3887,3816,20200225,7703
20200222,1,중동,5579,5276,20200225,10855
20200222,1,도화,2592,2293,20200225,4885
20200223,1,개봉,8211,8152,20200226,16363
20200223,1,오류동,5524,5030,20200226,10554
20200223,1,역곡,11009,10695,20200226,21704
20200223,1,부천,16143,15718,20200226,31861
20200223,1,송내,10373,10190,20200226,20563
20200223,1,부평,13448,13172,20200226,26620
20200223,1,백운,2721,2782,20200226,5503
20200223,1,동암,7452,7185,20200226,14637
20200223,1,주안,9603,8475,20200226,18078
20200223,1,제물포,3972,3883,20200226,7855
20200223,1,동인천,6895,6664,20200226,13559
20200223,1,인천,1696,1372,20200226,3068
20200223,1,구일,2256,2191,20200226,4447
20200223,1,소사,4664,4439,20200226,9103
20200223,1,부개,3391,3261,20200226,6652
20200223,1,간석,2288,2200,20200226,4488
20200223,1,도원,1339,1365,20200226,2704
20200223,1,온수,2900,2814,20200226,5714
20200223,1,중동,3279,3072,20200226,6351
20200223,1,도화,1614,1540,20200226,3154
20200224,1,개봉,18273,18394,20200227,36667
20200224,1,오류동,10552,10167,20200227,20719
20200224,1,역곡,24715,24410,20200227,49125
20200224,1,부천,28950,28781,20200227,57731
20200224,1,송내,26191,26046,20200227,52237
20200224,1,부평,23852,24642,20200227,48494
20200224,1,백운,6188,6072,20200227,12260
20200224,1,동암,14083,14133,20200227,28216
20200224,1,주안,17345,15968,20200227,33313
20200224,1,제물포,8677,8103,20200227,16780
20200224,1,동인천,12285,11520,20200227,23805
20200224,1,인천,2277,1712,20200227,3989
20200224,1,구일,5563,5733,20200227,11296
20200224,1,소사,8486,7834,20200227,16320
20200224,1,부개,7443,7072,20200227,14515
20200224,1,간석,5199,4852,20200227,10051
20200224,1,도원,2274,2359,20200227,4633
20200224,1,온수,5305,5420,20200227,10725
20200224,1,중동,8183,7716,20200227,15899
20200224,1,도화,3319,2902,20200227,6221
20200225,1,개봉,16793,16911,20200228,33704
20200225,1,오류동,9701,9362,20200228,19063
20200225,1,역곡,22404,22200,20200228,44604
20200225,1,부천,26449,26385,20200228,52834
20200225,1,송내,24619,24345,20200228,48964
20200225,1,부평,21761,22531,20200228,44292
20200225,1,백운,5506,5450,20200228,10956
20200225,1,동암,12754,12902,20200228,25656
20200225,1,주안,15458,14342,20200228,29800
20200225,1,제물포,7619,7188,20200228,14807
20200225,1,동인천,11004,10453,20200228,21457
20200225,1,인천,2102,1361,20200228,3463
20200225,1,구일,5104,5201,20200228,10305
20200225,1,소사,7549,7059,20200228,14608
20200225,1,부개,6926,6492,20200228,13418
20200225,1,간석,4756,4445,20200228,9201
20200225,1,도원,2079,2088,20200228,4167
20200225,1,온수,4935,4948,20200228,9883
20200225,1,중동,7483,7060,20200228,14543
20200225,1,도화,2976,2647,20200228,5623
20200226,1,개봉,17288,17567,20200229,34855
20200226,1,오류동,9978,9517,20200229,19495
20200226,1,역곡,23090,22744,20200229,45834
20200226,1,부천,27896,27949,20200229,55845
20200226,1,송내,24978,24619,20200229,49597
20200226,1,부평,23088,24110,20200229,47198
20200226,1,백운,5747,5731,20200229,11478
20200226,1,동암,13196,13339,20200229,26535
20200226,1,주안,15925,14680,20200229,30605
20200226,1,제물포,7830,7339,20200229,15169
20200226,1,동인천,11691,11083,20200229,22774
20200226,1,인천,2258,1639,20200229,3897
20200226,1,구일,5134,5189,20200229,10323
20200226,1,소사,7954,7482,20200229,15436
20200226,1,부개,7137,6835,20200229,13972
20200226,1,간석,4843,4524,20200229,9367
20200226,1,도원,2127,2153,20200229,4280
20200226,1,온수,5160,5168,20200229,10328
20200226,1,중동,7740,7268,20200229,15008
20200226,1,도화,2953,2572,20200229,5525
20200227,1,개봉,16801,17315,20200301,34116
20200227,1,오류동,9286,10241,20200301,19527
20200227,1,역곡,22186,22811,20200301,44997
20200227,1,부천,27189,27639,20200301,54828
20200227,1,송내,24382,23875,20200301,48257
20200227,1,부평,23169,24207,20200301,47376
20200227,1,백운,5607,5757,20200301,11364
20200227,1,동암,12963,13009,20200301,25972
20200227,1,주안,15374,13965,20200301,29339
20200227,1,제물포,7684,7143,20200301,14827
20200227,1,동인천,11192,10356,20200301,21548
20200227,1,인천,2263,1689,20200301,3952
20200227,1,구일,4628,5082,20200301,9710
20200227,1,소사,7864,8207,20200301,16071
20200227,1,부개,6988,6707,20200301,13695
20200227,1,간석,4724,4468,20200301,9192
20200227,1,도원,2108,2151,20200301,4259
20200227,1,온수,5031,5106,20200301,10137
20200227,1,중동,7279,7108,20200301,14387
20200227,1,도화,2729,2497,20200301,5226
20200228,1,개봉,16515,16814,20200302,33329
20200228,1,오류동,9401,8857,20200302,18258
20200228,1,역곡,21836,21438,20200302,43274
20200228,1,부천,26412,27106,20200302,53518
20200228,1,송내,23678,23654,20200302,47332
20200228,1,부평,22173,23692,20200302,45865
20200228,1,백운,5382,5303,20200302,10685
20200228,1,동암,12512,12696,20200302,25208
20200228,1,주안,15144,14052,20200302,29196
20200228,1,제물포,7392,6849,20200302,14241
20200228,1,동인천,10752,10234,20200302,20986
20200228,1,인천,1937,1375,20200302,3312
20200228,1,구일,4744,4930,20200302,9674
20200228,1,소사,7451,6884,20200302,14335
20200228,1,부개,6790,6396,20200302,13186
20200228,1,간석,4526,4270,20200302,8796
20200228,1,도원,2006,2027,20200302,4033
20200228,1,온수,4847,4807,20200302,9654
20200228,1,중동,7263,6908,20200302,14171
20200228,1,도화,2814,2432,20200302,5246
20200229,1,개봉,10366,10022,20200303,20388
20200229,1,오류동,5952,5652,20200303,11604
20200229,1,역곡,13138,13006,20200303,26144
20200229,1,부천,19399,20066,20200303,39465
20200229,1,송내,12380,12265,20200303,24645
20200229,1,부평,16461,18007,20200303,34468
20200229,1,백운,3513,3476,20200303,6989
20200229,1,동암,8423,8669,20200303,17092
20200229,1,주안,10159,9378,20200303,19537
20200229,1,제물포,4507,4218,20200303,8725
20200229,1,동인천,7463,7369,20200303,14832
20200229,1,인천,1690,1421,20200303,3111
20200229,1,구일,2589,2416,20200303,5005
20200229,1,소사,5297,5173,20200303,10470
20200229,1,부개,4168,3969,20200303,8137
20200229,1,간석,2717,2611,20200303,5328
20200229,1,도원,1414,1452,20200303,2866
20200229,1,온수,3137,2939,20200303,6076
20200229,1,중동,4241,4018,20200303,8259
20200229,1,도화,1809,1646,20200303,3455
20200301,1,개봉,6619,6489,20200304,13108
20200301,1,오류동,4431,3973,20200304,8404
20200301,1,역곡,8437,8276,20200304,16713
20200301,1,부천,13325,13221,20200304,26546
20200301,1,송내,8118,7890,20200304,16008
20200301,1,부평,11188,11583,20200304,22771
20200301,1,백운,2294,2192,20200304,4486
20200301,1,동암,5801,5686,20200304,11487
20200301,1,주안,7150,6302,20200304,13452
20200301,1,제물포,3018,2924,20200304,5942
20200301,1,동인천,5016,4849,20200304,9865
20200301,1,인천,1143,970,20200304,2113
20200301,1,구일,1787,1753,20200304,3540
20200301,1,소사,3405,3064,20200304,6469
20200301,1,부개,2717,2631,20200304,5348
20200301,1,간석,1782,1680,20200304,3462
20200301,1,도원,995,1033,20200304,2028
20200301,1,온수,2181,2117,20200304,4298
20200301,1,중동,2755,2533,20200304,5288
20200301,1,도화,1159,1102,20200304,2261
20200302,1,개봉,16704,16991,20200305,33695
20200302,1,오류동,9420,9008,20200305,18428
20200302,1,역곡,22343,22072,20200305,44415
20200302,1,부천,26918,26659,20200305,53577
20200302,1,송내,24030,23707,20200305,47737
20200302,1,부평,22715,23728,20200305,46443
20200302,1,백운,5741,5756,20200305,11497
20200302,1,동암,13025,12789,20200305,25814
20200302,1,주안,15447,14105,20200305,29552
20200302,1,제물포,7716,7239,20200305,14955
20200302,1,동인천,11303,10628,20200305,21931
20200302,1,인천,2154,1614,20200305,3768
20200302,1,구일,4844,5034,20200305,9878
20200302,1,소사,7506,7085,20200305,14591
20200302,1,부개,6870,6532,20200305,13402
20200302,1,간석,4647,4414,20200305,9061
20200302,1,도원,2114,2155,20200305,4269
20200302,1,온수,4899,4803,20200305,9702
20200302,1,중동,7466,7063,20200305,14529
20200302,1,도화,2911,2611,20200305,5522
20200303,1,개봉,16629,17157,20200306,33786
20200303,1,오류동,9344,8957,20200306,18301
20200303,1,역곡,21949,21739,20200306,43688
20200303,1,부천,26342,26478,20200306,52820
20200303,1,송내,23890,23593,20200306,47483
20200303,1,부평,21918,22539,20200306,44457
20200303,1,백운,5647,5605,20200306,11252
20200303,1,동암,12806,12818,20200306,25624
20200303,1,주안,15066,13976,20200306,29042
20200303,1,제물포,7486,7089,20200306,14575
20200303,1,동인천,11088,10455,20200306,21543
20200303,1,인천,2284,1694,20200306,3978
20200303,1,구일,4815,4881,20200306,9696
20200303,1,소사,7622,7026,20200306,14648
20200303,1,부개,6732,6344,20200306,13076
20200303,1,간석,4605,4353,20200306,8958
20200303,1,도원,2096,2193,20200306,4289
20200303,1,온수,4962,4811,20200306,9773
20200303,1,중동,7259,6974,20200306,14233
20200303,1,도화,2905,2566,20200306,5471
20200304,1,개봉,16488,16911,20200307,33399
20200304,1,오류동,9442,9096,20200307,18538
20200304,1,역곡,21931,21757,20200307,43688
20200304,1,부천,26733,26667,20200307,53400
20200304,1,송내,23911,23743,20200307,47654
20200304,1,부평,22188,22849,20200307,45037
20200304,1,백운,5579,5456,20200307,11035
20200304,1,동암,12473,12379,20200307,24852
20200304,1,주안,15367,14204,20200307,29571
20200304,1,제물포,7398,6965,20200307,14363
20200304,1,동인천,11090,10433,20200307,21523
20200304,1,인천,2073,1496,20200307,3569
20200304,1,구일,4639,4755,20200307,9394
20200304,1,소사,7458,7124,20200307,14582
20200304,1,부개,6729,6499,20200307,13228
20200304,1,간석,4492,4281,20200307,8773
20200304,1,도원,2091,2162,20200307,4253
20200304,1,온수,4871,4829,20200307,9700
20200304,1,중동,7272,6985,20200307,14257
20200304,1,도화,2803,2519,20200307,5322
20200305,1,개봉,16756,17204,20200308,33960
20200305,1,오류동,9469,8852,20200308,18321
20200305,1,역곡,21921,21885,20200308,43806
20200305,1,부천,26693,26689,20200308,53382
20200305,1,송내,23954,23734,20200308,47688
20200305,1,부평,22568,23780,20200308,46348
20200305,1,백운,5603,5424,20200308,11027
20200305,1,동암,12538,12613,20200308,25151
20200305,1,주안,15292,14074,20200308,29366
20200305,1,제물포,7521,7038,20200308,14559
20200305,1,동인천,11018,10506,20200308,21524
20200305,1,인천,2114,1622,20200308,3736
20200305,1,구일,4789,4887,20200308,9676
20200305,1,소사,7413,6959,20200308,14372
20200305,1,부개,6708,6307,20200308,13015
20200305,1,간석,4622,4355,20200308,8977
20200305,1,도원,2064,2129,20200308,4193
20200305,1,온수,4863,4801,20200308,9664
20200305,1,중동,7338,6849,20200308,14187
20200305,1,도화,2869,2535,20200308,5404
20200306,1,개봉,17242,17365,20200309,34607
20200306,1,오류동,9676,8930,20200309,18606
20200306,1,역곡,22851,22548,20200309,45399
20200306,1,부천,27733,28617,20200309,56350
20200306,1,송내,24446,24118,20200309,48564
20200306,1,부평,23641,25481,20200309,49122
20200306,1,백운,5757,5647,20200309,11404
20200306,1,동암,13063,13250,20200309,26313
20200306,1,주안,15950,14779,20200309,30729
20200306,1,제물포,7764,7202,20200309,14966
20200306,1,동인천,11681,11065,20200309,22746
20200306,1,인천,2333,1754,20200309,4087
20200306,1,구일,5007,5101,20200309,10108
20200306,1,소사,7575,7077,20200309,14652
20200306,1,부개,6922,6472,20200309,13394
20200306,1,간석,4659,4453,20200309,9112
20200306,1,도원,2143,2174,20200309,4317
20200306,1,온수,5046,4871,20200309,9917
20200306,1,중동,7489,7022,20200309,14511
20200306,1,도화,3116,2637,20200309,5753
20200307,1,개봉,11101,10844,20200310,21945
20200307,1,오류동,6268,5739,20200310,12007
20200307,1,역곡,13995,13977,20200310,27972
20200307,1,부천,20869,21573,20200310,42442
20200307,1,송내,13374,13134,20200310,26508
20200307,1,부평,18146,20377,20200310,38523
20200307,1,백운,3721,3611,20200310,7332
20200307,1,동암,9069,9292,20200310,18361
20200307,1,주안,11282,10088,20200310,21370
20200307,1,제물포,4805,4550,20200310,9355
20200307,1,동인천,7871,7671,20200310,15542
20200307,1,인천,1747,1479,20200310,3226
20200307,1,구일,2804,2740,20200310,5544
20200307,1,소사,5287,5234,20200310,10521
20200307,1,부개,4453,4229,20200310,8682
20200307,1,간석,2916,2748,20200310,5664
20200307,1,도원,1522,1573,20200310,3095
20200307,1,온수,3261,3104,20200310,6365
20200307,1,중동,4522,4259,20200310,8781
20200307,1,도화,1984,1771,20200310,3755
20200308,1,개봉,7405,7211,20200311,14616
20200308,1,오류동,4263,3920,20200311,8183
20200308,1,역곡,9450,8970,20200311,18420
20200308,1,부천,14293,13968,20200311,28261
20200308,1,송내,9121,8787,20200311,17908
20200308,1,부평,13609,13902,20200311,27511
20200308,1,백운,2568,2486,20200311,5054
20200308,1,동암,6526,6303,20200311,12829
20200308,1,주안,7956,7178,20200311,15134
20200308,1,제물포,3382,3256,20200311,6638
20200308,1,동인천,5924,5749,20200311,11673
20200308,1,인천,1859,1536,20200311,3395
20200308,1,구일,1892,1924,20200311,3816
20200308,1,소사,3703,3381,20200311,7084
20200308,1,부개,3002,2744,20200311,5746
20200308,1,간석,2056,1984,20200311,4040
20200308,1,도원,1106,1155,20200311,2261
20200308,1,온수,2291,2127,20200311,4418
20200308,1,중동,3005,2833,20200311,5838
20200308,1,도화,1432,1299,20200311,2731
20200309,1,개봉,17513,17720,20200312,35233
20200309,1,오류동,9811,9405,20200312,19216
20200309,1,역곡,23311,23023,20200312,46334
20200309,1,부천,27929,27934,20200312,55863
20200309,1,송내,24853,24526,20200312,49379
20200309,1,부평,23969,25143,20200312,49112
20200309,1,백운,6025,5919,20200312,11944
20200309,1,동암,13503,13342,20200312,26845
20200309,1,주안,16145,14809,20200312,30954
20200309,1,제물포,8033,7525,20200312,15558
20200309,1,동인천,11793,11064,20200312,22857
20200309,1,인천,2304,1776,20200312,4080
20200309,1,구일,4965,5121,20200312,10086
20200309,1,소사,7890,7365,20200312,15255
20200309,1,부개,7088,6602,20200312,13690
20200309,1,간석,4862,4527,20200312,9389
20200309,1,도원,2267,2333,20200312,4600
20200309,1,온수,5004,4900,20200312,9904
20200309,1,중동,7752,7207,20200312,14959
20200309,1,도화,3064,2745,20200312,5809
20200310,1,개봉,16382,16592,20200313,32974
20200310,1,오류동,9128,8676,20200313,17804
20200310,1,역곡,21572,21250,20200313,42822
20200310,1,부천,25755,25661,20200313,51416
20200310,1,송내,23577,23380,20200313,46957
20200310,1,부평,21736,22458,20200313,44194
20200310,1,백운,5463,5409,20200313,10872
20200310,1,동암,12112,12161,20200313,24273
20200310,1,주안,14976,13648,20200313,28624
20200310,1,제물포,7265,6833,20200313,14098
20200310,1,동인천,10619,10026,20200313,20645
20200310,1,인천,2004,1414,20200313,3418
20200310,1,구일,4723,4826,20200313,9549
20200310,1,소사,7222,6934,20200313,14156
20200310,1,부개,6577,6228,20200313,12805
20200310,1,간석,4536,4320,20200313,8856
20200310,1,도원,1903,1967,20200313,3870
20200310,1,온수,4768,4693,20200313,9461
20200310,1,중동,7103,6668,20200313,13771
20200310,1,도화,2823,2478,20200313,5301
20200311,1,개봉,16319,16591,20200314,32910
20200311,1,오류동,9116,8565,20200314,17681
20200311,1,역곡,21771,21570,20200314,43341
20200311,1,부천,26397,26353,20200314,52750
20200311,1,송내,23779,23333,20200314,47112
20200311,1,부평,22485,23775,20200314,46260
20200311,1,백운,5536,5450,20200314,10986
20200311,1,동암,12506,12437,20200314,24943
20200311,1,주안,15439,14101,20200314,29540
20200311,1,제물포,7476,7040,20200314,14516
20200311,1,동인천,11032,10482,20200314,21514
20200311,1,인천,2285,1643,20200314,3928
20200311,1,구일,4576,4774,20200314,9350
20200311,1,소사,7395,6959,20200314,14354
20200311,1,부개,6636,6295,20200314,12931
20200311,1,간석,4536,4254,20200314,8790
20200311,1,도원,2030,2117,20200314,4147
20200311,1,온수,4834,4695,20200314,9529
20200311,1,중동,7272,6813,20200314,14085
20200311,1,도화,3013,2588,20200314,5601
20200312,1,개봉,15950,16216,20200315,32166
20200312,1,오류동,8869,8214,20200315,17083
20200312,1,역곡,21397,21110,20200315,42507
20200312,1,부천,25636,25789,20200315,51425
20200312,1,송내,23206,22962,20200315,46168
20200312,1,부평,22246,23280,20200315,45526
20200312,1,백운,5478,5453,20200315,10931
20200312,1,동암,12189,12120,20200315,24309
20200312,1,주안,14995,13841,20200315,28836
20200312,1,제물포,7319,7019,20200315,14338
20200312,1,동인천,10687,10273,20200315,20960
20200312,1,인천,2147,1563,20200315,3710
20200312,1,구일,4570,4625,20200315,9195
20200312,1,소사,7304,6856,20200315,14160
20200312,1,부개,6501,6136,20200315,12637
20200312,1,간석,4404,4176,20200315,8580
20200312,1,도원,2018,2029,20200315,4047
20200312,1,온수,4633,4539,20200315,9172
20200312,1,중동,7197,6762,20200315,13959
20200312,1,도화,2828,2520,20200315,5348
20200313,1,개봉,16386,16413,20200316,32799
20200313,1,오류동,9048,8469,20200316,17517
20200313,1,역곡,21996,21617,20200316,43613
20200313,1,부천,26798,27441,20200316,54239
20200313,1,송내,23490,23237,20200316,46727
20200313,1,부평,23324,25755,20200316,49079
20200313,1,백운,5579,5465,20200316,11044
20200313,1,동암,12494,12425,20200316,24919
20200313,1,주안,15781,14411,20200316,30192
20200313,1,제물포,7628,7098,20200316,14726
20200313,1,동인천,11235,10521,20200316,21756
20200313,1,인천,2139,1605,20200316,3744
20200313,1,구일,4587,4603,20200316,9190
20200313,1,소사,7347,6779,20200316,14126
20200313,1,부개,6560,6188,20200316,12748
20200313,1,간석,4550,4326,20200316,8876
20200313,1,도원,2080,2084,20200316,4164
20200313,1,온수,4648,4611,20200316,9259
20200313,1,중동,7304,6684,20200316,13988
20200313,1,도화,2936,2578,20200316,5514
20200314,1,개봉,10625,10336,20200317,20961
20200314,1,오류동,5756,5365,20200317,11121
20200314,1,역곡,13697,13487,20200317,27184
20200314,1,부천,19970,20421,20200317,40391
20200314,1,송내,12965,12700,20200317,25665
20200314,1,부평,18234,20267,20200317,38501
20200314,1,백운,3646,3571,20200317,7217
20200314,1,동암,8875,9064,20200317,17939
20200314,1,주안,11196,9988,20200317,21184
20200314,1,제물포,4877,4544,20200317,9421
20200314,1,동인천,7580,7431,20200317,15011
20200314,1,인천,1846,1589,20200317,3435
20200314,1,구일,2651,2544,20200317,5195
20200314,1,소사,5265,5133,20200317,10398
20200314,1,부개,4145,3981,20200317,8126
20200314,1,간석,2841,2710,20200317,5551
20200314,1,도원,1524,1512,20200317,3036
20200314,1,온수,3044,2969,20200317,6013
20200314,1,중동,4257,4005,20200317,8262
20200314,1,도화,2006,1767,20200317,3773
20200315,1,개봉,6723,6672,20200318,13395
20200315,1,오류동,3822,3539,20200318,7361
20200315,1,역곡,8822,8622,20200318,17444
20200315,1,부천,13762,13421,20200318,27183
20200315,1,송내,8396,8117,20200318,16513
20200315,1,부평,13193,13464,20200318,26657
20200315,1,백운,2383,2340,20200318,4723
20200315,1,동암,5908,5831,20200318,11739
20200315,1,주안,7707,6748,20200318,14455
20200315,1,제물포,3088,3072,20200318,6160
20200315,1,동인천,5352,5086,20200318,10438
20200315,1,인천,1373,1181,20200318,2554
20200315,1,구일,1795,1769,20200318,3564
20200315,1,소사,3338,3135,20200318,6473
20200315,1,부개,2813,2671,20200318,5484
20200315,1,간석,1927,1834,20200318,3761
20200315,1,도원,1046,1078,20200318,2124
20200315,1,온수,2096,1988,20200318,4084
20200315,1,중동,2764,2620,20200318,5384
20200315,1,도화,1292,1199,20200318,2491
20200316,1,개봉,16652,17001,20200319,33653
20200316,1,오류동,9302,8795,20200319,18097
20200316,1,역곡,22084,21984,20200319,44068
20200316,1,부천,26477,26326,20200319,52803
20200316,1,송내,23813,23523,20200319,47336
20200316,1,부평,23081,24244,20200319,47325
20200316,1,백운,5763,5673,20200319,11436
20200316,1,동암,12672,12575,20200319,25247
20200316,1,주안,15459,14282,20200319,29741
20200316,1,제물포,7726,7201,20200319,14927
20200316,1,동인천,11009,10474,20200319,21483
20200316,1,인천,2165,1621,20200319,3786
20200316,1,구일,4655,4792,20200319,9447
20200316,1,소사,7433,6835,20200319,14268
20200316,1,부개,6637,6347,20200319,12984
20200316,1,간석,4670,4339,20200319,9009
20200316,1,도원,2082,2130,20200319,4212
20200316,1,온수,4626,4616,20200319,9242
20200316,1,중동,7345,6931,20200319,14276
20200316,1,도화,2979,2623,20200319,5602
20200317,1,개봉,16800,16967,20200320,33767
20200317,1,오류동,9262,8754,20200320,18016
20200317,1,역곡,21771,22030,20200320,43801
20200317,1,부천,26332,26299,20200320,52631
20200317,1,송내,23782,23639,20200320,47421
20200317,1,부평,23052,24035,20200320,47087
20200317,1,백운,5608,5513,20200320,11121
20200317,1,동암,12602,12577,20200320,25179
20200317,1,주안,15454,14180,20200320,29634
20200317,1,제물포,7508,7073,20200320,14581
20200317,1,동인천,10942,10378,20200320,21320
20200317,1,인천,2121,1581,20200320,3702
20200317,1,구일,4658,4732,20200320,9390
20200317,1,소사,7493,6873,20200320,14366
20200317,1,부개,6595,6140,20200320,12735
20200317,1,간석,4539,4309,20200320,8848
20200317,1,도원,2032,2089,20200320,4121
20200317,1,온수,4678,4656,20200320,9334
20200317,1,중동,7223,6863,20200320,14086
20200317,1,도화,2947,2623,20200320,5570
20200318,1,개봉,17085,17267,20200321,34352
20200318,1,오류동,9459,8837,20200321,18296
20200318,1,역곡,22599,22300,20200321,44899
20200318,1,부천,27173,27391,20200321,54564
20200318,1,송내,24220,23912,20200321,48132
20200318,1,부평,23960,24560,20200321,48520
20200318,1,백운,5809,5702,20200321,11511
20200318,1,동암,12930,12918,20200321,25848
20200318,1,주안,16128,14845,20200321,30973
20200318,1,제물포,7853,7434,20200321,15287
20200318,1,동인천,11693,11044,20200321,22737
20200318,1,인천,2472,1910,20200321,4382
20200318,1,구일,4814,4800,20200321,9614
20200318,1,소사,7632,7109,20200321,14741
20200318,1,부개,6895,6506,20200321,13401
20200318,1,간석,4810,4512,20200321,9322
20200318,1,도원,2091,2163,20200321,4254
20200318,1,온수,4855,4837,20200321,9692
20200318,1,중동,7505,7010,20200321,14515
20200318,1,도화,3080,2717,20200321,5797
20200319,1,개봉,16304,16618,20200322,32922
20200319,1,오류동,9063,8514,20200322,17577
20200319,1,역곡,21499,21248,20200322,42747
20200319,1,부천,25775,25870,20200322,51645
20200319,1,송내,23465,22869,20200322,46334
20200319,1,부평,22557,23763,20200322,46320
20200319,1,백운,5398,5338,20200322,10736
20200319,1,동암,12216,12167,20200322,24383
20200319,1,주안,15148,14014,20200322,29162
20200319,1,제물포,7315,6906,20200322,14221
20200319,1,동인천,10587,10044,20200322,20631
20200319,1,인천,1931,1375,20200322,3306
20200319,1,구일,4532,4581,20200322,9113
20200319,1,소사,7213,6718,20200322,13931
20200319,1,부개,6576,6219,20200322,12795
20200319,1,간석,4474,4160,20200322,8634
20200319,1,도원,1906,2005,20200322,3911
20200319,1,온수,4616,4601,20200322,9217
20200319,1,중동,7160,6613,20200322,13773
20200319,1,도화,2871,2533,20200322,5404
20200320,1,개봉,17705,17773,20200323,35478
20200320,1,오류동,9731,8906,20200323,18637
20200320,1,역곡,23455,23055,20200323,46510
20200320,1,부천,28369,29194,20200323,57563
20200320,1,송내,24952,24287,20200323,49239
20200320,1,부평,25038,27727,20200323,52765
20200320,1,백운,5888,5749,20200323,11637
20200320,1,동암,13473,13409,20200323,26882
20200320,1,주안,17050,15537,20200323,32587
20200320,1,제물포,8246,7533,20200323,15779
20200320,1,동인천,12085,11418,20200323,23503
20200320,1,인천,2452,1858,20200323,4310
20200320,1,구일,5073,4981,20200323,10054
20200320,1,소사,7769,7155,20200323,14924
20200320,1,부개,7180,6640,20200323,13820
20200320,1,간석,4846,4520,20200323,9366
20200320,1,도원,2193,2279,20200323,4472
20200320,1,온수,5046,4854,20200323,9900
20200320,1,중동,7675,7183,20200323,14858
20200320,1,도화,3169,2741,20200323,5910
20200321,1,개봉,11602,11353,20200324,22955
20200321,1,오류동,6465,6014,20200324,12479
20200321,1,역곡,14674,14498,20200324,29172
20200321,1,부천,21418,22169,20200324,43587
20200321,1,송내,14020,13797,20200324,27817
20200321,1,부평,19776,21618,20200324,41394
20200321,1,백운,3831,3908,20200324,7739
20200321,1,동암,9532,9665,20200324,19197
20200321,1,주안,11912,10560,20200324,22472
20200321,1,제물포,5190,4850,20200324,10040
20200321,1,동인천,8442,8181,20200324,16623
20200321,1,인천,2167,1851,20200324,4018
20200321,1,구일,2964,2807,20200324,5771
20200321,1,소사,5495,5338,20200324,10833
20200321,1,부개,4535,4347,20200324,8882
20200321,1,간석,3127,2961,20200324,6088
20200321,1,도원,1625,1662,20200324,3287
20200321,1,온수,3395,3156,20200324,6551
20200321,1,중동,4661,4439,20200324,9100
20200321,1,도화,2100,1911,20200324,4011
20200322,1,개봉,7587,7448,20200325,15035
20200322,1,오류동,4174,3976,20200325,8150
20200322,1,역곡,9622,9371,20200325,18993
20200322,1,부천,14774,14489,20200325,29263
20200322,1,송내,9361,9066,20200325,18427
20200322,1,부평,14624,14414,20200325,29038
20200322,1,백운,2591,2636,20200325,5227
20200322,1,동암,6769,6611,20200325,13380
20200322,1,주안,8365,7472,20200325,15837
20200322,1,제물포,3497,3396,20200325,6893
20200322,1,동인천,6054,5833,20200325,11887
20200322,1,인천,1985,1654,20200325,3639
20200322,1,구일,2020,1915,20200325,3935
20200322,1,소사,3850,3476,20200325,7326
20200322,1,부개,3012,2902,20200325,5914
20200322,1,간석,2150,2026,20200325,4176
20200322,1,도원,1095,1134,20200325,2229
20200322,1,온수,2383,2282,20200325,4665
20200322,1,중동,3058,2845,20200325,5903
20200322,1,도화,1416,1367,20200325,2783
20200323,1,개봉,17325,17535,20200326,34860
20200323,1,오류동,9676,9150,20200326,18826
20200323,1,역곡,22957,22681,20200326,45638
20200323,1,부천,27778,27310,20200326,55088
20200323,1,송내,24614,24113,20200326,48727
20200323,1,부평,24099,25139,20200326,49238
20200323,1,백운,6099,5913,20200326,12012
20200323,1,동암,13281,13103,20200326,26384
20200323,1,주안,16206,14745,20200326,30951
20200323,1,제물포,7995,7618,20200326,15613
20200323,1,동인천,11584,10825,20200326,22409
20200323,1,인천,2338,1775,20200326,4113
20200323,1,구일,4917,5099,20200326,10016
20200323,1,소사,7905,7486,20200326,15391
20200323,1,부개,6956,6491,20200326,13447
20200323,1,간석,4775,4517,20200326,9292
20200323,1,도원,2154,2231,20200326,4385
20200323,1,온수,4988,4888,20200326,9876
20200323,1,중동,7553,7173,20200326,14726
20200323,1,도화,3091,2791,20200326,5882
20200324,1,개봉,17449,17639,20200327,35088
20200324,1,오류동,9612,9202,20200327,18814
20200324,1,역곡,22806,22509,20200327,45315
20200324,1,부천,27216,27655,20200327,54871
20200324,1,송내,24446,24274,20200327,48720
20200324,1,부평,24140,24616,20200327,48756
20200324,1,백운,5918,5814,20200327,11732
20200324,1,동암,13015,13044,20200327,26059
20200324,1,주안,15865,14636,20200327,30501
20200324,1,제물포,7965,7545,20200327,15510
20200324,1,동인천,11585,10941,20200327,22526
20200324,1,인천,2448,1884,20200327,4332
20200324,1,구일,4986,5092,20200327,10078
20200324,1,소사,7818,7372,20200327,15190
20200324,1,부개,6899,6446,20200327,13345
20200324,1,간석,4707,4521,20200327,9228
20200324,1,도원,2170,2233,20200327,4403
20200324,1,온수,5047,4948,20200327,9995
20200324,1,중동,7415,7010,20200327,14425
20200324,1,도화,2996,2684,20200327,5680
20200325,1,개봉,17534,17711,20200328,35245
20200325,1,오류동,9765,9195,20200328,18960
20200325,1,역곡,23055,22956,20200328,46011
20200325,1,부천,28077,28308,20200328,56385
20200325,1,송내,24829,24558,20200328,49387
20200325,1,부평,24806,26614,20200328,51420
20200325,1,백운,5878,5850,20200328,11728
20200325,1,동암,13265,13272,20200328,26537
20200325,1,주안,16653,15244,20200328,31897
20200325,1,제물포,8082,7642,20200328,15724
20200325,1,동인천,11922,11229,20200328,23151
20200325,1,인천,2531,1926,20200328,4457
20200325,1,구일,5028,5130,20200328,10158
20200325,1,소사,8064,7483,20200328,15547
20200325,1,부개,7231,6855,20200328,14086
20200325,1,간석,4851,4524,20200328,9375
20200325,1,도원,2270,2310,20200328,4580
20200325,1,온수,4985,4940,20200328,9925
20200325,1,중동,7636,7196,20200328,14832
20200325,1,도화,3127,2831,20200328,5958
20200326,1,개봉,17338,17539,20200329,34877
20200326,1,오류동,9475,9076,20200329,18551
20200326,1,역곡,22696,22338,20200329,45034
20200326,1,부천,26962,26967,20200329,53929
20200326,1,송내,24250,24051,20200329,48301
20200326,1,부평,23892,25462,20200329,49354
20200326,1,백운,5769,5628,20200329,11397
20200326,1,동암,12849,12848,20200329,25697
20200326,1,주안,15817,14532,20200329,30349
20200326,1,제물포,7779,7443,20200329,15222
20200326,1,동인천,11477,10878,20200329,22355
20200326,1,인천,2337,1793,20200329,4130
20200326,1,구일,4860,4988,20200329,9848
20200326,1,소사,7679,7347,20200329,15026
20200326,1,부개,6914,6508,20200329,13422
20200326,1,간석,4711,4403,20200329,9114
20200326,1,도원,2127,2213,20200329,4340
20200326,1,온수,4771,4818,20200329,9589
20200326,1,중동,7464,6916,20200329,14380
20200326,1,도화,3004,2634,20200329,5638
20200327,1,개봉,17810,17715,20200330,35525
20200327,1,오류동,9746,9034,20200330,18780
20200327,1,역곡,23496,22969,20200330,46465
20200327,1,부천,28797,29833,20200330,58630
20200327,1,송내,24975,24332,20200330,49307
20200327,1,부평,25400,28726,20200330,54126
20200327,1,백운,5929,5986,20200330,11915
20200327,1,동암,13501,13485,20200330,26986
20200327,1,주안,16959,15496,20200330,32455
20200327,1,제물포,8186,7533,20200330,15719
20200327,1,동인천,11830,11280,20200330,23110
20200327,1,인천,2504,1946,20200330,4450
20200327,1,구일,5057,5025,20200330,10082
20200327,1,소사,7823,7237,20200330,15060
20200327,1,부개,7032,6595,20200330,13627
20200327,1,간석,4896,4607,20200330,9503
20200327,1,도원,2118,2188,20200330,4306
20200327,1,온수,5055,4946,20200330,10001
20200327,1,중동,7639,7092,20200330,14731
20200327,1,도화,3114,2735,20200330,5849
20200328,1,개봉,11672,11524,20200331,23196
20200328,1,오류동,6565,6006,20200331,12571
20200328,1,역곡,14914,14762,20200331,29676
20200328,1,부천,21788,22650,20200331,44438
20200328,1,송내,14018,13873,20200331,27891
20200328,1,부평,20270,23137,20200331,43407
20200328,1,백운,3761,3730,20200331,7491
20200328,1,동암,9564,9688,20200331,19252
20200328,1,주안,12218,10929,20200331,23147
20200328,1,제물포,5314,5059,20200331,10373
20200328,1,동인천,8572,8239,20200331,16811
20200328,1,인천,2252,1881,20200331,4133
20200328,1,구일,3159,3014,20200331,6173
20200328,1,소사,5681,5534,20200331,11215
20200328,1,부개,4580,4241,20200331,8821
20200328,1,간석,3096,2968,20200331,6064
20200328,1,도원,1547,1626,20200331,3173
20200328,1,온수,3304,3073,20200331,6377
20200328,1,중동,4696,4457,20200331,9153
20200328,1,도화,2142,1869,20200331,4011
20200329,1,개봉,7856,7687,20200401,15543
20200329,1,오류동,4435,4166,20200401,8601
20200329,1,역곡,10013,9726,20200401,19739
20200329,1,부천,15588,15318,20200401,30906
20200329,1,송내,9548,9246,20200401,18794
20200329,1,부평,14743,14704,20200401,29447
20200329,1,백운,2568,2540,20200401,5108
20200329,1,동암,6772,6639,20200401,13411
20200329,1,주안,8516,7445,20200401,15961
20200329,1,제물포,3586,3482,20200401,7068
20200329,1,동인천,6371,6054,20200401,12425
20200329,1,인천,2074,1800,20200401,3874
20200329,1,구일,2277,2290,20200401,4567
20200329,1,소사,4041,3714,20200401,7755
20200329,1,부개,3190,2988,20200401,6178
20200329,1,간석,2234,2050,20200401,4284
20200329,1,도원,1123,1172,20200401,2295
20200329,1,온수,2310,2226,20200401,4536
20200329,1,중동,3197,3048,20200401,6245
20200329,1,도화,1429,1394,20200401,2823
20200330,1,개봉,17603,17892,20200402,35495
20200330,1,오류동,10087,9387,20200402,19474
20200330,1,역곡,23130,23100,20200402,46230
20200330,1,부천,27930,27763,20200402,55693
20200330,1,송내,24533,24272,20200402,48805
20200330,1,부평,24429,25406,20200402,49835
20200330,1,백운,5934,5907,20200402,11841
20200330,1,동암,13258,13041,20200402,26299
20200330,1,주안,16117,14736,20200402,30853
20200330,1,제물포,8095,7493,20200402,15588
20200330,1,동인천,11887,11173,20200402,23060
20200330,1,인천,2435,1867,20200402,4302
20200330,1,구일,5141,5327,20200402,10468
20200330,1,소사,8049,7590,20200402,15639
20200330,1,부개,7207,6804,20200402,14011
20200330,1,간석,4857,4482,20200402,9339
20200330,1,도원,2221,2281,20200402,4502
20200330,1,온수,4970,5026,20200402,9996
20200330,1,중동,7726,7305,20200402,15031
20200330,1,도화,3054,2783,20200402,5837
20200331,1,개봉,17520,17910,20200403,35430
20200331,1,오류동,9805,9148,20200403,18953
20200331,1,역곡,23226,23058,20200403,46284
20200331,1,부천,27738,27780,20200403,55518
20200331,1,송내,24668,24564,20200403,49232
20200331,1,부평,24248,25478,20200403,49726
20200331,1,백운,5813,5805,20200403,11618
20200331,1,동암,13311,13135,20200403,26446
20200331,1,주안,16027,14807,20200403,30834
20200331,1,제물포,8142,7612,20200403,15754
20200331,1,동인천,11773,11058,20200403,22831
20200331,1,인천,2433,1908,20200403,4341
20200331,1,구일,5122,5322,20200403,10444
20200331,1,소사,8036,7490,20200403,15526
20200331,1,부개,7185,6799,20200403,13984
20200331,1,간석,4935,4611,20200403,9546
20200331,1,도원,2206,2253,20200403,4459
20200331,1,온수,5143,5041,20200403,10184
20200331,1,중동,7685,7313,20200403,14998
20200331,1,도화,3149,2807,20200403,5956
20200401,1,개봉,17997,18078,20200404,36075
20200401,1,오류동,9851,9329,20200404,19180
20200401,1,역곡,23141,22921,20200404,46062
20200401,1,부천,27919,28031,20200404,55950
20200401,1,송내,24795,24506,20200404,49301
20200401,1,부평,24824,25734,20200404,50558
20200401,1,백운,5996,5960,20200404,11956
20200401,1,동암,13214,13244,20200404,26458
20200401,1,주안,16518,15108,20200404,31626
20200401,1,제물포,8173,7717,20200404,15890
20200401,1,동인천,11757,11288,20200404,23045
20200401,1,인천,2527,1900,20200404,4427
20200401,1,구일,5279,5374,20200404,10653
20200401,1,소사,7889,7521,20200404,15410
20200401,1,부개,7169,6794,20200404,13963
20200401,1,간석,4885,4566,20200404,9451
20200401,1,도원,2271,2369,20200404,4640
20200401,1,온수,5030,5104,20200404,10134
20200401,1,중동,7764,7391,20200404,15155
20200401,1,도화,3161,2787,20200404,5948
20200402,1,개봉,17689,18016,20200405,35705
20200402,1,오류동,9795,9224,20200405,19019
20200402,1,역곡,23155,22849,20200405,46004
20200402,1,부천,27946,28237,20200405,56183
20200402,1,송내,24634,24386,20200405,49020
20200402,1,부평,24738,26065,20200405,50803
20200402,1,백운,5936,5857,20200405,11793
20200402,1,동암,13327,13247,20200405,26574
20200402,1,주안,16157,14843,20200405,31000
20200402,1,제물포,8201,7774,20200405,15975
20200402,1,동인천,11907,11277,20200405,23184
20200402,1,인천,2422,1849,20200405,4271
20200402,1,구일,5221,5302,20200405,10523
20200402,1,소사,7970,7483,20200405,15453
20200402,1,부개,7281,6797,20200405,14078
20200402,1,간석,4758,4503,20200405,9261
20200402,1,도원,2270,2316,20200405,4586
20200402,1,온수,5010,4945,20200405,9955
20200402,1,중동,7758,7191,20200405,14949
20200402,1,도화,3059,2783,20200405,5842
20200403,1,개봉,18249,18370,20200406,36619
20200403,1,오류동,10253,9430,20200406,19683
20200403,1,역곡,23825,23515,20200406,47340
20200403,1,부천,29510,30677,20200406,60187
20200403,1,송내,25613,25114,20200406,50727
20200403,1,부평,26430,29260,20200406,55690
20200403,1,백운,6026,5927,20200406,11953
20200403,1,동암,13821,13884,20200406,27705
20200403,1,주안,17362,15811,20200406,33173
20200403,1,제물포,8482,7930,20200406,16412
20200403,1,동인천,12319,11664,20200406,23983
20200403,1,인천,2615,2067,20200406,4682
20200403,1,구일,5421,5499,20200406,10920
20200403,1,소사,8270,7546,20200406,15816
20200403,1,부개,7498,6928,20200406,14426
20200403,1,간석,5005,4688,20200406,9693
20200403,1,도원,2317,2335,20200406,4652
20200403,1,온수,5308,5216,20200406,10524
20200403,1,중동,7921,7456,20200406,15377
20200403,1,도화,3232,2838,20200406,6070
20200404,1,개봉,12063,11851,20200407,23914
20200404,1,오류동,6695,6195,20200407,12890
20200404,1,역곡,15045,14841,20200407,29886
20200404,1,부천,22112,22882,20200407,44994
20200404,1,송내,13983,13865,20200407,27848
20200404,1,부평,20871,23142,20200407,44013
20200404,1,백운,3946,4031,20200407,7977
20200404,1,동암,9627,9921,20200407,19548
20200404,1,주안,12126,10777,20200407,22903
20200404,1,제물포,5198,4919,20200407,10117
20200404,1,동인천,8398,8328,20200407,16726
20200404,1,인천,2061,1747,20200407,3808
20200404,1,구일,3419,3318,20200407,6737
20200404,1,소사,5730,5479,20200407,11209
20200404,1,부개,4712,4413,20200407,9125
20200404,1,간석,3098,2941,20200407,6039
20200404,1,도원,1588,1603,20200407,3191
20200404,1,온수,3455,3328,20200407,6783
20200404,1,중동,4912,4597,20200407,9509
20200404,1,도화,2095,1866,20200407,3961
20200405,1,개봉,7901,7790,20200408,15691
20200405,1,오류동,4439,4204,20200408,8643
20200405,1,역곡,10258,9961,20200408,20219
20200405,1,부천,16209,15746,20200408,31955
20200405,1,송내,9511,9148,20200408,18659
20200405,1,부평,15272,15778,20200408,31050
20200405,1,백운,2785,2822,20200408,5607
20200405,1,동암,6928,6746,20200408,13674
20200405,1,주안,8652,7750,20200408,16402
20200405,1,제물포,3593,3363,20200408,6956
20200405,1,동인천,6273,6002,20200408,12275
20200405,1,인천,1674,1445,20200408,3119
20200405,1,구일,2473,2467,20200408,4940
20200405,1,소사,4306,3982,20200408,8288
20200405,1,부개,3187,3066,20200408,6253
20200405,1,간석,2150,2120,20200408,4270
20200405,1,도원,1102,1191,20200408,2293
20200405,1,온수,2319,2278,20200408,4597
20200405,1,중동,3364,3185,20200408,6549
20200405,1,도화,1466,1365,20200408,2831
20200406,1,개봉,18401,18888,20200409,37289
20200406,1,오류동,10187,9642,20200409,19829
20200406,1,역곡,23964,23939,20200409,47903
20200406,1,부천,28763,28951,20200409,57714
20200406,1,송내,25311,25120,20200409,50431
20200406,1,부평,25592,26809,20200409,52401
20200406,1,백운,6101,6146,20200409,12247
20200406,1,동암,13741,13567,20200409,27308
20200406,1,주안,16769,15387,20200409,32156
20200406,1,제물포,8476,7979,20200409,16455
20200406,1,동인천,12058,11407,20200409,23465
20200406,1,인천,2319,1794,20200409,4113
20200406,1,구일,5422,5603,20200409,11025
20200406,1,소사,8434,7752,20200409,16186
20200406,1,부개,7380,6974,20200409,14354
20200406,1,간석,4981,4697,20200409,9678
20200406,1,도원,2427,2473,20200409,4900
20200406,1,온수,5376,5286,20200409,10662
20200406,1,중동,8059,7605,20200409,15664
20200406,1,도화,3212,2940,20200409,6152
20200407,1,개봉,18334,18593,20200410,36927
20200407,1,오류동,10226,9731,20200410,19957
20200407,1,역곡,23802,23782,20200410,47584
20200407,1,부천,28593,28684,20200410,57277
20200407,1,송내,25461,25230,20200410,50691
20200407,1,부평,24953,26571,20200410,51524
20200407,1,백운,6146,6050,20200410,12196
20200407,1,동암,13665,13629,20200410,27294
20200407,1,주안,16563,15416,20200410,31979
20200407,1,제물포,8540,7948,20200410,16488
20200407,1,동인천,11954,11434,20200410,23388
20200407,1,인천,2498,1884,20200410,4382
20200407,1,구일,5516,5610,20200410,11126
20200407,1,소사,8167,7698,20200410,15865
20200407,1,부개,7371,7163,20200410,14534
20200407,1,간석,5012,4739,20200410,9751
20200407,1,도원,2489,2550,20200410,5039
20200407,1,온수,5283,5231,20200410,10514
20200407,1,중동,7999,7656,20200410,15655
20200407,1,도화,3230,2885,20200410,6115
20200408,1,개봉,18472,18726,20200411,37198
20200408,1,오류동,10032,9587,20200411,19619
20200408,1,역곡,24090,24093,20200411,48183
20200408,1,부천,28782,29124,20200411,57906
20200408,1,송내,25535,25455,20200411,50990
20200408,1,부평,25748,27381,20200411,53129
20200408,1,백운,6198,5967,20200411,12165
20200408,1,동암,13702,13782,20200411,27484
20200408,1,주안,16973,15748,20200411,32721
20200408,1,제물포,8541,8032,20200411,16573
20200408,1,동인천,12184,11694,20200411,23878
20200408,1,인천,2445,1829,20200411,4274
20200408,1,구일,5436,5541,20200411,10977
20200408,1,소사,8216,7745,20200411,15961
20200408,1,부개,7381,6986,20200411,14367
20200408,1,간석,4999,4714,20200411,9713
20200408,1,도원,2425,2466,20200411,4891
20200408,1,온수,5367,5308,20200411,10675
20200408,1,중동,8029,7557,20200411,15586
20200408,1,도화,3276,2899,20200411,6175
20200409,1,개봉,18303,18629,20200412,36932
20200409,1,오류동,10150,9558,20200412,19708
20200409,1,역곡,24023,23711,20200412,47734
20200409,1,부천,28791,29071,20200412,57862
20200409,1,송내,25256,25185,20200412,50441
20200409,1,부평,25643,27249,20200412,52892
20200409,1,백운,6075,5996,20200412,12071
20200409,1,동암,13578,13430,20200412,27008
20200409,1,주안,16583,15259,20200412,31842
20200409,1,제물포,8385,7961,20200412,16346
20200409,1,동인천,12027,11452,20200412,23479
20200409,1,인천,2435,1833,20200412,4268
20200409,1,구일,5427,5464,20200412,10891
20200409,1,소사,8197,7639,20200412,15836
20200409,1,부개,7389,6980,20200412,14369
20200409,1,간석,5044,4739,20200412,9783
20200409,1,도원,2246,2364,20200412,4610
20200409,1,온수,5309,5284,20200412,10593
20200409,1,중동,7988,7531,20200412,15519
20200409,1,도화,3184,2833,20200412,6017
20200410,1,개봉,19052,19071,20200413,38123
20200410,1,오류동,10461,9722,20200413,20183
20200410,1,역곡,24935,24582,20200413,49517
20200410,1,부천,30306,31458,20200413,61764
20200410,1,송내,26099,25837,20200413,51936
20200410,1,부평,27395,31207,20200413,58602
20200410,1,백운,6334,6153,20200413,12487
20200410,1,동암,14225,14400,20200413,28625
20200410,1,주안,17675,16232,20200413,33907
20200410,1,제물포,8811,8120,20200413,16931
20200410,1,동인천,12689,11895,20200413,24584
20200410,1,인천,2503,1840,20200413,4343
20200410,1,구일,5561,5587,20200413,11148
20200410,1,소사,8463,7805,20200413,16268
20200410,1,부개,7496,7064,20200413,14560
20200410,1,간석,5175,4932,20200413,10107
20200410,1,도원,2408,2461,20200413,4869
20200410,1,온수,5453,5463,20200413,10916
20200410,1,중동,8238,7682,20200413,15920
20200410,1,도화,3343,2853,20200413,6196
20200411,1,개봉,13010,12420,20200414,25430
20200411,1,오류동,7033,6629,20200414,13662
20200411,1,역곡,16051,15813,20200414,31864
20200411,1,부천,23534,24613,20200414,48147
20200411,1,송내,14977,14625,20200414,29602
20200411,1,부평,22934,25947,20200414,48881
20200411,1,백운,4189,4311,20200414,8500
20200411,1,동암,10357,10488,20200414,20845
20200411,1,주안,12935,11685,20200414,24620
20200411,1,제물포,5527,5202,20200414,10729
20200411,1,동인천,9204,8992,20200414,18196
20200411,1,인천,2387,2003,20200414,4390
20200411,1,구일,3414,3331,20200414,6745
20200411,1,소사,6444,6254,20200414,12698
20200411,1,부개,5060,4713,20200414,9773
20200411,1,간석,3358,3114,20200414,6472
20200411,1,도원,1669,1768,20200414,3437
20200411,1,온수,3622,3467,20200414,7089
20200411,1,중동,5269,4968,20200414,10237
20200411,1,도화,2290,1986,20200414,4276
20200412,1,개봉,8383,8466,20200415,16849
20200412,1,오류동,4660,4382,20200415,9042
20200412,1,역곡,10687,10543,20200415,21230
20200412,1,부천,16438,16010,20200415,32448
20200412,1,송내,10193,9846,20200415,20039
20200412,1,부평,16701,16971,20200415,33672
20200412,1,백운,2873,2807,20200415,5680
20200412,1,동암,7348,7237,20200415,14585
20200412,1,주안,9035,8238,20200415,17273
20200412,1,제물포,3851,3765,20200415,7616
20200412,1,동인천,6850,6602,20200415,13452
20200412,1,인천,2032,1628,20200415,3660
20200412,1,구일,2310,2342,20200415,4652
20200412,1,소사,4415,4141,20200415,8556
20200412,1,부개,3347,3185,20200415,6532
20200412,1,간석,2334,2187,20200415,4521
20200412,1,도원,1218,1265,20200415,2483
20200412,1,온수,2515,2388,20200415,4903
20200412,1,중동,3343,3087,20200415,6430
20200412,1,도화,1511,1422,20200415,2933
20200413,1,개봉,18861,18997,20200416,37858
20200413,1,오류동,10332,9825,20200416,20157
20200413,1,역곡,24529,24374,20200416,48903
20200413,1,부천,29662,29450,20200416,59112
20200413,1,송내,25992,25467,20200416,51459
20200413,1,부평,26091,27767,20200416,53858
20200413,1,백운,6301,6244,20200416,12545
20200413,1,동암,14040,13799,20200416,27839
20200413,1,주안,17091,15861,20200416,32952
20200413,1,제물포,8757,8226,20200416,16983
20200413,1,동인천,12193,11714,20200416,23907
20200413,1,인천,2415,1900,20200416,4315
20200413,1,구일,5451,5549,20200416,11000
20200413,1,소사,8485,7952,20200416,16437
20200413,1,부개,7600,7108,20200416,14708
20200413,1,간석,5125,4771,20200416,9896
20200413,1,도원,2363,2440,20200416,4803
20200413,1,온수,5526,5404,20200416,10930
20200413,1,중동,8081,7835,20200416,15916
20200413,1,도화,3302,2947,20200416,6249
20200414,1,개봉,18014,18808,20200417,36822
20200414,1,오류동,9454,9566,20200417,19020
20200414,1,역곡,23336,24314,20200417,47650
20200414,1,부천,27680,29581,20200417,57261
20200414,1,송내,25739,24828,20200417,50567
20200414,1,부평,26383,29635,20200417,56018
20200414,1,백운,5995,5892,20200417,11887
20200414,1,동암,13850,13664,20200417,27514
20200414,1,주안,17371,15476,20200417,32847
20200414,1,제물포,8726,8094,20200417,16820
20200414,1,동인천,12339,11407,20200417,23746
20200414,1,인천,2580,1856,20200417,4436
20200414,1,구일,4694,5293,20200417,9987
20200414,1,소사,8347,8646,20200417,16993
20200414,1,부개,7304,7111,20200417,14415
20200414,1,간석,4939,4722,20200417,9661
20200414,1,도원,2326,2337,20200417,4663
20200414,1,온수,5419,5648,20200417,11067
20200414,1,중동,7683,7443,20200417,15126
20200414,1,도화,3232,2924,20200417,6156
20200415,1,개봉,11395,11123,20200418,22518
20200415,1,오류동,6141,5830,20200418,11971
20200415,1,역곡,14354,14322,20200418,28676
20200415,1,부천,21075,21216,20200418,42291
20200415,1,송내,13033,12934,20200418,25967
20200415,1,부평,20076,21016,20200418,41092
20200415,1,백운,3830,3797,20200418,7627
20200415,1,동암,9088,9085,20200418,18173
20200415,1,주안,11247,10170,20200418,21417
20200415,1,제물포,4870,4765,20200418,9635
20200415,1,동인천,8449,8165,20200418,16614
20200415,1,인천,2451,2081,20200418,4532
20200415,1,구일,2988,2981,20200418,5969
20200415,1,소사,5288,5027,20200418,10315
20200415,1,부개,4502,4341,20200418,8843
20200415,1,간석,3097,2935,20200418,6032
20200415,1,도원,1545,1593,20200418,3138
20200415,1,온수,3427,3412,20200418,6839
20200415,1,중동,4580,4317,20200418,8897
20200415,1,도화,2178,1980,20200418,4158
20200416,1,개봉,18822,18971,20200419,37793
20200416,1,오류동,10478,9858,20200419,20336
20200416,1,역곡,24513,24287,20200419,48800
20200416,1,부천,29624,29835,20200419,59459
20200416,1,송내,26141,25991,20200419,52132
20200416,1,부평,26792,28558,20200419,55350
20200416,1,백운,6414,6360,20200419,12774
20200416,1,동암,14155,14101,20200419,28256
20200416,1,주안,17292,15790,20200419,33082
20200416,1,제물포,8740,8254,20200419,16994
20200416,1,동인천,12595,11902,20200419,24497
20200416,1,인천,2565,1918,20200419,4483
20200416,1,구일,5439,5543,20200419,10982
20200416,1,소사,8649,7980,20200419,16629
20200416,1,부개,7590,7195,20200419,14785
20200416,1,간석,5224,4877,20200419,10101
20200416,1,도원,2406,2439,20200419,4845
20200416,1,온수,5557,5429,20200419,10986
20200416,1,중동,8367,7774,20200419,16141
20200416,1,도화,3289,2929,20200419,6218
20200417,1,개봉,18601,18656,20200420,37257
20200417,1,오류동,10197,9491,20200420,19688
20200417,1,역곡,24092,23836,20200420,47928
20200417,1,부천,29571,30420,20200420,59991
20200417,1,송내,25927,25560,20200420,51487
20200417,1,부평,26452,30237,20200420,56689
20200417,1,백운,6060,6003,20200420,12063
20200417,1,동암,13680,13910,20200420,27590
20200417,1,주안,17176,15956,20200420,33132
20200417,1,제물포,8588,7868,20200420,16456
20200417,1,동인천,12077,11519,20200420,23596
20200417,1,인천,2248,1582,20200420,3830
20200417,1,구일,5364,5441,20200420,10805
20200417,1,소사,8269,7629,20200420,15898
20200417,1,부개,7419,6967,20200420,14386
20200417,1,간석,4968,4690,20200420,9658
20200417,1,도원,2244,2231,20200420,4475
20200417,1,온수,5401,5265,20200420,10666
20200417,1,중동,8160,7482,20200420,15642
20200417,1,도화,3209,2828,20200420,6037
20200418,1,개봉,13740,13169,20200421,26909
20200418,1,오류동,7562,7090,20200421,14652
20200418,1,역곡,17075,16678,20200421,33753
20200418,1,부천,25245,26308,20200421,51553
20200418,1,송내,15861,15690,20200421,31551
20200418,1,부평,24831,28254,20200421,53085
20200418,1,백운,4515,4463,20200421,8978
20200418,1,동암,11085,11371,20200421,22456
20200418,1,주안,13798,12106,20200421,25904
20200418,1,제물포,6078,5569,20200421,11647
20200418,1,동인천,10140,9896,20200421,20036
20200418,1,인천,3039,2603,20200421,5642
20200418,1,구일,3661,3505,20200421,7166
20200418,1,소사,6579,6231,20200421,12810
20200418,1,부개,5380,5005,20200421,10385
20200418,1,간석,3555,3340,20200421,6895
20200418,1,도원,1883,1972,20200421,3855
20200418,1,온수,4054,3748,20200421,7802
20200418,1,중동,5482,5222,20200421,10704
20200418,1,도화,2435,2147,20200421,4582
20200419,1,개봉,8513,8579,20200422,17092
20200419,1,오류동,4617,4426,20200422,9043
20200419,1,역곡,10794,10609,20200422,21403
20200419,1,부천,17151,16753,20200422,33904
20200419,1,송내,10162,9901,20200422,20063
20200419,1,부평,16919,16997,20200422,33916
20200419,1,백운,2955,2943,20200422,5898
20200419,1,동암,7268,7167,20200422,14435
20200419,1,주안,8947,7982,20200422,16929
20200419,1,제물포,3712,3678,20200422,7390
20200419,1,동인천,6566,6320,20200422,12886
20200419,1,인천,1774,1413,20200422,3187
20200419,1,구일,2254,2246,20200422,4500
20200419,1,소사,4616,4212,20200422,8828
20200419,1,부개,3423,3329,20200422,6752
20200419,1,간석,2338,2252,20200422,4590
20200419,1,도원,1181,1220,20200422,2401
20200419,1,온수,2503,2431,20200422,4934
20200419,1,중동,3474,3275,20200422,6749
20200419,1,도화,1549,1470,20200422,3019
20200420,1,개봉,19033,19404,20200423,38437
20200420,1,오류동,10418,9942,20200423,20360
20200420,1,역곡,24850,24511,20200423,49361
20200420,1,부천,30184,29937,20200423,60121
20200420,1,송내,26413,26006,20200423,52419
20200420,1,부평,26633,28473,20200423,55106
20200420,1,백운,6584,6564,20200423,13148
20200420,1,동암,14239,13952,20200423,28191
20200420,1,주안,17311,15915,20200423,33226
20200420,1,제물포,8763,8154,20200423,16917
20200420,1,동인천,12420,11886,20200423,24306
20200420,1,인천,2416,1802,20200423,4218
20200420,1,구일,5412,5473,20200423,10885
20200420,1,소사,8827,8348,20200423,17175
20200420,1,부개,7682,7166,20200423,14848
20200420,1,간석,5316,4962,20200423,10278
20200420,1,도원,2451,2438,20200423,4889
20200420,1,온수,5475,5530,20200423,11005
20200420,1,중동,8304,7779,20200423,16083
20200420,1,도화,3313,2976,20200423,6289
20200421,1,개봉,19437,19759,20200424,39196
20200421,1,오류동,10449,9988,20200424,20437
20200421,1,역곡,25222,24821,20200424,50043
20200421,1,부천,29894,30053,20200424,59947
20200421,1,송내,26661,26498,20200424,53159
20200421,1,부평,26697,28294,20200424,54991
20200421,1,백운,6516,6589,20200424,13105
20200421,1,동암,14228,14361,20200424,28589
20200421,1,주안,17418,15843,20200424,33261
20200421,1,제물포,8719,8364,20200424,17083
20200421,1,동인천,12625,11895,20200424,24520
20200421,1,인천,2529,1882,20200424,4411
20200421,1,구일,5449,5524,20200424,10973
20200421,1,소사,8793,8311,20200424,17104
20200421,1,부개,7723,7366,20200424,15089
20200421,1,간석,5265,5050,20200424,10315
20200421,1,도원,2376,2390,20200424,4766
20200421,1,온수,5566,5542,20200424,11108
20200421,1,중동,8293,7952,20200424,16245
20200421,1,도화,3352,2999,20200424,6351
20200422,1,개봉,19174,19569,20200425,38743
20200422,1,오류동,10426,9904,20200425,20330
20200422,1,역곡,24649,24375,20200425,49024
20200422,1,부천,29977,30386,20200425,60363
20200422,1,송내,26556,26310,20200425,52866
20200422,1,부평,26699,28384,20200425,55083
20200422,1,백운,6421,6403,20200425,12824
20200422,1,동암,13929,14187,20200425,28116
20200422,1,주안,17579,16195,20200425,33774
20200422,1,제물포,8558,8114,20200425,16672
20200422,1,동인천,12350,11668,20200425,24018
20200422,1,인천,2358,1721,20200425,4079
20200422,1,구일,5403,5470,20200425,10873
20200422,1,소사,8584,8161,20200425,16745
20200422,1,부개,7644,7229,20200425,14873
20200422,1,간석,5298,5039,20200425,10337
20200422,1,도원,2395,2425,20200425,4820
20200422,1,온수,5473,5492,20200425,10965
20200422,1,중동,8320,7841,20200425,16161
20200422,1,도화,3341,2979,20200425,6320
20200423,1,개봉,19585,19829,20200426,39414
20200423,1,오류동,10701,10170,20200426,20871
20200423,1,역곡,25454,25049,20200426,50503
20200423,1,부천,30836,30885,20200426,61721
20200423,1,송내,27137,26874,20200426,54011
20200423,1,부평,27159,29280,20200426,56439
20200423,1,백운,6526,6470,20200426,12996
20200423,1,동암,14386,14441,20200426,28827
20200423,1,주안,17558,16163,20200426,33721
20200423,1,제물포,8772,8277,20200426,17049
20200423,1,동인천,12761,12038,20200426,24799
20200423,1,인천,2600,2040,20200426,4640
20200423,1,구일,5621,5718,20200426,11339
20200423,1,소사,8748,8363,20200426,17111
20200423,1,부개,7721,7393,20200426,15114
20200423,1,간석,5337,5037,20200426,10374
20200423,1,도원,2470,2488,20200426,4958
20200423,1,온수,5540,5568,20200426,11108
20200423,1,중동,8440,7968,20200426,16408
20200423,1,도화,3332,2955,20200426,6287
20200424,1,개봉,20373,20371,20200427,40744
20200424,1,오류동,11271,10426,20200427,21697
20200424,1,역곡,26455,26152,20200427,52607
20200424,1,부천,32284,33763,20200427,66047
20200424,1,송내,27749,27297,20200427,55046
20200424,1,부평,29451,33387,20200427,62838
20200424,1,백운,6813,6721,20200427,13534
20200424,1,동암,14957,15153,20200427,30110
20200424,1,주안,18724,17038,20200427,35762
20200424,1,제물포,9501,8785,20200427,18286
20200424,1,동인천,13660,12874,20200427,26534
20200424,1,인천,2853,2168,20200427,5021
20200424,1,구일,6017,5955,20200427,11972
20200424,1,소사,9030,8411,20200427,17441
20200424,1,부개,8167,7587,20200427,15754
20200424,1,간석,5661,5325,20200427,10986
20200424,1,도원,2529,2561,20200427,5090
20200424,1,온수,5892,5714,20200427,11606
20200424,1,중동,8717,7994,20200427,16711
20200424,1,도화,3536,3149,20200427,6685
20200425,1,개봉,14681,14141,20200428,28822
20200425,1,오류동,8031,7250,20200428,15281
20200425,1,역곡,18232,17778,20200428,36010
20200425,1,부천,26614,27698,20200428,54312
20200425,1,송내,17099,16609,20200428,33708
20200425,1,부평,25874,29721,20200428,55595
20200425,1,백운,4926,4815,20200428,9741
20200425,1,동암,11376,11686,20200428,23062
20200425,1,주안,14311,12815,20200428,27126
20200425,1,제물포,6672,6234,20200428,12906
20200425,1,동인천,10460,10226,20200428,20686
20200425,1,인천,2910,2482,20200428,5392
20200425,1,구일,3792,3516,20200428,7308
20200425,1,소사,7283,7021,20200428,14304
20200425,1,부개,5557,5206,20200428,10763
20200425,1,간석,3776,3634,20200428,7410
20200425,1,도원,1902,1935,20200428,3837
20200425,1,온수,4166,3919,20200428,8085
20200425,1,중동,5734,5478,20200428,11212
20200425,1,도화,2539,2208,20200428,4747
20200426,1,개봉,9941,9866,20200429,19807
20200426,1,오류동,5862,5462,20200429,11324
20200426,1,역곡,12260,11997,20200429,24257
20200426,1,부천,19080,18899,20200429,37979
20200426,1,송내,12074,11792,20200429,23866
20200426,1,부평,19582,20128,20200429,39710
20200426,1,백운,3418,3413,20200429,6831
20200426,1,동암,8498,8358,20200429,16856
20200426,1,주안,10291,9050,20200429,19341
20200426,1,제물포,4665,4519,20200429,9184
20200426,1,동인천,8234,7932,20200429,16166
20200426,1,인천,2939,2555,20200429,5494
20200426,1,구일,2707,2708,20200429,5415
20200426,1,소사,5165,4785,20200429,9950
20200426,1,부개,3927,3698,20200429,7625
20200426,1,간석,2750,2608,20200429,5358
20200426,1,도원,1486,1501,20200429,2987
20200426,1,온수,2923,2820,20200429,5743
20200426,1,중동,3971,3668,20200429,7639
20200426,1,도화,1871,1782,20200429,3653
20200427,1,개봉,20249,20460,20200430,40709
20200427,1,오류동,11350,10657,20200430,22007
20200427,1,역곡,26070,25651,20200430,51721
20200427,1,부천,31727,31611,20200430,63338
20200427,1,송내,27535,27115,20200430,54650
20200427,1,부평,28256,30060,20200430,58316
20200427,1,백운,6925,6785,20200430,13710
20200427,1,동암,14925,14732,20200430,29657
20200427,1,주안,18152,16550,20200430,34702
20200427,1,제물포,9177,8668,20200430,17845
20200427,1,동인천,13496,12908,20200430,26404
20200427,1,인천,2905,2298,20200430,5203
20200427,1,구일,5731,5889,20200430,11620
20200427,1,소사,9183,8701,20200430,17884
20200427,1,부개,8155,7560,20200430,15715
20200427,1,간석,5501,5223,20200430,10724
20200427,1,도원,2535,2619,20200430,5154
20200427,1,온수,5827,5851,20200430,11678
20200427,1,중동,8741,8218,20200430,16959
20200427,1,도화,3516,3104,20200430,6620
20200428,1,개봉,20495,20598,20200501,41093
20200428,1,오류동,11287,10674,20200501,21961
20200428,1,역곡,26496,26200,20200501,52696
20200428,1,부천,31497,31901,20200501,63398
20200428,1,송내,28009,27597,20200501,55606
20200428,1,부평,27909,29785,20200501,57694
20200428,1,백운,6851,6681,20200501,13532
20200428,1,동암,15225,15021,20200501,30246
20200428,1,주안,18145,16606,20200501,34751
20200428,1,제물포,9248,8752,20200501,18000
20200428,1,동인천,13572,12804,20200501,26376
20200428,1,인천,3097,2382,20200501,5479
20200428,1,구일,5906,5904,20200501,11810
20200428,1,소사,9330,8839,20200501,18169
20200428,1,부개,8176,7577,20200501,15753
20200428,1,간석,5578,5244,20200501,10822
20200428,1,도원,2545,2577,20200501,5122
20200428,1,온수,5997,5982,20200501,11979
20200428,1,중동,8791,8370,20200501,17161
20200428,1,도화,3631,3230,20200501,6861
20200429,1,개봉,21348,21087,20200502,42435
20200429,1,오류동,11744,10806,20200502,22550
20200429,1,역곡,27179,26824,20200502,54003
20200429,1,부천,33098,34378,20200502,67476
20200429,1,송내,28832,28237,20200502,57069
20200429,1,부평,30409,34139,20200502,64548
20200429,1,백운,7219,7004,20200502,14223
20200429,1,동암,15619,15590,20200502,31209
20200429,1,주안,19424,17396,20200502,36820
20200429,1,제물포,9737,9036,20200502,18773
20200429,1,동인천,14035,13358,20200502,27393
20200429,1,인천,3007,2386,20200502,5393
20200429,1,구일,6176,6102,20200502,12278
20200429,1,소사,9573,8986,20200502,18559
20200429,1,부개,8436,7846,20200502,16282
20200429,1,간석,5768,5410,20200502,11178
20200429,1,도원,2717,2745,20200502,5462
20200429,1,온수,6188,5976,20200502,12164
20200429,1,중동,9262,8624,20200502,17886
20200429,1,도화,3787,3293,20200502,7080
20200430,1,개봉,13577,12864,20200503,26441
20200430,1,오류동,7469,6516,20200503,13985
20200430,1,역곡,16486,15675,20200503,32161
20200430,1,부천,24560,24887,20200503,49447
20200430,1,송내,15654,15081,20200503,30735
20200430,1,부평,23607,26344,20200503,49951
20200430,1,백운,4486,4338,20200503,8824
20200430,1,동암,11003,11040,20200503,22043
20200430,1,주안,13116,11641,20200503,24757
20200430,1,제물포,5635,5364,20200503,10999
20200430,1,동인천,10222,10106,20200503,20328
20200430,1,인천,3973,3782,20200503,7755
20200430,1,구일,3665,3360,20200503,7025
20200430,1,소사,6329,6032,20200503,12361
20200430,1,부개,5258,4845,20200503,10103
20200430,1,간석,3583,3322,20200503,6905
20200430,1,도원,1834,1858,20200503,3692
20200430,1,온수,4006,3579,20200503,7585
20200430,1,중동,5482,5090,20200503,10572
20200430,1,도화,2474,2215,20200503,4689
20200501,1,도화,2515,2216,20200504,4731
20200501,1,중동,5848,5529,20200504,11377
20200501,1,온수,4146,3862,20200504,8008
20200501,1,도원,2168,2117,20200504,4285
20200501,1,간석,3856,3595,20200504,7451
20200501,1,부개,5470,5069,20200504,10539
20200501,1,소사,6696,6150,20200504,12846
20200501,1,구일,3700,3627,20200504,7327
20200501,1,인천,4132,3682,20200504,7814
20200501,1,동인천,11167,10758,20200504,21925
20200501,1,제물포,6475,6031,20200504,12506
20200501,1,주안,13961,12453,20200504,26414
20200501,1,동암,11286,11387,20200504,22673
20200501,1,백운,4864,4691,20200504,9555
20200501,1,부평,25210,27934,20200504,53144
20200501,1,송내,16973,16571,20200504,33544
20200501,1,부천,25582,26242,20200504,51824
20200501,1,역곡,18024,17440,20200504,35464
20200501,1,오류동,7706,7088,20200504,14794
20200501,1,개봉,14110,13768,20200504,27878
20200502,1,도화,2341,2041,20200505,4382
20200502,1,중동,5499,5193,20200505,10692
20200502,1,온수,3895,3686,20200505,7581
20200502,1,도원,1821,1854,20200505,3675
20200502,1,간석,3612,3337,20200505,6949
20200502,1,부개,5255,4949,20200505,10204
20200502,1,소사,6937,6638,20200505,13575
20200502,1,구일,3713,3534,20200505,7247
20200502,1,인천,4034,3571,20200505,7605
20200502,1,동인천,10406,10156,20200505,20562
20200502,1,제물포,6016,5712,20200505,11728
20200502,1,주안,13275,11883,20200505,25158
20200502,1,동암,10732,10975,20200505,21707
20200502,1,백운,4578,4501,20200505,9079
20200502,1,부평,24669,28026,20200505,52695
20200502,1,송내,15883,15464,20200505,31347
20200502,1,부천,25134,25926,20200505,51060
20200502,1,역곡,16936,16602,20200505,33538
20200502,1,오류동,7336,6611,20200505,13947
20200502,1,개봉,13824,13646,20200505,27470
20200503,1,도화,1887,1737,20200506,3624
20200503,1,중동,4220,3977,20200506,8197
20200503,1,온수,3060,2916,20200506,5976
20200503,1,도원,1546,1599,20200506,3145
20200503,1,간석,2844,2682,20200506,5526
20200503,1,부개,4066,3789,20200506,7855
20200503,1,소사,5567,5308,20200506,10875
20200503,1,구일,2729,2772,20200506,5501
20200503,1,인천,3365,3031,20200506,6396
20200503,1,동인천,8585,8198,20200506,16783
20200503,1,제물포,4603,4523,20200506,9126
20200503,1,주안,10326,9435,20200506,19761
20200503,1,동암,8780,8637,20200506,17417
20200503,1,백운,3560,3574,20200506,7134
20200503,1,부평,20242,21070,20200506,41312
20200503,1,송내,12260,11898,20200506,24158
20200503,1,부천,20290,20119,20200506,40409
20200503,1,역곡,12903,12888,20200506,25791
20200503,1,오류동,5988,5658,20200506,11646
20200503,1,개봉,10234,10386,20200506,20620
20200504,1,도화,3297,2922,20200507,6219
20200504,1,중동,8013,7462,20200507,15475
20200504,1,온수,5570,5256,20200507,10826
20200504,1,도원,2550,2680,20200507,5230
20200504,1,간석,5153,4842,20200507,9995
20200504,1,부개,7640,7052,20200507,14692
20200504,1,소사,8889,8183,20200507,17072
20200504,1,구일,5388,5401,20200507,10789
20200504,1,인천,3177,2654,20200507,5831
20200504,1,동인천,13211,12396,20200507,25607
20200504,1,제물포,8740,8067,20200507,16807
20200504,1,주안,17505,15812,20200507,33317
20200504,1,동암,14196,13977,20200507,28173
20200504,1,백운,6586,6491,20200507,13077
20200504,1,부평,29440,32778,20200507,62218
20200504,1,송내,24575,23885,20200507,48460
20200504,1,부천,31240,31906,20200507,63146
20200504,1,역곡,24543,24129,20200507,48672
20200504,1,오류동,10357,9686,20200507,20043
20200504,1,개봉,19046,18611,20200507,37657
20200505,1,개봉,11783,11779,20200508,23562
20200505,1,오류동,6317,6133,20200508,12450
20200505,1,역곡,14845,14912,20200508,29757
20200505,1,부천,22004,22114,20200508,44118
20200505,1,송내,13388,13296,20200508,26684
20200505,1,부평,21519,22828,20200508,44347
20200505,1,백운,4047,3901,20200508,7948
20200505,1,동암,9458,9435,20200508,18893
20200505,1,주안,10973,9778,20200508,20751
20200505,1,제물포,4839,4608,20200508,9447
20200505,1,동인천,8892,8802,20200508,17694
20200505,1,인천,3913,3427,20200508,7340
20200505,1,구일,3077,3136,20200508,6213
20200505,1,소사,5683,5346,20200508,11029
20200505,1,부개,4668,4336,20200508,9004
20200505,1,간석,3145,2964,20200508,6109
20200505,1,도원,1581,1643,20200508,3224
20200505,1,온수,3408,3278,20200508,6686
20200505,1,중동,4652,4405,20200508,9057
20200505,1,도화,2082,1923,20200508,4005
20200506,1,개봉,21491,21701,20200509,43192
20200506,1,오류동,11836,11096,20200509,22932
20200506,1,역곡,27616,27622,20200509,55238
20200506,1,부천,35008,35038,20200509,70046
20200506,1,송내,29382,29502,20200509,58884
20200506,1,부평,30249,32521,20200509,62770
20200506,1,백운,7316,7247,20200509,14563
20200506,1,동암,15819,15638,20200509,31457
20200506,1,주안,19532,17800,20200509,37332
20200506,1,제물포,10367,9737,20200509,20104
20200506,1,동인천,14352,13643,20200509,27995
20200506,1,인천,3307,2629,20200509,5936
20200506,1,구일,6381,6498,20200509,12879
20200506,1,소사,9879,9314,20200509,19193
20200506,1,부개,8598,8103,20200509,16701
20200506,1,간석,5861,5471,20200509,11332
20200506,1,도원,2960,3045,20200509,6005
20200506,1,온수,6095,6074,20200509,12169
20200506,1,중동,9344,8813,20200509,18157
20200506,1,도화,3811,3353,20200509,7164
20200507,1,도화,3758,3362,20200510,7120
20200507,1,중동,9387,8879,20200510,18266
20200507,1,온수,6401,6280,20200510,12681
20200507,1,도원,2862,2939,20200510,5801
20200507,1,간석,6044,5803,20200510,11847
20200507,1,부개,8556,8051,20200510,16607
20200507,1,소사,10055,9688,20200510,19743
20200507,1,구일,6415,6359,20200510,12774
20200507,1,인천,3421,2797,20200510,6218
20200507,1,동인천,14494,13633,20200510,28127
20200507,1,제물포,10518,9830,20200510,20348
20200507,1,주안,19591,17744,20200510,37335
20200507,1,동암,15785,15734,20200510,31519
20200507,1,백운,7434,7269,20200510,14703
20200507,1,부평,30592,33231,20200510,63823
20200507,1,송내,29712,29635,20200510,59347
20200507,1,부천,34698,34794,20200510,69492
20200507,1,역곡,28112,27816,20200510,55928
20200507,1,오류동,11951,11260,20200510,23211
20200507,1,개봉,21757,21889,20200510,43646
20200508,1,개봉,22217,23442,20200511,45659
20200508,1,오류동,11868,11207,20200511,23075
20200508,1,역곡,28594,29050,20200511,57644
20200508,1,부천,34979,36422,20200511,71401
20200508,1,송내,30110,30229,20200511,60339
20200508,1,부평,30697,34663,20200511,65360
20200508,1,백운,7473,7356,20200511,14829
20200508,1,동암,15999,16429,20200511,32428
20200508,1,주안,19915,18371,20200511,38286
20200508,1,제물포,10579,9905,20200511,20484
20200508,1,동인천,14170,13717,20200511,27887
20200508,1,인천,3394,2649,20200511,6043
20200508,1,구일,6503,6723,20200511,13226
20200508,1,소사,9910,9456,20200511,19366
20200508,1,부개,8688,8123,20200511,16811
20200508,1,간석,5957,5773,20200511,11730
20200508,1,도원,2766,2859,20200511,5625
20200508,1,온수,6338,6346,20200511,12684
20200508,1,중동,9407,9077,20200511,18484
20200508,1,도화,3768,3439,20200511,7207
20200509,1,개봉,13992,13433,20200512,27425
20200509,1,오류동,7280,6730,20200512,14010
20200509,1,역곡,16909,16781,20200512,33690
20200509,1,부천,24727,25827,20200512,50554
20200509,1,송내,16092,15634,20200512,31726
20200509,1,부평,23070,25980,20200512,49050
20200509,1,백운,4286,4192,20200512,8478
20200509,1,동암,10521,10875,20200512,21396
20200509,1,주안,13410,12147,20200512,25557
20200509,1,제물포,5870,5481,20200512,11351
20200509,1,동인천,8990,8916,20200512,17906
20200509,1,인천,1870,1543,20200512,3413
20200509,1,구일,3531,3434,20200512,6965
20200509,1,소사,6899,6604,20200512,13503
20200509,1,부개,5415,4946,20200512,10361
20200509,1,간석,3608,3302,20200512,6910
20200509,1,도원,1891,1824,20200512,3715
20200509,1,온수,3924,3640,20200512,7564
20200509,1,중동,5397,5156,20200512,10553
20200509,1,도화,2280,2071,20200512,4351
20200510,1,개봉,10721,10520,20200513,21241
20200510,1,오류동,6341,6000,20200513,12341
20200510,1,역곡,13267,12785,20200513,26052
20200510,1,부천,20570,20432,20200513,41002
20200510,1,송내,12628,12150,20200513,24778
20200510,1,부평,19956,20493,20200513,40449
20200510,1,백운,3585,3569,20200513,7154
20200510,1,동암,9121,8899,20200513,18020
20200510,1,주안,11150,9795,20200513,20945
20200510,1,제물포,4685,4533,20200513,9218
20200510,1,동인천,8725,8274,20200513,16999
20200510,1,인천,2699,2332,20200513,5031
20200510,1,구일,2802,2866,20200513,5668
20200510,1,소사,5617,5110,20200513,10727
20200510,1,부개,4249,4090,20200513,8339
20200510,1,간석,2939,2698,20200513,5637
20200510,1,도원,1591,1558,20200513,3149
20200510,1,온수,3210,3087,20200513,6297
20200510,1,중동,4417,4046,20200513,8463
20200510,1,도화,2013,1867,20200513,3880
20200511,1,도화,3689,3229,20200514,6918
20200511,1,중동,9266,8732,20200514,17998
20200511,1,온수,6142,6059,20200514,12201
20200511,1,도원,2932,3034,20200514,5966
20200511,1,간석,5789,5377,20200514,11166
20200511,1,부개,8471,7819,20200514,16290
20200511,1,소사,9503,9061,20200514,18564
20200511,1,구일,6124,6276,20200514,12400
20200511,1,인천,3006,2269,20200514,5275
20200511,1,동인천,13863,13112,20200514,26975
20200511,1,제물포,10814,10202,20200514,21016
20200511,1,주안,19000,17524,20200514,36524
20200511,1,동암,15399,15148,20200514,30547
20200511,1,백운,7206,7042,20200514,14248
20200511,1,부평,29101,30722,20200514,59823
20200511,1,송내,28847,28829,20200514,57676
20200511,1,부천,32854,33014,20200514,65868
20200511,1,역곡,27322,27280,20200514,54602
20200511,1,오류동,11622,11215,20200514,22837
20200511,1,개봉,21693,22020,20200514,43713
20200512,1,개봉,20929,21516,20200515,42445
20200512,1,오류동,11540,10911,20200515,22451
20200512,1,역곡,27105,27152,20200515,54257
20200512,1,부천,32118,32288,20200515,64406
20200512,1,송내,28524,28539,20200515,57063
20200512,1,부평,27610,29118,20200515,56728
20200512,1,백운,7015,7010,20200515,14025
20200512,1,동암,15183,15143,20200515,30326
20200512,1,주안,18597,17048,20200515,35645
20200512,1,제물포,10072,9396,20200515,19468
20200512,1,동인천,13289,12667,20200515,25956
20200512,1,인천,2899,2178,20200515,5077
20200512,1,구일,6213,6386,20200515,12599
20200512,1,소사,9299,8900,20200515,18199
20200512,1,부개,8246,7812,20200515,16058
20200512,1,간석,5634,5414,20200515,11048
20200512,1,도원,2777,2873,20200515,5650
20200512,1,온수,5977,6082,20200515,12059
20200512,1,중동,8976,8399,20200515,17375
20200512,1,도화,3569,3302,20200515,6871
20200513,1,개봉,21170,21807,20200516,42977
20200513,1,오류동,11609,11151,20200516,22760
20200513,1,역곡,27249,27090,20200516,54339
20200513,1,부천,32146,32758,20200516,64904
20200513,1,송내,28676,28626,20200516,57302
20200513,1,부평,28427,30350,20200516,58777
20200513,1,백운,7070,7080,20200516,14150
20200513,1,동암,15306,15375,20200516,30681
20200513,1,주안,18689,16925,20200516,35614
20200513,1,제물포,10318,9737,20200516,20055
20200513,1,동인천,13364,12877,20200516,26241
20200513,1,인천,3004,2395,20200516,5399
20200513,1,구일,6275,6377,20200516,12652
20200513,1,소사,9375,8818,20200516,18193
20200513,1,부개,8238,7754,20200516,15992
20200513,1,간석,5783,5503,20200516,11286
20200513,1,도원,2674,2771,20200516,5445
20200513,1,온수,6137,6130,20200516,12267
20200513,1,중동,9125,8703,20200516,17828
20200513,1,도화,3534,3188,20200516,6722
20200514,1,도화,3401,3070,20200517,6471
20200514,1,중동,9078,8521,20200517,17599
20200514,1,온수,5871,5851,20200517,11722
20200514,1,도원,2583,2618,20200517,5201
20200514,1,간석,5516,5276,20200517,10792
20200514,1,부개,8041,7628,20200517,15669
20200514,1,소사,9269,8760,20200517,18029
20200514,1,구일,6074,6231,20200517,12305
20200514,1,인천,2963,2304,20200517,5267
20200514,1,동인천,13132,12393,20200517,25525
20200514,1,제물포,10005,9500,20200517,19505
20200514,1,주안,17766,16126,20200517,33892
20200514,1,동암,14829,14812,20200517,29641
20200514,1,백운,6820,6786,20200517,13606
20200514,1,송내,28440,28627,20200517,57067
20200514,1,부천,32009,32357,20200517,64366
20200514,1,역곡,26935,26710,20200517,53645
20200514,1,오류동,11545,11106,20200517,22651
20200514,1,개봉,20723,21246,20200517,41969
20200514,1,부평,27773,29620,20200517,57393
20200515,1,도화,3305,2966,20200518,6271
20200515,1,중동,8483,8034,20200518,16517
20200515,1,온수,5851,5848,20200518,11699
20200515,1,도원,2416,2504,20200518,4920
20200515,1,간석,5300,5008,20200518,10308
20200515,1,부개,7772,7266,20200518,15038
20200515,1,소사,8647,8301,20200518,16948
20200515,1,구일,5799,5983,20200518,11782
20200515,1,인천,2309,1705,20200518,4014
20200515,1,동인천,12116,11552,20200518,23668
20200515,1,제물포,8881,7592,20200518,16473
20200515,1,주안,17469,16023,20200518,33492
20200515,1,동암,14242,14428,20200518,28670
20200515,1,백운,6436,6428,20200518,12864
20200515,1,부평,26883,29914,20200518,56797
20200515,1,송내,26919,27158,20200518,54077
20200515,1,부천,31151,32267,20200518,63418
20200515,1,역곡,26114,25825,20200518,51939
20200515,1,오류동,11001,10547,20200518,21548
20200515,1,개봉,20315,21013,20200518,41328
20200516,1,도화,2508,2141,20200519,4649
20200516,1,중동,6036,5657,20200519,11693
20200516,1,온수,4248,4028,20200519,8276
20200516,1,도원,2128,2152,20200519,4280
20200516,1,간석,3764,3601,20200519,7365
20200516,1,부개,5349,5060,20200519,10409
20200516,1,소사,7835,7312,20200519,15147
20200516,1,구일,4151,3950,20200519,8101
20200516,1,인천,2560,2289,20200519,4849
20200516,1,동인천,9949,9730,20200519,19679
20200516,1,제물포,6332,5980,20200519,12312
20200516,1,주안,13909,12384,20200519,26293
20200516,1,동암,11408,11652,20200519,23060
20200516,1,백운,4935,4802,20200519,9737
20200516,1,부평,24323,27343,20200519,51666
20200516,1,송내,17093,16899,20200519,33992
20200516,1,부천,26066,27323,20200519,53389
20200516,1,역곡,18324,17981,20200519,36305
20200516,1,오류동,7968,7453,20200519,15421
20200516,1,개봉,15341,14857,20200519,30198
20200517,1,도화,1883,1740,20200520,3623
20200517,1,중동,4303,4040,20200520,8343
20200517,1,온수,3220,2988,20200520,6208
20200517,1,도원,1608,1576,20200520,3184
20200517,1,간석,2796,2630,20200520,5426
20200517,1,부개,4122,3906,20200520,8028
20200517,1,소사,5677,5238,20200520,10915
20200517,1,구일,2865,2815,20200520,5680
20200517,1,인천,2607,2123,20200520,4730
20200517,1,동인천,7998,7741,20200520,15739
20200517,1,제물포,4400,4320,20200520,8720
20200517,1,주안,10361,9158,20200520,19519
20200517,1,동암,8761,8705,20200520,17466
20200517,1,백운,3555,3539,20200520,7094
20200517,1,부평,19170,19911,20200520,39081
20200517,1,송내,12369,11797,20200520,24166
20200517,1,부천,20473,20201,20200520,40674
20200517,1,역곡,13001,12916,20200520,25917
20200517,1,오류동,6303,5928,20200520,12231
20200517,1,개봉,10592,10512,20200520,21104
20200518,1,개봉,20186,21366,20200521,41552
20200518,1,오류동,11156,10809,20200521,21965
20200518,1,역곡,25849,25901,20200521,51750
20200518,1,부천,30718,30584,20200521,61302
20200518,1,송내,26924,26805,20200521,53729
20200518,1,부평,26530,27664,20200521,54194
20200518,1,백운,6772,6729,20200521,13501
20200518,1,동암,14474,14289,20200521,28763
20200518,1,주안,17266,15644,20200521,32910
20200518,1,제물포,8885,8423,20200521,17308
20200518,1,동인천,12319,11673,20200521,23992
20200518,1,인천,2399,1801,20200521,4200
20200518,1,구일,5904,6114,20200521,12018
20200518,1,소사,9149,8710,20200521,17859
20200518,1,부개,7952,7497,20200521,15449
20200518,1,간석,5374,5108,20200521,10482
20200518,1,도원,2557,2591,20200521,5148
20200518,1,온수,5737,5826,20200521,11563
20200518,1,중동,8774,8282,20200521,17056
20200518,1,도화,3296,2975,20200521,6271
20200519,1,도화,3401,3036,20200522,6437
20200519,1,중동,8611,8274,20200522,16885
20200519,1,온수,5808,5670,20200522,11478
20200519,1,도원,2536,2619,20200522,5155
20200519,1,간석,5370,5064,20200522,10434
20200519,1,부개,7819,7333,20200522,15152
20200519,1,소사,8966,8545,20200522,17511
20200519,1,구일,5969,6116,20200522,12085
20200519,1,인천,2484,1870,20200522,4354
20200519,1,동인천,12566,11892,20200522,24458
20200519,1,제물포,9028,8475,20200522,17503
20200519,1,주안,17200,15694,20200522,32894
20200519,1,동암,14376,14385,20200522,28761
20200519,1,백운,6614,6715,20200522,13329
20200519,1,부평,27037,28779,20200522,55816
20200519,1,송내,26856,27024,20200522,53880
20200519,1,부천,31045,30820,20200522,61865
20200519,1,역곡,26136,25745,20200522,51881
20200519,1,오류동,11078,10532,20200522,21610
20200519,1,개봉,20507,20910,20200522,41417
20200520,1,도화,3712,3322,20200523,7034
20200520,1,중동,9310,8762,20200523,18072
20200520,1,온수,6285,6406,20200523,12691
20200520,1,도원,3266,3249,20200523,6515
20200520,1,간석,5803,5578,20200523,11381
20200520,1,부개,8337,7833,20200523,16170
20200520,1,소사,9640,9187,20200523,18827
20200520,1,구일,6139,6410,20200523,12549
20200520,1,인천,3028,2339,20200523,5367
20200520,1,동인천,13838,13196,20200523,27034
20200520,1,제물포,9937,9395,20200523,19332
20200520,1,주안,18753,17048,20200523,35801
20200520,1,동암,15495,15452,20200523,30947
20200520,1,백운,7215,7153,20200523,14368
20200520,1,부평,28923,31014,20200523,59937
20200520,1,송내,28245,28266,20200523,56511
20200520,1,부천,32863,33050,20200523,65913
20200520,1,역곡,27436,27237,20200523,54673
20200520,1,오류동,11950,11293,20200523,23243
20200520,1,개봉,21616,22062,20200523,43678
20200521,1,도화,3510,3146,20200524,6656
20200521,1,중동,9065,8624,20200524,17689
20200521,1,온수,6370,6199,20200524,12569
20200521,1,도원,2622,2724,20200524,5346
20200521,1,간석,5473,5200,20200524,10673
20200521,1,부개,8260,7774,20200524,16034
20200521,1,소사,9522,9063,20200524,18585
20200521,1,구일,6338,6382,20200524,12720
20200521,1,인천,3096,2474,20200524,5570
20200521,1,동인천,13040,12502,20200524,25542
20200521,1,제물포,9307,8802,20200524,18109
20200521,1,주안,17941,16133,20200524,34074
20200521,1,동암,15407,15288,20200524,30695
20200521,1,백운,6929,6867,20200524,13796
20200521,1,부평,28397,30296,20200524,58693
20200521,1,송내,28209,27997,20200524,56206
20200521,1,부천,32296,32738,20200524,65034
20200521,1,역곡,27155,26905,20200524,54060
20200521,1,오류동,11696,11067,20200524,22763
20200521,1,개봉,21346,21711,20200524,43057
20200522,1,개봉,21661,22081,20200525,43742
20200522,1,오류동,11887,11134,20200525,23021
20200522,1,역곡,27712,27332,20200525,55044
20200522,1,부천,32974,34287,20200525,67261
20200522,1,송내,28530,28103,20200525,56633
20200522,1,부평,29482,33106,20200525,62588
20200522,1,백운,7092,7036,20200525,14128
20200522,1,동암,15211,15420,20200525,30631
20200522,1,주안,18813,16822,20200525,35635
20200522,1,제물포,9567,8852,20200525,18419
20200522,1,동인천,13501,12839,20200525,26340
20200522,1,인천,2993,2330,20200525,5323
20200522,1,구일,6298,6448,20200525,12746
20200522,1,소사,9437,8958,20200525,18395
20200522,1,부개,8350,7763,20200525,16113
20200522,1,간석,5689,5351,20200525,11040
20200522,1,도원,2688,2755,20200525,5443
20200522,1,온수,6478,6325,20200525,12803
20200522,1,중동,9178,8548,20200525,17726
20200522,1,도화,3553,3229,20200525,6782
20200523,1,개봉,16165,15482,20200526,31647
20200523,1,오류동,8764,7929,20200526,16693
20200523,1,역곡,18882,18726,20200526,37608
20200523,1,부천,26776,27876,20200526,54652
20200523,1,송내,17765,17344,20200526,35109
20200523,1,부평,25937,29042,20200526,54979
20200523,1,백운,5154,5064,20200526,10218
20200523,1,동암,11872,12087,20200526,23959
20200523,1,주안,14005,12688,20200526,26693
20200523,1,제물포,6492,6045,20200526,12537
20200523,1,동인천,10444,10403,20200526,20847
20200523,1,인천,3417,2991,20200526,6408
20200523,1,구일,4819,4496,20200526,9315
20200523,1,소사,7951,7535,20200526,15486
20200523,1,부개,5910,5485,20200526,11395
20200523,1,간석,3893,3632,20200526,7525
20200523,1,도원,2004,1963,20200526,3967
20200523,1,온수,4659,4329,20200526,8988
20200523,1,중동,6176,5909,20200526,12085
20200523,1,도화,2686,2295,20200526,4981
20200524,1,도화,1828,1745,20200527,3573
20200524,1,중동,3998,3756,20200527,7754
20200524,1,온수,3150,2972,20200527,6122
20200524,1,도원,1480,1526,20200527,3006
20200524,1,간석,2638,2536,20200527,5174
20200524,1,부개,3909,3694,20200527,7603
20200524,1,소사,5276,4870,20200527,10146
20200524,1,구일,2830,2827,20200527,5657
20200524,1,인천,2303,1979,20200527,4282
20200524,1,동인천,7656,7279,20200527,14935
20200524,1,제물포,4306,4092,20200527,8398
20200524,1,주안,9660,8600,20200527,18260
20200524,1,동암,8373,8095,20200527,16468
20200524,1,백운,3371,3330,20200527,6701
20200524,1,부평,18552,19124,20200527,37676
20200524,1,송내,11227,10943,20200527,22170
20200524,1,부천,18450,18076,20200527,36526
20200524,1,역곡,12341,12314,20200527,24655
20200524,1,오류동,5925,5570,20200527,11495
20200524,1,개봉,10067,9907,20200527,19974
20200525,1,도화,3623,3248,20200528,6871
20200525,1,중동,9226,8606,20200528,17832
20200525,1,온수,6472,6341,20200528,12813
20200525,1,도원,3301,3374,20200528,6675
20200525,1,간석,5756,5403,20200528,11159
20200525,1,부개,8344,7836,20200528,16180
20200525,1,소사,9697,9326,20200528,19023
20200525,1,구일,6148,6389,20200528,12537
20200525,1,인천,2900,2262,20200528,5162
20200525,1,동인천,13870,13219,20200528,27089
20200525,1,제물포,9741,9181,20200528,18922
20200525,1,주안,18359,16758,20200528,35117
20200525,1,동암,15328,15247,20200528,30575
20200525,1,백운,7277,7219,20200528,14496
20200525,1,부평,28957,30449,20200528,59406
20200525,1,송내,27902,27627,20200528,55529
20200525,1,부천,32398,32216,20200528,64614
20200525,1,역곡,27488,27098,20200528,54586
20200525,1,오류동,11838,11243,20200528,23081
20200525,1,개봉,21451,21883,20200528,43334
20200526,1,도화,3508,3173,20200529,6681
20200526,1,중동,9034,8612,20200529,17646
20200526,1,온수,6459,6419,20200529,12878
20200526,1,도원,3147,3242,20200529,6389
20200526,1,간석,5677,5400,20200529,11077
20200526,1,부개,8195,7741,20200529,15936
20200526,1,소사,9438,9117,20200529,18555
20200526,1,구일,6161,6373,20200529,12534
20200526,1,인천,2756,2073,20200529,4829
20200526,1,동인천,13437,12786,20200529,26223
20200526,1,제물포,9659,9022,20200529,18681
20200526,1,주안,18158,16641,20200529,34799
20200526,1,동암,14988,15267,20200529,30255
20200526,1,백운,7003,6975,20200529,13978
20200526,1,부평,27461,29004,20200529,56465
20200526,1,송내,27493,27580,20200529,55073
20200526,1,부천,31469,31327,20200529,62796
20200526,1,역곡,26796,26716,20200529,53512
20200526,1,오류동,11560,11017,20200529,22577
20200526,1,개봉,21285,22066,20200529,43351
20200527,1,도화,3741,3336,20200530,7077
20200527,1,중동,9174,8615,20200530,17789
20200527,1,온수,6671,6596,20200530,13267
20200527,1,도원,3671,3745,20200530,7416
20200527,1,간석,5938,5663,20200530,11601
20200527,1,부개,8390,7920,20200530,16310
20200527,1,소사,9620,9125,20200530,18745
20200527,1,구일,6512,6673,20200530,13185
20200527,1,인천,3174,2474,20200530,5648
20200527,1,동인천,14335,13568,20200530,27903
20200527,1,제물포,10276,9704,20200530,19980
20200527,1,주안,19217,17375,20200530,36592
20200527,1,동암,15649,15693,20200530,31342
20200527,1,백운,7186,7214,20200530,14400
20200527,1,부평,28654,30682,20200530,59336
20200527,1,송내,27886,27888,20200530,55774
20200527,1,부천,31795,31979,20200530,63774
20200527,1,역곡,27356,27084,20200530,54440
20200527,1,오류동,11946,11394,20200530,23340
20200527,1,개봉,21720,22101,20200530,43821
20200528,1,도화,3593,3213,20200531,6806
20200528,1,중동,8883,8235,20200531,17118
20200528,1,온수,6492,6343,20200531,12835
20200528,1,도원,3465,3568,20200531,7033
20200528,1,간석,5627,5359,20200531,10986
20200528,1,부개,8115,7686,20200531,15801
20200528,1,소사,9132,8773,20200531,17905
20200528,1,구일,6183,6395,20200531,12578
20200528,1,인천,2942,2223,20200531,5165
20200528,1,동인천,13603,12854,20200531,26457
20200528,1,제물포,9913,9325,20200531,19238
20200528,1,주안,18259,16839,20200531,35098
20200528,1,동암,15156,15048,20200531,30204
20200528,1,백운,6969,6943,20200531,13912
20200528,1,부평,27270,29089,20200531,56359
20200528,1,송내,27269,27250,20200531,54519
20200528,1,부천,30338,30226,20200531,60564
20200528,1,역곡,26603,26186,20200531,52789
20200528,1,오류동,11677,11002,20200531,22679
20200528,1,개봉,21185,21485,20200531,42670
20200529,1,개봉,21413,21883,20200601,43296
20200529,1,오류동,11896,11130,20200601,23026
20200529,1,역곡,26789,26466,20200601,53255
20200529,1,부천,30654,30975,20200601,61629
20200529,1,송내,27412,27056,20200601,54468
20200529,1,부평,27864,30454,20200601,58318
20200529,1,백운,7100,6906,20200601,14006
20200529,1,동암,15297,15622,20200601,30919
20200529,1,주안,19107,17291,20200601,36398
20200529,1,제물포,10013,9383,20200601,19396
20200529,1,동인천,13811,13165,20200601,26976
20200529,1,인천,2892,2289,20200601,5181
20200529,1,구일,6411,6445,20200601,12856
20200529,1,소사,9186,8603,20200601,17789
20200529,1,부개,8108,7537,20200601,15645
20200529,1,간석,5717,5373,20200601,11090
20200529,1,도원,3588,3605,20200601,7193
20200529,1,온수,6666,6550,20200601,13216
20200529,1,중동,8730,8212,20200601,16942
20200529,1,도화,3638,3228,20200601,6866
20200530,1,개봉,15518,14983,20200602,30501
20200530,1,오류동,8318,7615,20200602,15933
20200530,1,역곡,17787,17173,20200602,34960
20200530,1,부천,23599,24162,20200602,47761
20200530,1,송내,15709,15497,20200602,31206
20200530,1,부평,22802,25114,20200602,47916
20200530,1,백운,4952,4901,20200602,9853
20200530,1,동암,11641,11839,20200602,23480
20200530,1,주안,14077,12457,20200602,26534
20200530,1,제물포,6267,5933,20200602,12200
20200530,1,동인천,10105,10001,20200602,20106
20200530,1,인천,2604,2307,20200602,4911
20200530,1,구일,3939,3746,20200602,7685
20200530,1,소사,7173,6836,20200602,14009
20200530,1,부개,5318,5050,20200602,10368
20200530,1,간석,3781,3526,20200602,7307
20200530,1,도원,2012,2064,20200602,4076
20200530,1,온수,4520,4350,20200602,8870
20200530,1,중동,5679,5267,20200602,10946
20200530,1,도화,2538,2237,20200602,4775
20200531,1,도화,1749,1697,20200603,3446
20200531,1,중동,3822,3650,20200603,7472
20200531,1,온수,3177,2973,20200603,6150
20200531,1,도원,1444,1484,20200603,2928
20200531,1,간석,2569,2476,20200603,5045
20200531,1,부개,3806,3632,20200603,7438
20200531,1,소사,5214,4787,20200603,10001
20200531,1,구일,2837,2829,20200603,5666
20200531,1,인천,2401,1971,20200603,4372
20200531,1,동인천,7878,7402,20200603,15280
20200531,1,제물포,4300,4240,20200603,8540
20200531,1,주안,9533,8513,20200603,18046
20200531,1,동암,8190,8002,20200603,16192
20200531,1,백운,3334,3321,20200603,6655
20200531,1,부평,16926,17238,20200603,34164
20200531,1,송내,11045,10624,20200603,21669
20200531,1,부천,17411,17112,20200603,34523
20200531,1,역곡,11959,11853,20200603,23812
20200531,1,오류동,6180,5726,20200603,11906
20200531,1,개봉,10136,10198,20200603,20334
20200101,G,춘천,1729,1432,20200104,3161
20200101,G,남춘천,2139,2432,20200104,4571
20200101,G,김유정,339,320,20200104,659
20200101,G,강촌,337,312,20200104,649
20200101,G,백양리,270,260,20200104,530
20200101,G,굴봉산,129,104,20200104,233
20200101,G,가평,1554,1375,20200104,2929
20200101,G,상천,256,150,20200104,406
20200101,G,청평,1449,1186,20200104,2635
20200101,G,대성리,418,289,20200104,707
20200101,G,마석,1926,2041,20200104,3967
20200101,G,천마산,882,867,20200104,1749
20200101,G,평내호평,2928,2787,20200104,5715
20200101,G,금곡,743,780,20200104,1523
20200101,G,사릉,1385,1457,20200104,2842
20200101,G,퇴계원,1608,1639,20200104,3247
20200101,G,별내,1324,1326,20200104,2650
20200101,G,갈매,1011,1001,20200104,2012
20200101,G,신내,713,732,20200104,1445
20200102,G,신내,1389,1470,20200105,2859
20200102,G,갈매,3074,2573,20200105,5647
20200102,G,별내,2742,2704,20200105,5446
20200102,G,퇴계원,3946,3605,20200105,7551
20200102,G,사릉,3521,3306,20200105,6827
20200102,G,금곡,1736,1643,20200105,3379
20200102,G,평내호평,6178,5957,20200105,12135
20200102,G,천마산,1605,1480,20200105,3085
20200102,G,마석,3804,3694,20200105,7498
20200102,G,대성리,442,437,20200105,879
20200102,G,청평,2047,1862,20200105,3909
20200102,G,상천,237,219,20200105,456
20200102,G,가평,1962,2032,20200105,3994
20200102,G,굴봉산,97,131,20200105,228
20200102,G,백양리,260,249,20200105,509
20200102,G,강촌,399,391,20200105,790
20200102,G,김유정,312,333,20200105,645
20200102,G,남춘천,2939,3155,20200105,6094
20200102,G,춘천,1514,1331,20200105,2845
20200103,G,신내,1474,1481,20200106,2955
20200103,G,갈매,3195,2660,20200106,5855
20200103,G,별내,2902,2828,20200106,5730
20200103,G,퇴계원,4143,3727,20200106,7870
20200103,G,사릉,3706,3465,20200106,7171
20200103,G,금곡,1770,1696,20200106,3466
20200103,G,평내호평,6474,6382,20200106,12856
20200103,G,천마산,1705,1572,20200106,3277
20200103,G,마석,4420,4323,20200106,8743
20200103,G,대성리,539,660,20200106,1199
20200103,G,청평,2164,2197,20200106,4361
20200103,G,상천,255,265,20200106,520
20200103,G,가평,1960,2064,20200106,4024
20200103,G,굴봉산,130,145,20200106,275
20200103,G,백양리,297,341,20200106,638
20200103,G,강촌,426,409,20200106,835
20200103,G,김유정,339,385,20200106,724
20200103,G,남춘천,2981,2963,20200106,5944
20200103,G,춘천,1698,1456,20200106,3154
20200104,G,신내,1025,1150,20200107,2175
20200104,G,갈매,1951,1645,20200107,3596
20200104,G,별내,2144,2105,20200107,4249
20200104,G,퇴계원,2857,2612,20200107,5469
20200104,G,사릉,2568,2324,20200107,4892
20200104,G,금곡,1139,1032,20200107,2171
20200104,G,평내호평,4688,4641,20200107,9329
20200104,G,천마산,1391,1316,20200107,2707
20200104,G,마석,3200,3128,20200107,6328
20200104,G,대성리,690,785,20200107,1475
20200104,G,청평,2046,1896,20200107,3942
20200104,G,상천,272,322,20200107,594
20200104,G,가평,1902,1937,20200107,3839
20200104,G,굴봉산,175,223,20200107,398
20200104,G,백양리,325,324,20200107,649
20200104,G,강촌,453,539,20200107,992
20200104,G,김유정,444,464,20200107,908
20200104,G,남춘천,3104,3133,20200107,6237
20200104,G,춘천,1944,1787,20200107,3731
20200105,G,신내,871,901,20200108,1772
20200105,G,갈매,1423,1321,20200108,2744
20200105,G,별내,1663,1660,20200108,3323
20200105,G,퇴계원,2193,2042,20200108,4235
20200105,G,사릉,1934,1882,20200108,3816
20200105,G,금곡,879,857,20200108,1736
20200105,G,평내호평,3614,3362,20200108,6976
20200105,G,천마산,1252,1172,20200108,2424
20200105,G,마석,2548,2639,20200108,5187
20200105,G,대성리,735,392,20200108,1127
20200105,G,청평,1798,1574,20200108,3372
20200105,G,상천,460,280,20200108,740
20200105,G,가평,1678,1509,20200108,3187
20200105,G,굴봉산,204,158,20200108,362
20200105,G,백양리,351,220,20200108,571
20200105,G,강촌,580,445,20200108,1025
20200105,G,김유정,369,393,20200108,762
20200105,G,남춘천,2467,2795,20200108,5262
20200105,G,춘천,1813,1510,20200108,3323
20200106,G,신내,1442,1509,20200109,2951
20200106,G,갈매,3041,2576,20200109,5617
20200106,G,별내,2797,2679,20200109,5476
20200106,G,퇴계원,4061,3678,20200109,7739
20200106,G,사릉,3763,3484,20200109,7247
20200106,G,금곡,1725,1645,20200109,3370
20200106,G,평내호평,6343,6251,20200109,12594
20200106,G,천마산,1654,1517,20200109,3171
20200106,G,마석,3943,3786,20200109,7729
20200106,G,대성리,484,606,20200109,1090
20200106,G,청평,1877,1875,20200109,3752
20200106,G,상천,233,226,20200109,459
20200106,G,가평,1912,1963,20200109,3875
20200106,G,굴봉산,124,131,20200109,255
20200106,G,백양리,258,244,20200109,502
20200106,G,강촌,323,297,20200109,620
20200106,G,김유정,260,250,20200109,510
20200106,G,남춘천,2604,2718,20200109,5322
20200106,G,춘천,1444,1319,20200109,2763
20200107,G,신내,1391,1442,20200110,2833
20200107,G,갈매,2931,2398,20200110,5329
20200107,G,별내,2563,2457,20200110,5020
20200107,G,퇴계원,3755,3363,20200110,7118
20200107,G,사릉,3371,3129,20200110,6500
20200107,G,금곡,1531,1474,20200110,3005
20200107,G,평내호평,5773,5587,20200110,11360
20200107,G,천마산,1423,1298,20200110,2721
20200107,G,마석,3539,3470,20200110,7009
20200107,G,대성리,535,463,20200110,998
20200107,G,청평,1692,1569,20200110,3261
20200107,G,상천,172,185,20200110,357
20200107,G,가평,1685,1556,20200110,3241
20200107,G,굴봉산,85,79,20200110,164
20200107,G,백양리,193,144,20200110,337
20200107,G,강촌,258,240,20200110,498
20200107,G,김유정,213,223,20200110,436
20200107,G,남춘천,2579,2608,20200110,5187
20200107,G,춘천,1165,1085,20200110,2250
20200108,G,신내,1403,1463,20200111,2866
20200108,G,갈매,3041,2598,20200111,5639
20200108,G,별내,2700,2675,20200111,5375
20200108,G,퇴계원,4052,3663,20200111,7715
20200108,G,사릉,3581,3427,20200111,7008
20200108,G,금곡,1638,1505,20200111,3143
20200108,G,평내호평,6367,6113,20200111,12480
20200108,G,천마산,1651,1527,20200111,3178
20200108,G,마석,4178,3947,20200111,8125
20200108,G,대성리,629,518,20200111,1147
20200108,G,청평,1977,1958,20200111,3935
20200108,G,상천,239,203,20200111,442
20200108,G,가평,1751,1787,20200111,3538
20200108,G,굴봉산,125,126,20200111,251
20200108,G,백양리,143,194,20200111,337
20200108,G,강촌,299,286,20200111,585
20200108,G,김유정,229,268,20200111,497
20200108,G,남춘천,2637,2679,20200111,5316
20200108,G,춘천,1369,1242,20200111,2611
20200109,G,신내,1490,1497,20200112,2987
20200109,G,갈매,3092,2573,20200112,5665
20200109,G,별내,2881,2746,20200112,5627
20200109,G,퇴계원,4113,3734,20200112,7847
20200109,G,사릉,3674,3425,20200112,7099
20200109,G,금곡,1731,1684,20200112,3415
20200109,G,평내호평,6573,6335,20200112,12908
20200109,G,천마산,1662,1527,20200112,3189
20200109,G,마석,4019,3936,20200112,7955
20200109,G,대성리,508,517,20200112,1025
20200109,G,청평,2115,1975,20200112,4090
20200109,G,상천,244,230,20200112,474
20200109,G,가평,1963,2152,20200112,4115
20200109,G,굴봉산,121,151,20200112,272
20200109,G,백양리,197,255,20200112,452
20200109,G,강촌,367,339,20200112,706
20200109,G,김유정,302,331,20200112,633
20200109,G,남춘천,2685,2733,20200112,5418
20200109,G,춘천,1646,1393,20200112,3039
20200110,G,신내,1510,1548,20200113,3058
20200110,G,갈매,3153,2704,20200113,5857
20200110,G,별내,2884,2904,20200113,5788
20200110,G,퇴계원,4181,3719,20200113,7900
20200110,G,사릉,3835,3570,20200113,7405
20200110,G,금곡,1756,1638,20200113,3394
20200110,G,평내호평,6783,6520,20200113,13303
20200110,G,천마산,1720,1527,20200113,3247
20200110,G,마석,4245,4060,20200113,8305
20200110,G,대성리,607,785,20200113,1392
20200110,G,청평,2092,1999,20200113,4091
20200110,G,상천,263,234,20200113,497
20200110,G,가평,1998,2049,20200113,4047
20200110,G,굴봉산,156,151,20200113,307
20200110,G,백양리,317,287,20200113,604
20200110,G,강촌,303,339,20200113,642
20200110,G,김유정,336,359,20200113,695
20200110,G,남춘천,2974,2964,20200113,5938
20200110,G,춘천,1744,1535,20200113,3279
20200111,G,신내,1136,1093,20200114,2229
20200111,G,갈매,2040,1815,20200114,3855
20200111,G,별내,2203,2127,20200114,4330
20200111,G,퇴계원,3047,2797,20200114,5844
20200111,G,사릉,2670,2495,20200114,5165
20200111,G,금곡,1217,1143,20200114,2360
20200111,G,평내호평,5030,4882,20200114,9912
20200111,G,천마산,1452,1372,20200114,2824
20200111,G,마석,3410,3235,20200114,6645
20200111,G,대성리,713,869,20200114,1582
20200111,G,청평,2009,2071,20200114,4080
20200111,G,상천,308,368,20200114,676
20200111,G,가평,1881,2120,20200114,4001
20200111,G,굴봉산,146,205,20200114,351
20200111,G,백양리,282,326,20200114,608
20200111,G,강촌,522,589,20200114,1111
20200111,G,김유정,531,554,20200114,1085
20200111,G,남춘천,3344,3500,20200114,6844
20200111,G,춘천,2292,1875,20200114,4167
20200112,G,신내,879,977,20200115,1856
20200112,G,갈매,1532,1291,20200115,2823
20200112,G,별내,1707,1681,20200115,3388
20200112,G,퇴계원,2231,2113,20200115,4344
20200112,G,사릉,1902,1838,20200115,3740
20200112,G,금곡,944,924,20200115,1868
20200112,G,평내호평,3647,3477,20200115,7124
20200112,G,천마산,1273,1219,20200115,2492
20200112,G,마석,2542,2565,20200115,5107
20200112,G,대성리,841,404,20200115,1245
20200112,G,청평,1747,1568,20200115,3315
20200112,G,상천,361,227,20200115,588
20200112,G,가평,1826,1596,20200115,3422
20200112,G,굴봉산,217,150,20200115,367
20200112,G,백양리,332,234,20200115,566
20200112,G,강촌,694,532,20200115,1226
20200112,G,김유정,396,454,20200115,850
20200112,G,남춘천,3419,3646,20200115,7065
20200112,G,춘천,1906,1633,20200115,3539
20200113,G,신내,1452,1499,20200116,2951
20200113,G,갈매,3046,2587,20200116,5633
20200113,G,별내,2925,2749,20200116,5674
20200113,G,퇴계원,4058,3734,20200116,7792
20200113,G,사릉,3820,3581,20200116,7401
20200113,G,금곡,1772,1641,20200116,3413
20200113,G,평내호평,6667,6300,20200116,12967
20200113,G,천마산,1703,1498,20200116,3201
20200113,G,마석,4319,4333,20200116,8652
20200113,G,대성리,519,624,20200116,1143
20200113,G,청평,2006,1987,20200116,3993
20200113,G,상천,247,229,20200116,476
20200113,G,가평,1979,2172,20200116,4151
20200113,G,굴봉산,106,145,20200116,251
20200113,G,백양리,269,245,20200116,514
20200113,G,강촌,336,328,20200116,664
20200113,G,김유정,308,324,20200116,632
20200113,G,남춘천,2694,2857,20200116,5551
20200113,G,춘천,1506,1356,20200116,2862
20200114,G,춘천,1393,1319,20200117,2712
20200114,G,남춘천,2547,2628,20200117,5175
20200114,G,김유정,290,326,20200117,616
20200114,G,강촌,316,247,20200117,563
20200114,G,백양리,289,285,20200117,574
20200114,G,굴봉산,142,133,20200117,275
20200114,G,가평,1966,1891,20200117,3857
20200114,G,상천,220,213,20200117,433
20200114,G,청평,1979,1798,20200117,3777
20200114,G,대성리,735,507,20200117,1242
20200114,G,마석,3932,3848,20200117,7780
20200114,G,천마산,1631,1514,20200117,3145
20200114,G,평내호평,6446,6341,20200117,12787
20200114,G,금곡,1701,1604,20200117,3305
20200114,G,사릉,3735,3504,20200117,7239
20200114,G,퇴계원,4032,3663,20200117,7695
20200114,G,별내,2815,2743,20200117,5558
20200114,G,갈매,3040,2637,20200117,5677
20200114,G,신내,1550,1505,20200117,3055
20200115,G,신내,1491,1503,20200118,2994
20200115,G,갈매,3193,2717,20200118,5910
20200115,G,별내,2767,2675,20200118,5442
20200115,G,퇴계원,4106,3711,20200118,7817
20200115,G,사릉,3733,3515,20200118,7248
20200115,G,금곡,1662,1542,20200118,3204
20200115,G,평내호평,6424,6195,20200118,12619
20200115,G,천마산,1656,1525,20200118,3181
20200115,G,마석,4104,3983,20200118,8087
20200115,G,대성리,550,512,20200118,1062
20200115,G,청평,1982,1845,20200118,3827
20200115,G,상천,208,220,20200118,428
20200115,G,가평,1887,1871,20200118,3758
20200115,G,굴봉산,142,145,20200118,287
20200115,G,백양리,271,290,20200118,561
20200115,G,강촌,335,291,20200118,626
20200115,G,김유정,310,338,20200118,648
20200115,G,남춘천,2682,2494,20200118,5176
20200115,G,춘천,1399,1260,20200118,2659
20200116,G,춘천,1548,1371,20200119,2919
20200116,G,남춘천,2562,2681,20200119,5243
20200116,G,김유정,309,319,20200119,628
20200116,G,강촌,336,353,20200119,689
20200116,G,백양리,346,359,20200119,705
20200116,G,굴봉산,102,152,20200119,254
20200116,G,가평,1769,1825,20200119,3594
20200116,G,상천,231,219,20200119,450
20200116,G,청평,2003,1801,20200119,3804
20200116,G,대성리,589,585,20200119,1174
20200116,G,마석,3931,3726,20200119,7657
20200116,G,천마산,1652,1497,20200119,3149
20200116,G,평내호평,6435,6259,20200119,12694
20200116,G,금곡,1709,1626,20200119,3335
20200116,G,사릉,3716,3530,20200119,7246
20200116,G,퇴계원,4079,3737,20200119,7816
20200116,G,별내,2829,2737,20200119,5566
20200116,G,갈매,3094,2556,20200119,5650
20200116,G,신내,1489,1501,20200119,2990
20200117,G,신내,1529,1566,20200120,3095
20200117,G,갈매,3198,2778,20200120,5976
20200117,G,별내,2964,2931,20200120,5895
20200117,G,퇴계원,4281,3834,20200120,8115
20200117,G,사릉,3792,3445,20200120,7237
20200117,G,금곡,1769,1662,20200120,3431
20200117,G,평내호평,6697,6518,20200120,13215
20200117,G,천마산,1780,1608,20200120,3388
20200117,G,마석,4194,4006,20200120,8200
20200117,G,대성리,612,606,20200120,1218
20200117,G,청평,2163,2061,20200120,4224
20200117,G,상천,260,234,20200120,494
20200117,G,가평,1921,2239,20200120,4160
20200117,G,굴봉산,127,150,20200120,277
20200117,G,백양리,331,284,20200120,615
20200117,G,강촌,375,318,20200120,693
20200117,G,김유정,381,370,20200120,751
20200117,G,남춘천,3643,3599,20200120,7242
20200117,G,춘천,1748,1538,20200120,3286
20200118,G,신내,1180,1238,20200121,2418
20200118,G,갈매,1936,1750,20200121,3686
20200118,G,별내,2246,2138,20200121,4384
20200118,G,퇴계원,3109,2802,20200121,5911
20200118,G,사릉,2724,2515,20200121,5239
20200118,G,금곡,1273,1185,20200121,2458
20200118,G,평내호평,5093,4911,20200121,10004
20200118,G,천마산,1486,1344,20200121,2830
20200118,G,마석,3805,3622,20200121,7427
20200118,G,대성리,630,790,20200121,1420
20200118,G,청평,1937,2044,20200121,3981
20200118,G,상천,282,341,20200121,623
20200118,G,가평,2021,2097,20200121,4118
20200118,G,굴봉산,161,229,20200121,390
20200118,G,백양리,368,356,20200121,724
20200118,G,강촌,474,614,20200121,1088
20200118,G,김유정,448,485,20200121,933
20200118,G,남춘천,3042,3136,20200121,6178
20200118,G,춘천,1858,1606,20200121,3464
20200119,G,신내,811,849,20200122,1660
20200119,G,갈매,1476,1279,20200122,2755
20200119,G,별내,1759,1679,20200122,3438
20200119,G,퇴계원,2200,2079,20200122,4279
20200119,G,사릉,1779,1771,20200122,3550
20200119,G,금곡,877,872,20200122,1749
20200119,G,평내호평,3430,3269,20200122,6699
20200119,G,천마산,1151,1023,20200122,2174
20200119,G,마석,2422,2421,20200122,4843
20200119,G,대성리,764,433,20200122,1197
20200119,G,청평,1980,1580,20200122,3560
20200119,G,상천,379,257,20200122,636
20200119,G,가평,1668,1575,20200122,3243
20200119,G,굴봉산,178,127,20200122,305
20200119,G,백양리,321,235,20200122,556
20200119,G,강촌,547,452,20200122,999
20200119,G,김유정,351,377,20200122,728
20200119,G,남춘천,2616,2612,20200122,5228
20200119,G,춘천,1564,1425,20200122,2989
20200120,G,춘천,1375,1298,20200123,2673
20200120,G,남춘천,2592,2631,20200123,5223
20200120,G,김유정,354,350,20200123,704
20200120,G,강촌,344,375,20200123,719
20200120,G,백양리,295,317,20200123,612
20200120,G,굴봉산,131,197,20200123,328
20200120,G,가평,1843,1938,20200123,3781
20200120,G,상천,267,251,20200123,518
20200120,G,청평,2012,1905,20200123,3917
20200120,G,대성리,592,501,20200123,1093
20200120,G,마석,3979,3856,20200123,7835
20200120,G,천마산,1765,1516,20200123,3281
20200120,G,평내호평,6640,6392,20200123,13032
20200120,G,금곡,1719,1568,20200123,3287
20200120,G,사릉,3751,3436,20200123,7187
20200120,G,퇴계원,4077,3680,20200123,7757
20200120,G,별내,2888,2769,20200123,5657
20200120,G,갈매,3162,2642,20200123,5804
20200120,G,신내,1416,1458,20200123,2874
20200121,G,신내,1452,1535,20200124,2987
20200121,G,갈매,3067,2552,20200124,5619
20200121,G,별내,2791,2765,20200124,5556
20200121,G,퇴계원,3996,3738,20200124,7734
20200121,G,사릉,3633,3443,20200124,7076
20200121,G,금곡,1687,1574,20200124,3261
20200121,G,평내호평,6534,6263,20200124,12797
20200121,G,천마산,1683,1530,20200124,3213
20200121,G,마석,3890,3760,20200124,7650
20200121,G,대성리,602,491,20200124,1093
20200121,G,청평,2023,1763,20200124,3786
20200121,G,상천,238,206,20200124,444
20200121,G,가평,1820,1735,20200124,3555
20200121,G,굴봉산,163,164,20200124,327
20200121,G,백양리,346,259,20200124,605
20200121,G,강촌,353,286,20200124,639
20200121,G,김유정,284,303,20200124,587
20200121,G,남춘천,2498,2519,20200124,5017
20200121,G,춘천,1440,1318,20200124,2758
20200122,G,신내,1431,1424,20200125,2855
20200122,G,갈매,3085,2563,20200125,5648
20200122,G,별내,2730,2685,20200125,5415
20200122,G,퇴계원,4064,3646,20200125,7710
20200122,G,사릉,3621,3410,20200125,7031
20200122,G,금곡,1650,1517,20200125,3167
20200122,G,평내호평,6439,6173,20200125,12612
20200122,G,천마산,1687,1548,20200125,3235
20200122,G,마석,3847,3708,20200125,7555
20200122,G,대성리,514,446,20200125,960
20200122,G,청평,1936,1868,20200125,3804
20200122,G,상천,257,235,20200125,492
20200122,G,가평,1830,1809,20200125,3639
20200122,G,굴봉산,136,121,20200125,257
20200122,G,백양리,324,269,20200125,593
20200122,G,강촌,316,321,20200125,637
20200122,G,김유정,297,293,20200125,590
20200122,G,남춘천,2900,2941,20200125,5841
20200122,G,춘천,1285,1113,20200125,2398
20200123,G,신내,1325,1252,20200126,2577
20200123,G,갈매,2852,2389,20200126,5241
20200123,G,별내,2719,2632,20200126,5351
20200123,G,퇴계원,3816,3481,20200126,7297
20200123,G,사릉,3448,3221,20200126,6669
20200123,G,금곡,1620,1483,20200126,3103
20200123,G,평내호평,6102,5967,20200126,12069
20200123,G,천마산,1572,1394,20200126,2966
20200123,G,마석,4090,4113,20200126,8203
20200123,G,대성리,442,395,20200126,837
20200123,G,청평,1906,1915,20200126,3821
20200123,G,상천,248,245,20200126,493
20200123,G,가평,1570,1809,20200126,3379
20200123,G,굴봉산,102,124,20200126,226
20200123,G,백양리,251,226,20200126,477
20200123,G,강촌,280,277,20200126,557
20200123,G,김유정,244,327,20200126,571
20200123,G,남춘천,2719,3000,20200126,5719
20200123,G,춘천,1536,1404,20200126,2940
20200124,G,춘천,1344,1617,20200127,2961
20200124,G,남춘천,2033,2781,20200127,4814
20200124,G,김유정,226,383,20200127,609
20200124,G,강촌,252,343,20200127,595
20200124,G,백양리,313,293,20200127,606
20200124,G,굴봉산,105,162,20200127,267
20200124,G,가평,1384,1999,20200127,3383
20200124,G,상천,150,224,20200127,374
20200124,G,청평,1288,1592,20200127,2880
20200124,G,대성리,318,354,20200127,672
20200124,G,마석,2212,2371,20200127,4583
20200124,G,천마산,918,991,20200127,1909
20200124,G,평내호평,2658,2910,20200127,5568
20200124,G,금곡,725,713,20200127,1438
20200124,G,사릉,1598,1719,20200127,3317
20200124,G,퇴계원,1771,1774,20200127,3545
20200124,G,별내,1313,1199,20200127,2512
20200124,G,갈매,1082,955,20200127,2037
20200124,G,신내,618,603,20200127,1221
20200125,G,신내,685,674,20200128,1359
20200125,G,갈매,932,855,20200128,1787
20200125,G,별내,1219,1077,20200128,2296
20200125,G,퇴계원,1794,1605,20200128,3399
20200125,G,사릉,1685,1591,20200128,3276
20200125,G,금곡,816,738,20200128,1554
20200125,G,평내호평,2641,2531,20200128,5172
20200125,G,천마산,975,978,20200128,1953
20200125,G,마석,2489,2474,20200128,4963
20200125,G,대성리,440,351,20200128,791
20200125,G,청평,1672,1562,20200128,3234
20200125,G,상천,207,218,20200128,425
20200125,G,가평,2026,1984,20200128,4010
20200125,G,굴봉산,141,123,20200128,264
20200125,G,백양리,467,428,20200128,895
20200125,G,강촌,475,407,20200128,882
20200125,G,김유정,317,324,20200128,641
20200125,G,남춘천,2357,2501,20200128,4858
20200125,G,춘천,2087,1607,20200128,3694
20200126,G,신내,759,767,20200129,1526
20200126,G,갈매,1302,1129,20200129,2431
20200126,G,별내,1396,1326,20200129,2722
20200126,G,퇴계원,2026,1789,20200129,3815
20200126,G,사릉,1758,1728,20200129,3486
20200126,G,금곡,931,755,20200129,1686
20200126,G,평내호평,3316,3075,20200129,6391
20200126,G,천마산,1236,1043,20200129,2279
20200126,G,마석,2546,2464,20200129,5010
20200126,G,대성리,437,386,20200129,823
20200126,G,청평,1899,1605,20200129,3504
20200126,G,상천,316,211,20200129,527
20200126,G,가평,2052,1799,20200129,3851
20200126,G,굴봉산,153,167,20200129,320
20200126,G,백양리,381,363,20200129,744
20200126,G,강촌,596,486,20200129,1082
20200126,G,김유정,445,473,20200129,918
20200126,G,남춘천,2420,2430,20200129,4850
20200126,G,춘천,2201,1625,20200129,3826
20200127,G,신내,724,702,20200130,1426
20200127,G,갈매,1211,1103,20200130,2314
20200127,G,별내,1374,1366,20200130,2740
20200127,G,퇴계원,1965,1796,20200130,3761
20200127,G,사릉,1798,1751,20200130,3549
20200127,G,금곡,872,809,20200130,1681
20200127,G,평내호평,3287,3127,20200130,6414
20200127,G,천마산,989,928,20200130,1917
20200127,G,마석,2306,2253,20200130,4559
20200127,G,대성리,356,330,20200130,686
20200127,G,청평,1520,1257,20200130,2777
20200127,G,상천,260,170,20200130,430
20200127,G,가평,1742,1496,20200130,3238
20200127,G,굴봉산,129,161,20200130,290
20200127,G,백양리,319,292,20200130,611
20200127,G,강촌,557,421,20200130,978
20200127,G,김유정,370,390,20200130,760
20200127,G,남춘천,2768,2706,20200130,5474
20200127,G,춘천,2040,1444,20200130,3484
20200128,G,신내,1251,1302,20200131,2553
20200128,G,갈매,2718,2403,20200131,5121
20200128,G,별내,2506,2487,20200131,4993
20200128,G,퇴계원,3724,3383,20200131,7107
20200128,G,사릉,3453,3221,20200131,6674
20200128,G,금곡,1560,1458,20200131,3018
20200128,G,평내호평,5963,5862,20200131,11825
20200128,G,천마산,1589,1478,20200131,3067
20200128,G,마석,3951,3758,20200131,7709
20200128,G,대성리,470,437,20200131,907
20200128,G,청평,1870,1746,20200131,3616
20200128,G,상천,235,242,20200131,477
20200128,G,가평,1693,1753,20200131,3446
20200128,G,굴봉산,110,115,20200131,225
20200128,G,백양리,260,280,20200131,540
20200128,G,강촌,307,310,20200131,617
20200128,G,김유정,251,260,20200131,511
20200128,G,남춘천,2324,2548,20200131,4872
20200128,G,춘천,1385,1284,20200131,2669
20200129,G,신내,1303,1425,20200201,2728
20200129,G,갈매,2922,2495,20200201,5417
20200129,G,별내,2709,2677,20200201,5386
20200129,G,퇴계원,3786,3509,20200201,7295
20200129,G,사릉,3493,3355,20200201,6848
20200129,G,금곡,1593,1519,20200201,3112
20200129,G,평내호평,6250,6153,20200201,12403
20200129,G,천마산,1606,1504,20200201,3110
20200129,G,마석,3953,3816,20200201,7769
20200129,G,대성리,526,588,20200201,1114
20200129,G,청평,1864,1871,20200201,3735
20200129,G,상천,217,223,20200201,440
20200129,G,가평,1678,1661,20200201,3339
20200129,G,굴봉산,117,160,20200201,277
20200129,G,백양리,285,216,20200201,501
20200129,G,강촌,302,276,20200201,578
20200129,G,김유정,278,280,20200201,558
20200129,G,남춘천,2184,2214,20200201,4398
20200129,G,춘천,1293,1233,20200201,2526
20200130,G,춘천,1285,1170,20200202,2455
20200130,G,남춘천,2252,2382,20200202,4634
20200130,G,김유정,317,315,20200202,632
20200130,G,강촌,348,332,20200202,680
20200130,G,백양리,271,243,20200202,514
20200130,G,굴봉산,130,136,20200202,266
20200130,G,가평,1668,1738,20200202,3406
20200130,G,상천,266,237,20200202,503
20200130,G,청평,1853,1672,20200202,3525
20200130,G,대성리,599,545,20200202,1144
20200130,G,마석,3837,3736,20200202,7573
20200130,G,천마산,1622,1512,20200202,3134
20200130,G,평내호평,6196,6098,20200202,12294
20200130,G,금곡,1608,1544,20200202,3152
20200130,G,사릉,3531,3417,20200202,6948
20200130,G,퇴계원,3880,3621,20200202,7501
20200130,G,별내,2730,2628,20200202,5358
20200130,G,갈매,2964,2607,20200202,5571
20200130,G,신내,1358,1462,20200202,2820
20200131,G,신내,1304,1426,20200203,2730
20200131,G,갈매,3013,2587,20200203,5600
20200131,G,별내,2704,2719,20200203,5423
20200131,G,퇴계원,3876,3567,20200203,7443
20200131,G,사릉,3668,3393,20200203,7061
20200131,G,금곡,1679,1554,20200203,3233
20200131,G,평내호평,6265,6157,20200203,12422
20200131,G,천마산,1605,1475,20200203,3080
20200131,G,마석,3871,3718,20200203,7589
20200131,G,대성리,562,968,20200203,1530
20200131,G,청평,1874,2003,20200203,3877
20200131,G,상천,223,231,20200203,454
20200131,G,가평,1900,1917,20200203,3817
20200131,G,굴봉산,113,154,20200203,267
20200131,G,백양리,315,286,20200203,601
20200131,G,강촌,315,308,20200203,623
20200131,G,김유정,312,323,20200203,635
20200131,G,남춘천,2763,2645,20200203,5408
20200131,G,춘천,1513,1221,20200203,2734
20200201,G,신내,856,896,20200204,1752
20200201,G,갈매,1618,1434,20200204,3052
20200201,G,별내,1905,1907,20200204,3812
20200201,G,퇴계원,2496,2299,20200204,4795
20200201,G,사릉,2190,2152,20200204,4342
20200201,G,금곡,957,907,20200204,1864
20200201,G,평내호평,4128,4026,20200204,8154
20200201,G,천마산,1181,1143,20200204,2324
20200201,G,마석,2732,2653,20200204,5385
20200201,G,대성리,786,903,20200204,1689
20200201,G,청평,1644,1666,20200204,3310
20200201,G,상천,255,260,20200204,515
20200201,G,가평,1628,1724,20200204,3352
20200201,G,굴봉산,132,190,20200204,322
20200201,G,백양리,341,286,20200204,627
20200201,G,강촌,421,507,20200204,928
20200201,G,김유정,390,426,20200204,816
20200201,G,남춘천,2286,2404,20200204,4690
20200201,G,춘천,1282,1189,20200204,2471
20200202,G,신내,629,728,20200205,1357
20200202,G,갈매,1207,1115,20200205,2322
20200202,G,별내,1490,1414,20200205,2904
20200202,G,퇴계원,1825,1744,20200205,3569
20200202,G,사릉,1558,1523,20200205,3081
20200202,G,금곡,743,776,20200205,1519
20200202,G,평내호평,2968,2935,20200205,5903
20200202,G,천마산,906,960,20200205,1866
20200202,G,마석,2192,2178,20200205,4370
20200202,G,대성리,977,370,20200205,1347
20200202,G,청평,1610,1313,20200205,2923
20200202,G,상천,343,277,20200205,620
20200202,G,가평,1548,1343,20200205,2891
20200202,G,굴봉산,140,135,20200205,275
20200202,G,백양리,208,201,20200205,409
20200202,G,강촌,545,426,20200205,971
20200202,G,김유정,362,368,20200205,730
20200202,G,남춘천,2271,2444,20200205,4715
20200202,G,춘천,1217,1052,20200205,2269
20200203,G,신내,1333,1423,20200206,2756
20200203,G,갈매,3041,2503,20200206,5544
20200203,G,별내,2684,2547,20200206,5231
20200203,G,퇴계원,3758,3485,20200206,7243
20200203,G,사릉,3442,3326,20200206,6768
20200203,G,금곡,1584,1471,20200206,3055
20200203,G,평내호평,5983,5821,20200206,11804
20200203,G,천마산,1560,1391,20200206,2951
20200203,G,마석,3809,3765,20200206,7574
20200203,G,대성리,481,550,20200206,1031
20200203,G,청평,1645,1583,20200206,3228
20200203,G,상천,209,200,20200206,409
20200203,G,가평,1598,1652,20200206,3250
20200203,G,굴봉산,93,113,20200206,206
20200203,G,백양리,201,220,20200206,421
20200203,G,강촌,292,267,20200206,559
20200203,G,김유정,253,251,20200206,504
20200203,G,남춘천,2248,2227,20200206,4475
20200203,G,춘천,1203,1133,20200206,2336
20200204,G,신내,1338,1370,20200207,2708
20200204,G,갈매,2905,2482,20200207,5387
20200204,G,별내,2556,2480,20200207,5036
20200204,G,퇴계원,3650,3443,20200207,7093
20200204,G,사릉,3353,3249,20200207,6602
20200204,G,금곡,1553,1429,20200207,2982
20200204,G,평내호평,5813,5816,20200207,11629
20200204,G,천마산,1549,1375,20200207,2924
20200204,G,마석,3589,3560,20200207,7149
20200204,G,대성리,584,363,20200207,947
20200204,G,청평,1656,1484,20200207,3140
20200204,G,상천,189,195,20200207,384
20200204,G,가평,1625,1639,20200207,3264
20200204,G,굴봉산,120,131,20200207,251
20200204,G,백양리,260,210,20200207,470
20200204,G,강촌,316,283,20200207,599
20200204,G,김유정,262,270,20200207,532
20200204,G,남춘천,2094,2160,20200207,4254
20200204,G,춘천,1113,968,20200207,2081
20200205,G,신내,1223,1302,20200208,2525
20200205,G,갈매,2823,2378,20200208,5201
20200205,G,별내,2408,2419,20200208,4827
20200205,G,퇴계원,3403,3199,20200208,6602
20200205,G,사릉,3207,3057,20200208,6264
20200205,G,금곡,1396,1305,20200208,2701
20200205,G,평내호평,5528,5468,20200208,10996
20200205,G,천마산,1378,1234,20200208,2612
20200205,G,마석,3367,3251,20200208,6618
20200205,G,대성리,391,375,20200208,766
20200205,G,청평,1510,1478,20200208,2988
20200205,G,상천,175,153,20200208,328
20200205,G,가평,1425,1510,20200208,2935
20200205,G,굴봉산,104,96,20200208,200
20200205,G,백양리,239,211,20200208,450
20200205,G,강촌,246,244,20200208,490
20200205,G,김유정,231,205,20200208,436
20200205,G,남춘천,1889,1977,20200208,3866
20200205,G,춘천,1024,897,20200208,1921
20200206,G,신내,1296,1337,20200209,2633
20200206,G,갈매,2626,2208,20200209,4834
20200206,G,별내,2378,2316,20200209,4694
20200206,G,퇴계원,3394,3137,20200209,6531
20200206,G,사릉,3120,2940,20200209,6060
20200206,G,금곡,1366,1308,20200209,2674
20200206,G,평내호평,5319,5314,20200209,10633
20200206,G,천마산,1301,1208,20200209,2509
20200206,G,마석,3259,3226,20200209,6485
20200206,G,대성리,372,471,20200209,843
20200206,G,청평,1426,1369,20200209,2795
20200206,G,상천,153,140,20200209,293
20200206,G,가평,1456,1568,20200209,3024
20200206,G,굴봉산,71,75,20200209,146
20200206,G,백양리,226,202,20200209,428
20200206,G,강촌,269,282,20200209,551
20200206,G,김유정,205,207,20200209,412
20200206,G,남춘천,1828,1913,20200209,3741
20200206,G,춘천,968,891,20200209,1859
20200207,G,신내,1337,1374,20200210,2711
20200207,G,갈매,2761,2326,20200210,5087
20200207,G,별내,2545,2499,20200210,5044
20200207,G,퇴계원,3532,3266,20200210,6798
20200207,G,사릉,3266,3100,20200210,6366
20200207,G,금곡,1484,1401,20200210,2885
20200207,G,평내호평,5656,5544,20200210,11200
20200207,G,천마산,1466,1281,20200210,2747
20200207,G,마석,3478,3467,20200210,6945
20200207,G,대성리,555,625,20200210,1180
20200207,G,청평,1648,1678,20200210,3326
20200207,G,상천,184,214,20200210,398
20200207,G,가평,1627,1666,20200210,3293
20200207,G,굴봉산,88,93,20200210,181
20200207,G,백양리,172,223,20200210,395
20200207,G,강촌,305,302,20200210,607
20200207,G,김유정,241,263,20200210,504
20200207,G,남춘천,2510,2545,20200210,5055
20200207,G,춘천,1187,1078,20200210,2265
20200208,G,신내,875,920,20200211,1795
20200208,G,갈매,1563,1395,20200211,2958
20200208,G,별내,1873,1795,20200211,3668
20200208,G,퇴계원,2249,2125,20200211,4374
20200208,G,사릉,2058,1895,20200211,3953
20200208,G,금곡,977,890,20200211,1867
20200208,G,평내호평,3769,3802,20200211,7571
20200208,G,천마산,1140,1066,20200211,2206
20200208,G,마석,2726,2699,20200211,5425
20200208,G,대성리,568,618,20200211,1186
20200208,G,청평,1580,1474,20200211,3054
20200208,G,상천,241,197,20200211,438
20200208,G,가평,1376,1478,20200211,2854
20200208,G,굴봉산,96,195,20200211,291
20200208,G,백양리,287,246,20200211,533
20200208,G,강촌,355,435,20200211,790
20200208,G,김유정,384,407,20200211,791
20200208,G,남춘천,2251,2246,20200211,4497
20200208,G,춘천,1253,1167,20200211,2420
20200209,G,신내,684,719,20200212,1403
20200209,G,갈매,1159,1058,20200212,2217
20200209,G,별내,1494,1391,20200212,2885
20200209,G,퇴계원,1780,1618,20200212,3398
20200209,G,사릉,1459,1467,20200212,2926
20200209,G,금곡,715,705,20200212,1420
20200209,G,평내호평,2783,2815,20200212,5598
20200209,G,천마산,946,956,20200212,1902
20200209,G,마석,1968,2005,20200212,3973
20200209,G,대성리,655,344,20200212,999
20200209,G,청평,1463,1190,20200212,2653
20200209,G,상천,300,188,20200212,488
20200209,G,가평,1309,1258,20200212,2567
20200209,G,굴봉산,169,128,20200212,297
20200209,G,백양리,243,214,20200212,457
20200209,G,강촌,542,389,20200212,931
20200209,G,김유정,293,344,20200212,637
20200209,G,남춘천,1842,2010,20200212,3852
20200209,G,춘천,1231,1092,20200212,2323
20200210,G,신내,1252,1333,20200213,2585
20200210,G,갈매,2861,2401,20200213,5262
20200210,G,별내,2558,2473,20200213,5031
20200210,G,퇴계원,3724,3406,20200213,7130
20200210,G,사릉,3382,3249,20200213,6631
20200210,G,금곡,1541,1434,20200213,2975
20200210,G,평내호평,6068,5879,20200213,11947
20200210,G,천마산,1514,1415,20200213,2929
20200210,G,마석,3480,3477,20200213,6957
20200210,G,대성리,465,423,20200213,888
20200210,G,청평,1657,1611,20200213,3268
20200210,G,상천,224,209,20200213,433
20200210,G,가평,1636,1772,20200213,3408
20200210,G,굴봉산,123,138,20200213,261
20200210,G,백양리,210,184,20200213,394
20200210,G,강촌,262,270,20200213,532
20200210,G,김유정,260,276,20200213,536
20200210,G,남춘천,2228,2271,20200213,4499
20200210,G,춘천,1259,1138,20200213,2397
20200211,G,신내,1315,1318,20200214,2633
20200211,G,갈매,2893,2545,20200214,5438
20200211,G,별내,2560,2518,20200214,5078
20200211,G,퇴계원,3686,3477,20200214,7163
20200211,G,사릉,3398,3230,20200214,6628
20200211,G,금곡,1600,1504,20200214,3104
20200211,G,평내호평,5967,6035,20200214,12002
20200211,G,천마산,1537,1381,20200214,2918
20200211,G,마석,3625,3534,20200214,7159
20200211,G,대성리,506,449,20200214,955
20200211,G,청평,1738,1577,20200214,3315
20200211,G,상천,208,201,20200214,409
20200211,G,가평,1752,1695,20200214,3447
20200211,G,굴봉산,133,157,20200214,290
20200211,G,백양리,255,205,20200214,460
20200211,G,강촌,346,348,20200214,694
20200211,G,김유정,342,350,20200214,692
20200211,G,남춘천,2289,2413,20200214,4702
20200211,G,춘천,1304,1186,20200214,2490
20200212,G,신내,1237,1228,20200215,2465
20200212,G,갈매,2811,2352,20200215,5163
20200212,G,별내,2266,2256,20200215,4522
20200212,G,퇴계원,3542,3343,20200215,6885
20200212,G,사릉,3295,2976,20200215,6271
20200212,G,금곡,1436,1397,20200215,2833
20200212,G,평내호평,5479,5394,20200215,10873
20200212,G,천마산,1372,1299,20200215,2671
20200212,G,마석,3415,3264,20200215,6679
20200212,G,대성리,423,412,20200215,835
20200212,G,청평,1613,1522,20200215,3135
20200212,G,상천,145,138,20200215,283
20200212,G,가평,1543,1502,20200215,3045
20200212,G,굴봉산,114,123,20200215,237
20200212,G,백양리,208,180,20200215,388
20200212,G,강촌,284,281,20200215,565
20200212,G,김유정,226,226,20200215,452
20200212,G,남춘천,2222,2347,20200215,4569
20200212,G,춘천,1125,1038,20200215,2163
20200213,G,신내,1485,1437,20200216,2922
20200213,G,갈매,2950,2535,20200216,5485
20200213,G,별내,2745,2635,20200216,5380
20200213,G,퇴계원,3749,3437,20200216,7186
20200213,G,사릉,3438,3209,20200216,6647
20200213,G,금곡,1590,1557,20200216,3147
20200213,G,평내호평,6070,6008,20200216,12078
20200213,G,천마산,1575,1453,20200216,3028
20200213,G,마석,3918,3799,20200216,7717
20200213,G,대성리,500,473,20200216,973
20200213,G,청평,1801,1799,20200216,3600
20200213,G,상천,241,234,20200216,475
20200213,G,가평,1641,1710,20200216,3351
20200213,G,굴봉산,90,106,20200216,196
20200213,G,백양리,214,211,20200216,425
20200213,G,강촌,388,385,20200216,773
20200213,G,김유정,283,292,20200216,575
20200213,G,남춘천,2325,2286,20200216,4611
20200213,G,춘천,1296,1149,20200216,2445
20200214,G,신내,1434,1412,20200217,2846
20200214,G,갈매,3063,2557,20200217,5620
20200214,G,별내,2761,2755,20200217,5516
20200214,G,퇴계원,3948,3564,20200217,7512
20200214,G,사릉,3636,3346,20200217,6982
20200214,G,금곡,1629,1603,20200217,3232
20200214,G,평내호평,6368,6250,20200217,12618
20200214,G,천마산,1659,1437,20200217,3096
20200214,G,마석,3901,3753,20200217,7654
20200214,G,대성리,594,492,20200217,1086
20200214,G,청평,1975,1893,20200217,3868
20200214,G,상천,245,248,20200217,493
20200214,G,가평,1912,1906,20200217,3818
20200214,G,굴봉산,136,149,20200217,285
20200214,G,백양리,196,270,20200217,466
20200214,G,강촌,387,385,20200217,772
20200214,G,김유정,371,398,20200217,769
20200214,G,남춘천,2657,2756,20200217,5413
20200214,G,춘천,1483,1319,20200217,2802
20200215,G,신내,958,1057,20200218,2015
20200215,G,갈매,1803,1572,20200218,3375
20200215,G,별내,1981,1947,20200218,3928
20200215,G,퇴계원,2650,2409,20200218,5059
20200215,G,사릉,2378,2240,20200218,4618
20200215,G,금곡,1082,1014,20200218,2096
20200215,G,평내호평,4304,4250,20200218,8554
20200215,G,천마산,1298,1290,20200218,2588
20200215,G,마석,2988,2849,20200218,5837
20200215,G,대성리,550,626,20200218,1176
20200215,G,청평,1662,1644,20200218,3306
20200215,G,상천,274,262,20200218,536
20200215,G,가평,1615,1714,20200218,3329
20200215,G,굴봉산,172,208,20200218,380
20200215,G,백양리,285,244,20200218,529
20200215,G,강촌,525,531,20200218,1056
20200215,G,김유정,387,434,20200218,821
20200215,G,남춘천,2504,2732,20200218,5236
20200215,G,춘천,1569,1457,20200218,3026
20200216,G,신내,698,732,20200219,1430
20200216,G,갈매,1168,1099,20200219,2267
20200216,G,별내,1402,1401,20200219,2803
20200216,G,퇴계원,1901,1801,20200219,3702
20200216,G,사릉,1603,1675,20200219,3278
20200216,G,금곡,711,715,20200219,1426
20200216,G,평내호평,3058,2914,20200219,5972
20200216,G,천마산,913,830,20200219,1743
20200216,G,마석,2025,2138,20200219,4163
20200216,G,대성리,564,365,20200219,929
20200216,G,청평,1477,1270,20200219,2747
20200216,G,상천,277,214,20200219,491
20200216,G,가평,1430,1289,20200219,2719
20200216,G,굴봉산,141,116,20200219,257
20200216,G,백양리,281,227,20200219,508
20200216,G,강촌,448,341,20200219,789
20200216,G,김유정,300,272,20200219,572
20200216,G,남춘천,2019,2228,20200219,4247
20200216,G,춘천,1424,1217,20200219,2641
20200217,G,신내,1359,1355,20200220,2714
20200217,G,갈매,2883,2456,20200220,5339
20200217,G,별내,2611,2436,20200220,5047
20200217,G,퇴계원,3837,3512,20200220,7349
20200217,G,사릉,3451,3222,20200220,6673
20200217,G,금곡,1581,1543,20200220,3124
20200217,G,평내호평,6108,5968,20200220,12076
20200217,G,천마산,1525,1334,20200220,2859
20200217,G,마석,3600,3433,20200220,7033
20200217,G,대성리,425,493,20200220,918
20200217,G,청평,1714,1657,20200220,3371
20200217,G,상천,220,217,20200220,437
20200217,G,가평,1707,1868,20200220,3575
20200217,G,굴봉산,143,143,20200220,286
20200217,G,백양리,219,209,20200220,428
20200217,G,강촌,323,303,20200220,626
20200217,G,김유정,232,259,20200220,491
20200217,G,남춘천,2663,2787,20200220,5450
20200217,G,춘천,1357,1292,20200220,2649
20200218,G,신내,1287,1292,20200221,2579
20200218,G,갈매,2830,2439,20200221,5269
20200218,G,별내,2514,2544,20200221,5058
20200218,G,퇴계원,3698,3347,20200221,7045
20200218,G,사릉,3362,3195,20200221,6557
20200218,G,금곡,1571,1488,20200221,3059
20200218,G,평내호평,5985,5864,20200221,11849
20200218,G,천마산,1467,1347,20200221,2814
20200218,G,마석,3686,3644,20200221,7330
20200218,G,대성리,541,412,20200221,953
20200218,G,청평,1758,1567,20200221,3325
20200218,G,상천,211,191,20200221,402
20200218,G,가평,1659,1619,20200221,3278
20200218,G,굴봉산,105,118,20200221,223
20200218,G,백양리,209,154,20200221,363
20200218,G,강촌,301,294,20200221,595
20200218,G,김유정,300,333,20200221,633
20200218,G,남춘천,2260,2258,20200221,4518
20200218,G,춘천,1250,1097,20200221,2347
20200219,G,신내,1387,1369,20200222,2756
20200219,G,갈매,2966,2560,20200222,5526
20200219,G,별내,2521,2485,20200222,5006
20200219,G,퇴계원,3690,3512,20200222,7202
20200219,G,사릉,3527,3294,20200222,6821
20200219,G,금곡,1489,1429,20200222,2918
20200219,G,평내호평,6043,5968,20200222,12011
20200219,G,천마산,1567,1401,20200222,2968
20200219,G,마석,3679,3630,20200222,7309
20200219,G,대성리,488,447,20200222,935
20200219,G,청평,1692,1638,20200222,3330
20200219,G,상천,221,221,20200222,442
20200219,G,가평,1768,1737,20200222,3505
20200219,G,굴봉산,104,138,20200222,242
20200219,G,백양리,216,178,20200222,394
20200219,G,강촌,355,333,20200222,688
20200219,G,김유정,364,372,20200222,736
20200219,G,남춘천,2232,2354,20200222,4586
20200219,G,춘천,1260,1132,20200222,2392
20200220,G,신내,1305,1348,20200223,2653
20200220,G,갈매,2895,2453,20200223,5348
20200220,G,별내,2588,2465,20200223,5053
20200220,G,퇴계원,3703,3443,20200223,7146
20200220,G,사릉,3344,3215,20200223,6559
20200220,G,금곡,1522,1449,20200223,2971
20200220,G,평내호평,5942,5739,20200223,11681
20200220,G,천마산,1501,1397,20200223,2898
20200220,G,마석,3522,3381,20200223,6903
20200220,G,대성리,486,461,20200223,947
20200220,G,청평,1658,1517,20200223,3175
20200220,G,상천,219,207,20200223,426
20200220,G,가평,1685,1750,20200223,3435
20200220,G,굴봉산,124,114,20200223,238
20200220,G,백양리,222,227,20200223,449
20200220,G,강촌,391,364,20200223,755
20200220,G,김유정,281,315,20200223,596
20200220,G,남춘천,2255,2291,20200223,4546
20200220,G,춘천,1198,1145,20200223,2343
20200221,G,신내,1282,1298,20200224,2580
20200221,G,갈매,2919,2451,20200224,5370
20200221,G,별내,2427,2338,20200224,4765
20200221,G,퇴계원,3662,3286,20200224,6948
20200221,G,사릉,3285,3088,20200224,6373
20200221,G,금곡,1535,1375,20200224,2910
20200221,G,평내호평,5575,5557,20200224,11132
20200221,G,천마산,1463,1328,20200224,2791
20200221,G,마석,3396,3258,20200224,6654
20200221,G,대성리,497,666,20200224,1163
20200221,G,청평,1592,1593,20200224,3185
20200221,G,상천,201,203,20200224,404
20200221,G,가평,1621,1583,20200224,3204
20200221,G,굴봉산,101,106,20200224,207
20200221,G,백양리,200,174,20200224,374
20200221,G,강촌,269,308,20200224,577
20200221,G,김유정,219,253,20200224,472
20200221,G,남춘천,2355,2441,20200224,4796
20200221,G,춘천,1216,1085,20200224,2301
20200222,G,신내,795,787,20200225,1582
20200222,G,갈매,1445,1276,20200225,2721
20200222,G,별내,1534,1548,20200225,3082
20200222,G,퇴계원,2184,2015,20200225,4199
20200222,G,사릉,1734,1718,20200225,3452
20200222,G,금곡,879,853,20200225,1732
20200222,G,평내호평,3397,3419,20200225,6816
20200222,G,천마산,1021,953,20200225,1974
20200222,G,마석,2287,2215,20200225,4502
20200222,G,대성리,548,579,20200225,1127
20200222,G,청평,1134,1164,20200225,2298
20200222,G,상천,185,185,20200225,370
20200222,G,가평,1181,1240,20200225,2421
20200222,G,굴봉산,93,113,20200225,206
20200222,G,백양리,190,202,20200225,392
20200222,G,강촌,353,357,20200225,710
20200222,G,김유정,231,245,20200225,476
20200222,G,남춘천,2021,1998,20200225,4019
20200222,G,춘천,935,802,20200225,1737
20200223,G,신내,555,588,20200226,1143
20200223,G,갈매,990,887,20200226,1877
20200223,G,별내,1128,1137,20200226,2265
20200223,G,퇴계원,1519,1369,20200226,2888
20200223,G,사릉,1149,1227,20200226,2376
20200223,G,금곡,616,647,20200226,1263
20200223,G,평내호평,2354,2351,20200226,4705
20200223,G,천마산,726,769,20200226,1495
20200223,G,마석,1691,1827,20200226,3518
20200223,G,대성리,581,342,20200226,923
20200223,G,청평,1110,852,20200226,1962
20200223,G,상천,247,205,20200226,452
20200223,G,가평,1037,939,20200226,1976
20200223,G,굴봉산,74,93,20200226,167
20200223,G,백양리,179,121,20200226,300
20200223,G,강촌,316,279,20200226,595
20200223,G,김유정,207,199,20200226,406
20200223,G,남춘천,1205,1290,20200226,2495
20200223,G,춘천,822,670,20200226,1492
20200224,G,신내,1131,1169,20200227,2300
20200224,G,갈매,2558,2292,20200227,4850
20200224,G,별내,2138,2063,20200227,4201
20200224,G,퇴계원,3222,2997,20200227,6219
20200224,G,사릉,2996,2877,20200227,5873
20200224,G,금곡,1358,1267,20200227,2625
20200224,G,평내호평,4986,4897,20200227,9883
20200224,G,천마산,1307,1222,20200227,2529
20200224,G,마석,2976,2979,20200227,5955
20200224,G,대성리,420,330,20200227,750
20200224,G,청평,1166,1186,20200227,2352
20200224,G,상천,172,168,20200227,340
20200224,G,가평,1250,1227,20200227,2477
20200224,G,굴봉산,79,73,20200227,152
20200224,G,백양리,160,112,20200227,272
20200224,G,강촌,221,203,20200227,424
20200224,G,김유정,174,160,20200227,334
20200224,G,남춘천,1449,1505,20200227,2954
20200224,G,춘천,816,761,20200227,1577
20200225,G,신내,969,1023,20200228,1992
20200225,G,갈매,2299,2019,20200228,4318
20200225,G,별내,1750,1781,20200228,3531
20200225,G,퇴계원,2814,2683,20200228,5497
20200225,G,사릉,2676,2505,20200228,5181
20200225,G,금곡,1168,1074,20200228,2242
20200225,G,평내호평,4268,4258,20200228,8526
20200225,G,천마산,1067,979,20200228,2046
20200225,G,마석,2480,2439,20200228,4919
20200225,G,대성리,322,262,20200228,584
20200225,G,청평,971,873,20200228,1844
20200225,G,상천,117,105,20200228,222
20200225,G,가평,867,944,20200228,1811
20200225,G,굴봉산,50,39,20200228,89
20200225,G,백양리,94,78,20200228,172
20200225,G,강촌,134,146,20200228,280
20200225,G,김유정,87,83,20200228,170
20200225,G,남춘천,1112,1181,20200228,2293
20200225,G,춘천,618,562,20200228,1180
20200226,G,신내,1018,1009,20200229,2027
20200226,G,갈매,2291,2019,20200229,4310
20200226,G,별내,1783,1713,20200229,3496
20200226,G,퇴계원,2794,2609,20200229,5403
20200226,G,사릉,2583,2603,20200229,5186
20200226,G,금곡,1119,1097,20200229,2216
20200226,G,평내호평,4188,4059,20200229,8247
20200226,G,천마산,1055,910,20200229,1965
20200226,G,마석,2392,2390,20200229,4782
20200226,G,대성리,329,280,20200229,609
20200226,G,청평,991,931,20200229,1922
20200226,G,상천,178,164,20200229,342
20200226,G,가평,1128,1075,20200229,2203
20200226,G,굴봉산,55,66,20200229,121
20200226,G,백양리,124,104,20200229,228
20200226,G,강촌,216,217,20200229,433
20200226,G,김유정,157,155,20200229,312
20200226,G,남춘천,1333,1355,20200229,2688
20200226,G,춘천,729,745,20200229,1474
20200227,G,신내,1013,1076,20200301,2089
20200227,G,갈매,2285,1991,20200301,4276
20200227,G,별내,1856,1815,20200301,3671
20200227,G,퇴계원,2736,2523,20200301,5259
20200227,G,사릉,2623,2573,20200301,5196
20200227,G,금곡,1220,1152,20200301,2372
20200227,G,평내호평,4152,4138,20200301,8290
20200227,G,천마산,999,947,20200301,1946
20200227,G,마석,2272,2259,20200301,4531
20200227,G,대성리,283,307,20200301,590
20200227,G,청평,970,907,20200301,1877
20200227,G,상천,194,166,20200301,360
20200227,G,가평,1024,968,20200301,1992
20200227,G,굴봉산,83,91,20200301,174
20200227,G,백양리,101,110,20200301,211
20200227,G,강촌,201,192,20200301,393
20200227,G,김유정,139,134,20200301,273
20200227,G,남춘천,1302,1390,20200301,2692
20200227,G,춘천,691,648,20200301,1339
20200228,G,신내,947,958,20200302,1905
20200228,G,갈매,2225,1929,20200302,4154
20200228,G,별내,1779,1737,20200302,3516
20200228,G,퇴계원,2707,2478,20200302,5185
20200228,G,사릉,2506,2476,20200302,4982
20200228,G,금곡,1185,1111,20200302,2296
20200228,G,평내호평,3993,3934,20200302,7927
20200228,G,천마산,992,855,20200302,1847
20200228,G,마석,2429,2337,20200302,4766
20200228,G,대성리,313,293,20200302,606
20200228,G,청평,833,840,20200302,1673
20200228,G,상천,115,110,20200302,225
20200228,G,가평,950,973,20200302,1923
20200228,G,굴봉산,54,52,20200302,106
20200228,G,백양리,125,100,20200302,225
20200228,G,강촌,199,173,20200302,372
20200228,G,김유정,122,131,20200302,253
20200228,G,남춘천,1250,1379,20200302,2629
20200228,G,춘천,699,625,20200302,1324
20200229,G,신내,535,579,20200303,1114
20200229,G,갈매,1158,1022,20200303,2180
20200229,G,별내,1235,1205,20200303,2440
20200229,G,퇴계원,1521,1461,20200303,2982
20200229,G,사릉,1402,1449,20200303,2851
20200229,G,금곡,750,693,20200303,1443
20200229,G,평내호평,2503,2474,20200303,4977
20200229,G,천마산,690,671,20200303,1361
20200229,G,마석,1493,1534,20200303,3027
20200229,G,대성리,285,332,20200303,617
20200229,G,청평,678,761,20200303,1439
20200229,G,상천,215,154,20200303,369
20200229,G,가평,701,775,20200303,1476
20200229,G,굴봉산,64,73,20200303,137
20200229,G,백양리,113,105,20200303,218
20200229,G,강촌,251,238,20200303,489
20200229,G,김유정,171,188,20200303,359
20200229,G,남춘천,1064,1153,20200303,2217
20200229,G,춘천,629,545,20200303,1174
20200301,G,신내,412,424,20200304,836
20200301,G,갈매,773,705,20200304,1478
20200301,G,별내,823,863,20200304,1686
20200301,G,퇴계원,1152,1012,20200304,2164
20200301,G,사릉,901,901,20200304,1802
20200301,G,금곡,475,479,20200304,954
20200301,G,평내호평,1583,1602,20200304,3185
20200301,G,천마산,515,502,20200304,1017
20200301,G,마석,1040,1078,20200304,2118
20200301,G,대성리,277,204,20200304,481
20200301,G,청평,608,608,20200304,1216
20200301,G,상천,266,208,20200304,474
20200301,G,가평,624,551,20200304,1175
20200301,G,굴봉산,67,91,20200304,158
20200301,G,백양리,86,72,20200304,158
20200301,G,강촌,307,294,20200304,601
20200301,G,김유정,185,177,20200304,362
20200301,G,남춘천,942,971,20200304,1913
20200301,G,춘천,607,540,20200304,1147
20200302,G,신내,1013,1045,20200305,2058
20200302,G,갈매,2291,1966,20200305,4257
20200302,G,별내,1867,1844,20200305,3711
20200302,G,퇴계원,2825,2613,20200305,5438
20200302,G,사릉,2576,2520,20200305,5096
20200302,G,금곡,1202,1140,20200305,2342
20200302,G,평내호평,4109,4043,20200305,8152
20200302,G,천마산,1100,1020,20200305,2120
20200302,G,마석,2514,2469,20200305,4983
20200302,G,대성리,303,322,20200305,625
20200302,G,청평,926,875,20200305,1801
20200302,G,상천,169,180,20200305,349
20200302,G,가평,870,876,20200305,1746
20200302,G,굴봉산,73,76,20200305,149
20200302,G,백양리,60,49,20200305,109
20200302,G,강촌,186,181,20200305,367
20200302,G,김유정,158,160,20200305,318
20200302,G,남춘천,1340,1425,20200305,2765
20200302,G,춘천,745,676,20200305,1421
20200303,G,신내,1009,1030,20200306,2039
20200303,G,갈매,2191,1919,20200306,4110
20200303,G,별내,1807,1843,20200306,3650
20200303,G,퇴계원,2857,2544,20200306,5401
20200303,G,사릉,2522,2492,20200306,5014
20200303,G,금곡,1145,1114,20200306,2259
20200303,G,평내호평,3831,3714,20200306,7545
20200303,G,천마산,1051,989,20200306,2040
20200303,G,마석,2415,2427,20200306,4842
20200303,G,대성리,327,278,20200306,605
20200303,G,청평,829,829,20200306,1658
20200303,G,상천,149,126,20200306,275
20200303,G,가평,918,891,20200306,1809
20200303,G,굴봉산,62,61,20200306,123
20200303,G,백양리,46,44,20200306,90
20200303,G,강촌,224,191,20200306,415
20200303,G,김유정,136,143,20200306,279
20200303,G,남춘천,1239,1318,20200306,2557
20200303,G,춘천,654,616,20200306,1270
20200304,G,신내,940,985,20200307,1925
20200304,G,갈매,2280,1983,20200307,4263
20200304,G,별내,1736,1728,20200307,3464
20200304,G,퇴계원,2705,2496,20200307,5201
20200304,G,사릉,2544,2501,20200307,5045
20200304,G,금곡,1102,1020,20200307,2122
20200304,G,평내호평,3674,3718,20200307,7392
20200304,G,천마산,1064,959,20200307,2023
20200304,G,마석,2372,2337,20200307,4709
20200304,G,대성리,264,238,20200307,502
20200304,G,청평,857,854,20200307,1711
20200304,G,상천,139,127,20200307,266
20200304,G,가평,884,895,20200307,1779
20200304,G,굴봉산,57,57,20200307,114
20200304,G,백양리,46,40,20200307,86
20200304,G,강촌,176,190,20200307,366
20200304,G,김유정,158,168,20200307,326
20200304,G,남춘천,1207,1240,20200307,2447
20200304,G,춘천,628,555,20200307,1183
20200305,G,신내,974,1040,20200308,2014
20200305,G,갈매,2228,1941,20200308,4169
20200305,G,별내,1875,1848,20200308,3723
20200305,G,퇴계원,2724,2509,20200308,5233
20200305,G,사릉,2569,2522,20200308,5091
20200305,G,금곡,1194,1117,20200308,2311
20200305,G,평내호평,3792,3781,20200308,7573
20200305,G,천마산,1063,991,20200308,2054
20200305,G,마석,2424,2388,20200308,4812
20200305,G,대성리,293,291,20200308,584
20200305,G,청평,898,923,20200308,1821
20200305,G,상천,140,128,20200308,268
20200305,G,가평,918,892,20200308,1810
20200305,G,굴봉산,64,64,20200308,128
20200305,G,백양리,50,49,20200308,99
20200305,G,강촌,170,184,20200308,354
20200305,G,김유정,142,161,20200308,303
20200305,G,남춘천,1274,1267,20200308,2541
20200305,G,춘천,625,576,20200308,1201
20200306,G,신내,960,1034,20200309,1994
20200306,G,갈매,2357,2056,20200309,4413
20200306,G,별내,1933,1935,20200309,3868
20200306,G,퇴계원,2824,2568,20200309,5392
20200306,G,사릉,2683,2555,20200309,5238
20200306,G,금곡,1241,1182,20200309,2423
20200306,G,평내호평,4146,4042,20200309,8188
20200306,G,천마산,1119,992,20200309,2111
20200306,G,마석,2525,2548,20200309,5073
20200306,G,대성리,313,281,20200309,594
20200306,G,청평,962,959,20200309,1921
20200306,G,상천,158,153,20200309,311
20200306,G,가평,923,989,20200309,1912
20200306,G,굴봉산,75,77,20200309,152
20200306,G,백양리,48,39,20200309,87
20200306,G,강촌,204,205,20200309,409
20200306,G,김유정,154,172,20200309,326
20200306,G,남춘천,1413,1518,20200309,2931
20200306,G,춘천,797,718,20200309,1515
20200307,G,신내,655,628,20200310,1283
20200307,G,갈매,1197,1057,20200310,2254
20200307,G,별내,1269,1297,20200310,2566
20200307,G,퇴계원,1693,1586,20200310,3279
20200307,G,사릉,1550,1491,20200310,3041
20200307,G,금곡,746,755,20200310,1501
20200307,G,평내호평,2419,2442,20200310,4861
20200307,G,천마산,794,752,20200310,1546
20200307,G,마석,1746,1840,20200310,3586
20200307,G,대성리,330,371,20200310,701
20200307,G,청평,856,909,20200310,1765
20200307,G,상천,200,172,20200310,372
20200307,G,가평,791,901,20200310,1692
20200307,G,굴봉산,78,96,20200310,174
20200307,G,백양리,61,49,20200310,110
20200307,G,강촌,285,307,20200310,592
20200307,G,김유정,186,229,20200310,415
20200307,G,남춘천,1349,1301,20200310,2650
20200307,G,춘천,796,746,20200310,1542
20200308,G,신내,487,504,20200311,991
20200308,G,갈매,898,805,20200311,1703
20200308,G,별내,937,927,20200311,1864
20200308,G,퇴계원,1258,1210,20200311,2468
20200308,G,사릉,1004,1007,20200311,2011
20200308,G,금곡,576,555,20200311,1131
20200308,G,평내호평,1919,1915,20200311,3834
20200308,G,천마산,644,665,20200311,1309
20200308,G,마석,1477,1556,20200311,3033
20200308,G,대성리,396,318,20200311,714
20200308,G,청평,888,825,20200311,1713
20200308,G,상천,382,264,20200311,646
20200308,G,가평,828,727,20200311,1555
20200308,G,굴봉산,103,143,20200311,246
20200308,G,백양리,95,65,20200311,160
20200308,G,강촌,467,390,20200311,857
20200308,G,김유정,294,282,20200311,576
20200308,G,남춘천,1185,1229,20200311,2414
20200308,G,춘천,891,741,20200311,1632
20200309,G,신내,1068,1051,20200312,2119
20200309,G,갈매,2374,2080,20200312,4454
20200309,G,별내,1996,1949,20200312,3945
20200309,G,퇴계원,2956,2691,20200312,5647
20200309,G,사릉,2844,2661,20200312,5505
20200309,G,금곡,1265,1204,20200312,2469
20200309,G,평내호평,4520,4373,20200312,8893
20200309,G,천마산,1208,1114,20200312,2322
20200309,G,마석,2694,2599,20200312,5293
20200309,G,대성리,343,291,20200312,634
20200309,G,청평,991,957,20200312,1948
20200309,G,상천,202,204,20200312,406
20200309,G,가평,1044,1012,20200312,2056
20200309,G,굴봉산,90,92,20200312,182
20200309,G,백양리,58,38,20200312,96
20200309,G,강촌,227,226,20200312,453
20200309,G,김유정,166,165,20200312,331
20200309,G,남춘천,1496,1531,20200312,3027
20200309,G,춘천,764,769,20200312,1533
20200310,G,신내,954,977,20200313,1931
20200310,G,갈매,2257,1968,20200313,4225
20200310,G,별내,1798,1753,20200313,3551
20200310,G,퇴계원,2798,2552,20200313,5350
20200310,G,사릉,2529,2501,20200313,5030
20200310,G,금곡,1136,1016,20200313,2152
20200310,G,평내호평,3974,3958,20200313,7932
20200310,G,천마산,1009,930,20200313,1939
20200310,G,마석,2387,2376,20200313,4763
20200310,G,대성리,267,235,20200313,502
20200310,G,청평,827,785,20200313,1612
20200310,G,상천,117,115,20200313,232
20200310,G,가평,798,790,20200313,1588
20200310,G,굴봉산,50,49,20200313,99
20200310,G,백양리,36,26,20200313,62
20200310,G,강촌,147,140,20200313,287
20200310,G,김유정,124,113,20200313,237
20200310,G,남춘천,1228,1339,20200313,2567
20200310,G,춘천,670,629,20200313,1299
20200311,G,신내,1021,1058,20200314,2079
20200311,G,갈매,2334,2021,20200314,4355
20200311,G,별내,1827,1827,20200314,3654
20200311,G,퇴계원,2886,2662,20200314,5548
20200311,G,사릉,2702,2659,20200314,5361
20200311,G,금곡,1248,1174,20200314,2422
20200311,G,평내호평,4289,4183,20200314,8472
20200311,G,천마산,1198,1093,20200314,2291
20200311,G,마석,2638,2588,20200314,5226
20200311,G,대성리,330,301,20200314,631
20200311,G,청평,964,1033,20200314,1997
20200311,G,상천,200,179,20200314,379
20200311,G,가평,973,1003,20200314,1976
20200311,G,굴봉산,104,103,20200314,207
20200311,G,백양리,68,61,20200314,129
20200311,G,강촌,249,248,20200314,497
20200311,G,김유정,177,173,20200314,350
20200311,G,남춘천,1385,1493,20200314,2878
20200311,G,춘천,754,718,20200314,1472
20200312,G,신내,1042,1030,20200315,2072
20200312,G,갈매,2313,2048,20200315,4361
20200312,G,별내,1971,1911,20200315,3882
20200312,G,퇴계원,2850,2671,20200315,5521
20200312,G,사릉,2647,2588,20200315,5235
20200312,G,금곡,1226,1159,20200315,2385
20200312,G,평내호평,4313,4275,20200315,8588
20200312,G,천마산,1155,1096,20200315,2251
20200312,G,마석,2587,2550,20200315,5137
20200312,G,대성리,331,294,20200315,625
20200312,G,청평,1027,973,20200315,2000
20200312,G,상천,201,193,20200315,394
20200312,G,가평,936,992,20200315,1928
20200312,G,굴봉산,81,90,20200315,171
20200312,G,백양리,50,43,20200315,93
20200312,G,강촌,230,220,20200315,450
20200312,G,김유정,156,156,20200315,312
20200312,G,남춘천,1446,1523,20200315,2969
20200312,G,춘천,771,702,20200315,1473
20200313,G,신내,1021,1053,20200316,2074
20200313,G,갈매,2333,1991,20200316,4324
20200313,G,별내,2011,2038,20200316,4049
20200313,G,퇴계원,2867,2644,20200316,5511
20200313,G,사릉,2723,2557,20200316,5280
20200313,G,금곡,1258,1241,20200316,2499
20200313,G,평내호평,4354,4344,20200316,8698
20200313,G,천마산,1220,1102,20200316,2322
20200313,G,마석,2680,2610,20200316,5290
20200313,G,대성리,323,315,20200316,638
20200313,G,청평,955,1036,20200316,1991
20200313,G,상천,145,157,20200316,302
20200313,G,가평,995,991,20200316,1986
20200313,G,굴봉산,68,66,20200316,134
20200313,G,백양리,60,46,20200316,106
20200313,G,강촌,221,237,20200316,458
20200313,G,김유정,135,158,20200316,293
20200313,G,남춘천,1517,1555,20200316,3072
20200313,G,춘천,884,799,20200316,1683
20200314,G,신내,660,682,20200317,1342
20200314,G,갈매,1289,1122,20200317,2411
20200314,G,별내,1400,1337,20200317,2737
20200314,G,퇴계원,1840,1645,20200317,3485
20200314,G,사릉,1540,1546,20200317,3086
20200314,G,금곡,739,732,20200317,1471
20200314,G,평내호평,2859,2747,20200317,5606
20200314,G,천마산,888,904,20200317,1792
20200314,G,마석,1889,1961,20200317,3850
20200314,G,대성리,374,361,20200317,735
20200314,G,청평,938,1019,20200317,1957
20200314,G,상천,291,208,20200317,499
20200314,G,가평,938,990,20200317,1928
20200314,G,굴봉산,88,90,20200317,178
20200314,G,백양리,75,66,20200317,141
20200314,G,강촌,377,394,20200317,771
20200314,G,김유정,237,273,20200317,510
20200314,G,남춘천,1353,1438,20200317,2791
20200314,G,춘천,948,880,20200317,1828
20200315,G,신내,465,471,20200318,936
20200315,G,갈매,876,788,20200318,1664
20200315,G,별내,1028,1001,20200318,2029
20200315,G,퇴계원,1276,1175,20200318,2451
20200315,G,사릉,1050,1045,20200318,2095
20200315,G,금곡,567,530,20200318,1097
20200315,G,평내호평,1991,1990,20200318,3981
20200315,G,천마산,663,666,20200318,1329
20200315,G,마석,1399,1443,20200318,2842
20200315,G,대성리,309,271,20200318,580
20200315,G,청평,786,693,20200318,1479
20200315,G,상천,251,185,20200318,436
20200315,G,가평,731,659,20200318,1390
20200315,G,굴봉산,118,123,20200318,241
20200315,G,백양리,59,36,20200318,95
20200315,G,강촌,373,314,20200318,687
20200315,G,김유정,219,217,20200318,436
20200315,G,남춘천,1246,1354,20200318,2600
20200315,G,춘천,811,797,20200318,1608
20200316,G,신내,1025,1103,20200319,2128
20200316,G,갈매,2328,2022,20200319,4350
20200316,G,별내,1920,1914,20200319,3834
20200316,G,퇴계원,2981,2684,20200319,5665
20200316,G,사릉,2768,2656,20200319,5424
20200316,G,금곡,1265,1187,20200319,2452
20200316,G,평내호평,4421,4322,20200319,8743
20200316,G,천마산,1217,1117,20200319,2334
20200316,G,마석,2686,2599,20200319,5285
20200316,G,대성리,344,314,20200319,658
20200316,G,청평,994,937,20200319,1931
20200316,G,상천,178,173,20200319,351
20200316,G,가평,981,930,20200319,1911
20200316,G,굴봉산,75,94,20200319,169
20200316,G,백양리,44,38,20200319,82
20200316,G,강촌,244,216,20200319,460
20200316,G,김유정,164,138,20200319,302
20200316,G,남춘천,1470,1592,20200319,3062
20200316,G,춘천,763,750,20200319,1513
20200317,G,신내,998,1008,20200320,2006
20200317,G,갈매,2294,1993,20200320,4287
20200317,G,별내,1923,1930,20200320,3853
20200317,G,퇴계원,2907,2679,20200320,5586
20200317,G,사릉,2701,2613,20200320,5314
20200317,G,금곡,1199,1114,20200320,2313
20200317,G,평내호평,4299,4290,20200320,8589
20200317,G,천마산,1112,999,20200320,2111
20200317,G,마석,2577,2511,20200320,5088
20200317,G,대성리,283,265,20200320,548
20200317,G,청평,939,890,20200320,1829
20200317,G,상천,147,145,20200320,292
20200317,G,가평,871,906,20200320,1777
20200317,G,굴봉산,58,50,20200320,108
20200317,G,백양리,45,44,20200320,89
20200317,G,강촌,199,205,20200320,404
20200317,G,김유정,130,129,20200320,259
20200317,G,남춘천,1436,1467,20200320,2903
20200317,G,춘천,745,685,20200320,1430
20200318,G,신내,1086,1126,20200321,2212
20200318,G,갈매,2368,2111,20200321,4479
20200318,G,별내,1990,2008,20200321,3998
20200318,G,퇴계원,2889,2679,20200321,5568
20200318,G,사릉,2784,2721,20200321,5505
20200318,G,금곡,1323,1236,20200321,2559
20200318,G,평내호평,4580,4514,20200321,9094
20200318,G,천마산,1241,1165,20200321,2406
20200318,G,마석,2844,2813,20200321,5657
20200318,G,대성리,371,345,20200321,716
20200318,G,청평,1041,1061,20200321,2102
20200318,G,상천,238,212,20200321,450
20200318,G,가평,1021,1029,20200321,2050
20200318,G,굴봉산,83,89,20200321,172
20200318,G,백양리,47,47,20200321,94
20200318,G,강촌,254,267,20200321,521
20200318,G,김유정,182,193,20200321,375
20200318,G,남춘천,1448,1493,20200321,2941
20200318,G,춘천,844,712,20200321,1556
20200319,G,신내,992,1042,20200322,2034
20200319,G,갈매,2224,1951,20200322,4175
20200319,G,별내,1803,1779,20200322,3582
20200319,G,퇴계원,2737,2527,20200322,5264
20200319,G,사릉,2534,2471,20200322,5005
20200319,G,금곡,1202,1115,20200322,2317
20200319,G,평내호평,4073,4009,20200322,8082
20200319,G,천마산,1046,967,20200322,2013
20200319,G,마석,2376,2370,20200322,4746
20200319,G,대성리,305,284,20200322,589
20200319,G,청평,881,884,20200322,1765
20200319,G,상천,168,140,20200322,308
20200319,G,가평,831,884,20200322,1715
20200319,G,굴봉산,63,60,20200322,123
20200319,G,백양리,48,37,20200322,85
20200319,G,강촌,172,173,20200322,345
20200319,G,김유정,110,107,20200322,217
20200319,G,남춘천,1362,1341,20200322,2703
20200319,G,춘천,632,594,20200322,1226
20200320,G,신내,1100,1128,20200323,2228
20200320,G,갈매,2447,2127,20200323,4574
20200320,G,별내,1996,1998,20200323,3994
20200320,G,퇴계원,3062,2773,20200323,5835
20200320,G,사릉,2834,2723,20200323,5557
20200320,G,금곡,1317,1257,20200323,2574
20200320,G,평내호평,4596,4601,20200323,9197
20200320,G,천마산,1321,1201,20200323,2522
20200320,G,마석,2869,2775,20200323,5644
20200320,G,대성리,381,335,20200323,716
20200320,G,청평,1089,1125,20200323,2214
20200320,G,상천,223,227,20200323,450
20200320,G,가평,1068,1171,20200323,2239
20200320,G,굴봉산,77,85,20200323,162
20200320,G,백양리,63,48,20200323,111
20200320,G,강촌,250,264,20200323,514
20200320,G,김유정,194,217,20200323,411
20200320,G,남춘천,1781,1779,20200323,3560
20200320,G,춘천,1064,919,20200323,1983
20200321,G,신내,732,765,20200324,1497
20200321,G,갈매,1318,1150,20200324,2468
20200321,G,별내,1394,1378,20200324,2772
20200321,G,퇴계원,1842,1743,20200324,3585
20200321,G,사릉,1587,1581,20200324,3168
20200321,G,금곡,833,750,20200324,1583
20200321,G,평내호평,3005,2984,20200324,5989
20200321,G,천마산,889,906,20200324,1795
20200321,G,마석,1902,1980,20200324,3882
20200321,G,대성리,433,423,20200324,856
20200321,G,청평,1008,1191,20200324,2199
20200321,G,상천,300,238,20200324,538
20200321,G,가평,999,1077,20200324,2076
20200321,G,굴봉산,156,169,20200324,325
20200321,G,백양리,68,81,20200324,149
20200321,G,강촌,478,447,20200324,925
20200321,G,김유정,247,334,20200324,581
20200321,G,남춘천,1609,1627,20200324,3236
20200321,G,춘천,1052,920,20200324,1972
20200322,G,신내,558,543,20200325,1101
20200322,G,갈매,1005,892,20200325,1897
20200322,G,별내,1104,1102,20200325,2206
20200322,G,퇴계원,1401,1305,20200325,2706
20200322,G,사릉,1267,1217,20200325,2484
20200322,G,금곡,607,617,20200325,1224
20200322,G,평내호평,2161,2205,20200325,4366
20200322,G,천마산,750,743,20200325,1493
20200322,G,마석,1573,1597,20200325,3170
20200322,G,대성리,439,388,20200325,827
20200322,G,청평,1100,966,20200325,2066
20200322,G,상천,492,359,20200325,851
20200322,G,가평,1042,861,20200325,1903
20200322,G,굴봉산,183,241,20200325,424
20200322,G,백양리,89,61,20200325,150
20200322,G,강촌,630,523,20200325,1153
20200322,G,김유정,334,323,20200325,657
20200322,G,남춘천,1681,1758,20200325,3439
20200322,G,춘천,1041,908,20200325,1949
20200323,G,신내,1055,1088,20200326,2143
20200323,G,갈매,2375,2043,20200326,4418
20200323,G,별내,2010,2014,20200326,4024
20200323,G,퇴계원,3009,2760,20200326,5769
20200323,G,사릉,2868,2729,20200326,5597
20200323,G,금곡,1303,1206,20200326,2509
20200323,G,평내호평,4575,4501,20200326,9076
20200323,G,천마산,1263,1199,20200326,2462
20200323,G,마석,2943,2794,20200326,5737
20200323,G,대성리,369,338,20200326,707
20200323,G,청평,1127,1096,20200326,2223
20200323,G,상천,244,237,20200326,481
20200323,G,가평,1062,1005,20200326,2067
20200323,G,굴봉산,96,96,20200326,192
20200323,G,백양리,45,39,20200326,84
20200323,G,강촌,287,267,20200326,554
20200323,G,김유정,198,183,20200326,381
20200323,G,남춘천,1517,1704,20200326,3221
20200323,G,춘천,828,765,20200326,1593
20200324,G,신내,1033,1095,20200327,2128
20200324,G,갈매,2361,2064,20200327,4425
20200324,G,별내,2065,1992,20200327,4057
20200324,G,퇴계원,2982,2779,20200327,5761
20200324,G,사릉,2738,2633,20200327,5371
20200324,G,금곡,1310,1207,20200327,2517
20200324,G,평내호평,4500,4409,20200327,8909
20200324,G,천마산,1195,1161,20200327,2356
20200324,G,마석,2795,2740,20200327,5535
20200324,G,대성리,387,363,20200327,750
20200324,G,청평,1041,1017,20200327,2058
20200324,G,상천,219,199,20200327,418
20200324,G,가평,1029,1044,20200327,2073
20200324,G,굴봉산,96,109,20200327,205
20200324,G,백양리,84,66,20200327,150
20200324,G,강촌,288,283,20200327,571
20200324,G,김유정,230,228,20200327,458
20200324,G,남춘천,1501,1552,20200327,3053
20200324,G,춘천,840,803,20200327,1643
20200325,G,신내,1046,1119,20200328,2165
20200325,G,갈매,2429,2081,20200328,4510
20200325,G,별내,1963,1885,20200328,3848
20200325,G,퇴계원,2936,2765,20200328,5701
20200325,G,사릉,2800,2623,20200328,5423
20200325,G,금곡,1307,1254,20200328,2561
20200325,G,평내호평,4541,4437,20200328,8978
20200325,G,천마산,1288,1208,20200328,2496
20200325,G,마석,2792,2751,20200328,5543
20200325,G,대성리,381,378,20200328,759
20200325,G,청평,1065,1100,20200328,2165
20200325,G,상천,283,271,20200328,554
20200325,G,가평,1074,1086,20200328,2160
20200325,G,굴봉산,111,145,20200328,256
20200325,G,백양리,75,78,20200328,153
20200325,G,강촌,301,283,20200328,584
20200325,G,김유정,226,232,20200328,458
20200325,G,남춘천,1578,1594,20200328,3172
20200325,G,춘천,858,820,20200328,1678
20200326,G,신내,1034,1058,20200329,2092
20200326,G,갈매,2397,2056,20200329,4453
20200326,G,별내,2005,1972,20200329,3977
20200326,G,퇴계원,2936,2755,20200329,5691
20200326,G,사릉,2728,2592,20200329,5320
20200326,G,금곡,1300,1191,20200329,2491
20200326,G,평내호평,4469,4426,20200329,8895
20200326,G,천마산,1193,1161,20200329,2354
20200326,G,마석,2738,2658,20200329,5396
20200326,G,대성리,371,353,20200329,724
20200326,G,청평,1062,1047,20200329,2109
20200326,G,상천,212,198,20200329,410
20200326,G,가평,1026,991,20200329,2017
20200326,G,굴봉산,80,78,20200329,158
20200326,G,백양리,56,44,20200329,100
20200326,G,강촌,236,261,20200329,497
20200326,G,김유정,161,169,20200329,330
20200326,G,남춘천,1584,1550,20200329,3134
20200326,G,춘천,777,715,20200329,1492
20200327,G,신내,1005,1089,20200330,2094
20200327,G,갈매,2345,2105,20200330,4450
20200327,G,별내,1990,2013,20200330,4003
20200327,G,퇴계원,2938,2710,20200330,5648
20200327,G,사릉,2769,2607,20200330,5376
20200327,G,금곡,1251,1209,20200330,2460
20200327,G,평내호평,4478,4447,20200330,8925
20200327,G,천마산,1268,1140,20200330,2408
20200327,G,마석,2762,2734,20200330,5496
20200327,G,대성리,346,339,20200330,685
20200327,G,청평,1069,1141,20200330,2210
20200327,G,상천,171,186,20200330,357
20200327,G,가평,1034,1095,20200330,2129
20200327,G,굴봉산,96,99,20200330,195
20200327,G,백양리,57,69,20200330,126
20200327,G,강촌,216,233,20200330,449
20200327,G,김유정,149,165,20200330,314
20200327,G,남춘천,1887,1908,20200330,3795
20200327,G,춘천,957,800,20200330,1757
20200328,G,신내,707,720,20200331,1427
20200328,G,갈매,1400,1243,20200331,2643
20200328,G,별내,1505,1469,20200331,2974
20200328,G,퇴계원,2022,1856,20200331,3878
20200328,G,사릉,1702,1666,20200331,3368
20200328,G,금곡,857,775,20200331,1632
20200328,G,평내호평,3072,3029,20200331,6101
20200328,G,천마산,998,1041,20200331,2039
20200328,G,마석,2081,2188,20200331,4269
20200328,G,대성리,594,503,20200331,1097
20200328,G,청평,1110,1256,20200331,2366
20200328,G,상천,415,290,20200331,705
20200328,G,가평,1054,1165,20200331,2219
20200328,G,굴봉산,148,170,20200331,318
20200328,G,백양리,89,84,20200331,173
20200328,G,강촌,502,545,20200331,1047
20200328,G,김유정,255,331,20200331,586
20200328,G,남춘천,1603,1643,20200331,3246
20200328,G,춘천,1015,950,20200331,1965
20200329,G,신내,520,540,20200401,1060
20200329,G,갈매,947,825,20200401,1772
20200329,G,별내,1081,1055,20200401,2136
20200329,G,퇴계원,1399,1394,20200401,2793
20200329,G,사릉,1246,1286,20200401,2532
20200329,G,금곡,639,599,20200401,1238
20200329,G,평내호평,2311,2296,20200401,4607
20200329,G,천마산,816,822,20200401,1638
20200329,G,마석,1579,1609,20200401,3188
20200329,G,대성리,536,436,20200401,972
20200329,G,청평,1113,916,20200401,2029
20200329,G,상천,452,319,20200401,771
20200329,G,가평,1037,864,20200401,1901
20200329,G,굴봉산,156,168,20200401,324
20200329,G,백양리,89,71,20200401,160
20200329,G,강촌,619,475,20200401,1094
20200329,G,김유정,308,340,20200401,648
20200329,G,남춘천,1386,1484,20200401,2870
20200329,G,춘천,1001,900,20200401,1901
20200330,G,신내,1155,1153,20200402,2308
20200330,G,갈매,2447,2101,20200402,4548
20200330,G,별내,2008,2039,20200402,4047
20200330,G,퇴계원,3079,2705,20200402,5784
20200330,G,사릉,2855,2733,20200402,5588
20200330,G,금곡,1323,1215,20200402,2538
20200330,G,평내호평,4683,4586,20200402,9269
20200330,G,천마산,1315,1256,20200402,2571
20200330,G,마석,2937,2796,20200402,5733
20200330,G,대성리,468,465,20200402,933
20200330,G,청평,1142,1142,20200402,2284
20200330,G,상천,256,239,20200402,495
20200330,G,가평,1113,1048,20200402,2161
20200330,G,굴봉산,113,125,20200402,238
20200330,G,백양리,78,78,20200402,156
20200330,G,강촌,255,245,20200402,500
20200330,G,김유정,191,183,20200402,374
20200330,G,남춘천,1602,1626,20200402,3228
20200330,G,춘천,840,872,20200402,1712
20200331,G,신내,1041,1133,20200403,2174
20200331,G,갈매,2465,2130,20200403,4595
20200331,G,별내,2002,2016,20200403,4018
20200331,G,퇴계원,2988,2776,20200403,5764
20200331,G,사릉,2774,2654,20200403,5428
20200331,G,금곡,1274,1222,20200403,2496
20200331,G,평내호평,4581,4557,20200403,9138
20200331,G,천마산,1283,1204,20200403,2487
20200331,G,마석,2934,2797,20200403,5731
20200331,G,대성리,457,409,20200403,866
20200331,G,청평,1093,1073,20200403,2166
20200331,G,상천,257,256,20200403,513
20200331,G,가평,1045,1070,20200403,2115
20200331,G,굴봉산,142,125,20200403,267
20200331,G,백양리,56,63,20200403,119
20200331,G,강촌,267,253,20200403,520
20200331,G,김유정,231,222,20200403,453
20200331,G,남춘천,1491,1602,20200403,3093
20200331,G,춘천,803,791,20200403,1594
20200401,G,신내,1047,1109,20200404,2156
20200401,G,갈매,2505,2194,20200404,4699
20200401,G,별내,2033,2014,20200404,4047
20200401,G,퇴계원,2982,2744,20200404,5726
20200401,G,사릉,2803,2721,20200404,5524
20200401,G,금곡,1259,1201,20200404,2460
20200401,G,평내호평,4519,4423,20200404,8942
20200401,G,천마산,1240,1202,20200404,2442
20200401,G,마석,2820,2781,20200404,5601
20200401,G,대성리,409,416,20200404,825
20200401,G,청평,1131,1119,20200404,2250
20200401,G,상천,263,240,20200404,503
20200401,G,가평,1054,1057,20200404,2111
20200401,G,굴봉산,88,103,20200404,191
20200401,G,백양리,80,74,20200404,154
20200401,G,강촌,303,289,20200404,592
20200401,G,김유정,198,196,20200404,394
20200401,G,남춘천,1457,1509,20200404,2966
20200401,G,춘천,828,742,20200404,1570
20200402,G,신내,1104,1159,20200405,2263
20200402,G,갈매,2403,2097,20200405,4500
20200402,G,별내,2082,2032,20200405,4114
20200402,G,퇴계원,2975,2713,20200405,5688
20200402,G,사릉,2783,2633,20200405,5416
20200402,G,금곡,1226,1179,20200405,2405
20200402,G,평내호평,4555,4439,20200405,8994
20200402,G,천마산,1309,1228,20200405,2537
20200402,G,마석,2788,2727,20200405,5515
20200402,G,대성리,419,426,20200405,845
20200402,G,청평,1147,1137,20200405,2284
20200402,G,상천,232,246,20200405,478
20200402,G,가평,1069,1059,20200405,2128
20200402,G,굴봉산,111,104,20200405,215
20200402,G,백양리,87,84,20200405,171
20200402,G,강촌,235,227,20200405,462
20200402,G,김유정,203,221,20200405,424
20200402,G,남춘천,1619,1719,20200405,3338
20200402,G,춘천,857,736,20200405,1593
20200403,G,신내,1162,1185,20200406,2347
20200403,G,갈매,2468,2153,20200406,4621
20200403,G,별내,2128,2067,20200406,4195
20200403,G,퇴계원,3124,2840,20200406,5964
20200403,G,사릉,2842,2707,20200406,5549
20200403,G,금곡,1264,1264,20200406,2528
20200403,G,평내호평,4734,4626,20200406,9360
20200403,G,천마산,1292,1197,20200406,2489
20200403,G,마석,3034,2963,20200406,5997
20200403,G,대성리,446,429,20200406,875
20200403,G,청평,1159,1244,20200406,2403
20200403,G,상천,246,236,20200406,482
20200403,G,가평,1159,1234,20200406,2393
20200403,G,굴봉산,91,103,20200406,194
20200403,G,백양리,71,69,20200406,140
20200403,G,강촌,267,287,20200406,554
20200403,G,김유정,210,232,20200406,442
20200403,G,남춘천,1857,1905,20200406,3762
20200403,G,춘천,1028,837,20200406,1865
20200404,G,신내,666,726,20200407,1392
20200404,G,갈매,1351,1216,20200407,2567
20200404,G,별내,1488,1449,20200407,2937
20200404,G,퇴계원,1898,1786,20200407,3684
20200404,G,사릉,1772,1708,20200407,3480
20200404,G,금곡,818,829,20200407,1647
20200404,G,평내호평,3179,3213,20200407,6392
20200404,G,천마산,1002,1042,20200407,2044
20200404,G,마석,2089,2130,20200407,4219
20200404,G,대성리,663,678,20200407,1341
20200404,G,청평,1207,1283,20200407,2490
20200404,G,상천,452,347,20200407,799
20200404,G,가평,1155,1286,20200407,2441
20200404,G,굴봉산,163,186,20200407,349
20200404,G,백양리,104,91,20200407,195
20200404,G,강촌,480,513,20200407,993
20200404,G,김유정,297,342,20200407,639
20200404,G,남춘천,1625,1630,20200407,3255
20200404,G,춘천,1075,920,20200407,1995
20200405,G,신내,546,544,20200408,1090
20200405,G,갈매,1000,930,20200408,1930
20200405,G,별내,1090,1070,20200408,2160
20200405,G,퇴계원,1471,1385,20200408,2856
20200405,G,사릉,1225,1216,20200408,2441
20200405,G,금곡,600,570,20200408,1170
20200405,G,평내호평,2335,2430,20200408,4765
20200405,G,천마산,762,804,20200408,1566
20200405,G,마석,1773,1769,20200408,3542
20200405,G,대성리,823,707,20200408,1530
20200405,G,청평,1201,953,20200408,2154
20200405,G,상천,460,341,20200408,801
20200405,G,가평,1157,982,20200408,2139
20200405,G,굴봉산,148,200,20200408,348
20200405,G,백양리,105,68,20200408,173
20200405,G,강촌,648,472,20200408,1120
20200405,G,김유정,266,296,20200408,562
20200405,G,남춘천,1389,1534,20200408,2923
20200405,G,춘천,1041,873,20200408,1914
20200406,G,신내,1116,1165,20200409,2281
20200406,G,갈매,2570,2192,20200409,4762
20200406,G,별내,2113,2093,20200409,4206
20200406,G,퇴계원,3008,2781,20200409,5789
20200406,G,사릉,2913,2776,20200409,5689
20200406,G,금곡,1326,1253,20200409,2579
20200406,G,평내호평,4779,4728,20200409,9507
20200406,G,천마산,1356,1259,20200409,2615
20200406,G,마석,2936,2886,20200409,5822
20200406,G,대성리,493,441,20200409,934
20200406,G,청평,1186,1151,20200409,2337
20200406,G,상천,251,255,20200409,506
20200406,G,가평,1087,1081,20200409,2168
20200406,G,굴봉산,111,107,20200409,218
20200406,G,백양리,66,56,20200409,122
20200406,G,강촌,258,242,20200409,500
20200406,G,김유정,206,220,20200409,426
20200406,G,남춘천,1664,1737,20200409,3401
20200406,G,춘천,831,840,20200409,1671
20200407,G,신내,1165,1214,20200410,2379
20200407,G,갈매,2492,2173,20200410,4665
20200407,G,별내,2011,2034,20200410,4045
20200407,G,퇴계원,3060,2849,20200410,5909
20200407,G,사릉,2928,2814,20200410,5742
20200407,G,금곡,1298,1261,20200410,2559
20200407,G,평내호평,4761,4666,20200410,9427
20200407,G,천마산,1290,1219,20200410,2509
20200407,G,마석,2973,2908,20200410,5881
20200407,G,대성리,546,503,20200410,1049
20200407,G,청평,1215,1167,20200410,2382
20200407,G,상천,276,262,20200410,538
20200407,G,가평,1166,1138,20200410,2304
20200407,G,굴봉산,112,114,20200410,226
20200407,G,백양리,97,83,20200410,180
20200407,G,강촌,265,264,20200410,529
20200407,G,김유정,198,232,20200410,430
20200407,G,남춘천,1794,1853,20200410,3647
20200407,G,춘천,854,819,20200410,1673
20200408,G,신내,1163,1191,20200411,2354
20200408,G,갈매,2563,2185,20200411,4748
20200408,G,별내,2053,1990,20200411,4043
20200408,G,퇴계원,3008,2812,20200411,5820
20200408,G,사릉,2942,2775,20200411,5717
20200408,G,금곡,1261,1234,20200411,2495
20200408,G,평내호평,4667,4646,20200411,9313
20200408,G,천마산,1349,1271,20200411,2620
20200408,G,마석,3002,2916,20200411,5918
20200408,G,대성리,571,577,20200411,1148
20200408,G,청평,1214,1216,20200411,2430
20200408,G,상천,310,282,20200411,592
20200408,G,가평,1136,1152,20200411,2288
20200408,G,굴봉산,101,108,20200411,209
20200408,G,백양리,88,86,20200411,174
20200408,G,강촌,294,310,20200411,604
20200408,G,김유정,205,197,20200411,402
20200408,G,남춘천,1516,1606,20200411,3122
20200408,G,춘천,861,747,20200411,1608
20200409,G,신내,1188,1196,20200412,2384
20200409,G,갈매,2492,2240,20200412,4732
20200409,G,별내,2079,2000,20200412,4079
20200409,G,퇴계원,3051,2782,20200412,5833
20200409,G,사릉,2886,2718,20200412,5604
20200409,G,금곡,1310,1193,20200412,2503
20200409,G,평내호평,4672,4661,20200412,9333
20200409,G,천마산,1293,1226,20200412,2519
20200409,G,마석,2852,2806,20200412,5658
20200409,G,대성리,562,489,20200412,1051
20200409,G,청평,1163,1214,20200412,2377
20200409,G,상천,244,237,20200412,481
20200409,G,가평,1129,1114,20200412,2243
20200409,G,굴봉산,108,107,20200412,215
20200409,G,백양리,80,100,20200412,180
20200409,G,강촌,263,238,20200412,501
20200409,G,김유정,213,212,20200412,425
20200409,G,남춘천,1574,1621,20200412,3195
20200409,G,춘천,847,794,20200412,1641
20200410,G,신내,1148,1188,20200413,2336
20200410,G,갈매,2547,2195,20200413,4742
20200410,G,별내,2159,2168,20200413,4327
20200410,G,퇴계원,3134,2930,20200413,6064
20200410,G,사릉,2960,2738,20200413,5698
20200410,G,금곡,1310,1196,20200413,2506
20200410,G,평내호평,4922,4858,20200413,9780
20200410,G,천마산,1401,1285,20200413,2686
20200410,G,마석,3033,3012,20200413,6045
20200410,G,대성리,543,578,20200413,1121
20200410,G,청평,1268,1317,20200413,2585
20200410,G,상천,267,257,20200413,524
20200410,G,가평,1209,1254,20200413,2463
20200410,G,굴봉산,127,136,20200413,263
20200410,G,백양리,70,81,20200413,151
20200410,G,강촌,262,301,20200413,563
20200410,G,김유정,226,281,20200413,507
20200410,G,남춘천,1943,1908,20200413,3851
20200410,G,춘천,1052,879,20200413,1931
20200411,G,신내,791,858,20200414,1649
20200411,G,갈매,1460,1287,20200414,2747
20200411,G,별내,1547,1527,20200414,3074
20200411,G,퇴계원,2119,1915,20200414,4034
20200411,G,사릉,1819,1714,20200414,3533
20200411,G,금곡,894,813,20200414,1707
20200411,G,평내호평,3294,3347,20200414,6641
20200411,G,천마산,1080,1163,20200414,2243
20200411,G,마석,2271,2364,20200414,4635
20200411,G,대성리,867,907,20200414,1774
20200411,G,청평,1324,1430,20200414,2754
20200411,G,상천,407,390,20200414,797
20200411,G,가평,1300,1480,20200414,2780
20200411,G,굴봉산,189,209,20200414,398
20200411,G,백양리,144,111,20200414,255
20200411,G,강촌,723,730,20200414,1453
20200411,G,김유정,376,404,20200414,780
20200411,G,남춘천,1692,1896,20200414,3588
20200411,G,춘천,1302,1105,20200414,2407
20200412,G,신내,560,598,20200415,1158
20200412,G,갈매,1084,969,20200415,2053
20200412,G,별내,1092,1086,20200415,2178
20200412,G,퇴계원,1457,1389,20200415,2846
20200412,G,사릉,1285,1235,20200415,2520
20200412,G,금곡,644,674,20200415,1318
20200412,G,평내호평,2397,2395,20200415,4792
20200412,G,천마산,792,821,20200415,1613
20200412,G,마석,1831,1825,20200415,3656
20200412,G,대성리,748,455,20200415,1203
20200412,G,청평,1217,1056,20200415,2273
20200412,G,상천,576,466,20200415,1042
20200412,G,가평,1145,1017,20200415,2162
20200412,G,굴봉산,253,313,20200415,566
20200412,G,백양리,101,81,20200415,182
20200412,G,강촌,714,641,20200415,1355
20200412,G,김유정,321,337,20200415,658
20200412,G,남춘천,1702,1707,20200415,3409
20200412,G,춘천,1086,1012,20200415,2098
20200413,G,신내,1188,1238,20200416,2426
20200413,G,갈매,2600,2292,20200416,4892
20200413,G,별내,2208,2112,20200416,4320
20200413,G,퇴계원,3148,2868,20200416,6016
20200413,G,사릉,3093,2945,20200416,6038
20200413,G,금곡,1373,1300,20200416,2673
20200413,G,평내호평,5066,4860,20200416,9926
20200413,G,천마산,1389,1310,20200416,2699
20200413,G,마석,3173,3099,20200416,6272
20200413,G,대성리,461,407,20200416,868
20200413,G,청평,1270,1271,20200416,2541
20200413,G,상천,280,247,20200416,527
20200413,G,가평,1275,1257,20200416,2532
20200413,G,굴봉산,116,117,20200416,233
20200413,G,백양리,89,82,20200416,171
20200413,G,강촌,292,286,20200416,578
20200413,G,김유정,242,234,20200416,476
20200413,G,남춘천,1775,1863,20200416,3638
20200413,G,춘천,929,904,20200416,1833
20200414,G,신내,1201,1231,20200417,2432
20200414,G,갈매,2607,2257,20200417,4864
20200414,G,별내,2257,2149,20200417,4406
20200414,G,퇴계원,3228,2968,20200417,6196
20200414,G,사릉,3039,2847,20200417,5886
20200414,G,금곡,1377,1286,20200417,2663
20200414,G,평내호평,4947,4886,20200417,9833
20200414,G,천마산,1430,1326,20200417,2756
20200414,G,마석,3159,3113,20200417,6272
20200414,G,대성리,547,495,20200417,1042
20200414,G,청평,1274,1341,20200417,2615
20200414,G,상천,305,285,20200417,590
20200414,G,가평,1267,1277,20200417,2544
20200414,G,굴봉산,184,190,20200417,374
20200414,G,백양리,80,78,20200417,158
20200414,G,강촌,376,368,20200417,744
20200414,G,김유정,231,255,20200417,486
20200414,G,남춘천,1784,1829,20200417,3613
20200414,G,춘천,975,862,20200417,1837
20200415,G,신내,703,803,20200418,1506
20200415,G,갈매,1343,1218,20200418,2561
20200415,G,별내,1403,1400,20200418,2803
20200415,G,퇴계원,1974,1859,20200418,3833
20200415,G,사릉,1822,1804,20200418,3626
20200415,G,금곡,889,834,20200418,1723
20200415,G,평내호평,2990,3033,20200418,6023
20200415,G,천마산,980,1011,20200418,1991
20200415,G,마석,2116,2173,20200418,4289
20200415,G,대성리,626,563,20200418,1189
20200415,G,청평,1227,1167,20200418,2394
20200415,G,상천,509,431,20200418,940
20200415,G,가평,1264,1263,20200418,2527
20200415,G,굴봉산,230,234,20200418,464
20200415,G,백양리,101,106,20200418,207
20200415,G,강촌,598,566,20200418,1164
20200415,G,김유정,389,450,20200418,839
20200415,G,남춘천,1672,1739,20200418,3411
20200415,G,춘천,1268,1036,20200418,2304
20200416,G,신내,1220,1208,20200419,2428
20200416,G,갈매,2546,2291,20200419,4837
20200416,G,별내,2217,2169,20200419,4386
20200416,G,퇴계원,3171,2851,20200419,6022
20200416,G,사릉,3003,2853,20200419,5856
20200416,G,금곡,1340,1201,20200419,2541
20200416,G,평내호평,4957,4857,20200419,9814
20200416,G,천마산,1360,1263,20200419,2623
20200416,G,마석,3128,3052,20200419,6180
20200416,G,대성리,439,465,20200419,904
20200416,G,청평,1294,1313,20200419,2607
20200416,G,상천,311,298,20200419,609
20200416,G,가평,1317,1303,20200419,2620
20200416,G,굴봉산,196,196,20200419,392
20200416,G,백양리,114,116,20200419,230
20200416,G,강촌,364,345,20200419,709
20200416,G,김유정,226,229,20200419,455
20200416,G,남춘천,1716,1685,20200419,3401
20200416,G,춘천,936,862,20200419,1798
20200417,G,신내,1104,1115,20200420,2219
20200417,G,갈매,2526,2194,20200420,4720
20200417,G,별내,1980,1936,20200420,3916
20200417,G,퇴계원,2960,2754,20200420,5714
20200417,G,사릉,2896,2667,20200420,5563
20200417,G,금곡,1177,1154,20200420,2331
20200417,G,평내호평,4547,4517,20200420,9064
20200417,G,천마산,1246,1135,20200420,2381
20200417,G,마석,2784,2701,20200420,5485
20200417,G,대성리,317,285,20200420,602
20200417,G,청평,1000,1080,20200420,2080
20200417,G,상천,154,163,20200420,317
20200417,G,가평,985,1117,20200420,2102
20200417,G,굴봉산,69,79,20200420,148
20200417,G,백양리,44,50,20200420,94
20200417,G,강촌,182,196,20200420,378
20200417,G,김유정,161,199,20200420,360
20200417,G,남춘천,1811,1892,20200420,3703
20200417,G,춘천,950,805,20200420,1755
20200418,G,신내,878,920,20200421,1798
20200418,G,갈매,1534,1374,20200421,2908
20200418,G,별내,1734,1686,20200421,3420
20200418,G,퇴계원,2223,2094,20200421,4317
20200418,G,사릉,2153,2010,20200421,4163
20200418,G,금곡,1010,899,20200421,1909
20200418,G,평내호평,3792,3788,20200421,7580
20200418,G,천마산,1166,1240,20200421,2406
20200418,G,마석,2711,2792,20200421,5503
20200418,G,대성리,640,642,20200421,1282
20200418,G,청평,1579,1726,20200421,3305
20200418,G,상천,705,550,20200421,1255
20200418,G,가평,1626,1700,20200421,3326
20200418,G,굴봉산,319,355,20200421,674
20200418,G,백양리,149,150,20200421,299
20200418,G,강촌,712,715,20200421,1427
20200418,G,김유정,425,509,20200421,934
20200418,G,남춘천,2020,2064,20200421,4084
20200418,G,춘천,1493,1326,20200421,2819
20200419,G,신내,562,578,20200422,1140
20200419,G,갈매,1065,907,20200422,1972
20200419,G,별내,1121,1160,20200422,2281
20200419,G,퇴계원,1497,1371,20200422,2868
20200419,G,사릉,1309,1333,20200422,2642
20200419,G,금곡,650,632,20200422,1282
20200419,G,평내호평,2498,2474,20200422,4972
20200419,G,천마산,842,819,20200422,1661
20200419,G,마석,1821,1863,20200422,3684
20200419,G,대성리,543,458,20200422,1001
20200419,G,청평,1220,1124,20200422,2344
20200419,G,상천,574,414,20200422,988
20200419,G,가평,1250,1018,20200422,2268
20200419,G,굴봉산,360,330,20200422,690
20200419,G,백양리,107,99,20200422,206
20200419,G,강촌,645,668,20200422,1313
20200419,G,김유정,287,277,20200422,564
20200419,G,남춘천,1650,1669,20200422,3319
20200419,G,춘천,1138,989,20200422,2127
20200420,G,신내,1116,1137,20200423,2253
20200420,G,갈매,2628,2193,20200423,4821
20200420,G,별내,2142,2082,20200423,4224
20200420,G,퇴계원,3226,2873,20200423,6099
20200420,G,사릉,3032,2834,20200423,5866
20200420,G,금곡,1311,1277,20200423,2588
20200420,G,평내호평,4963,4836,20200423,9799
20200420,G,천마산,1271,1192,20200423,2463
20200420,G,마석,3090,2945,20200423,6035
20200420,G,대성리,396,369,20200423,765
20200420,G,청평,1384,1292,20200423,2676
20200420,G,상천,297,282,20200423,579
20200420,G,가평,1270,1235,20200423,2505
20200420,G,굴봉산,161,161,20200423,322
20200420,G,백양리,85,84,20200423,169
20200420,G,강촌,235,252,20200423,487
20200420,G,김유정,234,213,20200423,447
20200420,G,남춘천,1710,1858,20200423,3568
20200420,G,춘천,834,852,20200423,1686
20200421,G,신내,1178,1168,20200424,2346
20200421,G,갈매,2570,2198,20200424,4768
20200421,G,별내,2147,2150,20200424,4297
20200421,G,퇴계원,3177,3021,20200424,6198
20200421,G,사릉,3059,2872,20200424,5931
20200421,G,금곡,1295,1194,20200424,2489
20200421,G,평내호평,4926,4833,20200424,9759
20200421,G,천마산,1306,1240,20200424,2546
20200421,G,마석,3135,3014,20200424,6149
20200421,G,대성리,449,381,20200424,830
20200421,G,청평,1259,1277,20200424,2536
20200421,G,상천,357,336,20200424,693
20200421,G,가평,1315,1325,20200424,2640
20200421,G,굴봉산,250,243,20200424,493
20200421,G,백양리,95,124,20200424,219
20200421,G,강촌,362,335,20200424,697
20200421,G,김유정,234,248,20200424,482
20200421,G,남춘천,1672,1751,20200424,3423
20200421,G,춘천,919,853,20200424,1772
20200422,G,신내,1211,1218,20200425,2429
20200422,G,갈매,2621,2297,20200425,4918
20200422,G,별내,2053,2035,20200425,4088
20200422,G,퇴계원,3073,2853,20200425,5926
20200422,G,사릉,2976,2808,20200425,5784
20200422,G,금곡,1266,1219,20200425,2485
20200422,G,평내호평,4718,4572,20200425,9290
20200422,G,천마산,1326,1234,20200425,2560
20200422,G,마석,3005,2964,20200425,5969
20200422,G,대성리,382,350,20200425,732
20200422,G,청평,1159,1158,20200425,2317
20200422,G,상천,267,261,20200425,528
20200422,G,가평,1241,1201,20200425,2442
20200422,G,굴봉산,164,169,20200425,333
20200422,G,백양리,80,80,20200425,160
20200422,G,강촌,340,323,20200425,663
20200422,G,김유정,230,260,20200425,490
20200422,G,남춘천,1898,1928,20200425,3826
20200422,G,춘천,875,787,20200425,1662
20200423,G,신내,1196,1186,20200426,2382
20200423,G,갈매,2588,2226,20200426,4814
20200423,G,별내,2164,2142,20200426,4306
20200423,G,퇴계원,3291,2985,20200426,6276
20200423,G,사릉,3022,2923,20200426,5945
20200423,G,금곡,1314,1278,20200426,2592
20200423,G,평내호평,5038,4994,20200426,10032
20200423,G,천마산,1453,1354,20200426,2807
20200423,G,마석,3114,3061,20200426,6175
20200423,G,대성리,444,429,20200426,873
20200423,G,청평,1267,1281,20200426,2548
20200423,G,상천,306,300,20200426,606
20200423,G,가평,1252,1325,20200426,2577
20200423,G,굴봉산,150,160,20200426,310
20200423,G,백양리,89,104,20200426,193
20200423,G,강촌,336,303,20200426,639
20200423,G,김유정,227,223,20200426,450
20200423,G,남춘천,1701,1799,20200426,3500
20200423,G,춘천,935,804,20200426,1739
20200424,G,신내,1248,1209,20200427,2457
20200424,G,갈매,2740,2372,20200427,5112
20200424,G,별내,2312,2320,20200427,4632
20200424,G,퇴계원,3377,3097,20200427,6474
20200424,G,사릉,3198,2972,20200427,6170
20200424,G,금곡,1337,1276,20200427,2613
20200424,G,평내호평,5206,5085,20200427,10291
20200424,G,천마산,1446,1372,20200427,2818
20200424,G,마석,3336,3226,20200427,6562
20200424,G,대성리,432,423,20200427,855
20200424,G,청평,1396,1461,20200427,2857
20200424,G,상천,324,297,20200427,621
20200424,G,가평,1436,1553,20200427,2989
20200424,G,굴봉산,188,196,20200427,384
20200424,G,백양리,84,86,20200427,170
20200424,G,강촌,397,435,20200427,832
20200424,G,김유정,267,295,20200427,562
20200424,G,남춘천,2029,2028,20200427,4057
20200424,G,춘천,1177,922,20200427,2099
20200425,G,신내,920,984,20200428,1904
20200425,G,갈매,1531,1395,20200428,2926
20200425,G,별내,1819,1805,20200428,3624
20200425,G,퇴계원,2333,2214,20200428,4547
20200425,G,사릉,2113,2026,20200428,4139
20200425,G,금곡,985,920,20200428,1905
20200425,G,평내호평,3874,3754,20200428,7628
20200425,G,천마산,1197,1325,20200428,2522
20200425,G,마석,2769,2712,20200428,5481
20200425,G,대성리,623,703,20200428,1326
20200425,G,청평,1485,1657,20200428,3142
20200425,G,상천,592,528,20200428,1120
20200425,G,가평,1673,1708,20200428,3381
20200425,G,굴봉산,332,384,20200428,716
20200425,G,백양리,172,176,20200428,348
20200425,G,강촌,770,719,20200428,1489
20200425,G,김유정,393,489,20200428,882
20200425,G,남춘천,2220,2227,20200428,4447
20200425,G,춘천,1517,1321,20200428,2838
20200426,G,신내,708,804,20200429,1512
20200426,G,갈매,1204,1072,20200429,2276
20200426,G,별내,1351,1343,20200429,2694
20200426,G,퇴계원,1840,1790,20200429,3630
20200426,G,사릉,1430,1495,20200429,2925
20200426,G,금곡,845,798,20200429,1643
20200426,G,평내호평,2846,2947,20200429,5793
20200426,G,천마산,1049,1044,20200429,2093
20200426,G,마석,2251,2205,20200429,4456
20200426,G,대성리,696,579,20200429,1275
20200426,G,청평,1523,1353,20200429,2876
20200426,G,상천,722,558,20200429,1280
20200426,G,가평,1534,1343,20200429,2877
20200426,G,굴봉산,377,399,20200429,776
20200426,G,백양리,178,131,20200429,309
20200426,G,강촌,904,707,20200429,1611
20200426,G,김유정,525,515,20200429,1040
20200426,G,남춘천,2007,2019,20200429,4026
20200426,G,춘천,1496,1277,20200429,2773
20200427,G,신내,1293,1291,20200430,2584
20200427,G,갈매,2776,2379,20200430,5155
20200427,G,별내,2320,2271,20200430,4591
20200427,G,퇴계원,3508,3168,20200430,6676
20200427,G,사릉,3237,3033,20200430,6270
20200427,G,금곡,1423,1294,20200430,2717
20200427,G,평내호평,5214,5090,20200430,10304
20200427,G,천마산,1479,1400,20200430,2879
20200427,G,마석,3446,3295,20200430,6741
20200427,G,대성리,440,395,20200430,835
20200427,G,청평,1533,1453,20200430,2986
20200427,G,상천,386,379,20200430,765
20200427,G,가평,1412,1394,20200430,2806
20200427,G,굴봉산,217,212,20200430,429
20200427,G,백양리,119,120,20200430,239
20200427,G,강촌,414,387,20200430,801
20200427,G,김유정,233,235,20200430,468
20200427,G,남춘천,2170,2399,20200430,4569
20200427,G,춘천,1066,1031,20200430,2097
20200428,G,신내,1259,1352,20200501,2611
20200428,G,갈매,2795,2422,20200501,5217
20200428,G,별내,2334,2334,20200501,4668
20200428,G,퇴계원,3438,3149,20200501,6587
20200428,G,사릉,3236,2994,20200501,6230
20200428,G,금곡,1451,1401,20200501,2852
20200428,G,평내호평,5308,5230,20200501,10538
20200428,G,천마산,1504,1404,20200501,2908
20200428,G,마석,3513,3398,20200501,6911
20200428,G,대성리,491,450,20200501,941
20200428,G,청평,1506,1516,20200501,3022
20200428,G,상천,368,360,20200501,728
20200428,G,가평,1442,1484,20200501,2926
20200428,G,굴봉산,209,203,20200501,412
20200428,G,백양리,116,115,20200501,231
20200428,G,강촌,378,382,20200501,760
20200428,G,김유정,295,304,20200501,599
20200428,G,남춘천,1881,1962,20200501,3843
20200428,G,춘천,1091,981,20200501,2072
20200429,G,신내,1285,1335,20200502,2620
20200429,G,갈매,2869,2400,20200502,5269
20200429,G,별내,2440,2328,20200502,4768
20200429,G,퇴계원,3431,3065,20200502,6496
20200429,G,사릉,3329,3020,20200502,6349
20200429,G,금곡,1454,1388,20200502,2842
20200429,G,평내호평,5384,5342,20200502,10726
20200429,G,천마산,1543,1414,20200502,2957
20200429,G,마석,3535,3467,20200502,7002
20200429,G,대성리,540,506,20200502,1046
20200429,G,청평,1560,1635,20200502,3195
20200429,G,상천,410,381,20200502,791
20200429,G,가평,1517,1627,20200502,3144
20200429,G,굴봉산,230,251,20200502,481
20200429,G,백양리,126,125,20200502,251
20200429,G,강촌,392,457,20200502,849
20200429,G,김유정,327,350,20200502,677
20200429,G,남춘천,2135,2310,20200502,4445
20200429,G,춘천,1208,1120,20200502,2328
20200430,G,신내,894,883,20200503,1777
20200430,G,갈매,1568,1403,20200503,2971
20200430,G,별내,1781,1742,20200503,3523
20200430,G,퇴계원,2256,2085,20200503,4341
20200430,G,사릉,2125,2027,20200503,4152
20200430,G,금곡,1027,935,20200503,1962
20200430,G,평내호평,3820,3751,20200503,7571
20200430,G,천마산,1241,1234,20200503,2475
20200430,G,마석,2929,2830,20200503,5759
20200430,G,대성리,816,862,20200503,1678
20200430,G,청평,1807,2109,20200503,3916
20200430,G,상천,675,607,20200503,1282
20200430,G,가평,1936,2492,20200503,4428
20200430,G,굴봉산,391,394,20200503,785
20200430,G,백양리,208,220,20200503,428
20200430,G,강촌,867,908,20200503,1775
20200430,G,김유정,614,724,20200503,1338
20200430,G,남춘천,2241,2611,20200503,4852
20200430,G,춘천,2178,1898,20200503,4076
20200501,G,춘천,2203,1864,20200504,4067
20200501,G,남춘천,2440,2576,20200504,5016
20200501,G,김유정,587,635,20200504,1222
20200501,G,강촌,776,754,20200504,1530
20200501,G,백양리,193,179,20200504,372
20200501,G,굴봉산,372,361,20200504,733
20200501,G,가평,2366,2265,20200504,4631
20200501,G,상천,536,448,20200504,984
20200501,G,청평,1938,1898,20200504,3836
20200501,G,대성리,716,683,20200504,1399
20200501,G,마석,3137,2994,20200504,6131
20200501,G,천마산,1239,1165,20200504,2404
20200501,G,평내호평,3993,4007,20200504,8000
20200501,G,금곡,1073,1040,20200504,2113
20200501,G,사릉,2350,2221,20200504,4571
20200501,G,퇴계원,2461,2223,20200504,4684
20200501,G,별내,1726,1749,20200504,3475
20200501,G,갈매,1782,1584,20200504,3366
20200501,G,신내,918,880,20200504,1798
20200502,G,춘천,1932,1629,20200505,3561
20200502,G,남춘천,2822,2842,20200505,5664
20200502,G,김유정,588,630,20200505,1218
20200502,G,강촌,880,831,20200505,1711
20200502,G,백양리,192,181,20200505,373
20200502,G,굴봉산,294,350,20200505,644
20200502,G,가평,2219,2064,20200505,4283
20200502,G,상천,457,423,20200505,880
20200502,G,청평,1827,1868,20200505,3695
20200502,G,대성리,657,648,20200505,1305
20200502,G,마석,2771,2880,20200505,5651
20200502,G,천마산,1201,1208,20200505,2409
20200502,G,평내호평,3658,3584,20200505,7242
20200502,G,금곡,1037,980,20200505,2017
20200502,G,사릉,1981,1912,20200505,3893
20200502,G,퇴계원,2299,2142,20200505,4441
20200502,G,별내,1691,1580,20200505,3271
20200502,G,갈매,1582,1400,20200505,2982
20200502,G,신내,824,849,20200505,1673
20200503,G,춘천,1719,1285,20200506,3004
20200503,G,남춘천,1985,2011,20200506,3996
20200503,G,김유정,509,594,20200506,1103
20200503,G,강촌,904,669,20200506,1573
20200503,G,백양리,141,128,20200506,269
20200503,G,굴봉산,287,253,20200506,540
20200503,G,가평,1766,1513,20200506,3279
20200503,G,상천,623,567,20200506,1190
20200503,G,청평,1723,1352,20200506,3075
20200503,G,대성리,625,502,20200506,1127
20200503,G,마석,2508,2590,20200506,5098
20200503,G,천마산,969,943,20200506,1912
20200503,G,평내호평,2999,2971,20200506,5970
20200503,G,금곡,778,759,20200506,1537
20200503,G,사릉,1637,1594,20200506,3231
20200503,G,퇴계원,1767,1680,20200506,3447
20200503,G,별내,1469,1402,20200506,2871
20200503,G,갈매,1231,1158,20200506,2389
20200503,G,신내,669,728,20200506,1397
20200504,G,춘천,1349,1250,20200507,2599
20200504,G,남춘천,2052,2149,20200507,4201
20200504,G,김유정,335,379,20200507,714
20200504,G,강촌,536,437,20200507,973
20200504,G,백양리,115,111,20200507,226
20200504,G,굴봉산,232,221,20200507,453
20200504,G,가평,1740,1737,20200507,3477
20200504,G,상천,379,370,20200507,749
20200504,G,청평,1710,1613,20200507,3323
20200504,G,대성리,471,446,20200507,917
20200504,G,마석,3476,3368,20200507,6844
20200504,G,천마산,1502,1432,20200507,2934
20200504,G,평내호평,5133,4976,20200507,10109
20200504,G,금곡,1352,1277,20200507,2629
20200504,G,사릉,2948,2767,20200507,5715
20200504,G,퇴계원,3185,2888,20200507,6073
20200504,G,별내,2168,2254,20200507,4422
20200504,G,갈매,2399,2102,20200507,4501
20200504,G,신내,1142,1157,20200507,2299
20200505,G,신내,810,826,20200508,1636
20200505,G,갈매,1365,1239,20200508,2604
20200505,G,별내,1569,1545,20200508,3114
20200505,G,퇴계원,2069,1887,20200508,3956
20200505,G,사릉,1932,1813,20200508,3745
20200505,G,금곡,964,898,20200508,1862
20200505,G,평내호평,3270,3220,20200508,6490
20200505,G,천마산,1104,1105,20200508,2209
20200505,G,마석,2541,2554,20200508,5095
20200505,G,대성리,676,633,20200508,1309
20200505,G,청평,1442,1395,20200508,2837
20200505,G,상천,543,447,20200508,990
20200505,G,가평,1839,1732,20200508,3571
20200505,G,굴봉산,323,320,20200508,643
20200505,G,백양리,172,152,20200508,324
20200505,G,강촌,736,604,20200508,1340
20200505,G,김유정,503,554,20200508,1057
20200505,G,남춘천,1980,2085,20200508,4065
20200505,G,춘천,1697,1393,20200508,3090
20200506,G,신내,1258,1291,20200509,2549
20200506,G,갈매,2930,2535,20200509,5465
20200506,G,별내,2499,2417,20200509,4916
20200506,G,퇴계원,3515,3192,20200509,6707
20200506,G,사릉,3370,3158,20200509,6528
20200506,G,금곡,1439,1363,20200509,2802
20200506,G,평내호평,5571,5380,20200509,10951
20200506,G,천마산,1568,1413,20200509,2981
20200506,G,마석,3566,3501,20200509,7067
20200506,G,대성리,523,467,20200509,990
20200506,G,청평,1533,1565,20200509,3098
20200506,G,상천,362,354,20200509,716
20200506,G,가평,1573,1507,20200509,3080
20200506,G,굴봉산,190,194,20200509,384
20200506,G,백양리,135,125,20200509,260
20200506,G,강촌,401,368,20200509,769
20200506,G,김유정,269,262,20200509,531
20200506,G,남춘천,2042,2132,20200509,4174
20200506,G,춘천,1214,1068,20200509,2282
20200507,G,강촌,488,481,20200510,969
20200507,G,김유정,289,304,20200510,593
20200507,G,남춘천,2623,2605,20200510,5228
20200507,G,춘천,1232,1114,20200510,2346
20200507,G,백양리,140,127,20200510,267
20200507,G,굴봉산,201,186,20200510,387
20200507,G,가평,1602,1637,20200510,3239
20200507,G,상천,354,324,20200510,678
20200507,G,청평,1554,1581,20200510,3135
20200507,G,대성리,570,541,20200510,1111
20200507,G,마석,3764,3644,20200510,7408
20200507,G,천마산,1582,1484,20200510,3066
20200507,G,평내호평,5755,5576,20200510,11331
20200507,G,금곡,1567,1442,20200510,3009
20200507,G,사릉,3337,3163,20200510,6500
20200507,G,퇴계원,3480,3277,20200510,6757
20200507,G,별내,2450,2386,20200510,4836
20200507,G,갈매,2951,2557,20200510,5508
20200507,G,신내,1285,1339,20200510,2624
20200508,G,신내,1328,1310,20200511,2638
20200508,G,갈매,3036,2601,20200511,5637
20200508,G,별내,2508,2453,20200511,4961
20200508,G,퇴계원,3649,3460,20200511,7109
20200508,G,사릉,3384,3226,20200511,6610
20200508,G,금곡,1534,1484,20200511,3018
20200508,G,평내호평,5547,5637,20200511,11184
20200508,G,천마산,1569,1461,20200511,3030
20200508,G,마석,3749,3860,20200511,7609
20200508,G,대성리,515,491,20200511,1006
20200508,G,청평,1822,1683,20200511,3505
20200508,G,상천,301,289,20200511,590
20200508,G,가평,1588,1611,20200511,3199
20200508,G,굴봉산,179,171,20200511,350
20200508,G,백양리,109,101,20200511,210
20200508,G,강촌,358,386,20200511,744
20200508,G,김유정,242,267,20200511,509
20200508,G,남춘천,2526,2361,20200511,4887
20200508,G,춘천,1437,1100,20200511,2537
20200509,G,신내,692,733,20200512,1425
20200509,G,갈매,1473,1302,20200512,2775
20200509,G,별내,1530,1462,20200512,2992
20200509,G,퇴계원,1998,1829,20200512,3827
20200509,G,사릉,1815,1741,20200512,3556
20200509,G,금곡,749,712,20200512,1461
20200509,G,평내호평,3082,3085,20200512,6167
20200509,G,천마산,874,817,20200512,1691
20200509,G,마석,2195,2129,20200512,4324
20200509,G,대성리,326,438,20200512,764
20200509,G,청평,945,1098,20200512,2043
20200509,G,상천,150,146,20200512,296
20200509,G,가평,938,1176,20200512,2114
20200509,G,굴봉산,112,80,20200512,192
20200509,G,백양리,76,92,20200512,168
20200509,G,강촌,290,292,20200512,582
20200509,G,김유정,236,280,20200512,516
20200509,G,남춘천,1780,1956,20200512,3736
20200509,G,춘천,1018,1001,20200512,2019
20200510,G,신내,729,767,20200513,1496
20200510,G,갈매,1334,1216,20200513,2550
20200510,G,별내,1376,1342,20200513,2718
20200510,G,퇴계원,1942,1788,20200513,3730
20200510,G,사릉,1636,1611,20200513,3247
20200510,G,금곡,806,736,20200513,1542
20200510,G,평내호평,2899,2906,20200513,5805
20200510,G,천마산,962,924,20200513,1886
20200510,G,마석,2348,2405,20200513,4753
20200510,G,대성리,641,534,20200513,1175
20200510,G,청평,1484,1194,20200513,2678
20200510,G,상천,487,398,20200513,885
20200510,G,가평,1527,1408,20200513,2935
20200510,G,굴봉산,252,219,20200513,471
20200510,G,백양리,149,175,20200513,324
20200510,G,강촌,816,576,20200513,1392
20200510,G,김유정,348,375,20200513,723
20200510,G,남춘천,1985,2198,20200513,4183
20200510,G,춘천,1438,1319,20200513,2757
20200511,G,춘천,1190,1152,20200514,2342
20200511,G,남춘천,1998,2212,20200514,4210
20200511,G,김유정,246,253,20200514,499
20200511,G,강촌,421,393,20200514,814
20200511,G,백양리,112,110,20200514,222
20200511,G,굴봉산,203,201,20200514,404
20200511,G,가평,1583,1592,20200514,3175
20200511,G,상천,310,328,20200514,638
20200511,G,청평,1563,1461,20200514,3024
20200511,G,대성리,532,460,20200514,992
20200511,G,마석,3707,3598,20200514,7305
20200511,G,천마산,1526,1418,20200514,2944
20200511,G,평내호평,5619,5476,20200514,11095
20200511,G,금곡,1524,1398,20200514,2922
20200511,G,사릉,3468,3296,20200514,6764
20200511,G,퇴계원,3551,3240,20200514,6791
20200511,G,별내,2442,2352,20200514,4794
20200511,G,갈매,2944,2528,20200514,5472
20200511,G,신내,1249,1279,20200514,2528
20200512,G,신내,1327,1334,20200515,2661
20200512,G,갈매,2778,2502,20200515,5280
20200512,G,별내,2477,2441,20200515,4918
20200512,G,퇴계원,3534,3194,20200515,6728
20200512,G,사릉,3348,3171,20200515,6519
20200512,G,금곡,1455,1363,20200515,2818
20200512,G,평내호평,5523,5330,20200515,10853
20200512,G,천마산,1489,1410,20200515,2899
20200512,G,마석,3480,3480,20200515,6960
20200512,G,대성리,522,472,20200515,994
20200512,G,청평,1406,1478,20200515,2884
20200512,G,상천,326,291,20200515,617
20200512,G,가평,1446,1439,20200515,2885
20200512,G,굴봉산,186,184,20200515,370
20200512,G,백양리,92,103,20200515,195
20200512,G,강촌,368,337,20200515,705
20200512,G,김유정,279,278,20200515,557
20200512,G,남춘천,2265,2359,20200515,4624
20200512,G,춘천,1149,1055,20200515,2204
20200513,G,신내,1289,1306,20200516,2595
20200513,G,갈매,2821,2526,20200516,5347
20200513,G,별내,2407,2324,20200516,4731
20200513,G,퇴계원,3560,3254,20200516,6814
20200513,G,사릉,3311,3160,20200516,6471
20200513,G,금곡,1445,1355,20200516,2800
20200513,G,평내호평,5551,5430,20200516,10981
20200513,G,천마산,1565,1484,20200516,3049
20200513,G,마석,3720,3722,20200516,7442
20200513,G,대성리,599,528,20200516,1127
20200513,G,청평,1608,1533,20200516,3141
20200513,G,상천,352,355,20200516,707
20200513,G,가평,1554,1578,20200516,3132
20200513,G,굴봉산,230,210,20200516,440
20200513,G,백양리,104,98,20200516,202
20200513,G,강촌,436,414,20200516,850
20200513,G,김유정,288,336,20200516,624
20200513,G,남춘천,1953,2012,20200516,3965
20200513,G,춘천,1148,1010,20200516,2158
20200514,G,춘천,1230,1075,20200517,2305
20200514,G,남춘천,1990,2064,20200517,4054
20200514,G,김유정,294,307,20200517,601
20200514,G,강촌,364,367,20200517,731
20200514,G,백양리,114,102,20200517,216
20200514,G,굴봉산,178,186,20200517,364
20200514,G,가평,1530,1521,20200517,3051
20200514,G,상천,363,351,20200517,714
20200514,G,청평,1510,1855,20200517,3365
20200514,G,대성리,589,482,20200517,1071
20200514,G,마석,3634,3501,20200517,7135
20200514,G,천마산,1463,1444,20200517,2907
20200514,G,평내호평,5545,5416,20200517,10961
20200514,G,금곡,1416,1391,20200517,2807
20200514,G,사릉,3319,3181,20200517,6500
20200514,G,퇴계원,3568,3201,20200517,6769
20200514,G,별내,2487,2393,20200517,4880
20200514,G,갈매,2889,2470,20200517,5359
20200514,G,신내,1342,1322,20200517,2664
20200515,G,춘천,1165,947,20200518,2112
20200515,G,남춘천,2128,2108,20200518,4236
20200515,G,김유정,151,196,20200518,347
20200515,G,강촌,235,243,20200518,478
20200515,G,백양리,70,51,20200518,121
20200515,G,굴봉산,84,101,20200518,185
20200515,G,가평,1232,1415,20200518,2647
20200515,G,상천,189,173,20200518,362
20200515,G,청평,1402,1405,20200518,2807
20200515,G,대성리,361,381,20200518,742
20200515,G,마석,3256,3112,20200518,6368
20200515,G,천마산,1356,1240,20200518,2596
20200515,G,평내호평,5002,5105,20200518,10107
20200515,G,금곡,1277,1228,20200518,2505
20200515,G,사릉,3141,2872,20200518,6013
20200515,G,퇴계원,3253,3018,20200518,6271
20200515,G,별내,2340,2232,20200518,4572
20200515,G,갈매,2724,2439,20200518,5163
20200515,G,신내,1179,1146,20200518,2325
20200516,G,춘천,1321,1197,20200519,2518
20200516,G,남춘천,2176,2186,20200519,4362
20200516,G,김유정,392,434,20200519,826
20200516,G,강촌,564,600,20200519,1164
20200516,G,백양리,123,118,20200519,241
20200516,G,굴봉산,154,164,20200519,318
20200516,G,가평,1443,1628,20200519,3071
20200516,G,상천,297,274,20200519,571
20200516,G,청평,1444,1614,20200519,3058
20200516,G,대성리,597,710,20200519,1307
20200516,G,마석,2732,2814,20200519,5546
20200516,G,천마산,1130,1138,20200519,2268
20200516,G,평내호평,3886,3822,20200519,7708
20200516,G,금곡,1002,972,20200519,1974
20200516,G,사릉,2088,2017,20200519,4105
20200516,G,퇴계원,2301,2121,20200519,4422
20200516,G,별내,1757,1786,20200519,3543
20200516,G,갈매,1693,1496,20200519,3189
20200516,G,신내,873,956,20200519,1829
20200517,G,춘천,1509,1300,20200520,2809
20200517,G,남춘천,2484,2649,20200520,5133
20200517,G,김유정,422,486,20200520,908
20200517,G,강촌,857,749,20200520,1606
20200517,G,백양리,168,155,20200520,323
20200517,G,굴봉산,296,306,20200520,602
20200517,G,가평,1797,1553,20200520,3350
20200517,G,상천,601,465,20200520,1066
20200517,G,청평,1784,1482,20200520,3266
20200517,G,대성리,850,606,20200520,1456
20200517,G,마석,2510,2533,20200520,5043
20200517,G,천마산,1039,1087,20200520,2126
20200517,G,평내호평,2912,3047,20200520,5959
20200517,G,금곡,774,750,20200520,1524
20200517,G,사릉,1578,1567,20200520,3145
20200517,G,퇴계원,1909,1774,20200520,3683
20200517,G,별내,1433,1449,20200520,2882
20200517,G,갈매,1341,1222,20200520,2563
20200517,G,신내,804,821,20200520,1625
20200518,G,신내,1241,1186,20200521,2427
20200518,G,갈매,2736,2414,20200521,5150
20200518,G,별내,2232,2184,20200521,4416
20200518,G,퇴계원,3342,3092,20200521,6434
20200518,G,사릉,3203,2990,20200521,6193
20200518,G,금곡,1363,1288,20200521,2651
20200518,G,평내호평,5349,5048,20200521,10397
20200518,G,천마산,1429,1332,20200521,2761
20200518,G,마석,3396,3339,20200521,6735
20200518,G,대성리,430,354,20200521,784
20200518,G,청평,1370,1293,20200521,2663
20200518,G,상천,207,207,20200521,414
20200518,G,가평,1331,1238,20200521,2569
20200518,G,굴봉산,108,122,20200521,230
20200518,G,백양리,76,57,20200521,133
20200518,G,강촌,284,255,20200521,539
20200518,G,김유정,190,164,20200521,354
20200518,G,남춘천,1820,1932,20200521,3752
20200518,G,춘천,968,984,20200521,1952
20200519,G,춘천,931,853,20200522,1784
20200519,G,남춘천,1682,1852,20200522,3534
20200519,G,김유정,175,183,20200522,358
20200519,G,강촌,209,209,20200522,418
20200519,G,백양리,51,54,20200522,105
20200519,G,굴봉산,90,101,20200522,191
20200519,G,가평,1231,1167,20200522,2398
20200519,G,상천,174,189,20200522,363
20200519,G,청평,1257,1188,20200522,2445
20200519,G,대성리,361,319,20200522,680
20200519,G,마석,3179,3066,20200522,6245
20200519,G,천마산,1315,1269,20200522,2584
20200519,G,평내호평,5173,5035,20200522,10208
20200519,G,금곡,1319,1226,20200522,2545
20200519,G,사릉,3125,2967,20200522,6092
20200519,G,퇴계원,3349,3070,20200522,6419
20200519,G,별내,2314,2229,20200522,4543
20200519,G,갈매,2752,2410,20200522,5162
20200519,G,신내,1187,1199,20200522,2386
20200520,G,춘천,1152,1043,20200523,2195
20200520,G,남춘천,1989,2055,20200523,4044
20200520,G,김유정,375,388,20200523,763
20200520,G,강촌,388,387,20200523,775
20200520,G,백양리,94,88,20200523,182
20200520,G,굴봉산,148,171,20200523,319
20200520,G,가평,1621,1654,20200523,3275
20200520,G,상천,331,320,20200523,651
20200520,G,청평,1510,1558,20200523,3068
20200520,G,대성리,604,596,20200523,1200
20200520,G,마석,3629,3537,20200523,7166
20200520,G,천마산,1588,1501,20200523,3089
20200520,G,평내호평,5592,5514,20200523,11106
20200520,G,금곡,1504,1417,20200523,2921
20200520,G,사릉,3488,3271,20200523,6759
20200520,G,퇴계원,3648,3251,20200523,6899
20200520,G,별내,2562,2434,20200523,4996
20200520,G,갈매,2940,2603,20200523,5543
20200520,G,신내,1410,1404,20200523,2814
20200521,G,춘천,1300,1150,20200524,2450
20200521,G,남춘천,2130,2217,20200524,4347
20200521,G,김유정,325,369,20200524,694
20200521,G,강촌,424,406,20200524,830
20200521,G,백양리,122,123,20200524,245
20200521,G,굴봉산,212,203,20200524,415
20200521,G,가평,1611,1629,20200524,3240
20200521,G,상천,307,324,20200524,631
20200521,G,청평,1552,1726,20200524,3278
20200521,G,대성리,611,566,20200524,1177
20200521,G,마석,3476,3427,20200524,6903
20200521,G,천마산,1542,1406,20200524,2948
20200521,G,평내호평,5719,5553,20200524,11272
20200521,G,금곡,1514,1415,20200524,2929
20200521,G,사릉,3395,3216,20200524,6611
20200521,G,퇴계원,3589,3281,20200524,6870
20200521,G,별내,2487,2415,20200524,4902
20200521,G,갈매,2929,2505,20200524,5434
20200521,G,신내,1395,1407,20200524,2802
20200522,G,신내,1376,1364,20200525,2740
20200522,G,갈매,2960,2555,20200525,5515
20200522,G,별내,2581,2562,20200525,5143
20200522,G,퇴계원,3660,3308,20200525,6968
20200522,G,사릉,3440,3227,20200525,6667
20200522,G,금곡,1521,1500,20200525,3021
20200522,G,평내호평,5615,5672,20200525,11287
20200522,G,천마산,1595,1450,20200525,3045
20200522,G,마석,3611,3608,20200525,7219
20200522,G,대성리,594,664,20200525,1258
20200522,G,청평,1680,1789,20200525,3469
20200522,G,상천,271,260,20200525,531
20200522,G,가평,1597,1799,20200525,3396
20200522,G,굴봉산,180,174,20200525,354
20200522,G,백양리,96,97,20200525,193
20200522,G,강촌,361,416,20200525,777
20200522,G,김유정,246,296,20200525,542
20200522,G,남춘천,2740,2750,20200525,5490
20200522,G,춘천,1445,1174,20200525,2619
20200523,G,신내,1055,1054,20200526,2109
20200523,G,갈매,1837,1627,20200526,3464
20200523,G,별내,2015,1990,20200526,4005
20200523,G,퇴계원,2659,2384,20200526,5043
20200523,G,사릉,2263,2188,20200526,4451
20200523,G,금곡,1111,1058,20200526,2169
20200523,G,평내호평,4299,4191,20200526,8490
20200523,G,천마산,1208,1285,20200526,2493
20200523,G,마석,3092,3068,20200526,6160
20200523,G,대성리,823,704,20200526,1527
20200523,G,청평,1850,2022,20200526,3872
20200523,G,상천,534,458,20200526,992
20200523,G,가평,1958,2181,20200526,4139
20200523,G,굴봉산,258,284,20200526,542
20200523,G,백양리,135,146,20200526,281
20200523,G,강촌,824,777,20200526,1601
20200523,G,김유정,513,656,20200526,1169
20200523,G,남춘천,2432,2542,20200526,4974
20200523,G,춘천,2019,1677,20200526,3696
20200524,G,춘천,1359,1143,20200527,2502
20200524,G,남춘천,1742,1888,20200527,3630
20200524,G,김유정,318,335,20200527,653
20200524,G,강촌,583,439,20200527,1022
20200524,G,백양리,90,57,20200527,147
20200524,G,굴봉산,163,142,20200527,305
20200524,G,가평,1405,1127,20200527,2532
20200524,G,상천,313,226,20200527,539
20200524,G,청평,1445,1035,20200527,2480
20200524,G,대성리,513,373,20200527,886
20200524,G,마석,1895,1865,20200527,3760
20200524,G,천마산,857,848,20200527,1705
20200524,G,평내호평,2681,2729,20200527,5410
20200524,G,금곡,741,704,20200527,1445
20200524,G,사릉,1441,1491,20200527,2932
20200524,G,퇴계원,1691,1578,20200527,3269
20200524,G,별내,1360,1308,20200527,2668
20200524,G,갈매,1203,1112,20200527,2315
20200524,G,신내,644,666,20200527,1310
20200525,G,춘천,1183,1213,20200528,2396
20200525,G,남춘천,1920,2038,20200528,3958
20200525,G,김유정,245,247,20200528,492
20200525,G,강촌,330,319,20200528,649
20200525,G,백양리,89,100,20200528,189
20200525,G,굴봉산,160,144,20200528,304
20200525,G,가평,1654,1614,20200528,3268
20200525,G,상천,298,305,20200528,603
20200525,G,청평,1543,1553,20200528,3096
20200525,G,대성리,532,440,20200528,972
20200525,G,마석,3647,3431,20200528,7078
20200525,G,천마산,1537,1443,20200528,2980
20200525,G,평내호평,5731,5491,20200528,11222
20200525,G,금곡,1472,1426,20200528,2898
20200525,G,사릉,3482,3290,20200528,6772
20200525,G,퇴계원,3627,3207,20200528,6834
20200525,G,별내,2482,2432,20200528,4914
20200525,G,갈매,2965,2564,20200528,5529
20200525,G,신내,1386,1355,20200528,2741
20200526,G,춘천,1146,1079,20200529,2225
20200526,G,남춘천,1875,2010,20200529,3885
20200526,G,김유정,236,243,20200529,479
20200526,G,강촌,419,388,20200529,807
20200526,G,백양리,86,73,20200529,159
20200526,G,굴봉산,176,160,20200529,336
20200526,G,가평,1526,1531,20200529,3057
20200526,G,상천,307,291,20200529,598
20200526,G,청평,1515,1544,20200529,3059
20200526,G,대성리,433,444,20200529,877
20200526,G,마석,3464,3371,20200529,6835
20200526,G,천마산,1473,1358,20200529,2831
20200526,G,평내호평,5593,5427,20200529,11020
20200526,G,금곡,1487,1412,20200529,2899
20200526,G,사릉,3386,3172,20200529,6558
20200526,G,퇴계원,3502,3181,20200529,6683
20200526,G,별내,2441,2421,20200529,4862
20200526,G,갈매,2861,2480,20200529,5341
20200526,G,신내,1369,1386,20200529,2755
20200527,G,춘천,1253,1149,20200530,2402
20200527,G,남춘천,2506,2638,20200530,5144
20200527,G,김유정,346,389,20200530,735
20200527,G,강촌,392,380,20200530,772
20200527,G,백양리,101,98,20200530,199
20200527,G,굴봉산,150,151,20200530,301
20200527,G,가평,1635,1701,20200530,3336
20200527,G,상천,363,337,20200530,700
20200527,G,청평,1657,1637,20200530,3294
20200527,G,대성리,521,450,20200530,971
20200527,G,마석,3697,3577,20200530,7274
20200527,G,천마산,1568,1454,20200530,3022
20200527,G,평내호평,5756,5607,20200530,11363
20200527,G,금곡,1489,1439,20200530,2928
20200527,G,사릉,3390,3317,20200530,6707
20200527,G,퇴계원,3641,3297,20200530,6938
20200527,G,별내,2543,2459,20200530,5002
20200527,G,갈매,2699,2275,20200530,4974
20200527,G,신내,1446,1408,20200530,2854
20200528,G,춘천,1300,1099,20200531,2399
20200528,G,남춘천,2076,2125,20200531,4201
20200528,G,김유정,321,369,20200531,690
20200528,G,강촌,360,361,20200531,721
20200528,G,백양리,86,91,20200531,177
20200528,G,굴봉산,118,131,20200531,249
20200528,G,가평,1607,1663,20200531,3270
20200528,G,상천,285,281,20200531,566
20200528,G,청평,1541,1724,20200531,3265
20200528,G,대성리,471,409,20200531,880
20200528,G,마석,3719,3634,20200531,7353
20200528,G,천마산,1495,1391,20200531,2886
20200528,G,평내호평,5737,5495,20200531,11232
20200528,G,금곡,1477,1398,20200531,2875
20200528,G,사릉,3417,3316,20200531,6733
20200528,G,퇴계원,3523,3193,20200531,6716
20200528,G,별내,2591,2456,20200531,5047
20200528,G,갈매,2615,2236,20200531,4851
20200528,G,신내,1385,1410,20200531,2795
20200529,G,신내,1433,1449,20200601,2882
20200529,G,갈매,2679,2287,20200601,4966
20200529,G,별내,2553,2497,20200601,5050
20200529,G,퇴계원,3498,3310,20200601,6808
20200529,G,사릉,3432,3218,20200601,6650
20200529,G,금곡,1473,1413,20200601,2886
20200529,G,평내호평,5671,5670,20200601,11341
20200529,G,천마산,1590,1455,20200601,3045
20200529,G,마석,3632,3558,20200601,7190
20200529,G,대성리,524,668,20200601,1192
20200529,G,청평,1691,1781,20200601,3472
20200529,G,상천,291,311,20200601,602
20200529,G,가평,1765,1869,20200601,3634
20200529,G,굴봉산,156,156,20200601,312
20200529,G,백양리,114,142,20200601,256
20200529,G,강촌,409,443,20200601,852
20200529,G,김유정,268,343,20200601,611
20200529,G,남춘천,2295,2435,20200601,4730
20200529,G,춘천,1540,1282,20200601,2822
20200530,G,신내,1003,1052,20200602,2055
20200530,G,갈매,1601,1425,20200602,3026
20200530,G,별내,1962,1817,20200602,3779
20200530,G,퇴계원,2427,2162,20200602,4589
20200530,G,사릉,2226,2159,20200602,4385
20200530,G,금곡,1042,1002,20200602,2044
20200530,G,평내호평,4104,4082,20200602,8186
20200530,G,천마산,1277,1227,20200602,2504
20200530,G,마석,2912,2908,20200602,5820
20200530,G,대성리,831,863,20200602,1694
20200530,G,청평,1656,1927,20200602,3583
20200530,G,상천,498,433,20200602,931
20200530,G,가평,2001,2249,20200602,4250
20200530,G,굴봉산,250,294,20200602,544
20200530,G,백양리,151,141,20200602,292
20200530,G,강촌,785,800,20200602,1585
20200530,G,김유정,474,577,20200602,1051
20200530,G,남춘천,2450,2516,20200602,4966
20200530,G,춘천,1911,1684,20200602,3595
20200531,G,춘천,1724,1427,20200603,3151
20200531,G,남춘천,1935,2058,20200603,3993
20200531,G,김유정,434,437,20200603,871
20200531,G,강촌,875,752,20200603,1627
20200531,G,백양리,152,120,20200603,272
20200531,G,굴봉산,252,254,20200603,506
20200531,G,가평,1881,1600,20200603,3481
20200531,G,상천,442,349,20200603,791
20200531,G,청평,1763,1290,20200603,3053
20200531,G,대성리,876,617,20200603,1493
20200531,G,마석,2171,2244,20200603,4415
20200531,G,천마산,931,949,20200603,1880
20200531,G,평내호평,3042,3070,20200603,6112
20200531,G,금곡,800,739,20200603,1539
20200531,G,사릉,1573,1582,20200603,3155
20200531,G,퇴계원,1851,1815,20200603,3666
20200531,G,별내,1368,1350,20200603,2718
20200531,G,갈매,1188,1068,20200603,2256
20200531,G,신내,666,702,20200603,1368
20200101,A,영종,2084,2010,20200104,4094
20200101,A,인천공항2터미널,5990,5801,20200104,11791
20200101,A,인천공항1터미널,16835,17571,20200104,34406
20200101,A,공항화물청사,1344,1439,20200104,2783
20200101,A,운서,5812,6205,20200104,12017
20200101,A,청라국제도시,2909,2894,20200104,5803
20200101,A,검암,3749,4134,20200104,7883
20200101,A,계양,4539,4675,20200104,9214
20200101,A,김포공항,8633,4690,20200104,13323
20200101,A,마곡나루,1495,1764,20200104,3259
20200101,A,디지털미디어시티,3420,3501,20200104,6921
20200101,A,홍대입구,10405,9279,20200104,19684
20200101,A,공덕,1281,1964,20200104,3245
20200101,A,서울역,14369,10789,20200104,25158
20200102,A,서울역,14563,11779,20200105,26342
20200102,A,공덕,2741,3602,20200105,6343
20200102,A,홍대입구,12860,12436,20200105,25296
20200102,A,디지털미디어시티,15588,13744,20200105,29332
20200102,A,마곡나루,7672,6905,20200105,14577
20200102,A,김포공항,10898,6974,20200105,17872
20200102,A,계양,10924,9754,20200105,20678
20200102,A,검암,8743,8146,20200105,16889
20200102,A,청라국제도시,7481,6909,20200105,14390
20200102,A,운서,7562,8105,20200105,15667
20200102,A,공항화물청사,2669,3006,20200105,5675
20200102,A,인천공항1터미널,16233,16860,20200105,33093
20200102,A,인천공항2터미널,5982,5497,20200105,11479
20200102,A,영종,3022,3036,20200105,6058
20200103,A,서울역,16000,13245,20200106,29245
20200103,A,공덕,2898,3757,20200106,6655
20200103,A,홍대입구,13732,14199,20200106,27931
20200103,A,디지털미디어시티,15676,13792,20200106,29468
20200103,A,마곡나루,8513,7111,20200106,15624
20200103,A,김포공항,11998,6776,20200106,18774
20200103,A,계양,11135,10171,20200106,21306
20200103,A,검암,9119,8520,20200106,17639
20200103,A,청라국제도시,7952,7183,20200106,15135
20200103,A,운서,7923,8298,20200106,16221
20200103,A,공항화물청사,2804,3013,20200106,5817
20200103,A,인천공항1터미널,16807,16833,20200106,33640
20200103,A,인천공항2터미널,5878,5210,20200106,11088
20200103,A,영종,3096,3297,20200106,6393
20200104,A,서울역,14880,12779,20200107,27659
20200104,A,공덕,2231,3398,20200107,5629
20200104,A,홍대입구,14817,14439,20200107,29256
20200104,A,디지털미디어시티,7122,6469,20200107,13591
20200104,A,마곡나루,2636,2783,20200107,5419
20200104,A,김포공항,10108,5491,20200107,15599
20200104,A,계양,8052,7258,20200107,15310
20200104,A,검암,5966,5959,20200107,11925
20200104,A,청라국제도시,4618,4416,20200107,9034
20200104,A,운서,7259,7833,20200107,15092
20200104,A,공항화물청사,1633,1715,20200107,3348
20200104,A,인천공항1터미널,16074,16738,20200107,32812
20200104,A,인천공항2터미널,5582,5267,20200107,10849
20200104,A,영종,2936,2867,20200107,5803
20200105,A,서울역,14277,11073,20200108,25350
20200105,A,공덕,1502,2001,20200108,3503
20200105,A,홍대입구,11792,10504,20200108,22296
20200105,A,디지털미디어시티,4116,4229,20200108,8345
20200105,A,마곡나루,1781,2095,20200108,3876
20200105,A,김포공항,9043,5190,20200108,14233
20200105,A,계양,5792,5588,20200108,11380
20200105,A,검암,4583,4797,20200108,9380
20200105,A,청라국제도시,3366,3358,20200108,6724
20200105,A,운서,6168,6898,20200108,13066
20200105,A,공항화물청사,1228,1415,20200108,2643
20200105,A,인천공항1터미널,15139,16502,20200108,31641
20200105,A,인천공항2터미널,5757,5215,20200108,10972
20200105,A,영종,2262,2373,20200108,4635
20200106,A,서울역,13217,11048,20200109,24265
20200106,A,공덕,2708,3445,20200109,6153
20200106,A,홍대입구,11564,11218,20200109,22782
20200106,A,디지털미디어시티,15552,13780,20200109,29332
20200106,A,마곡나루,7832,7139,20200109,14971
20200106,A,김포공항,11716,7190,20200109,18906
20200106,A,계양,11119,10098,20200109,21217
20200106,A,검암,8870,8323,20200109,17193
20200106,A,청라국제도시,7613,7021,20200109,14634
20200106,A,운서,7594,8000,20200109,15594
20200106,A,공항화물청사,2697,3083,20200109,5780
20200106,A,인천공항1터미널,15133,16717,20200109,31850
20200106,A,인천공항2터미널,5466,4944,20200109,10410
20200106,A,영종,3097,3063,20200109,6160
20200107,A,서울역,12581,10603,20200110,23184
20200107,A,공덕,2643,3462,20200110,6105
20200107,A,홍대입구,10744,10923,20200110,21667
20200107,A,디지털미디어시티,15340,13620,20200110,28960
20200107,A,마곡나루,7602,6768,20200110,14370
20200107,A,김포공항,11287,6997,20200110,18284
20200107,A,계양,10398,9586,20200110,19984
20200107,A,검암,8404,8020,20200110,16424
20200107,A,청라국제도시,7470,6961,20200110,14431
20200107,A,운서,7252,7422,20200110,14674
20200107,A,공항화물청사,2794,3101,20200110,5895
20200107,A,인천공항1터미널,14128,15444,20200110,29572
20200107,A,인천공항2터미널,5180,4822,20200110,10002
20200107,A,영종,2793,2854,20200110,5647
20200108,A,서울역,12673,10792,20200111,23465
20200108,A,공덕,2708,3611,20200111,6319
20200108,A,홍대입구,12092,11943,20200111,24035
20200108,A,디지털미디어시티,15662,14211,20200111,29873
20200108,A,마곡나루,8101,7205,20200111,15306
20200108,A,김포공항,11945,7317,20200111,19262
20200108,A,계양,10879,10175,20200111,21054
20200108,A,검암,8969,8425,20200111,17394
20200108,A,청라국제도시,7644,7082,20200111,14726
20200108,A,운서,7628,7901,20200111,15529
20200108,A,공항화물청사,2951,3181,20200111,6132
20200108,A,인천공항1터미널,13981,14966,20200111,28947
20200108,A,인천공항2터미널,5390,4815,20200111,10205
20200108,A,영종,3052,3136,20200111,6188
20200109,A,서울역,12892,10708,20200112,23600
20200109,A,공덕,2759,3685,20200112,6444
20200109,A,홍대입구,11889,12165,20200112,24054
20200109,A,디지털미디어시티,16625,14632,20200112,31257
20200109,A,마곡나루,8228,7250,20200112,15478
20200109,A,김포공항,12266,7285,20200112,19551
20200109,A,계양,11141,10085,20200112,21226
20200109,A,검암,9058,8628,20200112,17686
20200109,A,청라국제도시,7774,7276,20200112,15050
20200109,A,운서,7879,8018,20200112,15897
20200109,A,공항화물청사,2943,3313,20200112,6256
20200109,A,인천공항1터미널,15464,15224,20200112,30688
20200109,A,인천공항2터미널,5429,4747,20200112,10176
20200109,A,영종,3174,3244,20200112,6418
20200110,A,서울역,15248,13439,20200113,28687
20200110,A,공덕,2927,3914,20200113,6841
20200110,A,홍대입구,13201,14203,20200113,27404
20200110,A,디지털미디어시티,16084,14141,20200113,30225
20200110,A,마곡나루,8791,7438,20200113,16229
20200110,A,김포공항,13051,7165,20200113,20216
20200110,A,계양,11462,10203,20200113,21665
20200110,A,검암,9490,8911,20200113,18401
20200110,A,청라국제도시,8222,7478,20200113,15700
20200110,A,운서,8376,8477,20200113,16853
20200110,A,공항화물청사,2987,3171,20200113,6158
20200110,A,인천공항1터미널,17452,16085,20200113,33537
20200110,A,인천공항2터미널,5991,5113,20200113,11104
20200110,A,영종,3263,3430,20200113,6693
20200111,A,서울역,14295,13627,20200114,27922
20200111,A,공덕,2365,3639,20200114,6004
20200111,A,홍대입구,15501,15634,20200114,31135
20200111,A,디지털미디어시티,7359,6563,20200114,13922
20200111,A,마곡나루,2895,3176,20200114,6071
20200111,A,김포공항,11103,5594,20200114,16697
20200111,A,계양,8423,7497,20200114,15920
20200111,A,검암,6527,6228,20200114,12755
20200111,A,청라국제도시,5193,4855,20200114,10048
20200111,A,운서,7453,7744,20200114,15197
20200111,A,공항화물청사,1716,1830,20200114,3546
20200111,A,인천공항1터미널,18429,15796,20200114,34225
20200111,A,인천공항2터미널,6312,4764,20200114,11076
20200111,A,영종,3039,3165,20200114,6204
20200112,A,서울역,14322,11965,20200115,26287
20200112,A,공덕,1663,2222,20200115,3885
20200112,A,홍대입구,12951,11401,20200115,24352
20200112,A,디지털미디어시티,4215,4217,20200115,8432
20200112,A,마곡나루,1805,2163,20200115,3968
20200112,A,김포공항,9380,5243,20200115,14623
20200112,A,계양,5878,5830,20200115,11708
20200112,A,검암,4768,4889,20200115,9657
20200112,A,청라국제도시,3580,3574,20200115,7154
20200112,A,운서,6214,7130,20200115,13344
20200112,A,공항화물청사,1412,1524,20200115,2936
20200112,A,인천공항1터미널,15619,16545,20200115,32164
20200112,A,인천공항2터미널,6126,4956,20200115,11082
20200112,A,영종,2386,2398,20200115,4784
20200113,A,서울역,14014,11748,20200116,25762
20200113,A,공덕,2736,3443,20200116,6179
20200113,A,홍대입구,12168,11512,20200116,23680
20200113,A,디지털미디어시티,15392,13792,20200116,29184
20200113,A,마곡나루,7952,7113,20200116,15065
20200113,A,김포공항,11696,7249,20200116,18945
20200113,A,계양,11047,10101,20200116,21148
20200113,A,검암,9000,8472,20200116,17472
20200113,A,청라국제도시,7722,7133,20200116,14855
20200113,A,운서,7899,8280,20200116,16179
20200113,A,공항화물청사,2908,3194,20200116,6102
20200113,A,인천공항1터미널,15781,17767,20200116,33548
20200113,A,인천공항2터미널,5977,5515,20200116,11492
20200113,A,영종,3117,3206,20200116,6323
20200114,A,영종,3074,3265,20200117,6339
20200114,A,인천공항2터미널,5445,4937,20200117,10382
20200114,A,인천공항1터미널,15434,16163,20200117,31597
20200114,A,공항화물청사,2933,3184,20200117,6117
20200114,A,운서,7957,8159,20200117,16116
20200114,A,청라국제도시,7726,7198,20200117,14924
20200114,A,검암,9056,8562,20200117,17618
20200114,A,계양,11175,10077,20200117,21252
20200114,A,김포공항,11828,7276,20200117,19104
20200114,A,마곡나루,8125,7321,20200117,15446
20200114,A,디지털미디어시티,15808,14176,20200117,29984
20200114,A,홍대입구,12149,12241,20200117,24390
20200114,A,공덕,2730,3527,20200117,6257
20200114,A,서울역,13425,11169,20200117,24594
20200115,A,서울역,13053,11153,20200118,24206
20200115,A,공덕,2789,3729,20200118,6518
20200115,A,홍대입구,12349,12527,20200118,24876
20200115,A,디지털미디어시티,15871,14250,20200118,30121
20200115,A,마곡나루,8246,7227,20200118,15473
20200115,A,김포공항,12056,7379,20200118,19435
20200115,A,계양,11107,10061,20200118,21168
20200115,A,검암,9078,8441,20200118,17519
20200115,A,청라국제도시,7830,7245,20200118,15075
20200115,A,운서,7916,8227,20200118,16143
20200115,A,공항화물청사,2959,3311,20200118,6270
20200115,A,인천공항1터미널,15934,15656,20200118,31590
20200115,A,인천공항2터미널,5992,5020,20200118,11012
20200115,A,영종,3119,3164,20200118,6283
20200116,A,영종,3120,3340,20200119,6460
20200116,A,인천공항2터미널,5673,4776,20200119,10449
20200116,A,인천공항1터미널,16372,15703,20200119,32075
20200116,A,공항화물청사,2964,3289,20200119,6253
20200116,A,운서,8037,8404,20200119,16441
20200116,A,청라국제도시,7817,7205,20200119,15022
20200116,A,검암,9201,8655,20200119,17856
20200116,A,계양,11099,10089,20200119,21188
20200116,A,김포공항,12277,7240,20200119,19517
20200116,A,마곡나루,8186,7408,20200119,15594
20200116,A,디지털미디어시티,16690,14936,20200119,31626
20200116,A,홍대입구,12601,12765,20200119,25366
20200116,A,공덕,2813,3668,20200119,6481
20200116,A,서울역,13258,11383,20200119,24641
20200117,A,서울역,15865,13799,20200120,29664
20200117,A,공덕,3002,3942,20200120,6944
20200117,A,홍대입구,13939,14920,20200120,28859
20200117,A,디지털미디어시티,16159,14309,20200120,30468
20200117,A,마곡나루,8966,7488,20200120,16454
20200117,A,김포공항,13279,7237,20200120,20516
20200117,A,계양,11535,10212,20200120,21747
20200117,A,검암,9548,8807,20200120,18355
20200117,A,청라국제도시,8172,7377,20200120,15549
20200117,A,운서,8309,8569,20200120,16878
20200117,A,공항화물청사,2762,3157,20200120,5919
20200117,A,인천공항1터미널,18585,16648,20200120,35233
20200117,A,인천공항2터미널,6059,5023,20200120,11082
20200117,A,영종,3353,3449,20200120,6802
20200118,A,서울역,14154,13229,20200121,27383
20200118,A,공덕,2179,3491,20200121,5670
20200118,A,홍대입구,15919,15573,20200121,31492
20200118,A,디지털미디어시티,7669,7038,20200121,14707
20200118,A,마곡나루,2899,3020,20200121,5919
20200118,A,김포공항,10954,5730,20200121,16684
20200118,A,계양,8496,7782,20200121,16278
20200118,A,검암,6383,6047,20200121,12430
20200118,A,청라국제도시,5156,4914,20200121,10070
20200118,A,운서,7432,7538,20200121,14970
20200118,A,공항화물청사,1673,1753,20200121,3426
20200118,A,인천공항1터미널,16832,15949,20200121,32781
20200118,A,인천공항2터미널,5819,4933,20200121,10752
20200118,A,영종,3007,3031,20200121,6038
20200119,A,서울역,13943,11842,20200122,25785
20200119,A,공덕,1629,2135,20200122,3764
20200119,A,홍대입구,12513,10859,20200122,23372
20200119,A,디지털미디어시티,4222,4149,20200122,8371
20200119,A,마곡나루,1820,2155,20200122,3975
20200119,A,김포공항,8928,5296,20200122,14224
20200119,A,계양,5519,5582,20200122,11101
20200119,A,검암,4431,4599,20200122,9030
20200119,A,청라국제도시,3538,3433,20200122,6971
20200119,A,운서,6016,6487,20200122,12503
20200119,A,공항화물청사,1305,1464,20200122,2769
20200119,A,인천공항1터미널,15528,17108,20200122,32636
20200119,A,인천공항2터미널,5471,4965,20200122,10436
20200119,A,영종,2192,2350,20200122,4542
20200120,A,영종,3131,3181,20200123,6312
20200120,A,인천공항2터미널,5677,4956,20200123,10633
20200120,A,인천공항1터미널,16296,17255,20200123,33551
20200120,A,공항화물청사,2767,3079,20200123,5846
20200120,A,운서,7931,8385,20200123,16316
20200120,A,청라국제도시,7690,7228,20200123,14918
20200120,A,검암,8839,8535,20200123,17374
20200120,A,계양,11049,9978,20200123,21027
20200120,A,김포공항,11746,7077,20200123,18823
20200120,A,마곡나루,8066,7403,20200123,15469
20200120,A,디지털미디어시티,15666,14036,20200123,29702
20200120,A,홍대입구,12131,11678,20200123,23809
20200120,A,공덕,2915,3600,20200123,6515
20200120,A,서울역,12857,11964,20200123,24821
20200121,A,서울역,12790,11515,20200124,24305
20200121,A,공덕,2918,3623,20200124,6541
20200121,A,홍대입구,12303,11844,20200124,24147
20200121,A,디지털미디어시티,16161,14655,20200124,30816
20200121,A,마곡나루,8260,7574,20200124,15834
20200121,A,김포공항,11598,7316,20200124,18914
20200121,A,계양,11080,10054,20200124,21134
20200121,A,검암,9031,8502,20200124,17533
20200121,A,청라국제도시,7717,7186,20200124,14903
20200121,A,운서,7840,8189,20200124,16029
20200121,A,공항화물청사,2728,3105,20200124,5833
20200121,A,인천공항1터미널,15635,15958,20200124,31593
20200121,A,인천공항2터미널,5335,4652,20200124,9987
20200121,A,영종,3063,3143,20200124,6206
20200122,A,서울역,13354,12845,20200125,26199
20200122,A,공덕,2857,3675,20200125,6532
20200122,A,홍대입구,12724,12046,20200125,24770
20200122,A,디지털미디어시티,16332,14372,20200125,30704
20200122,A,마곡나루,8515,7432,20200125,15947
20200122,A,김포공항,12289,7307,20200125,19596
20200122,A,계양,11155,10035,20200125,21190
20200122,A,검암,9125,8567,20200125,17692
20200122,A,청라국제도시,7667,7115,20200125,14782
20200122,A,운서,8125,8128,20200125,16253
20200122,A,공항화물청사,2896,3107,20200125,6003
20200122,A,인천공항1터미널,15101,16347,20200125,31448
20200122,A,인천공항2터미널,5657,5168,20200125,10825
20200122,A,영종,3106,3125,20200125,6231
20200123,A,서울역,13197,14481,20200126,27678
20200123,A,공덕,2773,3252,20200126,6025
20200123,A,홍대입구,12001,12208,20200126,24209
20200123,A,디지털미디어시티,14780,12284,20200126,27064
20200123,A,마곡나루,8157,6269,20200126,14426
20200123,A,김포공항,11700,6825,20200126,18525
20200123,A,계양,10381,9439,20200126,19820
20200123,A,검암,8805,8188,20200126,16993
20200123,A,청라국제도시,7544,6805,20200126,14349
20200123,A,운서,7911,7727,20200126,15638
20200123,A,공항화물청사,2545,2838,20200126,5383
20200123,A,인천공항1터미널,15615,16322,20200126,31937
20200123,A,인천공항2터미널,5528,5184,20200126,10712
20200123,A,영종,2971,3045,20200126,6016
20200124,A,영종,1742,1894,20200127,3636
20200124,A,인천공항2터미널,5546,4706,20200127,10252
20200124,A,인천공항1터미널,15792,14470,20200127,30262
20200124,A,공항화물청사,1175,1220,20200127,2395
20200124,A,운서,5486,5346,20200127,10832
20200124,A,청라국제도시,2854,2676,20200127,5530
20200124,A,검암,4005,4040,20200127,8045
20200124,A,계양,4454,4253,20200127,8707
20200124,A,김포공항,8852,4874,20200127,13726
20200124,A,마곡나루,1518,1433,20200127,2951
20200124,A,디지털미디어시티,3419,2645,20200127,6064
20200124,A,홍대입구,8200,7655,20200127,15855
20200124,A,공덕,1381,1502,20200127,2883
20200124,A,서울역,10180,12784,20200127,22964
20200125,A,서울역,12369,10578,20200128,22947
20200125,A,공덕,1084,1578,20200128,2662
20200125,A,홍대입구,6364,6656,20200128,13020
20200125,A,디지털미디어시티,2684,2594,20200128,5278
20200125,A,마곡나루,1265,1371,20200128,2636
20200125,A,김포공항,7742,4076,20200128,11818
20200125,A,계양,4484,4231,20200128,8715
20200125,A,검암,3834,3825,20200128,7659
20200125,A,청라국제도시,2291,2245,20200128,4536
20200125,A,운서,4860,5089,20200128,9949
20200125,A,공항화물청사,915,998,20200128,1913
20200125,A,인천공항1터미널,15692,12429,20200128,28121
20200125,A,인천공항2터미널,4878,3697,20200128,8575
20200125,A,영종,1708,1797,20200128,3505
20200126,A,서울역,14480,9077,20200129,23557
20200126,A,공덕,1193,1866,20200129,3059
20200126,A,홍대입구,9060,9601,20200129,18661
20200126,A,디지털미디어시티,2961,3274,20200129,6235
20200126,A,마곡나루,1484,1874,20200129,3358
20200126,A,김포공항,8775,4266,20200129,13041
20200126,A,계양,5045,4814,20200129,9859
20200126,A,검암,4212,4370,20200129,8582
20200126,A,청라국제도시,2778,2899,20200129,5677
20200126,A,운서,5043,5817,20200129,10860
20200126,A,공항화물청사,868,1050,20200129,1918
20200126,A,인천공항1터미널,13476,13392,20200129,26868
20200126,A,인천공항2터미널,4918,3604,20200129,8522
20200126,A,영종,1938,1927,20200129,3865
20200127,A,서울역,14715,10477,20200130,25192
20200127,A,공덕,1383,1955,20200130,3338
20200127,A,홍대입구,9298,9152,20200130,18450
20200127,A,디지털미디어시티,3375,3661,20200130,7036
20200127,A,마곡나루,1590,1948,20200130,3538
20200127,A,김포공항,10100,4543,20200130,14643
20200127,A,계양,5036,4930,20200130,9966
20200127,A,검암,4230,4365,20200130,8595
20200127,A,청라국제도시,3099,3116,20200130,6215
20200127,A,운서,5074,6193,20200130,11267
20200127,A,공항화물청사,1151,1311,20200130,2462
20200127,A,인천공항1터미널,13813,14045,20200130,27858
20200127,A,인천공항2터미널,5407,4237,20200130,9644
20200127,A,영종,2063,2059,20200130,4122
20200128,A,서울역,13616,9572,20200131,23188
20200128,A,공덕,2523,3250,20200131,5773
20200128,A,홍대입구,10574,10444,20200131,21018
20200128,A,디지털미디어시티,13962,12830,20200131,26792
20200128,A,마곡나루,6665,6009,20200131,12674
20200128,A,김포공항,10050,5987,20200131,16037
20200128,A,계양,9935,9038,20200131,18973
20200128,A,검암,8056,7833,20200131,15889
20200128,A,청라국제도시,6669,6249,20200131,12918
20200128,A,운서,7003,7887,20200131,14890
20200128,A,공항화물청사,2570,2847,20200131,5417
20200128,A,인천공항1터미널,14776,13529,20200131,28305
20200128,A,인천공항2터미널,5408,4253,20200131,9661
20200128,A,영종,2707,2862,20200131,5569
20200129,A,서울역,11921,9575,20200201,21496
20200129,A,공덕,2701,3436,20200201,6137
20200129,A,홍대입구,10983,11406,20200201,22389
20200129,A,디지털미디어시티,14984,13509,20200201,28493
20200129,A,마곡나루,7702,7008,20200201,14710
20200129,A,김포공항,11350,6001,20200201,17351
20200129,A,계양,10264,9388,20200201,19652
20200129,A,검암,8414,8114,20200201,16528
20200129,A,청라국제도시,7140,6621,20200201,13761
20200129,A,운서,7357,8012,20200201,15369
20200129,A,공항화물청사,2750,2932,20200201,5682
20200129,A,인천공항1터미널,15176,13122,20200201,28298
20200129,A,인천공항2터미널,5749,4430,20200201,10179
20200129,A,영종,2746,2836,20200201,5582
20200130,A,영종,2713,2892,20200202,5605
20200130,A,인천공항2터미널,5027,4087,20200202,9114
20200130,A,인천공항1터미널,14790,13034,20200202,27824
20200130,A,공항화물청사,2639,2935,20200202,5574
20200130,A,운서,7620,7936,20200202,15556
20200130,A,청라국제도시,7181,6642,20200202,13823
20200130,A,검암,8485,8074,20200202,16559
20200130,A,계양,10250,9294,20200202,19544
20200130,A,김포공항,10840,5850,20200202,16690
20200130,A,마곡나루,7705,6862,20200202,14567
20200130,A,디지털미디어시티,15685,14215,20200202,29900
20200130,A,홍대입구,11092,11288,20200202,22380
20200130,A,공덕,2599,3386,20200202,5985
20200130,A,서울역,11771,9783,20200202,21554
20200131,A,서울역,13100,10935,20200203,24035
20200131,A,공덕,2718,3547,20200203,6265
20200131,A,홍대입구,11310,11954,20200203,23264
20200131,A,디지털미디어시티,14974,13596,20200203,28570
20200131,A,마곡나루,8188,6957,20200203,15145
20200131,A,김포공항,10801,5694,20200203,16495
20200131,A,계양,10258,9243,20200203,19501
20200131,A,검암,8462,8068,20200203,16530
20200131,A,청라국제도시,7184,6494,20200203,13678
20200131,A,운서,7656,8031,20200203,15687
20200131,A,공항화물청사,2589,2870,20200203,5459
20200131,A,인천공항1터미널,14759,13291,20200203,28050
20200131,A,인천공항2터미널,5412,4230,20200203,9642
20200131,A,영종,2753,2963,20200203,5716
20200201,A,서울역,10865,9930,20200204,20795
20200201,A,공덕,1798,2790,20200204,4588
20200201,A,홍대입구,11464,11581,20200204,23045
20200201,A,디지털미디어시티,5077,4790,20200204,9867
20200201,A,마곡나루,2177,2336,20200204,4513
20200201,A,김포공항,8042,3963,20200204,12005
20200201,A,계양,6290,5694,20200204,11984
20200201,A,검암,4925,4876,20200204,9801
20200201,A,청라국제도시,3586,3462,20200204,7048
20200201,A,운서,6244,6555,20200204,12799
20200201,A,공항화물청사,1459,1535,20200204,2994
20200201,A,인천공항1터미널,13925,11877,20200204,25802
20200201,A,인천공항2터미널,4743,4000,20200204,8743
20200201,A,영종,2148,2264,20200204,4412
20200202,A,서울역,10516,8602,20200205,19118
20200202,A,공덕,1344,1671,20200205,3015
20200202,A,홍대입구,9552,8682,20200205,18234
20200202,A,디지털미디어시티,3316,3416,20200205,6732
20200202,A,마곡나루,1325,1550,20200205,2875
20200202,A,김포공항,6937,3525,20200205,10462
20200202,A,계양,4421,4303,20200205,8724
20200202,A,검암,3675,3710,20200205,7385
20200202,A,청라국제도시,2449,2485,20200205,4934
20200202,A,운서,4949,5714,20200205,10663
20200202,A,공항화물청사,1093,1221,20200205,2314
20200202,A,인천공항1터미널,12238,12288,20200205,24526
20200202,A,인천공항2터미널,4900,3866,20200205,8766
20200202,A,영종,1721,1697,20200205,3418
20200203,A,서울역,10045,8761,20200206,18806
20200203,A,공덕,2446,3053,20200206,5499
20200203,A,홍대입구,9778,9814,20200206,19592
20200203,A,디지털미디어시티,14246,12789,20200206,27035
20200203,A,마곡나루,7371,6781,20200206,14152
20200203,A,김포공항,8937,5552,20200206,14489
20200203,A,계양,9752,8881,20200206,18633
20200203,A,검암,8007,7564,20200206,15571
20200203,A,청라국제도시,6598,6201,20200206,12799
20200203,A,운서,6900,7296,20200206,14196
20200203,A,공항화물청사,2497,2829,20200206,5326
20200203,A,인천공항1터미널,13572,11997,20200206,25569
20200203,A,인천공항2터미널,4840,3944,20200206,8784
20200203,A,영종,2593,2648,20200206,5241
20200204,A,서울역,9756,8243,20200207,17999
20200204,A,공덕,2398,3069,20200207,5467
20200204,A,홍대입구,10123,10392,20200207,20515
20200204,A,디지털미디어시티,14744,13186,20200207,27930
20200204,A,마곡나루,7629,6708,20200207,14337
20200204,A,김포공항,8716,5156,20200207,13872
20200204,A,계양,9892,8898,20200207,18790
20200204,A,검암,7929,7646,20200207,15575
20200204,A,청라국제도시,6537,6208,20200207,12745
20200204,A,운서,6883,7036,20200207,13919
20200204,A,공항화물청사,2495,2813,20200207,5308
20200204,A,인천공항1터미널,12911,11537,20200207,24448
20200204,A,인천공항2터미널,4476,3735,20200207,8211
20200204,A,영종,2512,2587,20200207,5099
20200205,A,서울역,9896,8151,20200208,18047
20200205,A,공덕,2330,2985,20200208,5315
20200205,A,홍대입구,10242,10295,20200208,20537
20200205,A,디지털미디어시티,14379,12938,20200208,27317
20200205,A,마곡나루,7323,6476,20200208,13799
20200205,A,김포공항,8286,5392,20200208,13678
20200205,A,계양,9461,8793,20200208,18254
20200205,A,검암,7860,7432,20200208,15292
20200205,A,청라국제도시,6506,6060,20200208,12566
20200205,A,운서,6666,6826,20200208,13492
20200205,A,공항화물청사,2540,2772,20200208,5312
20200205,A,인천공항1터미널,11102,11511,20200208,22613
20200205,A,인천공항2터미널,4669,3927,20200208,8596
20200205,A,영종,2373,2444,20200208,4817
20200206,A,서울역,9541,8075,20200209,17616
20200206,A,공덕,2334,3051,20200209,5385
20200206,A,홍대입구,9935,10384,20200209,20319
20200206,A,디지털미디어시티,14490,12978,20200209,27468
20200206,A,마곡나루,7191,6496,20200209,13687
20200206,A,김포공항,8651,5434,20200209,14085
20200206,A,계양,9497,8619,20200209,18116
20200206,A,검암,7851,7428,20200209,15279
20200206,A,청라국제도시,6372,6021,20200209,12393
20200206,A,운서,6619,6817,20200209,13436
20200206,A,공항화물청사,2556,2840,20200209,5396
20200206,A,인천공항1터미널,12364,11098,20200209,23462
20200206,A,인천공항2터미널,4450,3616,20200209,8066
20200206,A,영종,2435,2481,20200209,4916
20200207,A,서울역,11045,10059,20200210,21104
20200207,A,공덕,2401,3133,20200210,5534
20200207,A,홍대입구,10797,11357,20200210,22154
20200207,A,디지털미디어시티,14694,12852,20200210,27546
20200207,A,마곡나루,7958,6643,20200210,14601
20200207,A,김포공항,9333,5607,20200210,14940
20200207,A,계양,9646,8761,20200210,18407
20200207,A,검암,8110,7537,20200210,15647
20200207,A,청라국제도시,6720,6208,20200210,12928
20200207,A,운서,6744,7127,20200210,13871
20200207,A,공항화물청사,2521,2701,20200210,5222
20200207,A,인천공항1터미널,13088,11245,20200210,24333
20200207,A,인천공항2터미널,4716,3612,20200210,8328
20200207,A,영종,2616,2746,20200210,5362
20200208,A,서울역,9330,8679,20200211,18009
20200208,A,공덕,1446,2282,20200211,3728
20200208,A,홍대입구,10955,11290,20200211,22245
20200208,A,디지털미디어시티,5314,4942,20200211,10256
20200208,A,마곡나루,2061,2298,20200211,4359
20200208,A,김포공항,6850,3887,20200211,10737
20200208,A,계양,5983,5477,20200211,11460
20200208,A,검암,4820,4730,20200211,9550
20200208,A,청라국제도시,3477,3229,20200211,6706
20200208,A,운서,5908,6363,20200211,12271
20200208,A,공항화물청사,1471,1502,20200211,2973
20200208,A,인천공항1터미널,12545,10339,20200211,22884
20200208,A,인천공항2터미널,4506,3534,20200211,8040
20200208,A,영종,2093,2073,20200211,4166
20200209,A,서울역,9769,7775,20200212,17544
20200209,A,공덕,1096,1512,20200212,2608
20200209,A,홍대입구,9447,8572,20200212,18019
20200209,A,디지털미디어시티,3216,3322,20200212,6538
20200209,A,마곡나루,1404,1644,20200212,3048
20200209,A,김포공항,7161,3876,20200212,11037
20200209,A,계양,4452,4273,20200212,8725
20200209,A,검암,3607,3537,20200212,7144
20200209,A,청라국제도시,2546,2513,20200212,5059
20200209,A,운서,5030,5592,20200212,10622
20200209,A,공항화물청사,1010,1171,20200212,2181
20200209,A,인천공항1터미널,11150,11343,20200212,22493
20200209,A,인천공항2터미널,4505,3838,20200212,8343
20200209,A,영종,1620,1711,20200212,3331
20200210,A,서울역,10576,9047,20200213,19623
20200210,A,공덕,2424,2853,20200213,5277
20200210,A,홍대입구,10671,10339,20200213,21010
20200210,A,디지털미디어시티,14388,13019,20200213,27407
20200210,A,마곡나루,7562,6867,20200213,14429
20200210,A,김포공항,9179,5639,20200213,14818
20200210,A,계양,9749,8786,20200213,18535
20200210,A,검암,8065,7442,20200213,15507
20200210,A,청라국제도시,6673,6175,20200213,12848
20200210,A,운서,6841,7244,20200213,14085
20200210,A,공항화물청사,2527,2778,20200213,5305
20200210,A,인천공항1터미널,12137,12278,20200213,24415
20200210,A,인천공항2터미널,4573,4173,20200213,8746
20200210,A,영종,2696,2712,20200213,5408
20200211,A,서울역,10442,8327,20200214,18769
20200211,A,공덕,2415,2933,20200214,5348
20200211,A,홍대입구,10851,10590,20200214,21441
20200211,A,디지털미디어시티,14816,13422,20200214,28238
20200211,A,마곡나루,7683,6970,20200214,14653
20200211,A,김포공항,8834,6036,20200214,14870
20200211,A,계양,9970,8970,20200214,18940
20200211,A,검암,8246,7899,20200214,16145
20200211,A,청라국제도시,6771,6360,20200214,13131
20200211,A,운서,7109,7273,20200214,14382
20200211,A,공항화물청사,2507,2777,20200214,5284
20200211,A,인천공항1터미널,11627,11692,20200214,23319
20200211,A,인천공항2터미널,4203,3851,20200214,8054
20200211,A,영종,2746,2733,20200214,5479
20200212,A,서울역,10019,8420,20200215,18439
20200212,A,공덕,2408,2973,20200215,5381
20200212,A,홍대입구,10170,10185,20200215,20355
20200212,A,디지털미디어시티,14474,13033,20200215,27507
20200212,A,마곡나루,7513,6643,20200215,14156
20200212,A,김포공항,8450,5787,20200215,14237
20200212,A,계양,9698,8711,20200215,18409
20200212,A,검암,7810,7371,20200215,15181
20200212,A,청라국제도시,6625,6266,20200215,12891
20200212,A,운서,6749,6981,20200215,13730
20200212,A,공항화물청사,2485,2801,20200215,5286
20200212,A,인천공항1터미널,11673,10986,20200215,22659
20200212,A,인천공항2터미널,4412,3594,20200215,8006
20200212,A,영종,2467,2578,20200215,5045
20200213,A,서울역,10260,8627,20200216,18887
20200213,A,공덕,2399,3030,20200216,5429
20200213,A,홍대입구,11039,11311,20200216,22350
20200213,A,디지털미디어시티,15128,13581,20200216,28709
20200213,A,마곡나루,7899,7078,20200216,14977
20200213,A,김포공항,9266,6225,20200216,15491
20200213,A,계양,10164,9128,20200216,19292
20200213,A,검암,8270,7875,20200216,16145
20200213,A,청라국제도시,6998,6491,20200216,13489
20200213,A,운서,7088,7261,20200216,14349
20200213,A,공항화물청사,2564,2814,20200216,5378
20200213,A,인천공항1터미널,11472,10594,20200216,22066
20200213,A,인천공항2터미널,4196,3549,20200216,7745
20200213,A,영종,2766,2833,20200216,5599
20200214,A,영종,2971,3053,20200217,6024
20200214,A,인천공항2터미널,4519,3650,20200217,8169
20200214,A,인천공항1터미널,11974,11228,20200217,23202
20200214,A,서울역,12643,11033,20200217,23676
20200214,A,공덕,2522,3412,20200217,5934
20200214,A,홍대입구,12606,12895,20200217,25501
20200214,A,디지털미디어시티,15188,13691,20200217,28879
20200214,A,마곡나루,8483,7231,20200217,15714
20200214,A,김포공항,10280,6374,20200217,16654
20200214,A,계양,10587,9283,20200217,19870
20200214,A,검암,8679,8223,20200217,16902
20200214,A,청라국제도시,7314,6676,20200217,13990
20200214,A,공항화물청사,2515,2768,20200217,5283
20200214,A,운서,7520,7742,20200217,15262
20200215,A,서울역,9947,9775,20200218,19722
20200215,A,공덕,1689,2526,20200218,4215
20200215,A,홍대입구,12529,12476,20200218,25005
20200215,A,디지털미디어시티,6206,5863,20200218,12069
20200215,A,마곡나루,2404,2669,20200218,5073
20200215,A,김포공항,8198,4741,20200218,12939
20200215,A,계양,6832,6220,20200218,13052
20200215,A,검암,5541,5324,20200218,10865
20200215,A,청라국제도시,3955,3860,20200218,7815
20200215,A,운서,6423,6697,20200218,13120
20200215,A,공항화물청사,1403,1461,20200218,2864
20200215,A,인천공항1터미널,11482,10743,20200218,22225
20200215,A,인천공항2터미널,4160,3443,20200218,7603
20200215,A,영종,2437,2520,20200218,4957
20200216,A,서울역,10562,8379,20200219,18941
20200216,A,공덕,1213,1645,20200219,2858
20200216,A,홍대입구,9269,8716,20200219,17985
20200216,A,디지털미디어시티,3493,3586,20200219,7079
20200216,A,마곡나루,1468,1685,20200219,3153
20200216,A,김포공항,7877,4650,20200219,12527
20200216,A,계양,4803,4716,20200219,9519
20200216,A,검암,3681,3886,20200219,7567
20200216,A,청라국제도시,2836,2753,20200219,5589
20200216,A,운서,5184,5649,20200219,10833
20200216,A,공항화물청사,1060,1219,20200219,2279
20200216,A,인천공항1터미널,10591,11170,20200219,21761
20200216,A,인천공항2터미널,4300,3496,20200219,7796
20200216,A,영종,1833,1833,20200219,3666
20200217,A,서울역,10502,9254,20200220,19756
20200217,A,공덕,2394,2955,20200220,5349
20200217,A,홍대입구,9941,10389,20200220,20330
20200217,A,디지털미디어시티,14952,13533,20200220,28485
20200217,A,마곡나루,7579,6933,20200220,14512
20200217,A,김포공항,9436,6144,20200220,15580
20200217,A,계양,10048,9121,20200220,19169
20200217,A,검암,7984,7597,20200220,15581
20200217,A,청라국제도시,6974,6477,20200220,13451
20200217,A,운서,6893,7139,20200220,14032
20200217,A,공항화물청사,2440,2811,20200220,5251
20200217,A,인천공항1터미널,12154,10826,20200220,22980
20200217,A,인천공항2터미널,4778,3976,20200220,8754
20200217,A,영종,2694,2781,20200220,5475
20200218,A,서울역,9615,8282,20200221,17897
20200218,A,공덕,2406,3077,20200221,5483
20200218,A,홍대입구,10689,10808,20200221,21497
20200218,A,디지털미디어시티,14833,13435,20200221,28268
20200218,A,마곡나루,7731,6870,20200221,14601
20200218,A,김포공항,9861,6388,20200221,16249
20200218,A,계양,10013,9130,20200221,19143
20200218,A,검암,8139,7695,20200221,15834
20200218,A,청라국제도시,6842,6378,20200221,13220
20200218,A,운서,7030,7303,20200221,14333
20200218,A,공항화물청사,2516,2724,20200221,5240
20200218,A,인천공항1터미널,11559,10390,20200221,21949
20200218,A,인천공항2터미널,4294,3351,20200221,7645
20200218,A,영종,2621,2781,20200221,5402
20200219,A,서울역,9830,8414,20200222,18244
20200219,A,공덕,2464,3193,20200222,5657
20200219,A,홍대입구,10711,11148,20200222,21859
20200219,A,디지털미디어시티,15265,13716,20200222,28981
20200219,A,마곡나루,7858,7060,20200222,14918
20200219,A,김포공항,9346,6156,20200222,15502
20200219,A,계양,10092,9169,20200222,19261
20200219,A,검암,8249,7711,20200222,15960
20200219,A,청라국제도시,7042,6520,20200222,13562
20200219,A,운서,7093,7303,20200222,14396
20200219,A,공항화물청사,2486,2819,20200222,5305
20200219,A,인천공항1터미널,11235,10529,20200222,21764
20200219,A,인천공항2터미널,4378,3508,20200222,7886
20200219,A,영종,2788,2808,20200222,5596
20200220,A,서울역,9968,8556,20200223,18524
20200220,A,공덕,2425,3097,20200223,5522
20200220,A,홍대입구,10676,10943,20200223,21619
20200220,A,디지털미디어시티,14666,13284,20200223,27950
20200220,A,마곡나루,7777,7073,20200223,14850
20200220,A,김포공항,10249,6319,20200223,16568
20200220,A,계양,10143,9087,20200223,19230
20200220,A,검암,8072,7745,20200223,15817
20200220,A,청라국제도시,6880,6417,20200223,13297
20200220,A,운서,6889,7176,20200223,14065
20200220,A,공항화물청사,2573,2821,20200223,5394
20200220,A,인천공항1터미널,11441,10529,20200223,21970
20200220,A,인천공항2터미널,4075,3500,20200223,7575
20200220,A,영종,2788,2853,20200223,5641
20200221,A,서울역,10716,9111,20200224,19827
20200221,A,공덕,2463,3410,20200224,5873
20200221,A,홍대입구,10524,11293,20200224,21817
20200221,A,디지털미디어시티,14193,13154,20200224,27347
20200221,A,마곡나루,7904,6650,20200224,14554
20200221,A,김포공항,10096,6072,20200224,16168
20200221,A,계양,9763,8780,20200224,18543
20200221,A,검암,8066,7507,20200224,15573
20200221,A,청라국제도시,6818,6365,20200224,13183
20200221,A,운서,6878,6965,20200224,13843
20200221,A,공항화물청사,2480,2707,20200224,5187
20200221,A,인천공항1터미널,11491,10671,20200224,22162
20200221,A,인천공항2터미널,4310,3534,20200224,7844
20200221,A,영종,2631,2745,20200224,5376
20200222,A,서울역,7830,6911,20200225,14741
20200222,A,공덕,1408,2239,20200225,3647
20200222,A,홍대입구,9007,9374,20200225,18381
20200222,A,디지털미디어시티,4844,4592,20200225,9436
20200222,A,마곡나루,1781,1986,20200225,3767
20200222,A,김포공항,7280,4024,20200225,11304
20200222,A,계양,5219,4975,20200225,10194
20200222,A,검암,4098,4273,20200225,8371
20200222,A,청라국제도시,3097,2966,20200225,6063
20200222,A,운서,5457,5712,20200225,11169
20200222,A,공항화물청사,1372,1463,20200225,2835
20200222,A,인천공항1터미널,11000,9363,20200225,20363
20200222,A,인천공항2터미널,4127,3144,20200225,7271
20200222,A,영종,1885,1961,20200225,3846
20200223,A,서울역,7338,5657,20200226,12995
20200223,A,공덕,902,1291,20200226,2193
20200223,A,홍대입구,7366,6471,20200226,13837
20200223,A,디지털미디어시티,3052,3045,20200226,6097
20200223,A,마곡나루,1203,1406,20200226,2609
20200223,A,김포공항,6574,3693,20200226,10267
20200223,A,계양,3530,3468,20200226,6998
20200223,A,검암,3027,3106,20200226,6133
20200223,A,청라국제도시,2086,2130,20200226,4216
20200223,A,운서,4549,5060,20200226,9609
20200223,A,공항화물청사,967,1095,20200226,2062
20200223,A,인천공항1터미널,9449,9999,20200226,19448
20200223,A,인천공항2터미널,3873,3299,20200226,7172
20200223,A,영종,1474,1435,20200226,2909
20200224,A,서울역,8263,6269,20200227,14532
20200224,A,공덕,2124,2559,20200227,4683
20200224,A,홍대입구,7999,7753,20200227,15752
20200224,A,디지털미디어시티,12683,11556,20200227,24239
20200224,A,마곡나루,6742,6008,20200227,12750
20200224,A,김포공항,7587,5210,20200227,12797
20200224,A,계양,8589,7902,20200227,16491
20200224,A,검암,7123,6785,20200227,13908
20200224,A,청라국제도시,5870,5476,20200227,11346
20200224,A,운서,6046,6419,20200227,12465
20200224,A,공항화물청사,2395,2632,20200227,5027
20200224,A,인천공항1터미널,9568,10684,20200227,20252
20200224,A,인천공항2터미널,3863,3765,20200227,7628
20200224,A,영종,2240,2266,20200227,4506
20200225,A,서울역,6657,5159,20200228,11816
20200225,A,공덕,1888,2330,20200228,4218
20200225,A,홍대입구,7263,7022,20200228,14285
20200225,A,디지털미디어시티,12315,11231,20200228,23546
20200225,A,마곡나루,6319,5590,20200228,11909
20200225,A,김포공항,6364,4575,20200228,10939
20200225,A,계양,7974,7344,20200228,15318
20200225,A,검암,6523,6410,20200228,12933
20200225,A,청라국제도시,5395,5076,20200228,10471
20200225,A,운서,5493,5794,20200228,11287
20200225,A,공항화물청사,2369,2551,20200228,4920
20200225,A,인천공항1터미널,8969,9010,20200228,17979
20200225,A,인천공항2터미널,3565,3189,20200228,6754
20200225,A,영종,1900,1960,20200228,3860
20200226,A,서울역,6164,4917,20200229,11081
20200226,A,공덕,1870,2335,20200229,4205
20200226,A,홍대입구,7149,7111,20200229,14260
20200226,A,디지털미디어시티,11742,10883,20200229,22625
20200226,A,마곡나루,6307,5691,20200229,11998
20200226,A,김포공항,6217,4368,20200229,10585
20200226,A,계양,7848,7295,20200229,15143
20200226,A,검암,6630,6375,20200229,13005
20200226,A,청라국제도시,5352,5027,20200229,10379
20200226,A,운서,5703,6049,20200229,11752
20200226,A,공항화물청사,2345,2600,20200229,4945
20200226,A,인천공항1터미널,7918,8445,20200229,16363
20200226,A,인천공항2터미널,3403,2896,20200229,6299
20200226,A,영종,1931,1953,20200229,3884
20200227,A,영종,1996,1963,20200301,3959
20200227,A,인천공항2터미널,3112,2771,20200301,5883
20200227,A,인천공항1터미널,7253,8103,20200301,15356
20200227,A,공항화물청사,2366,2608,20200301,4974
20200227,A,운서,5760,5895,20200301,11655
20200227,A,청라국제도시,5310,4898,20200301,10208
20200227,A,검암,6510,6232,20200301,12742
20200227,A,계양,7689,7145,20200301,14834
20200227,A,김포공항,5921,4082,20200301,10003
20200227,A,마곡나루,6125,5497,20200301,11622
20200227,A,디지털미디어시티,11139,10477,20200301,21616
20200227,A,홍대입구,6584,6654,20200301,13238
20200227,A,공덕,1916,2268,20200301,4184
20200227,A,서울역,5649,4637,20200301,10286
20200228,A,서울역,5983,4877,20200302,10860
20200228,A,공덕,1791,2323,20200302,4114
20200228,A,홍대입구,6118,6370,20200302,12488
20200228,A,디지털미디어시티,10684,9876,20200302,20560
20200228,A,마곡나루,5702,5059,20200302,10761
20200228,A,김포공항,5997,4143,20200302,10140
20200228,A,계양,7416,6608,20200302,14024
20200228,A,검암,6097,5862,20200302,11959
20200228,A,청라국제도시,4887,4644,20200302,9531
20200228,A,운서,5507,5648,20200302,11155
20200228,A,공항화물청사,2272,2520,20200302,4792
20200228,A,인천공항1터미널,6999,7845,20200302,14844
20200228,A,인천공항2터미널,3208,2696,20200302,5904
20200228,A,영종,1849,1958,20200302,3807
20200229,A,영종,1305,1375,20200303,2680
20200229,A,인천공항2터미널,2779,2265,20200303,5044
20200229,A,인천공항1터미널,6315,6474,20200303,12789
20200229,A,공항화물청사,1262,1321,20200303,2583
20200229,A,운서,4498,4664,20200303,9162
20200229,A,청라국제도시,2091,2024,20200303,4115
20200229,A,검암,3037,3163,20200303,6200
20200229,A,계양,3911,3624,20200303,7535
20200229,A,김포공항,4030,2732,20200303,6762
20200229,A,마곡나루,1331,1469,20200303,2800
20200229,A,디지털미디어시티,2931,2821,20200303,5752
20200229,A,홍대입구,5468,5253,20200303,10721
20200229,A,공덕,936,1360,20200303,2296
20200229,A,서울역,3642,3166,20200303,6808
20200301,A,운서,3621,3795,20200304,7416
20200301,A,영종,1085,996,20200304,2081
20200301,A,인천공항2터미널,2739,2327,20200304,5066
20200301,A,인천공항1터미널,5508,5637,20200304,11145
20200301,A,공항화물청사,981,1098,20200304,2079
20200301,A,서울역,2938,2562,20200304,5500
20200301,A,공덕,604,740,20200304,1344
20200301,A,홍대입구,3868,3510,20200304,7378
20200301,A,디지털미디어시티,1928,2042,20200304,3970
20200301,A,마곡나루,895,925,20200304,1820
20200301,A,김포공항,3863,2436,20200304,6299
20200301,A,계양,2654,2531,20200304,5185
20200301,A,검암,2230,2313,20200304,4543
20200301,A,청라국제도시,1525,1444,20200304,2969
20200302,A,서울역,4393,3901,20200305,8294
20200302,A,공덕,1714,2080,20200305,3794
20200302,A,홍대입구,5458,5687,20200305,11145
20200302,A,디지털미디어시티,10594,9864,20200305,20458
20200302,A,마곡나루,5868,5418,20200305,11286
20200302,A,김포공항,5398,3953,20200305,9351
20200302,A,계양,7384,6825,20200305,14209
20200302,A,검암,6186,5887,20200305,12073
20200302,A,청라국제도시,4884,4536,20200305,9420
20200302,A,운서,5464,5534,20200305,10998
20200302,A,공항화물청사,2196,2467,20200305,4663
20200302,A,인천공항1터미널,5705,5538,20200305,11243
20200302,A,인천공항2터미널,2798,2332,20200305,5130
20200302,A,영종,1832,1909,20200305,3741
20200303,A,운서,5243,5462,20200306,10705
20200303,A,공항화물청사,2268,2520,20200306,4788
20200303,A,인천공항1터미널,5207,5024,20200306,10231
20200303,A,인천공항2터미널,2630,2249,20200306,4879
20200303,A,영종,1889,1907,20200306,3796
20200303,A,서울역,4182,3741,20200306,7923
20200303,A,공덕,1705,2048,20200306,3753
20200303,A,홍대입구,5892,5875,20200306,11767
20200303,A,디지털미디어시티,10548,9819,20200306,20367
20200303,A,마곡나루,5730,5290,20200306,11020
20200303,A,김포공항,5101,3883,20200306,8984
20200303,A,계양,7384,6777,20200306,14161
20200303,A,검암,6141,5919,20200306,12060
20200303,A,청라국제도시,4848,4499,20200306,9347
20200304,A,서울역,4097,3602,20200307,7699
20200304,A,공덕,1673,2128,20200307,3801
20200304,A,홍대입구,5683,6004,20200307,11687
20200304,A,디지털미디어시티,10412,9527,20200307,19939
20200304,A,마곡나루,5605,5189,20200307,10794
20200304,A,김포공항,5176,3619,20200307,8795
20200304,A,계양,7304,6788,20200307,14092
20200304,A,검암,6093,5749,20200307,11842
20200304,A,청라국제도시,4878,4613,20200307,9491
20200304,A,운서,5266,5325,20200307,10591
20200304,A,공항화물청사,2286,2507,20200307,4793
20200304,A,인천공항1터미널,4898,5009,20200307,9907
20200304,A,인천공항2터미널,2617,2194,20200307,4811
20200304,A,영종,1823,1893,20200307,3716
20200305,A,서울역,4061,3666,20200308,7727
20200305,A,공덕,1627,2094,20200308,3721
20200305,A,홍대입구,5902,6040,20200308,11942
20200305,A,디지털미디어시티,10464,9705,20200308,20169
20200305,A,마곡나루,5618,5193,20200308,10811
20200305,A,김포공항,5660,3886,20200308,9546
20200305,A,계양,7418,6756,20200308,14174
20200305,A,검암,5927,5636,20200308,11563
20200305,A,청라국제도시,4913,4470,20200308,9383
20200305,A,운서,5257,5374,20200308,10631
20200305,A,공항화물청사,2280,2543,20200308,4823
20200305,A,인천공항1터미널,4769,4805,20200308,9574
20200305,A,인천공항2터미널,2600,2183,20200308,4783
20200305,A,영종,1859,1893,20200308,3752
20200306,A,서울역,5067,4497,20200309,9564
20200306,A,공덕,1730,2236,20200309,3966
20200306,A,홍대입구,6287,6694,20200309,12981
20200306,A,디지털미디어시티,10625,9654,20200309,20279
20200306,A,마곡나루,5804,5107,20200309,10911
20200306,A,김포공항,6027,3892,20200309,9919
20200306,A,계양,7569,6804,20200309,14373
20200306,A,검암,6299,5955,20200309,12254
20200306,A,청라국제도시,4877,4573,20200309,9450
20200306,A,운서,5533,5560,20200309,11093
20200306,A,공항화물청사,2187,2454,20200309,4641
20200306,A,인천공항1터미널,4566,4893,20200309,9459
20200306,A,인천공항2터미널,2491,2142,20200309,4633
20200306,A,영종,1924,2123,20200309,4047
20200307,A,서울역,3156,2836,20200310,5992
20200307,A,공덕,965,1438,20200310,2403
20200307,A,홍대입구,5773,6024,20200310,11797
20200307,A,디지털미디어시티,3272,3101,20200310,6373
20200307,A,마곡나루,1491,1562,20200310,3053
20200307,A,김포공항,4249,2715,20200310,6964
20200307,A,계양,4230,3929,20200310,8159
20200307,A,검암,3265,3304,20200310,6569
20200307,A,청라국제도시,2317,2179,20200310,4496
20200307,A,운서,4494,4657,20200310,9151
20200307,A,공항화물청사,1285,1362,20200310,2647
20200307,A,인천공항1터미널,4229,4315,20200310,8544
20200307,A,인천공항2터미널,2150,1813,20200310,3963
20200307,A,영종,1445,1529,20200310,2974
20200308,A,서울역,2850,2762,20200311,5612
20200308,A,공덕,712,956,20200311,1668
20200308,A,홍대입구,4765,4495,20200311,9260
20200308,A,디지털미디어시티,2217,2167,20200311,4384
20200308,A,마곡나루,1075,1147,20200311,2222
20200308,A,김포공항,3997,2348,20200311,6345
20200308,A,계양,3086,2871,20200311,5957
20200308,A,검암,2520,2631,20200311,5151
20200308,A,청라국제도시,1769,1651,20200311,3420
20200308,A,운서,3825,4023,20200311,7848
20200308,A,공항화물청사,991,1082,20200311,2073
20200308,A,인천공항1터미널,4594,4530,20200311,9124
20200308,A,인천공항2터미널,2291,1960,20200311,4251
20200308,A,영종,1210,1193,20200311,2403
20200309,A,서울역,4372,4029,20200312,8401
20200309,A,공덕,1730,2142,20200312,3872
20200309,A,홍대입구,6098,6270,20200312,12368
20200309,A,디지털미디어시티,10853,10018,20200312,20871
20200309,A,마곡나루,6057,5605,20200312,11662
20200309,A,김포공항,5793,3706,20200312,9499
20200309,A,계양,7774,7049,20200312,14823
20200309,A,검암,6386,6075,20200312,12461
20200309,A,청라국제도시,5064,4652,20200312,9716
20200309,A,운서,5294,5426,20200312,10720
20200309,A,공항화물청사,2127,2450,20200312,4577
20200309,A,인천공항1터미널,4198,3991,20200312,8189
20200309,A,인천공항2터미널,2328,1969,20200312,4297
20200309,A,영종,2047,2087,20200312,4134
20200310,A,서울역,3872,3738,20200313,7610
20200310,A,공덕,1698,2124,20200313,3822
20200310,A,홍대입구,5429,5654,20200313,11083
20200310,A,디지털미디어시티,10654,9802,20200313,20456
20200310,A,마곡나루,5787,5235,20200313,11022
20200310,A,김포공항,4872,3546,20200313,8418
20200310,A,계양,7408,6759,20200313,14167
20200310,A,검암,6012,5816,20200313,11828
20200310,A,청라국제도시,4893,4539,20200313,9432
20200310,A,운서,5117,5115,20200313,10232
20200310,A,공항화물청사,2285,2409,20200313,4694
20200310,A,인천공항1터미널,3765,3767,20200313,7532
20200310,A,인천공항2터미널,2204,1911,20200313,4115
20200310,A,영종,1935,1895,20200313,3830
20200311,A,서울역,4125,3735,20200314,7860
20200311,A,공덕,1830,2169,20200314,3999
20200311,A,홍대입구,6205,6443,20200314,12648
20200311,A,디지털미디어시티,10872,9967,20200314,20839
20200311,A,마곡나루,5922,5462,20200314,11384
20200311,A,김포공항,5382,3793,20200314,9175
20200311,A,계양,7651,7034,20200314,14685
20200311,A,검암,6184,6025,20200314,12209
20200311,A,청라국제도시,5061,4656,20200314,9717
20200311,A,운서,5318,5478,20200314,10796
20200311,A,공항화물청사,2245,2362,20200314,4607
20200311,A,인천공항1터미널,3923,3703,20200314,7626
20200311,A,인천공항2터미널,2203,1760,20200314,3963
20200311,A,영종,1884,1960,20200314,3844
20200312,A,서울역,4091,3880,20200315,7971
20200312,A,공덕,1697,2134,20200315,3831
20200312,A,홍대입구,6091,6275,20200315,12366
20200312,A,디지털미디어시티,10655,9872,20200315,20527
20200312,A,마곡나루,5942,5468,20200315,11410
20200312,A,김포공항,5407,3650,20200315,9057
20200312,A,계양,7471,6764,20200315,14235
20200312,A,검암,6326,5980,20200315,12306
20200312,A,청라국제도시,4891,4602,20200315,9493
20200312,A,운서,5349,5284,20200315,10633
20200312,A,공항화물청사,2186,2489,20200315,4675
20200312,A,인천공항1터미널,3757,3673,20200315,7430
20200312,A,인천공항2터미널,2206,1883,20200315,4089
20200312,A,영종,2001,2050,20200315,4051
20200313,A,서울역,5133,4672,20200316,9805
20200313,A,공덕,1684,2219,20200316,3903
20200313,A,홍대입구,6582,7145,20200316,13727
20200313,A,디지털미디어시티,10433,9621,20200316,20054
20200313,A,마곡나루,5875,5256,20200316,11131
20200313,A,김포공항,5841,3530,20200316,9371
20200313,A,계양,7581,6830,20200316,14411
20200313,A,검암,6369,5992,20200316,12361
20200313,A,청라국제도시,5006,4656,20200316,9662
20200313,A,운서,5338,5425,20200316,10763
20200313,A,공항화물청사,2160,2381,20200316,4541
20200313,A,인천공항1터미널,3989,3882,20200316,7871
20200313,A,인천공항2터미널,2105,1751,20200316,3856
20200313,A,영종,1979,2149,20200316,4128
20200314,A,서울역,3119,3165,20200317,6284
20200314,A,공덕,863,1330,20200317,2193
20200314,A,홍대입구,6096,6275,20200317,12371
20200314,A,디지털미디어시티,3313,3116,20200317,6429
20200314,A,마곡나루,1601,1702,20200317,3303
20200314,A,김포공항,4345,2638,20200317,6983
20200314,A,계양,4345,3938,20200317,8283
20200314,A,검암,3377,3473,20200317,6850
20200314,A,청라국제도시,2373,2271,20200317,4644
20200314,A,운서,4440,4632,20200317,9072
20200314,A,공항화물청사,1238,1304,20200317,2542
20200314,A,인천공항1터미널,3471,3257,20200317,6728
20200314,A,인천공항2터미널,1921,1482,20200317,3403
20200314,A,영종,1500,1529,20200317,3029
20200315,A,서울역,2954,3063,20200318,6017
20200315,A,공덕,707,942,20200318,1649
20200315,A,홍대입구,4417,4313,20200318,8730
20200315,A,디지털미디어시티,2069,2192,20200318,4261
20200315,A,마곡나루,1013,1127,20200318,2140
20200315,A,김포공항,4003,2388,20200318,6391
20200315,A,계양,3058,2869,20200318,5927
20200315,A,검암,2481,2563,20200318,5044
20200315,A,청라국제도시,1699,1622,20200318,3321
20200315,A,운서,3585,3867,20200318,7452
20200315,A,공항화물청사,952,1034,20200318,1986
20200315,A,인천공항1터미널,3609,3341,20200318,6950
20200315,A,인천공항2터미널,2069,1575,20200318,3644
20200315,A,영종,1206,1128,20200318,2334
20200316,A,서울역,4465,4156,20200319,8621
20200316,A,공덕,1607,2106,20200319,3713
20200316,A,홍대입구,5674,5844,20200319,11518
20200316,A,디지털미디어시티,10542,9809,20200319,20351
20200316,A,마곡나루,5897,5571,20200319,11468
20200316,A,김포공항,5550,3677,20200319,9227
20200316,A,계양,7604,6837,20200319,14441
20200316,A,검암,6163,5956,20200319,12119
20200316,A,청라국제도시,5039,4641,20200319,9680
20200316,A,운서,5173,5172,20200319,10345
20200316,A,공항화물청사,2130,2439,20200319,4569
20200316,A,인천공항1터미널,4050,3649,20200319,7699
20200316,A,인천공항2터미널,2185,1701,20200319,3886
20200316,A,영종,1946,1961,20200319,3907
20200317,A,서울역,4097,3870,20200320,7967
20200317,A,공덕,1729,2119,20200320,3848
20200317,A,홍대입구,5906,6094,20200320,12000
20200317,A,디지털미디어시티,10751,9955,20200320,20706
20200317,A,마곡나루,6102,5537,20200320,11639
20200317,A,김포공항,5562,3603,20200320,9165
20200317,A,계양,7735,6990,20200320,14725
20200317,A,검암,6206,5937,20200320,12143
20200317,A,청라국제도시,5050,4668,20200320,9718
20200317,A,운서,5063,5155,20200320,10218
20200317,A,공항화물청사,2223,2441,20200320,4664
20200317,A,인천공항1터미널,3694,3532,20200320,7226
20200317,A,인천공항2터미널,2247,1763,20200320,4010
20200317,A,영종,1995,2030,20200320,4025
20200318,A,서울역,4359,4102,20200321,8461
20200318,A,공덕,1720,2187,20200321,3907
20200318,A,홍대입구,6272,6487,20200321,12759
20200318,A,디지털미디어시티,10730,9960,20200321,20690
20200318,A,마곡나루,6317,5724,20200321,12041
20200318,A,김포공항,5494,3846,20200321,9340
20200318,A,계양,7765,7131,20200321,14896
20200318,A,검암,6364,6160,20200321,12524
20200318,A,청라국제도시,5172,4839,20200321,10011
20200318,A,운서,5260,5271,20200321,10531
20200318,A,공항화물청사,2209,2456,20200321,4665
20200318,A,인천공항1터미널,3937,3690,20200321,7627
20200318,A,인천공항2터미널,2020,1656,20200321,3676
20200318,A,영종,2041,2011,20200321,4052
20200319,A,디지털미디어시티,10564,9746,20200322,20310
20200319,A,영종,1928,1993,20200322,3921
20200319,A,인천공항2터미널,2169,1715,20200322,3884
20200319,A,인천공항1터미널,3863,3509,20200322,7372
20200319,A,공항화물청사,2248,2466,20200322,4714
20200319,A,운서,4890,4868,20200322,9758
20200319,A,청라국제도시,4962,4653,20200322,9615
20200319,A,검암,5925,5809,20200322,11734
20200319,A,계양,7459,6868,20200322,14327
20200319,A,김포공항,5370,3882,20200322,9252
20200319,A,마곡나루,5844,5435,20200322,11279
20200319,A,서울역,4275,4087,20200322,8362
20200319,A,공덕,1663,2074,20200322,3737
20200319,A,홍대입구,5868,6154,20200322,12022
20200320,A,서울역,5363,5311,20200323,10674
20200320,A,공덕,1774,2273,20200323,4047
20200320,A,홍대입구,7198,7697,20200323,14895
20200320,A,디지털미디어시티,10786,9829,20200323,20615
20200320,A,마곡나루,6162,5466,20200323,11628
20200320,A,김포공항,5991,3719,20200323,9710
20200320,A,계양,7898,7192,20200323,15090
20200320,A,검암,6497,6241,20200323,12738
20200320,A,청라국제도시,5243,4971,20200323,10214
20200320,A,운서,5409,5436,20200323,10845
20200320,A,공항화물청사,2161,2390,20200323,4551
20200320,A,인천공항1터미널,3666,3424,20200323,7090
20200320,A,인천공항2터미널,2175,1630,20200323,3805
20200320,A,영종,2123,2233,20200323,4356
20200321,A,서울역,3507,3607,20200324,7114
20200321,A,공덕,888,1343,20200324,2231
20200321,A,홍대입구,6710,6827,20200324,13537
20200321,A,디지털미디어시티,3217,3108,20200324,6325
20200321,A,마곡나루,1688,1778,20200324,3466
20200321,A,김포공항,4450,2644,20200324,7094
20200321,A,계양,4540,4204,20200324,8744
20200321,A,검암,3606,3663,20200324,7269
20200321,A,청라국제도시,2473,2380,20200324,4853
20200321,A,운서,4390,4473,20200324,8863
20200321,A,공항화물청사,1240,1312,20200324,2552
20200321,A,인천공항1터미널,3388,3040,20200324,6428
20200321,A,인천공항2터미널,1831,1385,20200324,3216
20200321,A,영종,1682,1755,20200324,3437
20200322,A,서울역,3409,3340,20200325,6749
20200322,A,공덕,654,917,20200325,1571
20200322,A,홍대입구,5085,5000,20200325,10085
20200322,A,디지털미디어시티,2291,2315,20200325,4606
20200322,A,마곡나루,1157,1144,20200325,2301
20200322,A,김포공항,4154,2447,20200325,6601
20200322,A,계양,3348,3142,20200325,6490
20200322,A,검암,2772,2838,20200325,5610
20200322,A,청라국제도시,1827,1753,20200325,3580
20200322,A,운서,3730,3997,20200325,7727
20200322,A,공항화물청사,945,1097,20200325,2042
20200322,A,인천공항1터미널,3117,2848,20200325,5965
20200322,A,인천공항2터미널,1811,1375,20200325,3186
20200322,A,영종,1276,1232,20200325,2508
20200323,A,디지털미디어시티,10813,9871,20200326,20684
20200323,A,영종,2117,2153,20200326,4270
20200323,A,인천공항2터미널,2199,1676,20200326,3875
20200323,A,인천공항1터미널,3759,3438,20200326,7197
20200323,A,공항화물청사,2154,2523,20200326,4677
20200323,A,운서,5126,5261,20200326,10387
20200323,A,청라국제도시,5161,4775,20200326,9936
20200323,A,검암,6254,6063,20200326,12317
20200323,A,계양,7941,7100,20200326,15041
20200323,A,김포공항,5584,3805,20200326,9389
20200323,A,마곡나루,6063,5661,20200326,11724
20200323,A,서울역,4460,4196,20200326,8656
20200323,A,공덕,1715,2121,20200326,3836
20200323,A,홍대입구,6055,6136,20200326,12191
20200324,A,서울역,4219,4174,20200327,8393
20200324,A,공덕,1713,2174,20200327,3887
20200324,A,홍대입구,6162,6180,20200327,12342
20200324,A,디지털미디어시티,10890,10018,20200327,20908
20200324,A,마곡나루,6333,5817,20200327,12150
20200324,A,김포공항,5537,3609,20200327,9146
20200324,A,계양,7822,7164,20200327,14986
20200324,A,검암,6343,6091,20200327,12434
20200324,A,청라국제도시,5212,4884,20200327,10096
20200324,A,운서,5225,5267,20200327,10492
20200324,A,공항화물청사,2219,2494,20200327,4713
20200324,A,인천공항1터미널,3734,3460,20200327,7194
20200324,A,인천공항2터미널,2284,1691,20200327,3975
20200324,A,영종,2086,2133,20200327,4219
20200325,A,서울역,4275,4167,20200328,8442
20200325,A,공덕,1700,2121,20200328,3821
20200325,A,홍대입구,6501,6710,20200328,13211
20200325,A,디지털미디어시티,10875,9938,20200328,20813
20200325,A,마곡나루,6365,5691,20200328,12056
20200325,A,김포공항,5499,3389,20200328,8888
20200325,A,계양,7828,7134,20200328,14962
20200325,A,검암,6330,6095,20200328,12425
20200325,A,청라국제도시,5341,4988,20200328,10329
20200325,A,운서,5346,5362,20200328,10708
20200325,A,공항화물청사,2301,2562,20200328,4863
20200325,A,인천공항1터미널,3726,3581,20200328,7307
20200325,A,인천공항2터미널,2257,1805,20200328,4062
20200325,A,영종,2038,2150,20200328,4188
20200326,A,서울역,4292,4218,20200329,8510
20200326,A,공덕,1685,2180,20200329,3865
20200326,A,홍대입구,6174,6329,20200329,12503
20200326,A,디지털미디어시티,10831,9979,20200329,20810
20200326,A,마곡나루,6103,5656,20200329,11759
20200326,A,김포공항,5376,3397,20200329,8773
20200326,A,계양,7701,6943,20200329,14644
20200326,A,검암,6310,5998,20200329,12308
20200326,A,청라국제도시,5077,4795,20200329,9872
20200326,A,운서,5129,5089,20200329,10218
20200326,A,공항화물청사,2199,2539,20200329,4738
20200326,A,인천공항1터미널,3671,3499,20200329,7170
20200326,A,인천공항2터미널,2207,1761,20200329,3968
20200326,A,영종,2056,2116,20200329,4172
20200327,A,서울역,5394,5134,20200330,10528
20200327,A,공덕,1714,2248,20200330,3962
20200327,A,홍대입구,6959,7377,20200330,14336
20200327,A,디지털미디어시티,10862,9798,20200330,20660
20200327,A,마곡나루,6268,5658,20200330,11926
20200327,A,김포공항,5558,3417,20200330,8975
20200327,A,계양,7948,7099,20200330,15047
20200327,A,검암,6458,6148,20200330,12606
20200327,A,청라국제도시,5195,5017,20200330,10212
20200327,A,운서,5477,5425,20200330,10902
20200327,A,공항화물청사,2243,2454,20200330,4697
20200327,A,인천공항1터미널,3663,3539,20200330,7202
20200327,A,인천공항2터미널,2244,1751,20200330,3995
20200327,A,영종,2115,2166,20200330,4281
20200328,A,서울역,3560,3580,20200331,7140
20200328,A,공덕,945,1413,20200331,2358
20200328,A,홍대입구,6306,6458,20200331,12764
20200328,A,디지털미디어시티,3524,3275,20200331,6799
20200328,A,마곡나루,1673,1821,20200331,3494
20200328,A,김포공항,3879,2559,20200331,6438
20200328,A,계양,4694,4330,20200331,9024
20200328,A,검암,3603,3686,20200331,7289
20200328,A,청라국제도시,2461,2457,20200331,4918
20200328,A,운서,4192,4386,20200331,8578
20200328,A,공항화물청사,1251,1365,20200331,2616
20200328,A,인천공항1터미널,3381,2993,20200331,6374
20200328,A,인천공항2터미널,1836,1417,20200331,3253
20200328,A,영종,1595,1680,20200331,3275
20200329,A,서울역,3353,3226,20200401,6579
20200329,A,공덕,682,908,20200401,1590
20200329,A,홍대입구,4767,4613,20200401,9380
20200329,A,디지털미디어시티,2080,2170,20200401,4250
20200329,A,마곡나루,1206,1287,20200401,2493
20200329,A,김포공항,4212,2242,20200401,6454
20200329,A,계양,3376,3152,20200401,6528
20200329,A,검암,2734,2844,20200401,5578
20200329,A,청라국제도시,1858,1733,20200401,3591
20200329,A,운서,3564,3876,20200401,7440
20200329,A,공항화물청사,959,1101,20200401,2060
20200329,A,인천공항1터미널,3049,2673,20200401,5722
20200329,A,인천공항2터미널,1862,1453,20200401,3315
20200329,A,영종,1232,1208,20200401,2440
20200330,A,서울역,4489,4175,20200402,8664
20200330,A,공덕,1707,2187,20200402,3894
20200330,A,홍대입구,6082,6244,20200402,12326
20200330,A,디지털미디어시티,10470,9747,20200402,20217
20200330,A,마곡나루,6255,5851,20200402,12106
20200330,A,김포공항,5119,3348,20200402,8467
20200330,A,계양,7930,7229,20200402,15159
20200330,A,검암,6362,6173,20200402,12535
20200330,A,청라국제도시,5213,4814,20200402,10027
20200330,A,운서,5084,5268,20200402,10352
20200330,A,공항화물청사,2221,2500,20200402,4721
20200330,A,인천공항1터미널,3599,3286,20200402,6885
20200330,A,인천공항2터미널,1976,1679,20200402,3655
20200330,A,영종,2146,2188,20200402,4334
20200331,A,서울역,4343,3939,20200403,8282
20200331,A,공덕,1704,2123,20200403,3827
20200331,A,홍대입구,6200,6478,20200403,12678
20200331,A,디지털미디어시티,10925,9983,20200403,20908
20200331,A,마곡나루,6354,5826,20200403,12180
20200331,A,김포공항,5335,3338,20200403,8673
20200331,A,계양,8010,7273,20200403,15283
20200331,A,검암,6474,6270,20200403,12744
20200331,A,청라국제도시,5233,4827,20200403,10060
20200331,A,운서,5234,5291,20200403,10525
20200331,A,공항화물청사,2240,2538,20200403,4778
20200331,A,인천공항1터미널,3733,3376,20200403,7109
20200331,A,인천공항2터미널,2178,1750,20200403,3928
20200331,A,영종,2086,2126,20200403,4212
20200401,A,서울역,4294,3826,20200404,8120
20200401,A,공덕,1765,2204,20200404,3969
20200401,A,홍대입구,6421,6616,20200404,13037
20200401,A,디지털미디어시티,10783,9981,20200404,20764
20200401,A,마곡나루,6389,5938,20200404,12327
20200401,A,김포공항,4768,3500,20200404,8268
20200401,A,계양,7913,7215,20200404,15128
20200401,A,검암,6302,6197,20200404,12499
20200401,A,청라국제도시,5262,4937,20200404,10199
20200401,A,운서,5238,5260,20200404,10498
20200401,A,공항화물청사,2260,2476,20200404,4736
20200401,A,인천공항1터미널,3188,3188,20200404,6376
20200401,A,인천공항2터미널,1822,1616,20200404,3438
20200401,A,영종,2118,2047,20200404,4165
20200402,A,서울역,4414,4012,20200405,8426
20200402,A,공덕,1752,2126,20200405,3878
20200402,A,홍대입구,6463,6450,20200405,12913
20200402,A,디지털미디어시티,10788,10041,20200405,20829
20200402,A,마곡나루,6437,6014,20200405,12451
20200402,A,김포공항,5036,3610,20200405,8646
20200402,A,계양,7921,7189,20200405,15110
20200402,A,검암,6365,6012,20200405,12377
20200402,A,청라국제도시,5148,4897,20200405,10045
20200402,A,운서,5036,5142,20200405,10178
20200402,A,공항화물청사,2267,2525,20200405,4792
20200402,A,인천공항1터미널,3084,3019,20200405,6103
20200402,A,인천공항2터미널,1852,1599,20200405,3451
20200402,A,영종,2054,2095,20200405,4149
20200403,A,서울역,5323,4998,20200406,10321
20200403,A,공덕,1781,2254,20200406,4035
20200403,A,홍대입구,7329,7686,20200406,15015
20200403,A,디지털미디어시티,10747,9839,20200406,20586
20200403,A,마곡나루,6624,5847,20200406,12471
20200403,A,김포공항,5698,3674,20200406,9372
20200403,A,계양,8002,7305,20200406,15307
20200403,A,검암,6496,6142,20200406,12638
20200403,A,청라국제도시,5348,5004,20200406,10352
20200403,A,운서,5390,5227,20200406,10617
20200403,A,공항화물청사,2192,2413,20200406,4605
20200403,A,인천공항1터미널,3012,3046,20200406,6058
20200403,A,인천공항2터미널,1773,1544,20200406,3317
20200403,A,영종,2187,2255,20200406,4442
20200404,A,운서,4294,4398,20200407,8692
20200404,A,영종,1681,1705,20200407,3386
20200404,A,인천공항2터미널,1476,1277,20200407,2753
20200404,A,인천공항1터미널,2514,2311,20200407,4825
20200404,A,공항화물청사,1211,1284,20200407,2495
20200404,A,서울역,3438,3596,20200407,7034
20200404,A,공덕,985,1414,20200407,2399
20200404,A,홍대입구,6580,6865,20200407,13445
20200404,A,디지털미디어시티,3214,3129,20200407,6343
20200404,A,마곡나루,1727,1787,20200407,3514
20200404,A,김포공항,4244,2640,20200407,6884
20200404,A,계양,4645,4318,20200407,8963
20200404,A,검암,3611,3785,20200407,7396
20200404,A,청라국제도시,2582,2515,20200407,5097
20200405,A,서울역,3477,3146,20200408,6623
20200405,A,공덕,668,888,20200408,1556
20200405,A,홍대입구,4886,4862,20200408,9748
20200405,A,디지털미디어시티,2395,2358,20200408,4753
20200405,A,마곡나루,1203,1237,20200408,2440
20200405,A,김포공항,4511,2229,20200408,6740
20200405,A,계양,3323,3064,20200408,6387
20200405,A,검암,2736,2845,20200408,5581
20200405,A,청라국제도시,1888,1745,20200408,3633
20200405,A,운서,3457,3756,20200408,7213
20200405,A,공항화물청사,866,952,20200408,1818
20200405,A,인천공항1터미널,2408,2343,20200408,4751
20200405,A,인천공항2터미널,1529,1267,20200408,2796
20200405,A,영종,1326,1286,20200408,2612
20200406,A,공항화물청사,2163,2411,20200409,4574
20200406,A,인천공항1터미널,3005,2885,20200409,5890
20200406,A,인천공항2터미널,1840,1581,20200409,3421
20200406,A,영종,2212,2242,20200409,4454
20200406,A,청라국제도시,5394,5052,20200409,10446
20200406,A,검암,6534,6284,20200409,12818
20200406,A,계양,8196,7496,20200409,15692
20200406,A,김포공항,5715,3509,20200409,9224
20200406,A,마곡나루,6537,6184,20200409,12721
20200406,A,디지털미디어시티,11114,10120,20200409,21234
20200406,A,홍대입구,6154,6310,20200409,12464
20200406,A,공덕,1788,2190,20200409,3978
20200406,A,서울역,4671,4342,20200409,9013
20200406,A,운서,5131,5155,20200409,10286
20200407,A,청라국제도시,5352,5027,20200410,10379
20200407,A,서울역,4384,4031,20200410,8415
20200407,A,공덕,1809,2273,20200410,4082
20200407,A,홍대입구,6336,6500,20200410,12836
20200407,A,디지털미디어시티,11148,10315,20200410,21463
20200407,A,마곡나루,6785,6169,20200410,12954
20200407,A,김포공항,5253,3435,20200410,8688
20200407,A,계양,8172,7454,20200410,15626
20200407,A,검암,6454,6102,20200410,12556
20200407,A,운서,5157,5247,20200410,10404
20200407,A,공항화물청사,2213,2484,20200410,4697
20200407,A,인천공항1터미널,3001,2975,20200410,5976
20200407,A,인천공항2터미널,1814,1549,20200410,3363
20200407,A,영종,2075,2110,20200410,4185
20200408,A,운서,5093,5155,20200411,10248
20200408,A,영종,2205,2243,20200411,4448
20200408,A,인천공항2터미널,1721,1498,20200411,3219
20200408,A,인천공항1터미널,3023,2939,20200411,5962
20200408,A,공항화물청사,2247,2470,20200411,4717
20200408,A,서울역,4441,4095,20200411,8536
20200408,A,공덕,1887,2296,20200411,4183
20200408,A,홍대입구,6567,6763,20200411,13330
20200408,A,디지털미디어시티,11220,10463,20200411,21683
20200408,A,마곡나루,6757,6295,20200411,13052
20200408,A,김포공항,5148,3427,20200411,8575
20200408,A,계양,8162,7380,20200411,15542
20200408,A,검암,6552,6263,20200411,12815
20200408,A,청라국제도시,5491,5100,20200411,10591
20200409,A,서울역,4647,4417,20200412,9064
20200409,A,공덕,1827,2283,20200412,4110
20200409,A,홍대입구,6558,6818,20200412,13376
20200409,A,디지털미디어시티,11364,10419,20200412,21783
20200409,A,마곡나루,6975,6160,20200412,13135
20200409,A,김포공항,5454,3820,20200412,9274
20200409,A,계양,8132,7314,20200412,15446
20200409,A,검암,6618,6298,20200412,12916
20200409,A,청라국제도시,5419,5082,20200412,10501
20200409,A,운서,5233,5287,20200412,10520
20200409,A,공항화물청사,2291,2506,20200412,4797
20200409,A,인천공항1터미널,2982,2854,20200412,5836
20200409,A,인천공항2터미널,1784,1572,20200412,3356
20200409,A,영종,2218,2252,20200412,4470
20200410,A,서울역,5700,5468,20200413,11168
20200410,A,공덕,1783,2324,20200413,4107
20200410,A,홍대입구,7303,7812,20200413,15115
20200410,A,디지털미디어시티,10779,9743,20200413,20522
20200410,A,마곡나루,3467,3665,20200413,7132
20200410,A,김포공항,5833,4056,20200413,9889
20200410,A,계양,8174,7405,20200413,15579
20200410,A,검암,6621,6354,20200413,12975
20200410,A,청라국제도시,5467,5152,20200413,10619
20200410,A,운서,5449,5427,20200413,10876
20200410,A,공항화물청사,2191,2394,20200413,4585
20200410,A,인천공항1터미널,3033,2958,20200413,5991
20200410,A,인천공항2터미널,1880,1566,20200413,3446
20200410,A,영종,2266,2350,20200413,4616
20200411,A,서울역,3772,3769,20200414,7541
20200411,A,공덕,1021,1592,20200414,2613
20200411,A,홍대입구,6911,7202,20200414,14113
20200411,A,디지털미디어시티,3811,3696,20200414,7507
20200411,A,마곡나루,1772,1750,20200414,3522
20200411,A,김포공항,4428,2755,20200414,7183
20200411,A,계양,4780,4436,20200414,9216
20200411,A,검암,3839,4045,20200414,7884
20200411,A,청라국제도시,2700,2559,20200414,5259
20200411,A,운서,4461,4638,20200414,9099
20200411,A,공항화물청사,1272,1311,20200414,2583
20200411,A,인천공항1터미널,2515,2422,20200414,4937
20200411,A,인천공항2터미널,1543,1278,20200414,2821
20200411,A,영종,1849,1861,20200414,3710
20200412,A,서울역,3701,3410,20200415,7111
20200412,A,공덕,753,1076,20200415,1829
20200412,A,홍대입구,5284,5008,20200415,10292
20200412,A,디지털미디어시티,2541,2495,20200415,5036
20200412,A,마곡나루,1169,1295,20200415,2464
20200412,A,김포공항,4393,2368,20200415,6761
20200412,A,계양,3484,3177,20200415,6661
20200412,A,검암,2856,2929,20200415,5785
20200412,A,청라국제도시,2021,1775,20200415,3796
20200412,A,운서,3602,3861,20200415,7463
20200412,A,공항화물청사,874,986,20200415,1860
20200412,A,인천공항1터미널,2417,2344,20200415,4761
20200412,A,인천공항2터미널,1509,1266,20200415,2775
20200412,A,영종,1418,1401,20200415,2819
20200413,A,서울역,4911,4463,20200416,9374
20200413,A,공덕,1830,2226,20200416,4056
20200413,A,홍대입구,6488,6432,20200416,12920
20200413,A,디지털미디어시티,11354,10501,20200416,21855
20200413,A,마곡나루,6108,5807,20200416,11915
20200413,A,김포공항,5698,3755,20200416,9453
20200413,A,계양,8324,7564,20200416,15888
20200413,A,검암,6598,6425,20200416,13023
20200413,A,청라국제도시,5397,5119,20200416,10516
20200413,A,운서,5266,5342,20200416,10608
20200413,A,공항화물청사,2173,2423,20200416,4596
20200413,A,인천공항1터미널,2933,2846,20200416,5779
20200413,A,인천공항2터미널,1742,1560,20200416,3302
20200413,A,영종,2348,2280,20200416,4628
20200414,A,영종,2347,2382,20200417,4729
20200414,A,인천공항2터미널,1789,1523,20200417,3312
20200414,A,인천공항1터미널,3009,2950,20200417,5959
20200414,A,공항화물청사,2249,2471,20200417,4720
20200414,A,청라국제도시,5533,5136,20200417,10669
20200414,A,검암,6834,6511,20200417,13345
20200414,A,계양,8743,7521,20200417,16264
20200414,A,김포공항,6041,3969,20200417,10010
20200414,A,마곡나루,6443,5901,20200417,12344
20200414,A,디지털미디어시티,11679,10784,20200417,22463
20200414,A,홍대입구,7100,7609,20200417,14709
20200414,A,공덕,1896,2389,20200417,4285
20200414,A,서울역,5084,4849,20200417,9933
20200414,A,운서,5531,5466,20200417,10997
20200415,A,서울역,3274,2913,20200418,6187
20200415,A,공덕,827,1135,20200418,1962
20200415,A,홍대입구,5985,5673,20200418,11658
20200415,A,디지털미디어시티,3311,3323,20200418,6634
20200415,A,마곡나루,1517,1556,20200418,3073
20200415,A,김포공항,4577,2696,20200418,7273
20200415,A,계양,4461,4072,20200418,8533
20200415,A,검암,3368,3442,20200418,6810
20200415,A,청라국제도시,2473,2356,20200418,4829
20200415,A,운서,4051,4256,20200418,8307
20200415,A,공항화물청사,1169,1279,20200418,2448
20200415,A,인천공항1터미널,2525,2515,20200418,5040
20200415,A,인천공항2터미널,1530,1294,20200418,2824
20200415,A,영종,1718,1771,20200418,3489
20200416,A,서울역,4986,4582,20200419,9568
20200416,A,공덕,1827,2323,20200419,4150
20200416,A,홍대입구,6782,7068,20200419,13850
20200416,A,디지털미디어시티,11348,10493,20200419,21841
20200416,A,마곡나루,6706,6389,20200419,13095
20200416,A,김포공항,5757,3771,20200419,9528
20200416,A,계양,8409,7577,20200419,15986
20200416,A,검암,6698,6426,20200419,13124
20200416,A,청라국제도시,5606,5183,20200419,10789
20200416,A,운서,5423,5547,20200419,10970
20200416,A,공항화물청사,2268,2521,20200419,4789
20200416,A,인천공항1터미널,3212,3060,20200419,6272
20200416,A,인천공항2터미널,1786,1562,20200419,3348
20200416,A,영종,2322,2334,20200419,4656
20200417,A,서울역,5928,5490,20200420,11418
20200417,A,공덕,1792,2425,20200420,4217
20200417,A,홍대입구,6941,7432,20200420,14373
20200417,A,디지털미디어시티,11597,10411,20200420,22008
20200417,A,마곡나루,6908,5985,20200420,12893
20200417,A,김포공항,5861,3831,20200420,9692
20200417,A,계양,8249,7335,20200420,15584
20200417,A,검암,6508,6149,20200420,12657
20200417,A,청라국제도시,5457,5079,20200420,10536
20200417,A,운서,5205,5070,20200420,10275
20200417,A,공항화물청사,2199,2386,20200420,4585
20200417,A,인천공항1터미널,3008,2935,20200420,5943
20200417,A,인천공항2터미널,1682,1465,20200420,3147
20200417,A,영종,2164,2277,20200420,4441
20200418,A,서울역,4145,4108,20200421,8253
20200418,A,공덕,1072,1524,20200421,2596
20200418,A,홍대입구,7665,7890,20200421,15555
20200418,A,디지털미디어시티,3947,3720,20200421,7667
20200418,A,마곡나루,1948,2145,20200421,4093
20200418,A,김포공항,5138,2878,20200421,8016
20200418,A,계양,5341,4758,20200421,10099
20200418,A,검암,3994,4201,20200421,8195
20200418,A,청라국제도시,2897,2901,20200421,5798
20200418,A,운서,4747,4870,20200421,9617
20200418,A,공항화물청사,1296,1349,20200421,2645
20200418,A,인천공항1터미널,2743,2649,20200421,5392
20200418,A,인천공항2터미널,1430,1245,20200421,2675
20200418,A,영종,1968,2150,20200421,4118
20200419,A,서울역,3966,3625,20200422,7591
20200419,A,공덕,734,1060,20200422,1794
20200419,A,홍대입구,4890,4811,20200422,9701
20200419,A,디지털미디어시티,2240,2259,20200422,4499
20200419,A,마곡나루,1142,1200,20200422,2342
20200419,A,김포공항,4985,2380,20200422,7365
20200419,A,계양,3339,3171,20200422,6510
20200419,A,검암,2788,2770,20200422,5558
20200419,A,청라국제도시,1980,1814,20200422,3794
20200419,A,운서,3552,3886,20200422,7438
20200419,A,공항화물청사,864,991,20200422,1855
20200419,A,인천공항1터미널,2426,2326,20200422,4752
20200419,A,인천공항2터미널,1382,1170,20200422,2552
20200419,A,영종,1493,1419,20200422,2912
20200420,A,서울역,5249,4734,20200423,9983
20200420,A,공덕,1802,2345,20200423,4147
20200420,A,홍대입구,6368,6686,20200423,13054
20200420,A,디지털미디어시티,11812,10844,20200423,22656
20200420,A,마곡나루,6793,6443,20200423,13236
20200420,A,김포공항,6019,4061,20200423,10080
20200420,A,계양,8517,7672,20200423,16189
20200420,A,검암,6705,6373,20200423,13078
20200420,A,청라국제도시,5544,5200,20200423,10744
20200420,A,운서,5096,5199,20200423,10295
20200420,A,공항화물청사,2150,2453,20200423,4603
20200420,A,인천공항1터미널,3088,2978,20200423,6066
20200420,A,인천공항2터미널,1607,1500,20200423,3107
20200420,A,영종,2398,2382,20200423,4780
20200421,A,서울역,4856,4472,20200424,9328
20200421,A,공덕,1830,2376,20200424,4206
20200421,A,홍대입구,6523,6914,20200424,13437
20200421,A,디지털미디어시티,12004,11012,20200424,23016
20200421,A,마곡나루,6966,6370,20200424,13336
20200421,A,김포공항,5858,3960,20200424,9818
20200421,A,계양,8598,7780,20200424,16378
20200421,A,검암,6683,6356,20200424,13039
20200421,A,청라국제도시,5594,5260,20200424,10854
20200421,A,운서,5349,5432,20200424,10781
20200421,A,공항화물청사,2316,2532,20200424,4848
20200421,A,인천공항1터미널,3246,3150,20200424,6396
20200421,A,인천공항2터미널,1650,1459,20200424,3109
20200421,A,영종,2421,2402,20200424,4823
20200422,A,서울역,4998,4565,20200425,9563
20200422,A,공덕,1864,2351,20200425,4215
20200422,A,홍대입구,6666,6931,20200425,13597
20200422,A,디지털미디어시티,11876,10926,20200425,22802
20200422,A,마곡나루,7041,6425,20200425,13466
20200422,A,김포공항,5926,4090,20200425,10016
20200422,A,계양,8364,7660,20200425,16024
20200422,A,검암,6629,6317,20200425,12946
20200422,A,청라국제도시,5594,5245,20200425,10839
20200422,A,운서,5208,5237,20200425,10445
20200422,A,공항화물청사,2224,2516,20200425,4740
20200422,A,인천공항1터미널,3333,3272,20200425,6605
20200422,A,인천공항2터미널,1704,1524,20200425,3228
20200422,A,영종,2329,2389,20200425,4718
20200423,A,서울역,5215,4812,20200426,10027
20200423,A,공덕,1852,2394,20200426,4246
20200423,A,홍대입구,6941,7390,20200426,14331
20200423,A,디지털미디어시티,12187,11260,20200426,23447
20200423,A,마곡나루,7172,6622,20200426,13794
20200423,A,김포공항,6345,4147,20200426,10492
20200423,A,계양,8565,7835,20200426,16400
20200423,A,검암,6782,6540,20200426,13322
20200423,A,청라국제도시,5752,5378,20200426,11130
20200423,A,운서,5456,5477,20200426,10933
20200423,A,공항화물청사,2265,2501,20200426,4766
20200423,A,인천공항1터미널,3276,3154,20200426,6430
20200423,A,인천공항2터미널,1695,1507,20200426,3202
20200423,A,영종,2375,2359,20200426,4734
20200424,A,서울역,6561,6067,20200427,12628
20200424,A,공덕,2042,2663,20200427,4705
20200424,A,홍대입구,8136,8756,20200427,16892
20200424,A,디지털미디어시티,12285,11188,20200427,23473
20200424,A,마곡나루,7506,6666,20200427,14172
20200424,A,김포공항,7005,4640,20200427,11645
20200424,A,계양,8850,7994,20200427,16844
20200424,A,검암,7035,6689,20200427,13724
20200424,A,청라국제도시,5915,5509,20200427,11424
20200424,A,운서,5784,5622,20200427,11406
20200424,A,공항화물청사,2222,2532,20200427,4754
20200424,A,인천공항1터미널,3258,3223,20200427,6481
20200424,A,인천공항2터미널,1694,1482,20200427,3176
20200424,A,영종,2568,2633,20200427,5201
20200425,A,서울역,4738,4637,20200428,9375
20200425,A,공덕,1237,1693,20200428,2930
20200425,A,홍대입구,8338,8545,20200428,16883
20200425,A,디지털미디어시티,4168,3900,20200428,8068
20200425,A,마곡나루,2063,2198,20200428,4261
20200425,A,김포공항,5499,3166,20200428,8665
20200425,A,계양,5533,5051,20200428,10584
20200425,A,검암,4192,4260,20200428,8452
20200425,A,청라국제도시,3120,3126,20200428,6246
20200425,A,운서,4771,4976,20200428,9747
20200425,A,공항화물청사,1212,1257,20200428,2469
20200425,A,인천공항1터미널,2821,2734,20200428,5555
20200425,A,인천공항2터미널,1346,1187,20200428,2533
20200425,A,영종,2213,2285,20200428,4498
20200426,A,서울역,4520,4274,20200429,8794
20200426,A,공덕,822,1147,20200429,1969
20200426,A,홍대입구,6428,6155,20200429,12583
20200426,A,디지털미디어시티,2591,2659,20200429,5250
20200426,A,마곡나루,1503,1604,20200429,3107
20200426,A,김포공항,5659,2979,20200429,8638
20200426,A,계양,3938,3671,20200429,7609
20200426,A,검암,3245,3405,20200429,6650
20200426,A,청라국제도시,2351,2272,20200429,4623
20200426,A,운서,3824,4310,20200429,8134
20200426,A,공항화물청사,955,1011,20200429,1966
20200426,A,인천공항1터미널,2905,2770,20200429,5675
20200426,A,인천공항2터미널,1435,1239,20200429,2674
20200426,A,영종,1896,1801,20200429,3697
20200427,A,서울역,5582,5050,20200430,10632
20200427,A,공덕,1960,2442,20200430,4402
20200427,A,홍대입구,6824,7068,20200430,13892
20200427,A,디지털미디어시티,12244,11340,20200430,23584
20200427,A,마곡나루,7255,6826,20200430,14081
20200427,A,김포공항,7078,4606,20200430,11684
20200427,A,계양,8901,8119,20200430,17020
20200427,A,검암,7025,6695,20200430,13720
20200427,A,청라국제도시,5856,5486,20200430,11342
20200427,A,운서,5568,5668,20200430,11236
20200427,A,공항화물청사,2277,2515,20200430,4792
20200427,A,인천공항1터미널,3332,3263,20200430,6595
20200427,A,인천공항2터미널,1719,1509,20200430,3228
20200427,A,영종,2554,2647,20200430,5201
20200428,A,서울역,5645,5145,20200501,10790
20200428,A,공덕,1986,2554,20200501,4540
20200428,A,홍대입구,7275,7573,20200501,14848
20200428,A,디지털미디어시티,12538,11590,20200501,24128
20200428,A,마곡나루,7541,6856,20200501,14397
20200428,A,김포공항,6841,4900,20200501,11741
20200428,A,계양,8954,8037,20200501,16991
20200428,A,검암,7215,6790,20200501,14005
20200428,A,청라국제도시,5946,5578,20200501,11524
20200428,A,운서,5703,5803,20200501,11506
20200428,A,공항화물청사,2275,2571,20200501,4846
20200428,A,인천공항1터미널,3360,3305,20200501,6665
20200428,A,인천공항2터미널,1715,1582,20200501,3297
20200428,A,영종,2667,2606,20200501,5273
20200429,A,서울역,6900,7346,20200502,14246
20200429,A,공덕,2122,2754,20200502,4876
20200429,A,홍대입구,8261,8657,20200502,16918
20200429,A,디지털미디어시티,13035,11656,20200502,24691
20200429,A,마곡나루,8030,7015,20200502,15045
20200429,A,김포공항,8008,5649,20200502,13657
20200429,A,계양,9257,8109,20200502,17366
20200429,A,검암,7396,7088,20200502,14484
20200429,A,청라국제도시,6244,5821,20200502,12065
20200429,A,운서,6160,5995,20200502,12155
20200429,A,공항화물청사,2304,2541,20200502,4845
20200429,A,인천공항1터미널,3576,3450,20200502,7026
20200429,A,인천공항2터미널,1810,1541,20200502,3351
20200429,A,영종,2738,2807,20200502,5545
20200430,A,서울역,5032,6331,20200503,11363
20200430,A,공덕,1122,1471,20200503,2593
20200430,A,홍대입구,7672,7922,20200503,15594
20200430,A,디지털미디어시티,3729,3298,20200503,7027
20200430,A,마곡나루,2042,2075,20200503,4117
20200430,A,김포공항,6064,4261,20200503,10325
20200430,A,계양,5485,4756,20200503,10241
20200430,A,검암,4190,4163,20200503,8353
20200430,A,청라국제도시,3153,2984,20200503,6137
20200430,A,운서,4912,5055,20200503,9967
20200430,A,공항화물청사,1207,1273,20200503,2480
20200430,A,인천공항1터미널,3612,3835,20200503,7447
20200430,A,인천공항2터미널,1525,1341,20200503,2866
20200430,A,영종,2050,2252,20200503,4302
20200501,A,영종,2217,2296,20200504,4513
20200501,A,인천공항2터미널,1471,1228,20200504,2699
20200501,A,인천공항1터미널,3461,3535,20200504,6996
20200501,A,공항화물청사,1327,1460,20200504,2787
20200501,A,운서,4936,4979,20200504,9915
20200501,A,청라국제도시,3071,2858,20200504,5929
20200501,A,검암,4354,4322,20200504,8676
20200501,A,계양,5394,4985,20200504,10379
20200501,A,김포공항,6202,3774,20200504,9976
20200501,A,마곡나루,1999,2012,20200504,4011
20200501,A,디지털미디어시티,4170,3894,20200504,8064
20200501,A,홍대입구,7870,7992,20200504,15862
20200501,A,공덕,1128,1455,20200504,2583
20200501,A,서울역,5359,5615,20200504,10974
20200502,A,영종,2217,2245,20200505,4462
20200502,A,인천공항2터미널,1338,1179,20200505,2517
20200502,A,인천공항1터미널,3098,3011,20200505,6109
20200502,A,공항화물청사,1224,1286,20200505,2510
20200502,A,운서,4654,4589,20200505,9243
20200502,A,청라국제도시,2988,2928,20200505,5916
20200502,A,검암,4065,4197,20200505,8262
20200502,A,계양,5148,4824,20200505,9972
20200502,A,김포공항,6151,3151,20200505,9302
20200502,A,마곡나루,1914,1958,20200505,3872
20200502,A,디지털미디어시티,3496,3401,20200505,6897
20200502,A,홍대입구,8172,8006,20200505,16178
20200502,A,공덕,1003,1384,20200505,2387
20200502,A,서울역,5765,5207,20200505,10972
20200503,A,영종,1774,1719,20200506,3493
20200503,A,인천공항2터미널,1393,1282,20200506,2675
20200503,A,인천공항1터미널,2911,2755,20200506,5666
20200503,A,공항화물청사,969,1000,20200506,1969
20200503,A,운서,4107,4484,20200506,8591
20200503,A,청라국제도시,2404,2243,20200506,4647
20200503,A,검암,3377,3673,20200506,7050
20200503,A,계양,4032,3988,20200506,8020
20200503,A,김포공항,7182,3007,20200506,10189
20200503,A,마곡나루,1533,1717,20200506,3250
20200503,A,디지털미디어시티,2509,2613,20200506,5122
20200503,A,홍대입구,6683,6475,20200506,13158
20200503,A,공덕,816,1226,20200506,2042
20200503,A,서울역,6282,4880,20200506,11162
20200504,A,영종,2431,2549,20200507,4980
20200504,A,인천공항2터미널,1612,1369,20200507,2981
20200504,A,인천공항1터미널,3271,3303,20200507,6574
20200504,A,공항화물청사,1977,2190,20200507,4167
20200504,A,운서,5440,5571,20200507,11011
20200504,A,청라국제도시,4856,4556,20200507,9412
20200504,A,검암,5923,5813,20200507,11736
20200504,A,계양,7593,6843,20200507,14436
20200504,A,김포공항,7030,3674,20200507,10704
20200504,A,마곡나루,4165,3980,20200507,8145
20200504,A,디지털미디어시티,8803,8315,20200507,17118
20200504,A,홍대입구,7636,8002,20200507,15638
20200504,A,공덕,1482,2164,20200507,3646
20200504,A,서울역,5813,4891,20200507,10704
20200505,A,서울역,5218,3903,20200508,9121
20200505,A,공덕,906,1192,20200508,2098
20200505,A,홍대입구,6886,6688,20200508,13574
20200505,A,디지털미디어시티,3106,3171,20200508,6277
20200505,A,마곡나루,1701,1908,20200508,3609
20200505,A,김포공항,6477,3113,20200508,9590
20200505,A,계양,4483,4197,20200508,8680
20200505,A,검암,3311,3639,20200508,6950
20200505,A,청라국제도시,2580,2542,20200508,5122
20200505,A,운서,4142,4303,20200508,8445
20200505,A,공항화물청사,1108,1180,20200508,2288
20200505,A,인천공항1터미널,3028,2888,20200508,5916
20200505,A,인천공항2터미널,1322,1150,20200508,2472
20200505,A,영종,1863,1821,20200508,3684
20200506,A,서울역,6043,5468,20200509,11511
20200506,A,공덕,2019,2569,20200509,4588
20200506,A,홍대입구,7662,7855,20200509,15517
20200506,A,디지털미디어시티,12772,11675,20200509,24447
20200506,A,마곡나루,7356,6791,20200509,14147
20200506,A,김포공항,7980,4604,20200509,12584
20200506,A,계양,9227,8310,20200509,17537
20200506,A,검암,7286,6997,20200509,14283
20200506,A,청라국제도시,6133,5655,20200509,11788
20200506,A,운서,5807,5727,20200509,11534
20200506,A,공항화물청사,2364,2619,20200509,4983
20200506,A,인천공항1터미널,3376,3334,20200509,6710
20200506,A,인천공항2터미널,1644,1446,20200509,3090
20200506,A,영종,2836,2748,20200509,5584
20200507,A,서울역,6105,5659,20200510,11764
20200507,A,공덕,2033,2527,20200510,4560
20200507,A,홍대입구,7997,8017,20200510,16014
20200507,A,디지털미디어시티,12965,11922,20200510,24887
20200507,A,마곡나루,7678,7112,20200510,14790
20200507,A,김포공항,7400,4594,20200510,11994
20200507,A,계양,9269,8364,20200510,17633
20200507,A,검암,7302,7077,20200510,14379
20200507,A,청라국제도시,6198,5792,20200510,11990
20200507,A,운서,5822,5714,20200510,11536
20200507,A,공항화물청사,2405,2623,20200510,5028
20200507,A,인천공항1터미널,3293,3231,20200510,6524
20200507,A,인천공항2터미널,1716,1565,20200510,3281
20200507,A,영종,2756,2747,20200510,5503
20200508,A,서울역,7696,7944,20200511,15640
20200508,A,공덕,2049,2681,20200511,4730
20200508,A,홍대입구,8138,8555,20200511,16693
20200508,A,디지털미디어시티,13897,11967,20200511,25864
20200508,A,마곡나루,8124,6976,20200511,15100
20200508,A,김포공항,7741,4847,20200511,12588
20200508,A,계양,9375,8773,20200511,18148
20200508,A,검암,7641,7201,20200511,14842
20200508,A,청라국제도시,6180,5993,20200511,12173
20200508,A,운서,5766,5481,20200511,11247
20200508,A,공항화물청사,2311,2538,20200511,4849
20200508,A,인천공항1터미널,3273,3272,20200511,6545
20200508,A,인천공항2터미널,1683,1444,20200511,3127
20200508,A,영종,2663,2821,20200511,5484
20200509,A,서울역,5138,5220,20200512,10358
20200509,A,공덕,1103,1799,20200512,2902
20200509,A,홍대입구,6976,7418,20200512,14394
20200509,A,디지털미디어시티,3933,3648,20200512,7581
20200509,A,마곡나루,1640,1758,20200512,3398
20200509,A,김포공항,5550,3351,20200512,8901
20200509,A,계양,5084,4444,20200512,9528
20200509,A,검암,3752,3759,20200512,7511
20200509,A,청라국제도시,2863,2818,20200512,5681
20200509,A,운서,4179,4274,20200512,8453
20200509,A,공항화물청사,1198,1227,20200512,2425
20200509,A,인천공항1터미널,2346,2311,20200512,4657
20200509,A,인천공항2터미널,1295,1133,20200512,2428
20200509,A,영종,1947,2011,20200512,3958
20200510,A,서울역,5589,4745,20200513,10334
20200510,A,공덕,936,1166,20200513,2102
20200510,A,홍대입구,6421,6197,20200513,12618
20200510,A,디지털미디어시티,2960,3023,20200513,5983
20200510,A,마곡나루,1435,1646,20200513,3081
20200510,A,김포공항,5815,3538,20200513,9353
20200510,A,계양,4306,3822,20200513,8128
20200510,A,검암,3344,3444,20200513,6788
20200510,A,청라국제도시,2461,2331,20200513,4792
20200510,A,운서,3949,4392,20200513,8341
20200510,A,공항화물청사,940,1064,20200513,2004
20200510,A,인천공항1터미널,2874,2664,20200513,5538
20200510,A,인천공항2터미널,1393,1273,20200513,2666
20200510,A,영종,1792,1787,20200513,3579
20200511,A,영종,2590,2551,20200514,5141
20200511,A,인천공항2터미널,1647,1443,20200514,3090
20200511,A,인천공항1터미널,3076,3022,20200514,6098
20200511,A,공항화물청사,2270,2493,20200514,4763
20200511,A,운서,5423,5540,20200514,10963
20200511,A,청라국제도시,6073,5629,20200514,11702
20200511,A,검암,7217,6808,20200514,14025
20200511,A,계양,9253,8454,20200514,17707
20200511,A,김포공항,7015,4823,20200514,11838
20200511,A,마곡나루,7441,6903,20200514,14344
20200511,A,디지털미디어시티,12899,11662,20200514,24561
20200511,A,홍대입구,6977,7184,20200514,14161
20200511,A,공덕,1935,2529,20200514,4464
20200511,A,서울역,6163,5507,20200514,11670
20200512,A,서울역,5831,5224,20200515,11055
20200512,A,공덕,1978,2491,20200515,4469
20200512,A,홍대입구,6921,7153,20200515,14074
20200512,A,디지털미디어시티,12833,11752,20200515,24585
20200512,A,마곡나루,7488,6933,20200515,14421
20200512,A,김포공항,7460,5062,20200515,12522
20200512,A,계양,9084,8208,20200515,17292
20200512,A,검암,7282,7047,20200515,14329
20200512,A,청라국제도시,6046,5699,20200515,11745
20200512,A,운서,5671,5671,20200515,11342
20200512,A,공항화물청사,2359,2620,20200515,4979
20200512,A,인천공항1터미널,3119,3060,20200515,6179
20200512,A,인천공항2터미널,1674,1464,20200515,3138
20200512,A,영종,2564,2713,20200515,5277
20200513,A,서울역,5733,5356,20200516,11089
20200513,A,공덕,2014,2590,20200516,4604
20200513,A,홍대입구,6856,6975,20200516,13831
20200513,A,디지털미디어시티,12504,11516,20200516,24020
20200513,A,마곡나루,7667,6966,20200516,14633
20200513,A,김포공항,7206,4474,20200516,11680
20200513,A,계양,9119,8280,20200516,17399
20200513,A,검암,7138,6962,20200516,14100
20200513,A,청라국제도시,5968,5663,20200516,11631
20200513,A,운서,5621,5666,20200516,11287
20200513,A,공항화물청사,2363,2613,20200516,4976
20200513,A,인천공항1터미널,3249,3259,20200516,6508
20200513,A,인천공항2터미널,1712,1494,20200516,3206
20200513,A,영종,2618,2643,20200516,5261
20200514,A,영종,2480,2515,20200517,4995
20200514,A,인천공항2터미널,1685,1585,20200517,3270
20200514,A,인천공항1터미널,3120,3014,20200517,6134
20200514,A,공항화물청사,2297,2563,20200517,4860
20200514,A,운서,5447,5506,20200517,10953
20200514,A,청라국제도시,5937,5554,20200517,11491
20200514,A,검암,7108,7004,20200517,14112
20200514,A,계양,8909,8130,20200517,17039
20200514,A,김포공항,7754,4635,20200517,12389
20200514,A,마곡나루,7543,7049,20200517,14592
20200514,A,디지털미디어시티,12420,11670,20200517,24090
20200514,A,홍대입구,6511,6662,20200517,13173
20200514,A,공덕,1966,2517,20200517,4483
20200514,A,서울역,6216,5397,20200517,11613
20200515,A,영종,2349,2463,20200518,4812
20200515,A,인천공항2터미널,1700,1446,20200518,3146
20200515,A,인천공항1터미널,2953,2943,20200518,5896
20200515,A,공항화물청사,2160,2428,20200518,4588
20200515,A,운서,5272,5269,20200518,10541
20200515,A,청라국제도시,5805,5423,20200518,11228
20200515,A,검암,6817,6510,20200518,13327
20200515,A,계양,8717,7868,20200518,16585
20200515,A,김포공항,7798,4677,20200518,12475
20200515,A,마곡나루,7325,6379,20200518,13704
20200515,A,디지털미디어시티,12537,11289,20200518,23826
20200515,A,홍대입구,6102,6480,20200518,12582
20200515,A,공덕,1914,2617,20200518,4531
20200515,A,서울역,7086,6971,20200518,14057
20200516,A,영종,2021,2018,20200519,4039
20200516,A,인천공항2터미널,1461,1260,20200519,2721
20200516,A,인천공항1터미널,2554,2526,20200519,5080
20200516,A,공항화물청사,1240,1267,20200519,2507
20200516,A,운서,4757,4745,20200519,9502
20200516,A,청라국제도시,2918,2899,20200519,5817
20200516,A,검암,4022,4146,20200519,8168
20200516,A,계양,5303,4706,20200519,10009
20200516,A,김포공항,6087,3589,20200519,9676
20200516,A,마곡나루,1886,2024,20200519,3910
20200516,A,디지털미디어시티,4319,4172,20200519,8491
20200516,A,홍대입구,5573,5616,20200519,11189
20200516,A,공덕,1194,1836,20200519,3030
20200516,A,서울역,4855,5033,20200519,9888
20200517,A,영종,1736,1630,20200520,3366
20200517,A,인천공항2터미널,1376,1228,20200520,2604
20200517,A,인천공항1터미널,2723,2594,20200520,5317
20200517,A,공항화물청사,963,1008,20200520,1971
20200517,A,운서,4007,4328,20200520,8335
20200517,A,청라국제도시,2271,2226,20200520,4497
20200517,A,검암,3229,3407,20200520,6636
20200517,A,계양,3906,3792,20200520,7698
20200517,A,김포공항,5880,3376,20200520,9256
20200517,A,마곡나루,1496,1614,20200520,3110
20200517,A,디지털미디어시티,3080,2996,20200520,6076
20200517,A,홍대입구,4805,4428,20200520,9233
20200517,A,공덕,950,1309,20200520,2259
20200517,A,서울역,4921,4362,20200520,9283
20200518,A,서울역,5774,5226,20200521,11000
20200518,A,공덕,1895,2397,20200521,4292
20200518,A,홍대입구,5733,6022,20200521,11755
20200518,A,디지털미디어시티,12497,11267,20200521,23764
20200518,A,마곡나루,7056,6566,20200521,13622
20200518,A,김포공항,7102,4723,20200521,11825
20200518,A,계양,8625,7786,20200521,16411
20200518,A,검암,6808,6391,20200521,13199
20200518,A,청라국제도시,5623,5251,20200521,10874
20200518,A,운서,5018,5014,20200521,10032
20200518,A,공항화물청사,2193,2501,20200521,4694
20200518,A,인천공항1터미널,2915,2844,20200521,5759
20200518,A,인천공항2터미널,1641,1441,20200521,3082
20200518,A,영종,2361,2323,20200521,4684
20200519,A,영종,2349,2442,20200522,4791
20200519,A,인천공항2터미널,1686,1494,20200522,3180
20200519,A,인천공항1터미널,2949,2887,20200522,5836
20200519,A,공항화물청사,2259,2433,20200522,4692
20200519,A,운서,5196,5288,20200522,10484
20200519,A,청라국제도시,5727,5403,20200522,11130
20200519,A,검암,6837,6546,20200522,13383
20200519,A,계양,8731,7930,20200522,16661
20200519,A,김포공항,7245,4709,20200522,11954
20200519,A,마곡나루,7415,6736,20200522,14151
20200519,A,디지털미디어시티,12838,11683,20200522,24521
20200519,A,홍대입구,6007,6233,20200522,12240
20200519,A,공덕,1924,2434,20200522,4358
20200519,A,서울역,5651,5231,20200522,10882
20200520,A,영종,2646,2665,20200523,5311
20200520,A,인천공항2터미널,1600,1410,20200523,3010
20200520,A,인천공항1터미널,3237,3181,20200523,6418
20200520,A,공항화물청사,2332,2584,20200523,4916
20200520,A,운서,5696,5607,20200523,11303
20200520,A,청라국제도시,6022,5662,20200523,11684
20200520,A,검암,7132,6948,20200523,14080
20200520,A,계양,9071,8327,20200523,17398
20200520,A,김포공항,7432,4773,20200523,12205
20200520,A,마곡나루,7737,7101,20200523,14838
20200520,A,디지털미디어시티,13159,11898,20200523,25057
20200520,A,홍대입구,6851,6988,20200523,13839
20200520,A,공덕,2028,2518,20200523,4546
20200520,A,서울역,5927,5397,20200523,11324
20200521,A,홍대입구,7085,7145,20200524,14230
20200521,A,공덕,2080,2627,20200524,4707
20200521,A,서울역,6508,5666,20200524,12174
20200521,A,인천공항2터미널,1727,1638,20200524,3365
20200521,A,영종,2614,2631,20200524,5245
20200521,A,인천공항1터미널,3220,3205,20200524,6425
20200521,A,공항화물청사,2345,2645,20200524,4990
20200521,A,운서,5558,5689,20200524,11247
20200521,A,청라국제도시,5904,5456,20200524,11360
20200521,A,검암,7253,7128,20200524,14381
20200521,A,계양,9338,8457,20200524,17795
20200521,A,김포공항,8129,5112,20200524,13241
20200521,A,마곡나루,7719,7133,20200524,14852
20200521,A,디지털미디어시티,13182,12080,20200524,25262
20200522,A,서울역,7738,7375,20200525,15113
20200522,A,공덕,2077,2891,20200525,4968
20200522,A,홍대입구,7380,7729,20200525,15109
20200522,A,디지털미디어시티,13472,11918,20200525,25390
20200522,A,마곡나루,8053,7086,20200525,15139
20200522,A,김포공항,8360,4958,20200525,13318
20200522,A,계양,9242,8283,20200525,17525
20200522,A,검암,7333,6952,20200525,14285
20200522,A,청라국제도시,5960,5628,20200525,11588
20200522,A,운서,5803,5803,20200525,11606
20200522,A,공항화물청사,2207,2467,20200525,4674
20200522,A,인천공항1터미널,3227,3183,20200525,6410
20200522,A,인천공항2터미널,1729,1537,20200525,3266
20200522,A,영종,2654,2836,20200525,5490
20200523,A,서울역,5513,5702,20200526,11215
20200523,A,공덕,1347,1998,20200526,3345
20200523,A,홍대입구,7114,7036,20200526,14150
20200523,A,디지털미디어시티,5016,4756,20200526,9772
20200523,A,마곡나루,2276,2427,20200526,4703
20200523,A,김포공항,6909,3966,20200526,10875
20200523,A,계양,5937,5457,20200526,11394
20200523,A,검암,4453,4610,20200526,9063
20200523,A,청라국제도시,3318,3294,20200526,6612
20200523,A,운서,5158,5252,20200526,10410
20200523,A,공항화물청사,1259,1304,20200526,2563
20200523,A,인천공항1터미널,2809,2886,20200526,5695
20200523,A,인천공항2터미널,1384,1168,20200526,2552
20200523,A,영종,2316,2336,20200526,4652
20200524,A,검암,2970,3163,20200527,6133
20200524,A,청라국제도시,2138,2059,20200527,4197
20200524,A,운서,3837,4118,20200527,7955
20200524,A,공항화물청사,849,963,20200527,1812
20200524,A,인천공항1터미널,2596,2522,20200527,5118
20200524,A,인천공항2터미널,1312,1161,20200527,2473
20200524,A,영종,1776,1757,20200527,3533
20200524,A,계양,3945,3822,20200527,7767
20200524,A,김포공항,7619,3914,20200527,11533
20200524,A,마곡나루,1669,1854,20200527,3523
20200524,A,디지털미디어시티,2902,2929,20200527,5831
20200524,A,홍대입구,5263,5026,20200527,10289
20200524,A,공덕,913,1127,20200527,2040
20200524,A,서울역,5154,4315,20200527,9469
20200525,A,영종,2673,2632,20200528,5305
20200525,A,인천공항2터미널,1708,1518,20200528,3226
20200525,A,인천공항1터미널,3262,3098,20200528,6360
20200525,A,공항화물청사,2227,2525,20200528,4752
20200525,A,운서,5517,5614,20200528,11131
20200525,A,청라국제도시,5934,5543,20200528,11477
20200525,A,검암,7225,6757,20200528,13982
20200525,A,계양,9261,8414,20200528,17675
20200525,A,김포공항,8181,4765,20200528,12946
20200525,A,마곡나루,7563,6992,20200528,14555
20200525,A,디지털미디어시티,12921,11593,20200528,24514
20200525,A,홍대입구,6626,6753,20200528,13379
20200525,A,공덕,1942,2483,20200528,4425
20200525,A,서울역,6283,5951,20200528,12234
20200526,A,영종,2575,2600,20200529,5175
20200526,A,인천공항2터미널,1619,1518,20200529,3137
20200526,A,인천공항1터미널,3063,2976,20200529,6039
20200526,A,공항화물청사,2332,2613,20200529,4945
20200526,A,운서,5490,5415,20200529,10905
20200526,A,청라국제도시,5960,5567,20200529,11527
20200526,A,검암,7209,6814,20200529,14023
20200526,A,계양,9150,8334,20200529,17484
20200526,A,김포공항,7990,4869,20200529,12859
20200526,A,마곡나루,7620,6993,20200529,14613
20200526,A,디지털미디어시티,13214,12210,20200529,25424
20200526,A,홍대입구,6765,6945,20200529,13710
20200526,A,공덕,2044,2682,20200529,4726
20200526,A,서울역,5886,5370,20200529,11256
20200527,A,영종,2698,2793,20200530,5491
20200527,A,인천공항2터미널,1579,1391,20200530,2970
20200527,A,인천공항1터미널,3323,3195,20200530,6518
20200527,A,공항화물청사,2353,2626,20200530,4979
20200527,A,운서,5767,5729,20200530,11496
20200527,A,청라국제도시,5947,5658,20200530,11605
20200527,A,검암,7226,7030,20200530,14256
20200527,A,계양,9135,8323,20200530,17458
20200527,A,김포공항,7756,5093,20200530,12849
20200527,A,마곡나루,7859,7136,20200530,14995
20200527,A,디지털미디어시티,13097,11927,20200530,25024
20200527,A,홍대입구,7256,7351,20200530,14607
20200527,A,공덕,2014,2745,20200530,4759
20200527,A,서울역,6246,5568,20200530,11814
20200528,A,영종,2665,2731,20200531,5396
20200528,A,인천공항2터미널,1671,1567,20200531,3238
20200528,A,인천공항1터미널,3229,3142,20200531,6371
20200528,A,공항화물청사,2287,2586,20200531,4873
20200528,A,운서,5750,5785,20200531,11535
20200528,A,청라국제도시,6036,5648,20200531,11684
20200528,A,검암,7149,7059,20200531,14208
20200528,A,계양,9065,8312,20200531,17377
20200528,A,김포공항,8262,5145,20200531,13407
20200528,A,마곡나루,7683,7085,20200531,14768
20200528,A,디지털미디어시티,13310,12205,20200531,25515
20200528,A,홍대입구,6998,7292,20200531,14290
20200528,A,공덕,2080,2608,20200531,4688
20200528,A,서울역,6536,5754,20200531,12290
20200529,A,서울역,7466,7526,20200601,14992
20200529,A,공덕,2116,2732,20200601,4848
20200529,A,홍대입구,7693,8133,20200601,15826
20200529,A,디지털미디어시티,13303,11709,20200601,25012
20200529,A,마곡나루,7976,6942,20200601,14918
20200529,A,김포공항,8782,5234,20200601,14016
20200529,A,계양,9073,8198,20200601,17271
20200529,A,검암,7194,7104,20200601,14298
20200529,A,청라국제도시,6044,5693,20200601,11737
20200529,A,운서,5895,5891,20200601,11786
20200529,A,공항화물청사,2312,2503,20200601,4815
20200529,A,인천공항1터미널,3299,3409,20200601,6708
20200529,A,인천공항2터미널,1652,1498,20200601,3150
20200529,A,영종,2787,2847,20200601,5634
20200530,A,서울역,5213,5249,20200602,10462
20200530,A,공덕,1286,1837,20200602,3123
20200530,A,홍대입구,6879,7024,20200602,13903
20200530,A,디지털미디어시티,4405,4256,20200602,8661
20200530,A,마곡나루,2146,2284,20200602,4430
20200530,A,김포공항,6822,3924,20200602,10746
20200530,A,계양,5490,4898,20200602,10388
20200530,A,검암,4172,4363,20200602,8535
20200530,A,청라국제도시,3168,3098,20200602,6266
20200530,A,운서,5068,5246,20200602,10314
20200530,A,공항화물청사,1282,1376,20200602,2658
20200530,A,인천공항1터미널,2822,2884,20200602,5706
20200530,A,인천공항2터미널,1391,1192,20200602,2583
20200530,A,영종,2218,2322,20200602,4540
20200531,A,영종,1761,1669,20200603,3430
20200531,A,인천공항2터미널,1354,1188,20200603,2542
20200531,A,인천공항1터미널,2884,2711,20200603,5595
20200531,A,공항화물청사,962,1052,20200603,2014
20200531,A,운서,4180,4478,20200603,8658
20200531,A,청라국제도시,2187,2183,20200603,4370
20200531,A,검암,3179,3172,20200603,6351
20200531,A,계양,3869,3631,20200603,7500
20200531,A,김포공항,6679,3664,20200603,10343
20200531,A,마곡나루,1489,1643,20200603,3132
20200531,A,디지털미디어시티,2927,2922,20200603,5849
20200531,A,홍대입구,5560,5147,20200603,10707
20200531,A,공덕,883,1256,20200603,2139
20200531,A,서울역,5171,4440,20200603,9611
20200101,4,범계,12483,12506,20200104,24989
20200101,4,평촌,5750,5856,20200104,11606
20200101,4,인덕원,10051,10474,20200104,20525
20200101,4,정부과천청사,5647,4838,20200104,10485
20200101,4,과천,2266,2016,20200104,4282
20200101,4,대공원,1769,1797,20200104,3566
20200101,4,경마공원,901,806,20200104,1707
20200101,4,선바위,2779,2858,20200104,5637
20200102,4,선바위,9795,8092,20200105,17887
20200102,4,경마공원,2263,2316,20200105,4579
20200102,4,대공원,2956,3116,20200105,6072
20200102,4,과천,5655,5064,20200105,10719
20200102,4,정부과천청사,12215,11914,20200105,24129
20200102,4,인덕원,27051,27675,20200105,54726
20200102,4,평촌,19978,19849,20200105,39827
20200102,4,범계,30719,29837,20200105,60556
20200103,4,선바위,10557,8620,20200106,19177
20200103,4,경마공원,8145,8317,20200106,16462
20200103,4,대공원,2619,2703,20200106,5322
20200103,4,과천,5952,5296,20200106,11248
20200103,4,정부과천청사,12535,12336,20200106,24871
20200103,4,인덕원,28912,29177,20200106,58089
20200103,4,평촌,20967,20670,20200106,41637
20200103,4,범계,33156,32998,20200106,66154
20200104,4,선바위,6389,5115,20200107,11504
20200104,4,경마공원,13625,13930,20200107,27555
20200104,4,대공원,4370,4785,20200107,9155
20200104,4,과천,4537,4066,20200107,8603
20200104,4,정부과천청사,6796,6287,20200107,13083
20200104,4,인덕원,19392,18868,20200107,38260
20200104,4,평촌,11827,11549,20200107,23376
20200104,4,범계,25927,25300,20200107,51227
20200105,4,선바위,4727,4273,20200108,9000
20200105,4,경마공원,17371,17778,20200108,35149
20200105,4,대공원,3877,4055,20200108,7932
20200105,4,과천,3294,2937,20200108,6231
20200105,4,정부과천청사,9347,9274,20200108,18621
20200105,4,인덕원,14433,14444,20200108,28877
20200105,4,평촌,7743,7488,20200108,15231
20200105,4,범계,18413,17696,20200108,36109
20200106,4,선바위,10104,8489,20200109,18593
20200106,4,경마공원,933,942,20200109,1875
20200106,4,대공원,1449,1579,20200109,3028
20200106,4,과천,5473,5059,20200109,10532
20200106,4,정부과천청사,13298,13040,20200109,26338
20200106,4,인덕원,27544,28847,20200109,56391
20200106,4,평촌,21089,20871,20200109,41960
20200106,4,범계,30802,29852,20200109,60654
20200107,4,선바위,9967,8258,20200110,18225
20200107,4,경마공원,977,1035,20200110,2012
20200107,4,대공원,1620,1717,20200110,3337
20200107,4,과천,5511,5009,20200110,10520
20200107,4,정부과천청사,12213,12088,20200110,24301
20200107,4,인덕원,27126,28410,20200110,55536
20200107,4,평촌,20450,20314,20200110,40764
20200107,4,범계,30141,29565,20200110,59706
20200108,4,선바위,10369,8568,20200111,18937
20200108,4,경마공원,2526,2481,20200111,5007
20200108,4,대공원,2283,2387,20200111,4670
20200108,4,과천,5727,5309,20200111,11036
20200108,4,정부과천청사,16002,15949,20200111,31951
20200108,4,인덕원,28361,29351,20200111,57712
20200108,4,평촌,20996,20826,20200111,41822
20200108,4,범계,32101,31560,20200111,63661
20200109,4,선바위,10418,8913,20200112,19331
20200109,4,경마공원,2506,2601,20200112,5107
20200109,4,대공원,2839,2973,20200112,5812
20200109,4,과천,5946,5306,20200112,11252
20200109,4,정부과천청사,12776,12771,20200112,25547
20200109,4,인덕원,29195,30145,20200112,59340
20200109,4,평촌,21739,21447,20200112,43186
20200109,4,범계,32153,29999,20200112,62152
20200110,4,선바위,11236,8997,20200113,20233
20200110,4,경마공원,7951,8140,20200113,16091
20200110,4,대공원,2680,2816,20200113,5496
20200110,4,과천,6087,5450,20200113,11537
20200110,4,정부과천청사,13106,12554,20200113,25660
20200110,4,인덕원,30259,31004,20200113,61263
20200110,4,평촌,21845,19726,20200113,41571
20200110,4,범계,34377,33868,20200113,68245
20200111,4,선바위,7009,5757,20200114,12766
20200111,4,경마공원,13178,13378,20200114,26556
20200111,4,대공원,4091,4405,20200114,8496
20200111,4,과천,4828,4203,20200114,9031
20200111,4,정부과천청사,8790,8401,20200114,17191
20200111,4,인덕원,21397,20890,20200114,42287
20200111,4,평촌,12733,11328,20200114,24061
20200111,4,범계,27522,26987,20200114,54509
20200112,4,선바위,4740,4344,20200115,9084
20200112,4,경마공원,17124,17631,20200115,34755
20200112,4,대공원,3702,3928,20200115,7630
20200112,4,과천,3418,3066,20200115,6484
20200112,4,정부과천청사,9767,9508,20200115,19275
20200112,4,인덕원,14982,15164,20200115,30146
20200112,4,평촌,7919,7780,20200115,15699
20200112,4,범계,18997,18535,20200115,37532
20200113,4,선바위,10082,8540,20200116,18622
20200113,4,경마공원,1069,1023,20200116,2092
20200113,4,대공원,1963,2096,20200116,4059
20200113,4,과천,5602,5141,20200116,10743
20200113,4,정부과천청사,13263,12932,20200116,26195
20200113,4,인덕원,28250,29065,20200116,57315
20200113,4,평촌,21118,21211,20200116,42329
20200113,4,범계,31205,30601,20200116,61806
20200114,4,범계,32066,31316,20200117,63382
20200114,4,평촌,21111,20903,20200117,42014
20200114,4,인덕원,28635,29514,20200117,58149
20200114,4,정부과천청사,12944,12704,20200117,25648
20200114,4,과천,5989,5458,20200117,11447
20200114,4,대공원,3006,3129,20200117,6135
20200114,4,경마공원,1080,1067,20200117,2147
20200114,4,선바위,10368,8708,20200117,19076
20200115,4,선바위,10494,8914,20200118,19408
20200115,4,경마공원,3052,3021,20200118,6073
20200115,4,대공원,2637,2755,20200118,5392
20200115,4,과천,5998,5495,20200118,11493
20200115,4,정부과천청사,16168,16231,20200118,32399
20200115,4,인덕원,28674,29613,20200118,58287
20200115,4,평촌,21469,21232,20200118,42701
20200115,4,범계,32204,31375,20200118,63579
20200116,4,범계,32209,31346,20200119,63555
20200116,4,평촌,21344,21063,20200119,42407
20200116,4,인덕원,29010,29692,20200119,58702
20200116,4,정부과천청사,12836,12682,20200119,25518
20200116,4,과천,5886,5273,20200119,11159
20200116,4,대공원,2789,2958,20200119,5747
20200116,4,경마공원,2848,2822,20200119,5670
20200116,4,선바위,10402,8794,20200119,19196
20200117,4,선바위,11208,9039,20200120,20247
20200117,4,경마공원,8247,8420,20200120,16667
20200117,4,대공원,2895,2962,20200120,5857
20200117,4,과천,6254,5484,20200120,11738
20200117,4,정부과천청사,13385,12956,20200120,26341
20200117,4,인덕원,30537,31150,20200120,61687
20200117,4,평촌,21858,21385,20200120,43243
20200117,4,범계,34179,33841,20200120,68020
20200118,4,선바위,6994,5605,20200121,12599
20200118,4,경마공원,14063,14322,20200121,28385
20200118,4,대공원,5044,5384,20200121,10428
20200118,4,과천,4824,4202,20200121,9026
20200118,4,정부과천청사,7817,7610,20200121,15427
20200118,4,인덕원,21035,20495,20200121,41530
20200118,4,평촌,11999,11596,20200121,23595
20200118,4,범계,27079,25996,20200121,53075
20200119,4,선바위,4846,4314,20200122,9160
20200119,4,경마공원,18254,18781,20200122,37035
20200119,4,대공원,3085,3255,20200122,6340
20200119,4,과천,3327,3051,20200122,6378
20200119,4,정부과천청사,9471,9442,20200122,18913
20200119,4,인덕원,14738,14969,20200122,29707
20200119,4,평촌,7912,7737,20200122,15649
20200119,4,범계,18391,17589,20200122,35980
20200120,4,범계,31667,30703,20200123,62370
20200120,4,평촌,21160,20756,20200123,41916
20200120,4,인덕원,27788,28650,20200123,56438
20200120,4,정부과천청사,12540,12378,20200123,24918
20200120,4,과천,5679,5229,20200123,10908
20200120,4,대공원,2045,2103,20200123,4148
20200120,4,경마공원,1117,1093,20200123,2210
20200120,4,선바위,10177,8603,20200123,18780
20200121,4,선바위,10454,8744,20200124,19198
20200121,4,경마공원,1858,1820,20200124,3678
20200121,4,대공원,2672,2827,20200124,5499
20200121,4,과천,5921,5458,20200124,11379
20200121,4,정부과천청사,13145,12880,20200124,26025
20200121,4,인덕원,28366,29077,20200124,57443
20200121,4,평촌,21169,21078,20200124,42247
20200121,4,범계,31671,31143,20200124,62814
20200122,4,선바위,10429,8791,20200125,19220
20200122,4,경마공원,2985,2965,20200125,5950
20200122,4,대공원,2466,2581,20200125,5047
20200122,4,과천,5840,5272,20200125,11112
20200122,4,정부과천청사,15869,15980,20200125,31849
20200122,4,인덕원,28544,29191,20200125,57735
20200122,4,평촌,21370,21031,20200125,42401
20200122,4,범계,32225,31596,20200125,63821
20200123,4,선바위,9436,7873,20200126,17309
20200123,4,경마공원,2124,2134,20200126,4258
20200123,4,대공원,2400,2575,20200126,4975
20200123,4,과천,5305,4747,20200126,10052
20200123,4,정부과천청사,11092,10755,20200126,21847
20200123,4,인덕원,25983,25838,20200126,51821
20200123,4,평촌,19210,18816,20200126,38026
20200123,4,범계,30433,30948,20200126,61381
20200124,4,범계,11316,10719,20200127,22035
20200124,4,평촌,5951,5148,20200127,11099
20200124,4,인덕원,8823,8461,20200127,17284
20200124,4,정부과천청사,2834,2798,20200127,5632
20200124,4,과천,2067,1755,20200127,3822
20200124,4,대공원,2763,2830,20200127,5593
20200124,4,경마공원,437,414,20200127,851
20200124,4,선바위,2746,2538,20200127,5284
20200125,4,선바위,2422,2105,20200128,4527
20200125,4,경마공원,371,347,20200128,718
20200125,4,대공원,3440,3359,20200128,6799
20200125,4,과천,1855,1651,20200128,3506
20200125,4,정부과천청사,2063,2109,20200128,4172
20200125,4,인덕원,8500,8488,20200128,16988
20200125,4,평촌,4504,4396,20200128,8900
20200125,4,범계,8381,8622,20200128,17003
20200126,4,선바위,3227,2891,20200129,6118
20200126,4,경마공원,536,501,20200129,1037
20200126,4,대공원,4374,4495,20200129,8869
20200126,4,과천,2544,2147,20200129,4691
20200126,4,정부과천청사,7069,6925,20200129,13994
20200126,4,인덕원,10701,10501,20200129,21202
20200126,4,평촌,5871,6070,20200129,11941
20200126,4,범계,14496,14608,20200129,29104
20200127,4,선바위,3312,3020,20200130,6332
20200127,4,경마공원,430,392,20200130,822
20200127,4,대공원,3040,3120,20200130,6160
20200127,4,과천,2388,2186,20200130,4574
20200127,4,정부과천청사,3623,3607,20200130,7230
20200127,4,인덕원,11351,11387,20200130,22738
20200127,4,평촌,6437,6610,20200130,13047
20200127,4,범계,15877,15597,20200130,31474
20200128,4,선바위,8960,7700,20200131,16660
20200128,4,경마공원,966,978,20200131,1944
20200128,4,대공원,2052,2177,20200131,4229
20200128,4,과천,4896,4445,20200131,9341
20200128,4,정부과천청사,11982,12043,20200131,24025
20200128,4,인덕원,24696,25532,20200131,50228
20200128,4,평촌,18593,18315,20200131,36908
20200128,4,범계,28722,28115,20200131,56837
20200129,4,선바위,9755,8249,20200201,18004
20200129,4,경마공원,1901,1852,20200201,3753
20200129,4,대공원,2468,2652,20200201,5120
20200129,4,과천,5386,4926,20200201,10312
20200129,4,정부과천청사,14927,14900,20200201,29827
20200129,4,인덕원,26598,27470,20200201,54068
20200129,4,평촌,20059,19721,20200201,39780
20200129,4,범계,30085,29565,20200201,59650
20200130,4,범계,29570,28274,20200202,57844
20200130,4,평촌,20488,20068,20200202,40556
20200130,4,인덕원,27102,27470,20200202,54572
20200130,4,정부과천청사,11354,11226,20200202,22580
20200130,4,과천,5461,4948,20200202,10409
20200130,4,대공원,2443,2550,20200202,4993
20200130,4,경마공원,2046,2071,20200202,4117
20200130,4,선바위,9722,8453,20200202,18175
20200131,4,선바위,10140,8425,20200203,18565
20200131,4,경마공원,7682,7830,20200203,15512
20200131,4,대공원,2235,2322,20200203,4557
20200131,4,과천,5518,5031,20200203,10549
20200131,4,정부과천청사,11710,11366,20200203,23076
20200131,4,인덕원,28125,28564,20200203,56689
20200131,4,평촌,20281,19921,20200203,40202
20200131,4,범계,30843,30743,20200203,61586
20200201,4,선바위,5273,4489,20200204,9762
20200201,4,경마공원,12159,12362,20200204,24521
20200201,4,대공원,2761,2916,20200204,5677
20200201,4,과천,3607,3224,20200204,6831
20200201,4,정부과천청사,6872,6620,20200204,13492
20200201,4,인덕원,16458,16048,20200204,32506
20200201,4,평촌,9383,9239,20200204,18622
20200201,4,범계,21039,20529,20200204,41568
20200202,4,선바위,3835,3539,20200205,7374
20200202,4,경마공원,15278,15676,20200205,30954
20200202,4,대공원,2424,2545,20200205,4969
20200202,4,과천,2504,2506,20200205,5010
20200202,4,정부과천청사,8059,7701,20200205,15760
20200202,4,인덕원,13186,13450,20200205,26636
20200202,4,평촌,6272,6177,20200205,12449
20200202,4,범계,14527,13922,20200205,28449
20200203,4,선바위,9136,7796,20200206,16932
20200203,4,경마공원,994,903,20200206,1897
20200203,4,대공원,1603,1711,20200206,3314
20200203,4,과천,4858,4531,20200206,9389
20200203,4,정부과천청사,11347,11318,20200206,22665
20200203,4,인덕원,25164,25900,20200206,51064
20200203,4,평촌,18930,18959,20200206,37889
20200203,4,범계,26744,26060,20200206,52804
20200204,4,선바위,9301,7958,20200207,17259
20200204,4,경마공원,921,942,20200207,1863
20200204,4,대공원,1799,1950,20200207,3749
20200204,4,과천,5086,4802,20200207,9888
20200204,4,정부과천청사,10949,10779,20200207,21728
20200204,4,인덕원,25383,26531,20200207,51914
20200204,4,평촌,18968,18837,20200207,37805
20200204,4,범계,27235,26716,20200207,53951
20200205,4,선바위,9102,7814,20200208,16916
20200205,4,경마공원,1908,1875,20200208,3783
20200205,4,대공원,1413,1490,20200208,2903
20200205,4,과천,4812,4509,20200208,9321
20200205,4,정부과천청사,13611,13734,20200208,27345
20200205,4,인덕원,24663,25727,20200208,50390
20200205,4,평촌,18751,18757,20200208,37508
20200205,4,범계,27106,26157,20200208,53263
20200206,4,선바위,9092,7787,20200209,16879
20200206,4,경마공원,1894,1926,20200209,3820
20200206,4,대공원,1563,1657,20200209,3220
20200206,4,과천,4929,4529,20200209,9458
20200206,4,정부과천청사,10821,10910,20200209,21731
20200206,4,인덕원,24796,25513,20200209,50309
20200206,4,평촌,18617,18275,20200209,36892
20200206,4,범계,26679,25024,20200209,51703
20200207,4,선바위,9747,8038,20200210,17785
20200207,4,경마공원,7082,7335,20200210,14417
20200207,4,대공원,1736,1793,20200210,3529
20200207,4,과천,5196,4706,20200210,9902
20200207,4,정부과천청사,11074,10765,20200210,21839
20200207,4,인덕원,26281,26875,20200210,53156
20200207,4,평촌,19106,18719,20200210,37825
20200207,4,범계,28721,28813,20200210,57534
20200208,4,선바위,5003,4399,20200211,9402
20200208,4,경마공원,12189,12219,20200211,24408
20200208,4,대공원,2369,2405,20200211,4774
20200208,4,과천,3681,3249,20200211,6930
20200208,4,정부과천청사,6113,5851,20200211,11964
20200208,4,인덕원,15680,15565,20200211,31245
20200208,4,평촌,9337,9076,20200211,18413
20200208,4,범계,20180,20045,20200211,40225
20200209,4,선바위,3784,3484,20200212,7268
20200209,4,경마공원,14984,15382,20200212,30366
20200209,4,대공원,2212,2227,20200212,4439
20200209,4,과천,2574,2384,20200212,4958
20200209,4,정부과천청사,7923,7764,20200212,15687
20200209,4,인덕원,11900,12041,20200212,23941
20200209,4,평촌,6637,6372,20200212,13009
20200209,4,범계,15052,14423,20200212,29475
20200210,4,선바위,9251,7897,20200213,17148
20200210,4,경마공원,934,937,20200213,1871
20200210,4,대공원,1632,1784,20200213,3416
20200210,4,과천,4890,4504,20200213,9394
20200210,4,정부과천청사,11324,11370,20200213,22694
20200210,4,인덕원,25040,25779,20200213,50819
20200210,4,평촌,19031,18960,20200213,37991
20200210,4,범계,27204,26648,20200213,53852
20200211,4,선바위,9550,8160,20200214,17710
20200211,4,경마공원,1007,1000,20200214,2007
20200211,4,대공원,2408,2510,20200214,4918
20200211,4,과천,5245,4736,20200214,9981
20200211,4,정부과천청사,11141,11030,20200214,22171
20200211,4,인덕원,26466,27143,20200214,53609
20200211,4,평촌,19336,19119,20200214,38455
20200211,4,범계,28605,28049,20200214,56654
20200212,4,선바위,9291,7911,20200215,17202
20200212,4,경마공원,1847,1781,20200215,3628
20200212,4,대공원,1489,1593,20200215,3082
20200212,4,과천,5015,4671,20200215,9686
20200212,4,정부과천청사,13862,13924,20200215,27786
20200212,4,인덕원,25440,26405,20200215,51845
20200212,4,평촌,18758,18547,20200215,37305
20200212,4,범계,28077,27505,20200215,55582
20200213,4,선바위,9533,8257,20200216,17790
20200213,4,경마공원,2186,2222,20200216,4408
20200213,4,대공원,2096,2201,20200216,4297
20200213,4,과천,5356,4881,20200216,10237
20200213,4,정부과천청사,11687,11600,20200216,23287
20200213,4,인덕원,26672,27377,20200216,54049
20200213,4,평촌,19755,19526,20200216,39281
20200213,4,범계,29423,28689,20200216,58112
20200214,4,선바위,10382,8625,20200217,19007
20200214,4,경마공원,7706,7899,20200217,15605
20200214,4,대공원,2573,2699,20200217,5272
20200214,4,과천,5620,5047,20200217,10667
20200214,4,정부과천청사,11754,11469,20200217,23223
20200214,4,인덕원,28166,28472,20200217,56638
20200214,4,평촌,20144,19695,20200217,39839
20200214,4,범계,31537,31514,20200217,63051
20200215,4,선바위,5722,5061,20200218,10783
20200215,4,경마공원,12668,13027,20200218,25695
20200215,4,대공원,3309,3563,20200218,6872
20200215,4,과천,4082,3777,20200218,7859
20200215,4,정부과천청사,6823,6520,20200218,13343
20200215,4,인덕원,18127,17640,20200218,35767
20200215,4,평촌,10560,10319,20200218,20879
20200215,4,범계,23368,22928,20200218,46296
20200216,4,선바위,3807,3545,20200219,7352
20200216,4,경마공원,15825,16048,20200219,31873
20200216,4,대공원,1922,1988,20200219,3910
20200216,4,과천,2857,2602,20200219,5459
20200216,4,정부과천청사,8508,8345,20200219,16853
20200216,4,인덕원,12564,13023,20200219,25587
20200216,4,평촌,6904,6761,20200219,13665
20200216,4,범계,16240,15484,20200219,31724
20200217,4,선바위,9391,8024,20200220,17415
20200217,4,경마공원,1025,937,20200220,1962
20200217,4,대공원,1366,1477,20200220,2843
20200217,4,과천,5361,4892,20200220,10253
20200217,4,정부과천청사,12231,12304,20200220,24535
20200217,4,인덕원,27787,28094,20200220,55881
20200217,4,평촌,20878,20393,20200220,41271
20200217,4,범계,30065,28461,20200220,58526
20200218,4,선바위,9494,8145,20200221,17639
20200218,4,경마공원,949,972,20200221,1921
20200218,4,대공원,2060,2225,20200221,4285
20200218,4,과천,5199,4750,20200221,9949
20200218,4,정부과천청사,11172,11187,20200221,22359
20200218,4,인덕원,26565,27362,20200221,53927
20200218,4,평촌,19790,19481,20200221,39271
20200218,4,범계,28768,28201,20200221,56969
20200219,4,선바위,9729,8256,20200222,17985
20200219,4,경마공원,2230,2092,20200222,4322
20200219,4,대공원,2254,2460,20200222,4714
20200219,4,과천,5322,4912,20200222,10234
20200219,4,정부과천청사,10573,10272,20200222,20845
20200219,4,인덕원,26909,27654,20200222,54563
20200219,4,평촌,19630,19435,20200222,39065
20200219,4,범계,29397,29089,20200222,58486
20200220,4,선바위,9336,8131,20200223,17467
20200220,4,경마공원,1993,1996,20200223,3989
20200220,4,대공원,2331,2424,20200223,4755
20200220,4,과천,5111,4710,20200223,9821
20200220,4,정부과천청사,9858,9755,20200223,19613
20200220,4,인덕원,25781,26576,20200223,52357
20200220,4,평촌,19377,19275,20200223,38652
20200220,4,범계,28302,27682,20200223,55984
20200221,4,선바위,9439,7867,20200224,17306
20200221,4,경마공원,7046,7223,20200224,14269
20200221,4,대공원,1815,1879,20200224,3694
20200221,4,과천,4916,4489,20200224,9405
20200221,4,정부과천청사,9409,9166,20200224,18575
20200221,4,인덕원,25883,26315,20200224,52198
20200221,4,평촌,18551,18298,20200224,36849
20200221,4,범계,28149,27777,20200224,55926
20200222,4,선바위,4360,3846,20200225,8206
20200222,4,경마공원,10546,10878,20200225,21424
20200222,4,대공원,1730,1821,20200225,3551
20200222,4,과천,2878,2637,20200225,5515
20200222,4,정부과천청사,3792,3595,20200225,7387
20200222,4,인덕원,13926,13627,20200225,27553
20200222,4,평촌,8324,8014,20200225,16338
20200222,4,범계,17630,17385,20200225,35015
20200223,4,선바위,2572,2436,20200226,5008
20200223,4,경마공원,1015,1073,20200226,2088
20200223,4,대공원,1650,1772,20200226,3422
20200223,4,과천,1739,1642,20200226,3381
20200223,4,정부과천청사,2492,2596,20200226,5088
20200223,4,인덕원,8158,8211,20200226,16369
20200223,4,평촌,4875,4839,20200226,9714
20200223,4,범계,11024,10541,20200226,21565
20200224,4,선바위,7686,6730,20200227,14416
20200224,4,경마공원,727,728,20200227,1455
20200224,4,대공원,1235,1302,20200227,2537
20200224,4,과천,4116,3829,20200227,7945
20200224,4,정부과천청사,7995,7933,20200227,15928
20200224,4,인덕원,21096,22077,20200227,43173
20200224,4,평촌,16440,16449,20200227,32889
20200224,4,범계,22190,21276,20200227,43466
20200225,4,선바위,7184,6183,20200228,13367
20200225,4,경마공원,643,666,20200228,1309
20200225,4,대공원,885,964,20200228,1849
20200225,4,과천,3597,3396,20200228,6993
20200225,4,정부과천청사,7307,7144,20200228,14451
20200225,4,인덕원,19322,20415,20200228,39737
20200225,4,평촌,15167,15017,20200228,30184
20200225,4,범계,19591,18552,20200228,38143
20200226,4,선바위,6955,6220,20200229,13175
20200226,4,경마공원,1189,1205,20200229,2394
20200226,4,대공원,1257,1346,20200229,2603
20200226,4,과천,3694,3473,20200229,7167
20200226,4,정부과천청사,7049,7031,20200229,14080
20200226,4,인덕원,19402,20317,20200229,39719
20200226,4,평촌,14735,14531,20200229,29266
20200226,4,범계,19645,19067,20200229,38712
20200227,4,선바위,6816,6005,20200301,12821
20200227,4,경마공원,1113,1126,20200301,2239
20200227,4,대공원,1211,1307,20200301,2518
20200227,4,과천,3582,3344,20200301,6926
20200227,4,정부과천청사,6763,6623,20200301,13386
20200227,4,인덕원,18710,19460,20200301,38170
20200227,4,평촌,14402,14265,20200301,28667
20200227,4,범계,19254,18456,20200301,37710
20200228,4,선바위,6569,5796,20200302,12365
20200228,4,경마공원,1086,1121,20200302,2207
20200228,4,대공원,872,906,20200302,1778
20200228,4,과천,3320,3079,20200302,6399
20200228,4,정부과천청사,6530,6261,20200302,12791
20200228,4,인덕원,18080,18892,20200302,36972
20200228,4,평촌,13627,13648,20200302,27275
20200228,4,범계,18914,18404,20200302,37318
20200229,4,선바위,2809,2643,20200303,5452
20200229,4,경마공원,765,802,20200303,1567
20200229,4,대공원,1286,1402,20200303,2688
20200229,4,과천,2029,1871,20200303,3900
20200229,4,정부과천청사,2427,2484,20200303,4911
20200229,4,인덕원,8562,8364,20200303,16926
20200229,4,평촌,5440,5389,20200303,10829
20200229,4,범계,11203,10811,20200303,22014
20200301,4,선바위,1774,1784,20200304,3558
20200301,4,경마공원,349,335,20200304,684
20200301,4,대공원,1028,1146,20200304,2174
20200301,4,과천,1042,950,20200304,1992
20200301,4,정부과천청사,1584,1708,20200304,3292
20200301,4,인덕원,5465,5446,20200304,10911
20200301,4,평촌,3379,3347,20200304,6726
20200301,4,범계,7346,6939,20200304,14285
20200302,4,선바위,6729,6079,20200305,12808
20200302,4,경마공원,644,635,20200305,1279
20200302,4,대공원,1102,1166,20200305,2268
20200302,4,과천,3421,3232,20200305,6653
20200302,4,정부과천청사,6580,6419,20200305,12999
20200302,4,인덕원,18193,19135,20200305,37328
20200302,4,평촌,14313,14235,20200305,28548
20200302,4,범계,18575,17811,20200305,36386
20200303,4,선바위,6716,5976,20200306,12692
20200303,4,경마공원,695,725,20200306,1420
20200303,4,대공원,1189,1286,20200306,2475
20200303,4,과천,3457,3230,20200306,6687
20200303,4,정부과천청사,6586,6469,20200306,13055
20200303,4,인덕원,18318,19176,20200306,37494
20200303,4,평촌,14483,14300,20200306,28783
20200303,4,범계,19468,18912,20200306,38380
20200304,4,선바위,6725,6005,20200307,12730
20200304,4,경마공원,1011,1001,20200307,2012
20200304,4,대공원,1017,1092,20200307,2109
20200304,4,과천,3407,3238,20200307,6645
20200304,4,정부과천청사,6646,6420,20200307,13066
20200304,4,인덕원,18325,19168,20200307,37493
20200304,4,평촌,14083,13947,20200307,28030
20200304,4,범계,19233,18812,20200307,38045
20200305,4,선바위,6726,6097,20200308,12823
20200305,4,경마공원,1033,1050,20200308,2083
20200305,4,대공원,1105,1170,20200308,2275
20200305,4,과천,3468,3197,20200308,6665
20200305,4,정부과천청사,6724,6666,20200308,13390
20200305,4,인덕원,18505,19177,20200308,37682
20200305,4,평촌,14273,14276,20200308,28549
20200305,4,범계,19394,18724,20200308,38118
20200306,4,선바위,6948,6167,20200309,13115
20200306,4,경마공원,1029,1032,20200309,2061
20200306,4,대공원,1216,1300,20200309,2516
20200306,4,과천,3548,3309,20200309,6857
20200306,4,정부과천청사,6860,6582,20200309,13442
20200306,4,인덕원,19023,19581,20200309,38604
20200306,4,평촌,14250,14232,20200309,28482
20200306,4,범계,20236,19705,20200309,39941
20200307,4,선바위,3104,2833,20200310,5937
20200307,4,경마공원,692,730,20200310,1422
20200307,4,대공원,1453,1660,20200310,3113
20200307,4,과천,2244,2010,20200310,4254
20200307,4,정부과천청사,2835,2850,20200310,5685
20200307,4,인덕원,9457,9100,20200310,18557
20200307,4,평촌,5802,5715,20200310,11517
20200307,4,범계,12188,12122,20200310,24310
20200308,4,선바위,2139,2021,20200311,4160
20200308,4,경마공원,614,580,20200311,1194
20200308,4,대공원,1855,2022,20200311,3877
20200308,4,과천,1407,1245,20200311,2652
20200308,4,정부과천청사,2038,2171,20200311,4209
20200308,4,인덕원,6417,6220,20200311,12637
20200308,4,평촌,3898,3730,20200311,7628
20200308,4,범계,8418,8110,20200311,16528
20200309,4,선바위,7250,6429,20200312,13679
20200309,4,경마공원,697,699,20200312,1396
20200309,4,대공원,1309,1421,20200312,2730
20200309,4,과천,3687,3429,20200312,7116
20200309,4,정부과천청사,7097,6932,20200312,14029
20200309,4,인덕원,19385,20054,20200312,39439
20200309,4,평촌,14942,14933,20200312,29875
20200309,4,범계,20610,19845,20200312,40455
20200310,4,선바위,6867,6073,20200313,12940
20200310,4,경마공원,701,690,20200313,1391
20200310,4,대공원,793,920,20200313,1713
20200310,4,과천,3362,3098,20200313,6460
20200310,4,정부과천청사,6753,6683,20200313,13436
20200310,4,인덕원,18486,19388,20200313,37874
20200310,4,평촌,14557,14568,20200313,29125
20200310,4,범계,19365,18763,20200313,38128
20200311,4,선바위,7014,6324,20200314,13338
20200311,4,경마공원,1046,1061,20200314,2107
20200311,4,대공원,1328,1419,20200314,2747
20200311,4,과천,3638,3360,20200314,6998
20200311,4,정부과천청사,7014,6917,20200314,13931
20200311,4,인덕원,19353,20106,20200314,39459
20200311,4,평촌,14868,14658,20200314,29526
20200311,4,범계,20365,19861,20200314,40226
20200312,4,선바위,6964,6275,20200315,13239
20200312,4,경마공원,1003,1004,20200315,2007
20200312,4,대공원,1286,1423,20200315,2709
20200312,4,과천,3518,3268,20200315,6786
20200312,4,정부과천청사,6948,6849,20200315,13797
20200312,4,인덕원,18990,19754,20200315,38744
20200312,4,평촌,14534,14446,20200315,28980
20200312,4,범계,19956,19251,20200315,39207
20200313,4,선바위,7136,6231,20200316,13367
20200313,4,경마공원,972,998,20200316,1970
20200313,4,대공원,1249,1274,20200316,2523
20200313,4,과천,3518,3189,20200316,6707
20200313,4,정부과천청사,6772,6790,20200316,13562
20200313,4,인덕원,19305,19861,20200316,39166
20200313,4,평촌,14533,14557,20200316,29090
20200313,4,범계,21019,20670,20200316,41689
20200314,4,선바위,3245,3030,20200317,6275
20200314,4,경마공원,737,747,20200317,1484
20200314,4,대공원,1738,1966,20200317,3704
20200314,4,과천,2505,2134,20200317,4639
20200314,4,정부과천청사,3127,3264,20200317,6391
20200314,4,인덕원,10217,9927,20200317,20144
20200314,4,평촌,6176,6014,20200317,12190
20200314,4,범계,13424,13072,20200317,26496
20200315,4,선바위,2145,2034,20200318,4179
20200315,4,경마공원,609,548,20200318,1157
20200315,4,대공원,1306,1497,20200318,2803
20200315,4,과천,1377,1252,20200318,2629
20200315,4,정부과천청사,2039,2084,20200318,4123
20200315,4,인덕원,6521,6523,20200318,13044
20200315,4,평촌,3890,3766,20200318,7656
20200315,4,범계,8747,8422,20200318,17169
20200316,4,선바위,7065,6183,20200319,13248
20200316,4,경마공원,669,671,20200319,1340
20200316,4,대공원,1185,1281,20200319,2466
20200316,4,과천,3571,3345,20200319,6916
20200316,4,정부과천청사,7099,6964,20200319,14063
20200316,4,인덕원,19150,20153,20200319,39303
20200316,4,평촌,14800,14798,20200319,29598
20200316,4,범계,20297,19801,20200319,40098
20200317,4,선바위,6947,6250,20200320,13197
20200317,4,경마공원,700,751,20200320,1451
20200317,4,대공원,1109,1175,20200320,2284
20200317,4,과천,3507,3323,20200320,6830
20200317,4,정부과천청사,7101,6972,20200320,14073
20200317,4,인덕원,19294,20058,20200320,39352
20200317,4,평촌,14674,14598,20200320,29272
20200317,4,범계,20439,19855,20200320,40294
20200318,4,선바위,7198,6352,20200321,13550
20200318,4,경마공원,1021,1068,20200321,2089
20200318,4,대공원,1600,1688,20200321,3288
20200318,4,과천,3685,3438,20200321,7123
20200318,4,정부과천청사,7194,6981,20200321,14175
20200318,4,인덕원,19927,20788,20200321,40715
20200318,4,평촌,15057,14987,20200321,30044
20200318,4,범계,21078,20581,20200321,41659
20200319,4,선바위,6854,6157,20200322,13011
20200319,4,경마공원,1010,990,20200322,2000
20200319,4,대공원,872,964,20200322,1836
20200319,4,과천,3456,3278,20200322,6734
20200319,4,정부과천청사,6873,6818,20200322,13691
20200319,4,인덕원,18749,19448,20200322,38197
20200319,4,평촌,14449,14397,20200322,28846
20200319,4,범계,19767,19248,20200322,39015
20200320,4,선바위,7521,6711,20200323,14232
20200320,4,경마공원,1016,1063,20200323,2079
20200320,4,대공원,1559,1614,20200323,3173
20200320,4,과천,3817,3441,20200323,7258
20200320,4,정부과천청사,7433,7288,20200323,14721
20200320,4,인덕원,20495,20663,20200323,41158
20200320,4,평촌,15209,15062,20200323,30271
20200320,4,범계,22307,22253,20200323,44560
20200321,4,선바위,3431,3142,20200324,6573
20200321,4,경마공원,724,744,20200324,1468
20200321,4,대공원,2264,2458,20200324,4722
20200321,4,과천,2642,2338,20200324,4980
20200321,4,정부과천청사,3531,3564,20200324,7095
20200321,4,인덕원,10684,10177,20200324,20861
20200321,4,평촌,6558,6272,20200324,12830
20200321,4,범계,13928,13738,20200324,27666
20200322,4,선바위,2290,2215,20200325,4505
20200322,4,경마공원,434,386,20200325,820
20200322,4,대공원,2230,2493,20200325,4723
20200322,4,과천,1654,1421,20200325,3075
20200322,4,정부과천청사,2526,2741,20200325,5267
20200322,4,인덕원,7190,7084,20200325,14274
20200322,4,평촌,4161,4073,20200325,8234
20200322,4,범계,9610,9110,20200325,18720
20200323,4,선바위,7217,6340,20200326,13557
20200323,4,경마공원,735,707,20200326,1442
20200323,4,대공원,1537,1675,20200326,3212
20200323,4,과천,3738,3447,20200326,7185
20200323,4,정부과천청사,7111,6978,20200326,14089
20200323,4,인덕원,19664,20299,20200326,39963
20200323,4,평촌,15199,15229,20200326,30428
20200323,4,범계,20706,19987,20200326,40693
20200324,4,선바위,7244,6354,20200327,13598
20200324,4,경마공원,705,719,20200327,1424
20200324,4,대공원,1693,1843,20200327,3536
20200324,4,과천,3636,3396,20200327,7032
20200324,4,정부과천청사,7139,7033,20200327,14172
20200324,4,인덕원,19813,20504,20200327,40317
20200324,4,평촌,15142,14978,20200327,30120
20200324,4,범계,20661,20201,20200327,40862
20200325,4,선바위,7367,6552,20200328,13919
20200325,4,경마공원,1084,1063,20200328,2147
20200325,4,대공원,1806,1893,20200328,3699
20200325,4,과천,3696,3479,20200328,7175
20200325,4,정부과천청사,7281,7106,20200328,14387
20200325,4,인덕원,20217,20872,20200328,41089
20200325,4,평촌,15196,14913,20200328,30109
20200325,4,범계,21471,20880,20200328,42351
20200326,4,선바위,7153,6323,20200329,13476
20200326,4,경마공원,985,1011,20200329,1996
20200326,4,대공원,1331,1431,20200329,2762
20200326,4,과천,3693,3440,20200329,7133
20200326,4,정부과천청사,7210,7038,20200329,14248
20200326,4,인덕원,19593,20403,20200329,39996
20200326,4,평촌,14963,14985,20200329,29948
20200326,4,범계,20676,20016,20200329,40692
20200327,4,선바위,7380,6656,20200330,14036
20200327,4,경마공원,1069,1043,20200330,2112
20200327,4,대공원,1532,1652,20200330,3184
20200327,4,과천,3753,3446,20200330,7199
20200327,4,정부과천청사,7208,7113,20200330,14321
20200327,4,인덕원,20400,20830,20200330,41230
20200327,4,평촌,15226,15171,20200330,30397
20200327,4,범계,21952,22065,20200330,44017
20200328,4,선바위,3451,3212,20200331,6663
20200328,4,경마공원,684,700,20200331,1384
20200328,4,대공원,2529,2810,20200331,5339
20200328,4,과천,2668,2283,20200331,4951
20200328,4,정부과천청사,3649,3627,20200331,7276
20200328,4,인덕원,10835,10339,20200331,21174
20200328,4,평촌,6534,6370,20200331,12904
20200328,4,범계,14563,14129,20200331,28692
20200329,4,선바위,2387,2287,20200401,4674
20200329,4,경마공원,579,559,20200401,1138
20200329,4,대공원,2780,2830,20200401,5610
20200329,4,과천,1675,1434,20200401,3109
20200329,4,정부과천청사,2451,2602,20200401,5053
20200329,4,인덕원,7268,7180,20200401,14448
20200329,4,평촌,4090,4007,20200401,8097
20200329,4,범계,9671,9117,20200401,18788
20200330,4,선바위,7334,6510,20200402,13844
20200330,4,경마공원,741,735,20200402,1476
20200330,4,대공원,1840,1985,20200402,3825
20200330,4,과천,3824,3498,20200402,7322
20200330,4,정부과천청사,7493,7120,20200402,14613
20200330,4,인덕원,19838,20732,20200402,40570
20200330,4,평촌,15171,15183,20200402,30354
20200330,4,범계,20964,20171,20200402,41135
20200331,4,선바위,7312,6581,20200403,13893
20200331,4,경마공원,760,757,20200403,1517
20200331,4,대공원,2037,2166,20200403,4203
20200331,4,과천,3794,3498,20200403,7292
20200331,4,정부과천청사,7553,7070,20200403,14623
20200331,4,인덕원,20239,20918,20200403,41157
20200331,4,평촌,15298,15253,20200403,30551
20200331,4,범계,21042,20583,20200403,41625
20200401,4,선바위,7452,6733,20200404,14185
20200401,4,경마공원,1114,1114,20200404,2228
20200401,4,대공원,2067,2147,20200404,4214
20200401,4,과천,3794,3493,20200404,7287
20200401,4,정부과천청사,7468,7306,20200404,14774
20200401,4,인덕원,20441,20974,20200404,41415
20200401,4,평촌,15284,15224,20200404,30508
20200401,4,범계,21484,20704,20200404,42188
20200402,4,선바위,7389,6671,20200405,14060
20200402,4,경마공원,1067,1132,20200405,2199
20200402,4,대공원,2513,2627,20200405,5140
20200402,4,과천,3774,3495,20200405,7269
20200402,4,정부과천청사,7608,7429,20200405,15037
20200402,4,인덕원,20303,20886,20200405,41189
20200402,4,평촌,15354,15355,20200405,30709
20200402,4,범계,21174,20512,20200405,41686
20200403,4,선바위,7741,6705,20200406,14446
20200403,4,경마공원,1086,1092,20200406,2178
20200403,4,대공원,2734,2899,20200406,5633
20200403,4,과천,4009,3612,20200406,7621
20200403,4,정부과천청사,7700,7434,20200406,15134
20200403,4,인덕원,21266,21490,20200406,42756
20200403,4,평촌,15682,15418,20200406,31100
20200403,4,범계,22479,22443,20200406,44922
20200404,4,선바위,3644,3406,20200407,7050
20200404,4,경마공원,894,847,20200407,1741
20200404,4,대공원,4627,4855,20200407,9482
20200404,4,과천,2780,2478,20200407,5258
20200404,4,정부과천청사,3829,3884,20200407,7713
20200404,4,인덕원,11074,10779,20200407,21853
20200404,4,평촌,6573,6530,20200407,13103
20200404,4,범계,14763,14551,20200407,29314
20200405,4,선바위,2409,2324,20200408,4733
20200405,4,경마공원,670,641,20200408,1311
20200405,4,대공원,3697,3968,20200408,7665
20200405,4,과천,1727,1446,20200408,3173
20200405,4,정부과천청사,2661,2824,20200408,5485
20200405,4,인덕원,7418,7286,20200408,14704
20200405,4,평촌,4195,4158,20200408,8353
20200405,4,범계,9862,9322,20200408,19184
20200406,4,선바위,7667,6681,20200409,14348
20200406,4,경마공원,850,776,20200409,1626
20200406,4,대공원,2428,2557,20200409,4985
20200406,4,과천,3987,3677,20200409,7664
20200406,4,정부과천청사,7741,7608,20200409,15349
20200406,4,인덕원,20584,21157,20200409,41741
20200406,4,평촌,15855,15938,20200409,31793
20200406,4,범계,21731,20825,20200409,42556
20200407,4,선바위,7833,7061,20200410,14894
20200407,4,경마공원,823,796,20200410,1619
20200407,4,대공원,2585,2768,20200410,5353
20200407,4,과천,4029,3676,20200410,7705
20200407,4,정부과천청사,7861,7710,20200410,15571
20200407,4,인덕원,20504,21363,20200410,41867
20200407,4,평촌,16010,15938,20200410,31948
20200407,4,범계,21901,21237,20200410,43138
20200408,4,선바위,7710,6807,20200411,14517
20200408,4,경마공원,1147,1114,20200411,2261
20200408,4,대공원,2630,2789,20200411,5419
20200408,4,과천,3988,3762,20200411,7750
20200408,4,정부과천청사,7844,7717,20200411,15561
20200408,4,인덕원,20964,21471,20200411,42435
20200408,4,평촌,15858,15648,20200411,31506
20200408,4,범계,22365,21906,20200411,44271
20200409,4,선바위,7698,6903,20200412,14601
20200409,4,경마공원,1113,1119,20200412,2232
20200409,4,대공원,2368,2508,20200412,4876
20200409,4,과천,4053,3701,20200412,7754
20200409,4,정부과천청사,7943,7711,20200412,15654
20200409,4,인덕원,20964,21328,20200412,42292
20200409,4,평촌,15960,16054,20200412,32014
20200409,4,범계,21841,21231,20200412,43072
20200410,4,선바위,7721,6708,20200413,14429
20200410,4,경마공원,1144,1080,20200413,2224
20200410,4,대공원,2397,2555,20200413,4952
20200410,4,과천,4136,3707,20200413,7843
20200410,4,정부과천청사,7846,7633,20200413,15479
20200410,4,인덕원,21347,21677,20200413,43024
20200410,4,평촌,15981,15823,20200413,31804
20200410,4,범계,23292,23268,20200413,46560
20200411,4,선바위,3787,3563,20200414,7350
20200411,4,경마공원,594,604,20200414,1198
20200411,4,대공원,3559,3890,20200414,7449
20200411,4,과천,2976,2570,20200414,5546
20200411,4,정부과천청사,3921,3861,20200414,7782
20200411,4,인덕원,11635,11396,20200414,23031
20200411,4,평촌,7115,6873,20200414,13988
20200411,4,범계,15155,15183,20200414,30338
20200412,4,선바위,2508,2435,20200415,4943
20200412,4,경마공원,505,447,20200415,952
20200412,4,대공원,2645,2988,20200415,5633
20200412,4,과천,1772,1529,20200415,3301
20200412,4,정부과천청사,2816,2959,20200415,5775
20200412,4,인덕원,7663,7532,20200415,15195
20200412,4,평촌,4441,4400,20200415,8841
20200412,4,범계,10178,9798,20200415,19976
20200413,4,선바위,7621,6732,20200416,14353
20200413,4,경마공원,787,768,20200416,1555
20200413,4,대공원,2103,2232,20200416,4335
20200413,4,과천,4143,3727,20200416,7870
20200413,4,정부과천청사,7849,7808,20200416,15657
20200413,4,인덕원,20883,21548,20200416,42431
20200413,4,평촌,16208,16142,20200416,32350
20200413,4,범계,22246,21487,20200416,43733
20200414,4,선바위,7918,6924,20200417,14842
20200414,4,경마공원,861,856,20200417,1717
20200414,4,대공원,2381,2345,20200417,4726
20200414,4,과천,4217,3769,20200417,7986
20200414,4,정부과천청사,8086,7936,20200417,16022
20200414,4,인덕원,22004,22103,20200417,44107
20200414,4,평촌,16557,16279,20200417,32836
20200414,4,범계,23435,22836,20200417,46271
20200415,4,선바위,3269,3171,20200418,6440
20200415,4,경마공원,546,509,20200418,1055
20200415,4,대공원,3078,3080,20200418,6158
20200415,4,과천,2404,2104,20200418,4508
20200415,4,정부과천청사,3284,3407,20200418,6691
20200415,4,인덕원,10015,9890,20200418,19905
20200415,4,평촌,5896,5740,20200418,11636
20200415,4,범계,13176,12743,20200418,25919
20200416,4,선바위,7772,6892,20200419,14664
20200416,4,경마공원,1194,1128,20200419,2322
20200416,4,대공원,2234,2384,20200419,4618
20200416,4,과천,4150,3803,20200419,7953
20200416,4,정부과천청사,7844,7742,20200419,15586
20200416,4,인덕원,21417,21895,20200419,43312
20200416,4,평촌,16219,16205,20200419,32424
20200416,4,범계,22489,21784,20200419,44273
20200417,4,선바위,7865,6877,20200420,14742
20200417,4,경마공원,1088,1059,20200420,2147
20200417,4,대공원,988,1032,20200420,2020
20200417,4,과천,3950,3591,20200420,7541
20200417,4,정부과천청사,7739,7647,20200420,15386
20200417,4,인덕원,21179,21627,20200420,42806
20200417,4,평촌,15990,15876,20200420,31866
20200417,4,범계,22981,22565,20200420,45546
20200418,4,선바위,4254,3790,20200421,8044
20200418,4,경마공원,639,602,20200421,1241
20200418,4,대공원,3762,4312,20200421,8074
20200418,4,과천,3170,2631,20200421,5801
20200418,4,정부과천청사,4078,4164,20200421,8242
20200418,4,인덕원,12791,12289,20200421,25080
20200418,4,평촌,7636,7389,20200421,15025
20200418,4,범계,16692,16456,20200421,33148
20200419,4,선바위,2459,2437,20200422,4896
20200419,4,경마공원,436,404,20200422,840
20200419,4,대공원,1871,2109,20200422,3980
20200419,4,과천,1634,1592,20200422,3226
20200419,4,정부과천청사,2715,2769,20200422,5484
20200419,4,인덕원,7676,7667,20200422,15343
20200419,4,평촌,4426,4240,20200422,8666
20200419,4,범계,10178,9751,20200422,19929
20200420,4,선바위,7876,6893,20200423,14769
20200420,4,경마공원,772,730,20200423,1502
20200420,4,대공원,1429,1545,20200423,2974
20200420,4,과천,4202,3817,20200423,8019
20200420,4,정부과천청사,8212,8219,20200423,16431
20200420,4,인덕원,21450,22192,20200423,43642
20200420,4,평촌,16563,16477,20200423,33040
20200420,4,범계,22559,21879,20200423,44438
20200421,4,선바위,8136,7203,20200424,15339
20200421,4,경마공원,842,860,20200424,1702
20200421,4,대공원,1899,2006,20200424,3905
20200421,4,과천,4416,3977,20200424,8393
20200421,4,정부과천청사,8416,8387,20200424,16803
20200421,4,인덕원,21764,22473,20200424,44237
20200421,4,평촌,16876,16710,20200424,33586
20200421,4,범계,23230,22718,20200424,45948
20200422,4,선바위,7964,6921,20200425,14885
20200422,4,경마공원,1106,1093,20200425,2199
20200422,4,대공원,1326,1473,20200425,2799
20200422,4,과천,4281,3927,20200425,8208
20200422,4,정부과천청사,8137,8144,20200425,16281
20200422,4,인덕원,21702,22384,20200425,44086
20200422,4,평촌,16287,16204,20200425,32491
20200422,4,범계,23164,22737,20200425,45901
20200423,4,선바위,8095,7205,20200426,15300
20200423,4,경마공원,1150,1180,20200426,2330
20200423,4,대공원,1721,1874,20200426,3595
20200423,4,과천,4360,3939,20200426,8299
20200423,4,정부과천청사,8546,8480,20200426,17026
20200423,4,인덕원,22343,22652,20200426,44995
20200423,4,평촌,16842,16673,20200426,33515
20200423,4,범계,23204,22626,20200426,45830
20200424,4,선바위,8557,7431,20200427,15988
20200424,4,경마공원,1222,1194,20200427,2416
20200424,4,대공원,1800,2006,20200427,3806
20200424,4,과천,4480,3959,20200427,8439
20200424,4,정부과천청사,8510,8379,20200427,16889
20200424,4,인덕원,23063,23257,20200427,46320
20200424,4,평촌,17206,17007,20200427,34213
20200424,4,범계,25211,24756,20200427,49967
20200425,4,선바위,4467,4017,20200428,8484
20200425,4,경마공원,656,664,20200428,1320
20200425,4,대공원,3300,3796,20200428,7096
20200425,4,과천,3270,2767,20200428,6037
20200425,4,정부과천청사,4582,4642,20200428,9224
20200425,4,인덕원,13772,13082,20200428,26854
20200425,4,평촌,7956,7631,20200428,15587
20200425,4,범계,17799,17593,20200428,35392
20200426,4,선바위,3163,2975,20200429,6138
20200426,4,경마공원,534,498,20200429,1032
20200426,4,대공원,3466,3736,20200429,7202
20200426,4,과천,2281,1936,20200429,4217
20200426,4,정부과천청사,3191,3466,20200429,6657
20200426,4,인덕원,9330,8977,20200429,18307
20200426,4,평촌,5138,5076,20200429,10214
20200426,4,범계,12052,11430,20200429,23482
20200427,4,선바위,8340,7373,20200430,15713
20200427,4,경마공원,831,786,20200430,1617
20200427,4,대공원,2065,2176,20200430,4241
20200427,4,과천,4502,4088,20200430,8590
20200427,4,정부과천청사,8647,8477,20200430,17124
20200427,4,인덕원,22685,23208,20200430,45893
20200427,4,평촌,17211,17211,20200430,34422
20200427,4,범계,23629,23041,20200430,46670
20200428,4,선바위,8423,7424,20200501,15847
20200428,4,경마공원,914,956,20200501,1870
20200428,4,대공원,2537,2646,20200501,5183
20200428,4,과천,4517,4098,20200501,8615
20200428,4,정부과천청사,8776,8810,20200501,17586
20200428,4,인덕원,23203,23518,20200501,46721
20200428,4,평촌,17445,17316,20200501,34761
20200428,4,범계,24443,23782,20200501,48225
20200429,4,선바위,8745,7595,20200502,16340
20200429,4,경마공원,1400,1413,20200502,2813
20200429,4,대공원,2414,2536,20200502,4950
20200429,4,과천,4705,4134,20200502,8839
20200429,4,정부과천청사,8994,8823,20200502,17817
20200429,4,인덕원,24147,24154,20200502,48301
20200429,4,평촌,17899,17525,20200502,35424
20200429,4,범계,26656,26228,20200502,52884
20200430,4,선바위,3803,3479,20200503,7282
20200430,4,경마공원,687,710,20200503,1397
20200430,4,대공원,5021,5335,20200503,10356
20200430,4,과천,3079,2577,20200503,5656
20200430,4,정부과천청사,4025,3966,20200503,7991
20200430,4,인덕원,12199,11476,20200503,23675
20200430,4,평촌,6822,6607,20200503,13429
20200430,4,범계,15448,14973,20200503,30421
20200501,4,범계,16888,16773,20200504,33661
20200501,4,평촌,7685,7405,20200504,15090
20200501,4,인덕원,13030,12619,20200504,25649
20200501,4,정부과천청사,5502,5142,20200504,10644
20200501,4,과천,2904,2493,20200504,5397
20200501,4,대공원,4599,4804,20200504,9403
20200501,4,경마공원,660,647,20200504,1307
20200501,4,선바위,4385,4062,20200504,8447
20200502,4,범계,16488,16210,20200505,32698
20200502,4,평촌,6911,6775,20200505,13686
20200502,4,인덕원,11966,11664,20200505,23630
20200502,4,정부과천청사,4254,4308,20200505,8562
20200502,4,과천,2677,2405,20200505,5082
20200502,4,대공원,4610,4942,20200505,9552
20200502,4,경마공원,684,695,20200505,1379
20200502,4,선바위,4042,3753,20200505,7795
20200503,4,범계,12147,11878,20200506,24025
20200503,4,평촌,4998,5050,20200506,10048
20200503,4,인덕원,9245,8991,20200506,18236
20200503,4,정부과천청사,3075,3121,20200506,6196
20200503,4,과천,2087,1971,20200506,4058
20200503,4,대공원,3709,3830,20200506,7539
20200503,4,경마공원,548,527,20200506,1075
20200503,4,선바위,2945,2889,20200506,5834
20200504,4,범계,22507,22051,20200507,44558
20200504,4,평촌,13103,12859,20200507,25962
20200504,4,인덕원,18275,18335,20200507,36610
20200504,4,정부과천청사,6948,6867,20200507,13815
20200504,4,과천,4208,3651,20200507,7859
20200504,4,대공원,3509,3644,20200507,7153
20200504,4,경마공원,786,750,20200507,1536
20200504,4,선바위,6597,5922,20200507,12519
20200505,4,선바위,3366,3287,20200508,6653
20200505,4,경마공원,460,460,20200508,920
20200505,4,대공원,5365,5617,20200508,10982
20200505,4,과천,2665,2404,20200508,5069
20200505,4,정부과천청사,4406,4441,20200508,8847
20200505,4,인덕원,10297,10207,20200508,20504
20200505,4,평촌,5976,5916,20200508,11892
20200505,4,범계,13760,13316,20200508,27076
20200506,4,범계,25639,25292,20200509,50931
20200506,4,평촌,17801,17839,20200509,35640
20200506,4,선바위,8736,7527,20200509,16263
20200506,4,경마공원,1168,1121,20200509,2289
20200506,4,대공원,2925,3089,20200509,6014
20200506,4,과천,4949,4442,20200509,9391
20200506,4,정부과천청사,9222,9023,20200509,18245
20200506,4,인덕원,23854,24386,20200509,48240
20200507,4,선바위,9052,7812,20200510,16864
20200507,4,경마공원,1399,1360,20200510,2759
20200507,4,대공원,3053,3207,20200510,6260
20200507,4,과천,4885,4419,20200510,9304
20200507,4,정부과천청사,9312,9196,20200510,18508
20200507,4,인덕원,24139,24709,20200510,48848
20200507,4,평촌,17852,17859,20200510,35711
20200507,4,범계,26063,25416,20200510,51479
20200508,4,선바위,9648,8046,20200511,17694
20200508,4,경마공원,1247,1255,20200511,2502
20200508,4,대공원,2479,2617,20200511,5096
20200508,4,과천,5000,4549,20200511,9549
20200508,4,정부과천청사,9358,9291,20200511,18649
20200508,4,인덕원,24410,25200,20200511,49610
20200508,4,평촌,18146,18088,20200511,36234
20200508,4,범계,26248,26558,20200511,52806
20200509,4,선바위,4168,3507,20200512,7675
20200509,4,경마공원,706,732,20200512,1438
20200509,4,대공원,1219,1313,20200512,2532
20200509,4,과천,2660,2382,20200512,5042
20200509,4,정부과천청사,3908,3853,20200512,7761
20200509,4,인덕원,12450,12295,20200512,24745
20200509,4,평촌,8038,7888,20200512,15926
20200509,4,범계,16533,16375,20200512,32908
20200510,4,선바위,3203,3148,20200513,6351
20200510,4,경마공원,738,639,20200513,1377
20200510,4,대공원,3605,3977,20200513,7582
20200510,4,과천,2162,2064,20200513,4226
20200510,4,정부과천청사,3165,3473,20200513,6638
20200510,4,인덕원,9933,9684,20200513,19617
20200510,4,평촌,5354,5239,20200513,10593
20200510,4,범계,13058,12433,20200513,25491
20200511,4,범계,24564,23998,20200514,48562
20200511,4,평촌,17658,17568,20200514,35226
20200511,4,인덕원,23341,24098,20200514,47439
20200511,4,정부과천청사,8988,8956,20200514,17944
20200511,4,과천,4733,4341,20200514,9074
20200511,4,대공원,2240,2303,20200514,4543
20200511,4,경마공원,864,824,20200514,1688
20200511,4,선바위,8743,7556,20200514,16299
20200512,4,선바위,8718,7565,20200515,16283
20200512,4,경마공원,899,873,20200515,1772
20200512,4,대공원,2427,2606,20200515,5033
20200512,4,과천,4777,4226,20200515,9003
20200512,4,정부과천청사,9084,8976,20200515,18060
20200512,4,인덕원,23475,24235,20200515,47710
20200512,4,평촌,17654,17382,20200515,35036
20200512,4,범계,24621,24268,20200515,48889
20200513,4,선바위,8737,7622,20200516,16359
20200513,4,경마공원,1466,1415,20200516,2881
20200513,4,대공원,2773,2938,20200516,5711
20200513,4,과천,4815,4399,20200516,9214
20200513,4,정부과천청사,8878,8793,20200516,17671
20200513,4,인덕원,23834,24260,20200516,48094
20200513,4,평촌,17648,17477,20200516,35125
20200513,4,범계,25263,24742,20200516,50005
20200514,4,범계,24445,24051,20200517,48496
20200514,4,평촌,17688,17560,20200517,35248
20200514,4,인덕원,23315,23752,20200517,47067
20200514,4,정부과천청사,9302,9339,20200517,18641
20200514,4,과천,4782,4295,20200517,9077
20200514,4,대공원,2692,2848,20200517,5540
20200514,4,경마공원,1371,1366,20200517,2737
20200514,4,선바위,8542,7516,20200517,16058
20200515,4,범계,24649,24511,20200518,49160
20200515,4,평촌,17286,17257,20200518,34543
20200515,4,인덕원,22896,23531,20200518,46427
20200515,4,정부과천청사,8648,8609,20200518,17257
20200515,4,과천,4583,4084,20200518,8667
20200515,4,대공원,1215,1317,20200518,2532
20200515,4,경마공원,1180,1161,20200518,2341
20200515,4,선바위,8582,7178,20200518,15760
20200516,4,범계,17770,17744,20200519,35514
20200516,4,평촌,8266,8080,20200519,16346
20200516,4,인덕원,13323,12816,20200519,26139
20200516,4,정부과천청사,4607,4487,20200519,9094
20200516,4,과천,3105,2863,20200519,5968
20200516,4,대공원,3158,3561,20200519,6719
20200516,4,경마공원,937,851,20200519,1788
20200516,4,선바위,4500,3975,20200519,8475
20200517,4,범계,12546,12046,20200520,24592
20200517,4,평촌,5558,5328,20200520,10886
20200517,4,인덕원,10017,9688,20200520,19705
20200517,4,정부과천청사,3568,3710,20200520,7278
20200517,4,과천,2293,2055,20200520,4348
20200517,4,대공원,3762,4131,20200520,7893
20200517,4,경마공원,805,722,20200520,1527
20200517,4,선바위,3058,2976,20200520,6034
20200518,4,선바위,8237,7357,20200521,15594
20200518,4,경마공원,844,804,20200521,1648
20200518,4,대공원,1523,1625,20200521,3148
20200518,4,과천,4578,4365,20200521,8943
20200518,4,정부과천청사,8799,8871,20200521,17670
20200518,4,인덕원,22163,23190,20200521,45353
20200518,4,평촌,17249,17240,20200521,34489
20200518,4,범계,23594,22992,20200521,46586
20200519,4,범계,23912,23652,20200522,47564
20200519,4,평촌,17415,17121,20200522,34536
20200519,4,인덕원,22591,23252,20200522,45843
20200519,4,정부과천청사,8760,8651,20200522,17411
20200519,4,과천,4530,4080,20200522,8610
20200519,4,대공원,1530,1621,20200522,3151
20200519,4,경마공원,862,866,20200522,1728
20200519,4,선바위,8491,7310,20200522,15801
20200520,4,범계,25407,24716,20200523,50123
20200520,4,평촌,17727,17557,20200523,35284
20200520,4,인덕원,24043,24454,20200523,48497
20200520,4,정부과천청사,9122,9125,20200523,18247
20200520,4,과천,4870,4437,20200523,9307
20200520,4,대공원,3049,3269,20200523,6318
20200520,4,경마공원,1423,1353,20200523,2776
20200520,4,선바위,8730,7812,20200523,16542
20200521,4,범계,24939,23985,20200524,48924
20200521,4,평촌,17872,17693,20200524,35565
20200521,4,인덕원,24060,24650,20200524,48710
20200521,4,정부과천청사,9210,9146,20200524,18356
20200521,4,과천,4838,4446,20200524,9284
20200521,4,대공원,3108,3215,20200524,6323
20200521,4,경마공원,1385,1368,20200524,2753
20200521,4,선바위,8828,7885,20200524,16713
20200522,4,선바위,9205,7952,20200525,17157
20200522,4,경마공원,1219,1201,20200525,2420
20200522,4,대공원,2718,2915,20200525,5633
20200522,4,과천,5021,4557,20200525,9578
20200522,4,정부과천청사,9298,9250,20200525,18548
20200522,4,인덕원,24270,24720,20200525,48990
20200522,4,평촌,18028,17834,20200525,35862
20200522,4,범계,25674,25268,20200525,50942
20200523,4,선바위,5126,4498,20200526,9624
20200523,4,경마공원,1059,1050,20200526,2109
20200523,4,대공원,5379,6041,20200526,11420
20200523,4,과천,3684,3169,20200526,6853
20200523,4,정부과천청사,5351,5332,20200526,10683
20200523,4,인덕원,14554,13962,20200526,28516
20200523,4,평촌,8668,8521,20200526,17189
20200523,4,범계,18183,17372,20200526,35555
20200524,4,선바위,3015,2905,20200527,5920
20200524,4,경마공원,686,644,20200527,1330
20200524,4,대공원,2855,2992,20200527,5847
20200524,4,범계,11727,11014,20200527,22741
20200524,4,평촌,5132,4923,20200527,10055
20200524,4,인덕원,8932,8940,20200527,17872
20200524,4,정부과천청사,2815,2932,20200527,5747
20200524,4,과천,1960,1864,20200527,3824
20200525,4,범계,24373,23689,20200528,48062
20200525,4,평촌,17681,17621,20200528,35302
20200525,4,인덕원,23538,24192,20200528,47730
20200525,4,정부과천청사,9278,9113,20200528,18391
20200525,4,과천,4877,4360,20200528,9237
20200525,4,대공원,2395,2574,20200528,4969
20200525,4,경마공원,895,874,20200528,1769
20200525,4,선바위,8824,7627,20200528,16451
20200526,4,범계,24746,24164,20200529,48910
20200526,4,평촌,17853,17819,20200529,35672
20200526,4,인덕원,23697,24383,20200529,48080
20200526,4,정부과천청사,9149,9137,20200529,18286
20200526,4,과천,4957,4531,20200529,9488
20200526,4,대공원,2765,2946,20200529,5711
20200526,4,경마공원,930,935,20200529,1865
20200526,4,선바위,8925,7722,20200529,16647
20200527,4,범계,25596,25033,20200530,50629
20200527,4,평촌,18013,17678,20200530,35691
20200527,4,인덕원,24354,25000,20200530,49354
20200527,4,정부과천청사,9400,9313,20200530,18713
20200527,4,과천,5069,4490,20200530,9559
20200527,4,대공원,3125,3359,20200530,6484
20200527,4,경마공원,1482,1437,20200530,2919
20200527,4,선바위,9077,7925,20200530,17002
20200528,4,범계,24800,24013,20200531,48813
20200528,4,평촌,17909,17670,20200531,35579
20200528,4,인덕원,24119,24532,20200531,48651
20200528,4,정부과천청사,9530,9690,20200531,19220
20200528,4,과천,4971,4515,20200531,9486
20200528,4,대공원,3168,3378,20200531,6546
20200528,4,경마공원,1496,1450,20200531,2946
20200528,4,선바위,8780,7719,20200531,16499
20200529,4,선바위,9061,7741,20200601,16802
20200529,4,경마공원,1268,1237,20200601,2505
20200529,4,대공원,2808,3016,20200601,5824
20200529,4,과천,5129,4534,20200601,9663
20200529,4,정부과천청사,9405,9409,20200601,18814
20200529,4,인덕원,24547,24778,20200601,49325
20200529,4,평촌,17914,17746,20200601,35660
20200529,4,범계,25684,25637,20200601,51321
20200530,4,선바위,4764,4367,20200602,9131
20200530,4,경마공원,908,877,20200602,1785
20200530,4,대공원,4113,4663,20200602,8776
20200530,4,과천,3513,3176,20200602,6689
20200530,4,정부과천청사,5054,5165,20200602,10219
20200530,4,인덕원,14197,13564,20200602,27761
20200530,4,평촌,8388,8162,20200602,16550
20200530,4,범계,18160,17536,20200602,35696
20200531,4,범계,12068,11447,20200603,23515
20200531,4,평촌,5318,5192,20200603,10510
20200531,4,인덕원,9428,9214,20200603,18642
20200531,4,정부과천청사,3283,3356,20200603,6639
20200531,4,과천,2339,2048,20200603,4387
20200531,4,대공원,3552,3846,20200603,7398
20200531,4,경마공원,676,650,20200603,1326
20200531,4,선바위,3177,3050,20200603,6227
20200101,B,매교,982,1061,20200104,2043
20200101,B,수원시청,7916,6075,20200104,13991
20200101,B,매탄권선,2100,2204,20200104,4304
20200101,B,망포,5445,6235,20200104,11680
20200101,B,영통,4684,5088,20200104,9772
20200101,B,청명,1567,1878,20200104,3445
20200101,B,상갈,2755,2912,20200104,5667
20200101,B,기흥,4643,4639,20200104,9282
20200101,B,신갈,1759,1935,20200104,3694
20200101,B,구성,1970,2115,20200104,4085
20200101,B,죽전,6371,7489,20200104,13860
20200101,B,보정,1101,1014,20200104,2115
20200101,B,이매,2473,2629,20200104,5102
20200101,B,오리,5265,4627,20200104,9892
20200101,B,미금,7780,8614,20200104,16394
20200101,B,정자,6244,6615,20200104,12859
20200101,B,수내,4630,4720,20200104,9350
20200101,B,서현,13363,12778,20200104,26141
20200101,B,야탑,13790,14130,20200104,27920
20200101,B,모란,10572,10899,20200104,21471
20200101,B,태평,7649,7461,20200104,15110
20200101,B,가천대,2871,3742,20200104,6613
20200101,B,선정릉,1676,1640,20200104,3316
20200101,B,강남구청,2176,2431,20200104,4607
20200101,B,압구정로데오,4953,5406,20200104,10359
20200101,B,서울숲,2775,2832,20200104,5607
20200101,B,수원,4933,3437,20200104,8370
20200101,B,수서,7186,6991,20200104,14177
20200101,B,대모산입구,1205,1216,20200104,2421
20200101,B,개포동,1375,1439,20200104,2814
20200101,B,구룡,440,485,20200104,925
20200101,B,도곡,2185,2246,20200104,4431
20200101,B,한티,5839,5989,20200104,11828
20200101,B,선릉,2279,3268,20200104,5547
20200102,B,선릉,13838,22412,20200105,36250
20200102,B,한티,16300,17248,20200105,33548
20200102,B,도곡,7502,7484,20200105,14986
20200102,B,구룡,1406,1396,20200105,2802
20200102,B,개포동,3780,3924,20200105,7704
20200102,B,대모산입구,3685,3378,20200105,7063
20200102,B,수서,15312,15310,20200105,30622
20200102,B,수원,9026,6532,20200105,15558
20200102,B,서울숲,9266,9457,20200105,18723
20200102,B,압구정로데오,18458,20810,20200105,39268
20200102,B,강남구청,10709,12377,20200105,23086
20200102,B,선정릉,8828,9395,20200105,18223
20200102,B,가천대,7985,9151,20200105,17136
20200102,B,태평,14768,14637,20200105,29405
20200102,B,모란,22296,22292,20200105,44588
20200102,B,야탑,31717,33013,20200105,64730
20200102,B,서현,30391,30778,20200105,61169
20200102,B,수내,15559,15423,20200105,30982
20200102,B,정자,19060,20335,20200105,39395
20200102,B,미금,18907,20114,20200105,39021
20200102,B,오리,13824,11807,20200105,25631
20200102,B,이매,6297,6050,20200105,12347
20200102,B,보정,2968,2555,20200105,5523
20200102,B,죽전,15663,17358,20200105,33021
20200102,B,구성,5511,5397,20200105,10908
20200102,B,신갈,5408,5163,20200105,10571
20200102,B,기흥,11116,10540,20200105,21656
20200102,B,상갈,6107,5671,20200105,11778
20200102,B,청명,4750,4407,20200105,9157
20200102,B,영통,9611,9858,20200105,19469
20200102,B,망포,14984,14170,20200105,29154
20200102,B,매탄권선,4976,4653,20200105,9629
20200102,B,수원시청,12492,13898,20200105,26390
20200102,B,매교,2883,2898,20200105,5781
20200103,B,선릉,14556,23802,20200106,38358
20200103,B,한티,17545,18427,20200106,35972
20200103,B,도곡,7996,7930,20200106,15926
20200103,B,구룡,1545,1513,20200106,3058
20200103,B,개포동,4155,4300,20200106,8455
20200103,B,대모산입구,3791,3436,20200106,7227
20200103,B,수서,16925,17198,20200106,34123
20200103,B,수원,9988,7134,20200106,17122
20200103,B,서울숲,9719,9767,20200106,19486
20200103,B,압구정로데오,20260,23415,20200106,43675
20200103,B,강남구청,11495,13124,20200106,24619
20200103,B,선정릉,9403,9968,20200106,19371
20200103,B,가천대,8030,8776,20200106,16806
20200103,B,태평,15700,15462,20200106,31162
20200103,B,모란,24068,24684,20200106,48752
20200103,B,야탑,33522,35380,20200106,68902
20200103,B,서현,34042,34695,20200106,68737
20200103,B,수내,16534,16425,20200106,32959
20200103,B,정자,20520,22061,20200106,42581
20200103,B,미금,19842,21255,20200106,41097
20200103,B,오리,14653,12093,20200106,26746
20200103,B,이매,6789,6626,20200106,13415
20200103,B,보정,3126,2677,20200106,5803
20200103,B,죽전,17411,18419,20200106,35830
20200103,B,구성,5847,5707,20200106,11554
20200103,B,신갈,5785,5591,20200106,11376
20200103,B,기흥,11815,10974,20200106,22789
20200103,B,상갈,6685,6157,20200106,12842
20200103,B,청명,5247,4626,20200106,9873
20200103,B,영통,10939,11059,20200106,21998
20200103,B,망포,16845,15152,20200106,31997
20200103,B,매탄권선,5494,4901,20200106,10395
20200103,B,수원시청,13410,16738,20200106,30148
20200103,B,매교,2813,3092,20200106,5905
20200104,B,선릉,6047,9958,20200107,16005
20200104,B,한티,14882,14056,20200107,28938
20200104,B,도곡,5200,4825,20200107,10025
20200104,B,구룡,1037,1020,20200107,2057
20200104,B,개포동,2791,2847,20200107,5638
20200104,B,대모산입구,2716,2329,20200107,5045
20200104,B,수서,12654,12548,20200107,25202
20200104,B,수원,8136,5948,20200107,14084
20200104,B,서울숲,6653,6760,20200107,13413
20200104,B,압구정로데오,16232,18714,20200107,34946
20200104,B,강남구청,6113,7273,20200107,13386
20200104,B,선정릉,4237,4333,20200107,8570
20200104,B,가천대,5285,5870,20200107,11155
20200104,B,태평,12760,12505,20200107,25265
20200104,B,모란,26566,27577,20200107,54143
20200104,B,야탑,23732,25151,20200107,48883
20200104,B,서현,25584,25803,20200107,51387
20200104,B,수내,10939,10323,20200107,21262
20200104,B,정자,12743,13153,20200107,25896
20200104,B,미금,13953,14560,20200107,28513
20200104,B,오리,10007,8157,20200107,18164
20200104,B,이매,5052,5114,20200107,10166
20200104,B,보정,2145,1830,20200107,3975
20200104,B,죽전,12227,13916,20200107,26143
20200104,B,구성,3984,3893,20200107,7877
20200104,B,신갈,3659,3562,20200107,7221
20200104,B,기흥,8141,7719,20200107,15860
20200104,B,상갈,4881,4498,20200107,9379
20200104,B,청명,3312,3193,20200107,6505
20200104,B,영통,8337,8130,20200107,16467
20200104,B,망포,10754,9554,20200107,20308
20200104,B,매탄권선,3722,3374,20200107,7096
20200104,B,수원시청,12366,14853,20200107,27219
20200104,B,매교,1774,1895,20200107,3669
20200105,B,선릉,2974,4676,20200108,7650
20200105,B,한티,10538,9963,20200108,20501
20200105,B,도곡,3064,3010,20200108,6074
20200105,B,구룡,739,787,20200108,1526
20200105,B,개포동,2334,2284,20200108,4618
20200105,B,대모산입구,1812,1715,20200108,3527
20200105,B,수서,9696,9216,20200108,18912
20200105,B,복정,1,0,20200108,1
20200105,B,수원,5971,4204,20200108,10175
20200105,B,서울숲,4191,4329,20200108,8520
20200105,B,압구정로데오,8778,9495,20200108,18273
20200105,B,강남구청,3550,4181,20200108,7731
20200105,B,선정릉,2438,2526,20200108,4964
20200105,B,가천대,3618,4510,20200108,8128
20200105,B,태평,9529,9018,20200108,18547
20200105,B,모란,13301,13624,20200108,26925
20200105,B,야탑,18076,17952,20200108,36028
20200105,B,서현,19026,18871,20200108,37897
20200105,B,수내,7793,7437,20200108,15230
20200105,B,정자,8664,9184,20200108,17848
20200105,B,미금,10301,10849,20200108,21150
20200105,B,오리,7041,6116,20200108,13157
20200105,B,이매,4910,4969,20200108,9879
20200105,B,보정,1398,1307,20200108,2705
20200105,B,죽전,9541,10988,20200108,20529
20200105,B,구성,2795,2973,20200108,5768
20200105,B,신갈,2514,2576,20200108,5090
20200105,B,기흥,5959,5922,20200108,11881
20200105,B,상갈,3573,3583,20200108,7156
20200105,B,청명,2313,2433,20200108,4746
20200105,B,영통,5737,5908,20200108,11645
20200105,B,망포,7183,7477,20200108,14660
20200105,B,매탄권선,2645,2585,20200108,5230
20200105,B,수원시청,8468,8405,20200108,16873
20200105,B,매교,1377,1419,20200108,2796
20200106,B,선릉,15270,24661,20200109,39931
20200106,B,한티,16722,17685,20200109,34407
20200106,B,도곡,7883,8129,20200109,16012
20200106,B,구룡,1807,1752,20200109,3559
20200106,B,개포동,4012,4344,20200109,8356
20200106,B,대모산입구,3884,3586,20200109,7470
20200106,B,수서,15502,16155,20200109,31657
20200106,B,복정,1,0,20200109,1
20200106,B,수원,9142,6202,20200109,15344
20200106,B,서울숲,9346,9433,20200109,18779
20200106,B,압구정로데오,17729,19798,20200109,37527
20200106,B,강남구청,11062,12938,20200109,24000
20200106,B,선정릉,9556,10108,20200109,19664
20200106,B,가천대,8330,9471,20200109,17801
20200106,B,태평,15252,15034,20200109,30286
20200106,B,모란,22970,23055,20200109,46025
20200106,B,야탑,31430,33035,20200109,64465
20200106,B,서현,31889,32079,20200109,63968
20200106,B,수내,15724,15676,20200109,31400
20200106,B,정자,19896,21307,20200109,41203
20200106,B,미금,19591,20764,20200109,40355
20200106,B,오리,13823,11756,20200109,25579
20200106,B,이매,6287,6110,20200109,12397
20200106,B,보정,3153,2774,20200109,5927
20200106,B,죽전,15584,17341,20200109,32925
20200106,B,구성,5781,5804,20200109,11585
20200106,B,신갈,5652,5493,20200109,11145
20200106,B,기흥,11175,10626,20200109,21801
20200106,B,상갈,6319,5810,20200109,12129
20200106,B,청명,4807,4535,20200109,9342
20200106,B,영통,9759,9877,20200109,19636
20200106,B,망포,15383,14507,20200109,29890
20200106,B,매탄권선,4982,4745,20200109,9727
20200106,B,수원시청,12342,13688,20200109,26030
20200106,B,매교,2596,2652,20200109,5248
20200107,B,선릉,15502,24489,20200110,39991
20200107,B,한티,17081,17939,20200110,35020
20200107,B,도곡,7794,7873,20200110,15667
20200107,B,구룡,1751,1824,20200110,3575
20200107,B,개포동,3809,4009,20200110,7818
20200107,B,대모산입구,3573,3355,20200110,6928
20200107,B,수서,15403,15928,20200110,31331
20200107,B,수원,8730,6117,20200110,14847
20200107,B,서울숲,9268,9269,20200110,18537
20200107,B,압구정로데오,18547,20579,20200110,39126
20200107,B,강남구청,11299,12956,20200110,24255
20200107,B,선정릉,9471,10043,20200110,19514
20200107,B,가천대,8030,9220,20200110,17250
20200107,B,태평,14861,14479,20200110,29340
20200107,B,모란,21682,21828,20200110,43510
20200107,B,야탑,30783,32578,20200110,63361
20200107,B,서현,30633,31085,20200110,61718
20200107,B,수내,15484,15624,20200110,31108
20200107,B,정자,19792,21290,20200110,41082
20200107,B,미금,18477,19864,20200110,38341
20200107,B,오리,13760,11625,20200110,25385
20200107,B,이매,6309,5990,20200110,12299
20200107,B,보정,3131,2665,20200110,5796
20200107,B,죽전,15194,16902,20200110,32096
20200107,B,구성,5492,5540,20200110,11032
20200107,B,신갈,5545,5330,20200110,10875
20200107,B,기흥,10714,10358,20200110,21072
20200107,B,상갈,6191,5770,20200110,11961
20200107,B,청명,4929,4624,20200110,9553
20200107,B,영통,9537,9670,20200110,19207
20200107,B,망포,15272,14465,20200110,29737
20200107,B,매탄권선,4887,4781,20200110,9668
20200107,B,수원시청,12436,13648,20200110,26084
20200107,B,매교,2463,2499,20200110,4962
20200108,B,선릉,15117,24527,20200111,39644
20200108,B,한티,17105,18108,20200111,35213
20200108,B,도곡,7948,8096,20200111,16044
20200108,B,구룡,1737,1755,20200111,3492
20200108,B,개포동,4190,4355,20200111,8545
20200108,B,대모산입구,3878,3473,20200111,7351
20200108,B,수서,15892,16120,20200111,32012
20200108,B,복정,1,0,20200111,1
20200108,B,수원,9316,6705,20200111,16021
20200108,B,서울숲,9594,9807,20200111,19401
20200108,B,압구정로데오,18588,20954,20200111,39542
20200108,B,강남구청,11430,13336,20200111,24766
20200108,B,선정릉,9334,10036,20200111,19370
20200108,B,가천대,8072,9296,20200111,17368
20200108,B,태평,15488,15147,20200111,30635
20200108,B,모란,23176,23294,20200111,46470
20200108,B,야탑,33170,34953,20200111,68123
20200108,B,서현,32294,32587,20200111,64881
20200108,B,수내,16285,16320,20200111,32605
20200108,B,정자,20777,22258,20200111,43035
20200108,B,미금,19932,21382,20200111,41314
20200108,B,오리,14434,12162,20200111,26596
20200108,B,이매,6833,6428,20200111,13261
20200108,B,보정,3289,2757,20200111,6046
20200108,B,죽전,16239,17991,20200111,34230
20200108,B,구성,5748,5847,20200111,11595
20200108,B,신갈,5827,5618,20200111,11445
20200108,B,기흥,11568,10880,20200111,22448
20200108,B,상갈,6535,5996,20200111,12531
20200108,B,청명,4982,4691,20200111,9673
20200108,B,영통,10240,10182,20200111,20422
20200108,B,망포,15820,14763,20200111,30583
20200108,B,매탄권선,5082,4771,20200111,9853
20200108,B,수원시청,13016,14291,20200111,27307
20200108,B,매교,2668,2650,20200111,5318
20200109,B,선릉,15255,24816,20200112,40071
20200109,B,한티,17207,18178,20200112,35385
20200109,B,도곡,7979,7937,20200112,15916
20200109,B,구룡,1827,1743,20200112,3570
20200109,B,개포동,4032,4164,20200112,8196
20200109,B,대모산입구,3950,3699,20200112,7649
20200109,B,수서,16513,16902,20200112,33415
20200109,B,수원,9565,6892,20200112,16457
20200109,B,서울숲,9776,9888,20200112,19664
20200109,B,압구정로데오,19323,21823,20200112,41146
20200109,B,강남구청,11443,13269,20200112,24712
20200109,B,선정릉,9432,10138,20200112,19570
20200109,B,가천대,8485,9491,20200112,17976
20200109,B,태평,15899,15762,20200112,31661
20200109,B,모란,30291,31632,20200112,61923
20200109,B,야탑,33473,34667,20200112,68140
20200109,B,서현,32984,33389,20200112,66373
20200109,B,수내,16684,16767,20200112,33451
20200109,B,정자,21015,22393,20200112,43408
20200109,B,미금,20330,21543,20200112,41873
20200109,B,오리,15085,12718,20200112,27803
20200109,B,이매,6820,6599,20200112,13419
20200109,B,보정,3156,2774,20200112,5930
20200109,B,죽전,16808,18304,20200112,35112
20200109,B,구성,5839,5923,20200112,11762
20200109,B,신갈,5816,5658,20200112,11474
20200109,B,기흥,11862,11134,20200112,22996
20200109,B,상갈,6692,6156,20200112,12848
20200109,B,청명,5223,4862,20200112,10085
20200109,B,영통,10488,10465,20200112,20953
20200109,B,망포,16081,15199,20200112,31280
20200109,B,매탄권선,5142,4911,20200112,10053
20200109,B,수원시청,13118,14556,20200112,27674
20200109,B,매교,2619,2647,20200112,5266
20200110,B,선릉,15202,24680,20200113,39882
20200110,B,한티,17890,18829,20200113,36719
20200110,B,도곡,8286,8241,20200113,16527
20200110,B,구룡,1946,1853,20200113,3799
20200110,B,개포동,4276,4570,20200113,8846
20200110,B,대모산입구,4060,3677,20200113,7737
20200110,B,수서,18149,18324,20200113,36473
20200110,B,복정,2,0,20200113,2
20200110,B,수원,10442,7388,20200113,17830
20200110,B,서울숲,9875,9967,20200113,19842
20200110,B,압구정로데오,20516,24014,20200113,44530
20200110,B,강남구청,12046,13880,20200113,25926
20200110,B,선정릉,9659,10261,20200113,19920
20200110,B,가천대,8363,8995,20200113,17358
20200110,B,태평,16166,15707,20200113,31873
20200110,B,모란,24915,25341,20200113,50256
20200110,B,야탑,34427,36289,20200113,70716
20200110,B,서현,34453,35344,20200113,69797
20200110,B,수내,17214,17031,20200113,34245
20200110,B,정자,21417,23186,20200113,44603
20200110,B,미금,20579,21976,20200113,42555
20200110,B,오리,15192,12613,20200113,27805
20200110,B,이매,7309,6747,20200113,14056
20200110,B,보정,3076,2515,20200113,5591
20200110,B,죽전,17879,19060,20200113,36939
20200110,B,구성,6087,5923,20200113,12010
20200110,B,신갈,5986,5734,20200113,11720
20200110,B,기흥,12061,11197,20200113,23258
20200110,B,상갈,7132,6333,20200113,13465
20200110,B,청명,5366,4731,20200113,10097
20200110,B,영통,11315,11356,20200113,22671
20200110,B,망포,17845,15733,20200113,33578
20200110,B,매탄권선,5539,5067,20200113,10606
20200110,B,수원시청,14271,17486,20200113,31757
20200110,B,매교,2709,2835,20200113,5544
20200111,B,선릉,6367,10703,20200114,17070
20200111,B,한티,15800,15278,20200114,31078
20200111,B,도곡,5440,4978,20200114,10418
20200111,B,구룡,1109,1069,20200114,2178
20200111,B,개포동,2871,2920,20200114,5791
20200111,B,대모산입구,2872,2563,20200114,5435
20200111,B,수서,13129,13136,20200114,26265
20200111,B,복정,1,0,20200114,1
20200111,B,수원,8836,6239,20200114,15075
20200111,B,서울숲,6655,6826,20200114,13481
20200111,B,압구정로데오,17532,20305,20200114,37837
20200111,B,강남구청,6773,7956,20200114,14729
20200111,B,선정릉,4623,4700,20200114,9323
20200111,B,가천대,5764,6307,20200114,12071
20200111,B,태평,12768,12258,20200114,25026
20200111,B,모란,21066,21263,20200114,42329
20200111,B,야탑,24942,26754,20200114,51696
20200111,B,서현,25425,25363,20200114,50788
20200111,B,수내,11090,10404,20200114,21494
20200111,B,정자,13310,13529,20200114,26839
20200111,B,미금,14240,14996,20200114,29236
20200111,B,오리,10373,8372,20200114,18745
20200111,B,이매,5348,5278,20200114,10626
20200111,B,보정,2191,1943,20200114,4134
20200111,B,죽전,12745,14316,20200114,27061
20200111,B,구성,4131,4059,20200114,8190
20200111,B,신갈,3989,3875,20200114,7864
20200111,B,기흥,8642,8084,20200114,16726
20200111,B,상갈,5018,4807,20200114,9825
20200111,B,청명,3494,3289,20200114,6783
20200111,B,영통,8781,8617,20200114,17398
20200111,B,망포,11544,10328,20200114,21872
20200111,B,매탄권선,3968,3598,20200114,7566
20200111,B,수원시청,13328,16275,20200114,29603
20200111,B,매교,1893,2052,20200114,3945
20200112,B,선릉,3111,4958,20200115,8069
20200112,B,한티,10933,10324,20200115,21257
20200112,B,도곡,2898,2940,20200115,5838
20200112,B,구룡,726,771,20200115,1497
20200112,B,개포동,2436,2363,20200115,4799
20200112,B,대모산입구,1819,1685,20200115,3504
20200112,B,수서,9883,9736,20200115,19619
20200112,B,복정,1,0,20200115,1
20200112,B,수원,6408,4470,20200115,10878
20200112,B,서울숲,4341,4480,20200115,8821
20200112,B,압구정로데오,9374,10191,20200115,19565
20200112,B,강남구청,3907,4711,20200115,8618
20200112,B,선정릉,2726,2933,20200115,5659
20200112,B,가천대,4140,4948,20200115,9088
20200112,B,태평,9819,9443,20200115,19262
20200112,B,모란,14044,14285,20200115,28329
20200112,B,야탑,18639,18694,20200115,37333
20200112,B,서현,19052,17290,20200115,36342
20200112,B,수내,7743,7487,20200115,15230
20200112,B,정자,8635,9241,20200115,17876
20200112,B,미금,10259,11068,20200115,21327
20200112,B,오리,7379,6330,20200115,13709
20200112,B,이매,5101,5181,20200115,10282
20200112,B,보정,1360,1296,20200115,2656
20200112,B,죽전,9505,10904,20200115,20409
20200112,B,구성,2742,3060,20200115,5802
20200112,B,신갈,2510,2572,20200115,5082
20200112,B,기흥,6013,6112,20200115,12125
20200112,B,상갈,3595,3650,20200115,7245
20200112,B,청명,2451,2451,20200115,4902
20200112,B,영통,5667,5730,20200115,11397
20200112,B,망포,7430,7616,20200115,15046
20200112,B,매탄권선,2789,2749,20200115,5538
20200112,B,수원시청,8959,8882,20200115,17841
20200112,B,매교,1611,1602,20200115,3213
20200113,B,선릉,15071,24753,20200116,39824
20200113,B,한티,16967,18077,20200116,35044
20200113,B,도곡,7978,8105,20200116,16083
20200113,B,구룡,1849,1779,20200116,3628
20200113,B,개포동,3955,4157,20200116,8112
20200113,B,대모산입구,3860,3563,20200116,7423
20200113,B,수서,15726,16362,20200116,32088
20200113,B,수원,9235,6584,20200116,15819
20200113,B,서울숲,9222,9252,20200116,18474
20200113,B,압구정로데오,17761,20049,20200116,37810
20200113,B,강남구청,11190,13010,20200116,24200
20200113,B,선정릉,9816,10374,20200116,20190
20200113,B,가천대,8256,9458,20200116,17714
20200113,B,태평,15534,15291,20200116,30825
20200113,B,모란,23314,23447,20200116,46761
20200113,B,야탑,32464,33943,20200116,66407
20200113,B,서현,31674,31978,20200116,63652
20200113,B,수내,15911,15714,20200116,31625
20200113,B,정자,20030,21345,20200116,41375
20200113,B,미금,19925,21189,20200116,41114
20200113,B,오리,14386,12360,20200116,26746
20200113,B,이매,6420,6211,20200116,12631
20200113,B,보정,3004,2537,20200116,5541
20200113,B,죽전,15953,17537,20200116,33490
20200113,B,구성,5928,5949,20200116,11877
20200113,B,신갈,5957,5623,20200116,11580
20200113,B,기흥,11319,10917,20200116,22236
20200113,B,상갈,6459,6046,20200116,12505
20200113,B,청명,4836,4571,20200116,9407
20200113,B,영통,10067,10367,20200116,20434
20200113,B,망포,15716,14537,20200116,30253
20200113,B,매탄권선,5016,4743,20200116,9759
20200113,B,수원시청,12856,14054,20200116,26910
20200113,B,매교,2642,2707,20200116,5349
20200114,B,매교,2669,2696,20200117,5365
20200114,B,수원시청,13244,14496,20200117,27740
20200114,B,매탄권선,5052,4840,20200117,9892
20200114,B,망포,15920,14822,20200117,30742
20200114,B,영통,10311,10396,20200117,20707
20200114,B,청명,4954,4558,20200117,9512
20200114,B,상갈,6683,6167,20200117,12850
20200114,B,기흥,11680,11013,20200117,22693
20200114,B,신갈,5798,5609,20200117,11407
20200114,B,구성,5991,6040,20200117,12031
20200114,B,죽전,16598,18229,20200117,34827
20200114,B,보정,3170,2637,20200117,5807
20200114,B,이매,6605,6432,20200117,13037
20200114,B,오리,14992,12441,20200117,27433
20200114,B,미금,19947,21599,20200117,41546
20200114,B,정자,20731,21936,20200117,42667
20200114,B,수내,16481,16463,20200117,32944
20200114,B,서현,32125,32522,20200117,64647
20200114,B,야탑,32703,34411,20200117,67114
20200114,B,모란,30555,31589,20200117,62144
20200114,B,태평,16003,15609,20200117,31612
20200114,B,가천대,8043,9243,20200117,17286
20200114,B,선정릉,9852,10573,20200117,20425
20200114,B,강남구청,11548,13284,20200117,24832
20200114,B,압구정로데오,19455,21765,20200117,41220
20200114,B,서울숲,9697,9761,20200117,19458
20200114,B,수원,9193,6495,20200117,15688
20200114,B,복정,1,0,20200117,1
20200114,B,수서,16273,16477,20200117,32750
20200114,B,대모산입구,4023,3760,20200117,7783
20200114,B,개포동,3998,4250,20200117,8248
20200114,B,구룡,1886,1852,20200117,3738
20200114,B,도곡,8088,8235,20200117,16323
20200114,B,한티,17671,18608,20200117,36279
20200114,B,선릉,15671,24797,20200117,40468
20200115,B,선릉,15524,24828,20200118,40352
20200115,B,한티,17536,18646,20200118,36182
20200115,B,도곡,8308,8131,20200118,16439
20200115,B,구룡,1869,1857,20200118,3726
20200115,B,개포동,4299,4491,20200118,8790
20200115,B,대모산입구,3950,3697,20200118,7647
20200115,B,수서,15951,16585,20200118,32536
20200115,B,수원,9435,6826,20200118,16261
20200115,B,서울숲,10331,10457,20200118,20788
20200115,B,압구정로데오,19108,21531,20200118,40639
20200115,B,강남구청,11755,13492,20200118,25247
20200115,B,선정릉,9939,10588,20200118,20527
20200115,B,가천대,7995,9049,20200118,17044
20200115,B,태평,15660,15543,20200118,31203
20200115,B,모란,23614,23880,20200118,47494
20200115,B,야탑,33448,34997,20200118,68445
20200115,B,서현,31834,32063,20200118,63897
20200115,B,수내,16750,16638,20200118,33388
20200115,B,정자,20968,22252,20200118,43220
20200115,B,미금,20147,21635,20200118,41782
20200115,B,오리,14877,12569,20200118,27446
20200115,B,이매,6859,6627,20200118,13486
20200115,B,보정,3077,2551,20200118,5628
20200115,B,죽전,16444,18071,20200118,34515
20200115,B,구성,5958,5919,20200118,11877
20200115,B,신갈,5820,5626,20200118,11446
20200115,B,기흥,11643,10980,20200118,22623
20200115,B,상갈,6633,6079,20200118,12712
20200115,B,청명,4940,4662,20200118,9602
20200115,B,영통,10253,10320,20200118,20573
20200115,B,망포,16041,14870,20200118,30911
20200115,B,매탄권선,5127,4905,20200118,10032
20200115,B,수원시청,13591,14873,20200118,28464
20200115,B,매교,2603,2601,20200118,5204
20200116,B,매교,2616,2647,20200119,5263
20200116,B,수원시청,13325,14818,20200119,28143
20200116,B,매탄권선,5221,4880,20200119,10101
20200116,B,망포,16114,14911,20200119,31025
20200116,B,영통,10233,10240,20200119,20473
20200116,B,청명,4948,4604,20200119,9552
20200116,B,상갈,6472,5983,20200119,12455
20200116,B,기흥,11372,10865,20200119,22237
20200116,B,신갈,5844,5568,20200119,11412
20200116,B,구성,5929,5864,20200119,11793
20200116,B,죽전,16309,17968,20200119,34277
20200116,B,보정,3016,2487,20200119,5503
20200116,B,이매,6687,6396,20200119,13083
20200116,B,오리,15092,12942,20200119,28034
20200116,B,미금,20299,21645,20200119,41944
20200116,B,정자,20626,22029,20200119,42655
20200116,B,수내,16537,16673,20200119,33210
20200116,B,서현,31917,31997,20200119,63914
20200116,B,야탑,33491,34833,20200119,68324
20200116,B,모란,23923,24054,20200119,47977
20200116,B,태평,15928,15531,20200119,31459
20200116,B,가천대,8123,9149,20200119,17272
20200116,B,선정릉,9711,10552,20200119,20263
20200116,B,강남구청,11889,13791,20200119,25680
20200116,B,압구정로데오,19380,22250,20200119,41630
20200116,B,서울숲,10015,10031,20200119,20046
20200116,B,수원,9306,6496,20200119,15802
20200116,B,수서,16401,16616,20200119,33017
20200116,B,대모산입구,3981,3658,20200119,7639
20200116,B,개포동,4252,4348,20200119,8600
20200116,B,구룡,1874,1766,20200119,3640
20200116,B,도곡,7941,8056,20200119,15997
20200116,B,한티,17423,18437,20200119,35860
20200116,B,선릉,15594,25108,20200119,40702
20200117,B,선릉,15459,25082,20200120,40541
20200117,B,한티,18233,19027,20200120,37260
20200117,B,도곡,8399,8166,20200120,16565
20200117,B,구룡,1914,1768,20200120,3682
20200117,B,개포동,4337,4550,20200120,8887
20200117,B,대모산입구,3995,3658,20200120,7653
20200117,B,수서,18311,18205,20200120,36516
20200117,B,복정,1,0,20200120,1
20200117,B,수원,10364,7319,20200120,17683
20200117,B,서울숲,10024,10032,20200120,20056
20200117,B,압구정로데오,21458,25057,20200120,46515
20200117,B,강남구청,12111,13782,20200120,25893
20200117,B,선정릉,9809,10553,20200120,20362
20200117,B,가천대,8384,8952,20200120,17336
20200117,B,태평,16273,16022,20200120,32295
20200117,B,모란,24918,25272,20200120,50190
20200117,B,야탑,35072,36806,20200120,71878
20200117,B,서현,34642,35428,20200120,70070
20200117,B,수내,17243,17167,20200120,34410
20200117,B,정자,21935,23225,20200120,45160
20200117,B,미금,20613,22095,20200120,42708
20200117,B,오리,15232,12901,20200120,28133
20200117,B,이매,7070,6790,20200120,13860
20200117,B,보정,3131,2562,20200120,5693
20200117,B,죽전,17547,18614,20200120,36161
20200117,B,구성,6172,5871,20200120,12043
20200117,B,신갈,6058,5745,20200120,11803
20200117,B,기흥,12008,11243,20200120,23251
20200117,B,상갈,6947,6253,20200120,13200
20200117,B,청명,5374,4899,20200120,10273
20200117,B,영통,11010,11215,20200120,22225
20200117,B,망포,17515,15517,20200120,33032
20200117,B,매탄권선,5450,4989,20200120,10439
20200117,B,수원시청,14552,18011,20200120,32563
20200117,B,매교,2711,2760,20200120,5471
20200118,B,선릉,6646,10954,20200121,17600
20200118,B,한티,15124,14615,20200121,29739
20200118,B,도곡,5764,5364,20200121,11128
20200118,B,구룡,1067,1055,20200121,2122
20200118,B,개포동,3074,2980,20200121,6054
20200118,B,대모산입구,3178,2952,20200121,6130
20200118,B,수서,12803,12888,20200121,25691
20200118,B,복정,1,0,20200121,1
20200118,B,수원,8571,6030,20200121,14601
20200118,B,서울숲,6988,7161,20200121,14149
20200118,B,압구정로데오,18099,20862,20200121,38961
20200118,B,강남구청,6665,8067,20200121,14732
20200118,B,선정릉,4958,5072,20200121,10030
20200118,B,가천대,5814,6290,20200121,12104
20200118,B,태평,12783,12494,20200121,25277
20200118,B,모란,19952,20461,20200121,40413
20200118,B,야탑,24733,25974,20200121,50707
20200118,B,서현,25281,25714,20200121,50995
20200118,B,수내,11195,10459,20200121,21654
20200118,B,정자,13500,13682,20200121,27182
20200118,B,미금,14133,14836,20200121,28969
20200118,B,오리,10523,8602,20200121,19125
20200118,B,이매,5082,4886,20200121,9968
20200118,B,보정,2193,1896,20200121,4089
20200118,B,죽전,12958,14501,20200121,27459
20200118,B,구성,4050,4023,20200121,8073
20200118,B,신갈,3601,3592,20200121,7193
20200118,B,기흥,8437,7897,20200121,16334
20200118,B,상갈,4907,4639,20200121,9546
20200118,B,청명,3594,3454,20200121,7048
20200118,B,영통,9533,8921,20200121,18454
20200118,B,망포,11336,10241,20200121,21577
20200118,B,매탄권선,3839,3508,20200121,7347
20200118,B,수원시청,13258,16101,20200121,29359
20200118,B,매교,1875,1984,20200121,3859
20200119,B,선릉,3022,4725,20200122,7747
20200119,B,한티,10780,10245,20200122,21025
20200119,B,도곡,2986,3108,20200122,6094
20200119,B,구룡,720,743,20200122,1463
20200119,B,개포동,2392,2335,20200122,4727
20200119,B,대모산입구,1942,1855,20200122,3797
20200119,B,수서,10069,9983,20200122,20052
20200119,B,수원,6340,4371,20200122,10711
20200119,B,서울숲,4160,4235,20200122,8395
20200119,B,압구정로데오,9657,10708,20200122,20365
20200119,B,강남구청,3609,4448,20200122,8057
20200119,B,선정릉,2674,2792,20200122,5466
20200119,B,가천대,4009,4876,20200122,8885
20200119,B,태평,9940,9769,20200122,19709
20200119,B,모란,23159,24431,20200122,47590
20200119,B,야탑,18673,18857,20200122,37530
20200119,B,서현,19754,19225,20200122,38979
20200119,B,수내,7635,7571,20200122,15206
20200119,B,정자,8968,9214,20200122,18182
20200119,B,미금,10591,11331,20200122,21922
20200119,B,오리,7665,6751,20200122,14416
20200119,B,이매,5153,5255,20200122,10408
20200119,B,보정,1436,1344,20200122,2780
20200119,B,죽전,10212,11730,20200122,21942
20200119,B,구성,3032,3158,20200122,6190
20200119,B,신갈,2600,2670,20200122,5270
20200119,B,기흥,6193,6135,20200122,12328
20200119,B,상갈,3596,3581,20200122,7177
20200119,B,청명,2498,2496,20200122,4994
20200119,B,영통,5979,5889,20200122,11868
20200119,B,망포,7344,7713,20200122,15057
20200119,B,매탄권선,2750,2697,20200122,5447
20200119,B,수원시청,9416,9201,20200122,18617
20200119,B,매교,1365,1437,20200122,2802
20200120,B,매교,2683,2664,20200123,5347
20200120,B,수원시청,13221,14559,20200123,27780
20200120,B,매탄권선,5119,4814,20200123,9933
20200120,B,망포,15929,14689,20200123,30618
20200120,B,영통,9894,10102,20200123,19996
20200120,B,청명,4921,4503,20200123,9424
20200120,B,상갈,6633,6118,20200123,12751
20200120,B,기흥,11536,10966,20200123,22502
20200120,B,신갈,5821,5619,20200123,11440
20200120,B,구성,5907,5804,20200123,11711
20200120,B,죽전,16166,17716,20200123,33882
20200120,B,보정,3067,2544,20200123,5611
20200120,B,이매,6535,6375,20200123,12910
20200120,B,오리,14666,12627,20200123,27293
20200120,B,미금,20290,21579,20200123,41869
20200120,B,정자,20071,21694,20200123,41765
20200120,B,수내,16217,16134,20200123,32351
20200120,B,서현,32455,32764,20200123,65219
20200120,B,야탑,32549,34160,20200123,66709
20200120,B,모란,23631,23727,20200123,47358
20200120,B,태평,15812,15488,20200123,31300
20200120,B,가천대,8240,9203,20200123,17443
20200120,B,선정릉,10095,10739,20200123,20834
20200120,B,강남구청,11535,13373,20200123,24908
20200120,B,압구정로데오,18751,20896,20200123,39647
20200120,B,서울숲,9270,9374,20200123,18644
20200120,B,수원,9312,6541,20200123,15853
20200120,B,복정,1,0,20200123,1
20200120,B,수서,15874,16712,20200123,32586
20200120,B,대모산입구,4028,3734,20200123,7762
20200120,B,개포동,4402,4587,20200123,8989
20200120,B,구룡,1741,1751,20200123,3492
20200120,B,도곡,8133,8141,20200123,16274
20200120,B,한티,17050,18081,20200123,35131
20200120,B,선릉,15438,24938,20200123,40376
20200121,B,선릉,15459,24668,20200124,40127
20200121,B,한티,17457,18565,20200124,36022
20200121,B,도곡,8126,8062,20200124,16188
20200121,B,구룡,1668,1617,20200124,3285
20200121,B,개포동,4385,4440,20200124,8825
20200121,B,대모산입구,3947,3736,20200124,7683
20200121,B,수서,16046,16645,20200124,32691
20200121,B,수원,9322,6708,20200124,16030
20200121,B,서울숲,9944,10078,20200124,20022
20200121,B,압구정로데오,20074,22368,20200124,42442
20200121,B,강남구청,11533,13456,20200124,24989
20200121,B,선정릉,10195,10631,20200124,20826
20200121,B,가천대,8272,9171,20200124,17443
20200121,B,태평,16001,15632,20200124,31633
20200121,B,모란,23942,23845,20200124,47787
20200121,B,야탑,32398,33953,20200124,66351
20200121,B,서현,32129,32571,20200124,64700
20200121,B,수내,16790,16740,20200124,33530
20200121,B,정자,20539,21801,20200124,42340
20200121,B,미금,20241,21554,20200124,41795
20200121,B,오리,14927,12836,20200124,27763
20200121,B,이매,6699,6361,20200124,13060
20200121,B,보정,3050,2594,20200124,5644
20200121,B,죽전,16438,18047,20200124,34485
20200121,B,구성,5776,5710,20200124,11486
20200121,B,신갈,5733,5608,20200124,11341
20200121,B,기흥,11546,10809,20200124,22355
20200121,B,상갈,6556,6025,20200124,12581
20200121,B,청명,5043,4604,20200124,9647
20200121,B,영통,10507,10372,20200124,20879
20200121,B,망포,16042,15007,20200124,31049
20200121,B,매탄권선,5127,4856,20200124,9983
20200121,B,수원시청,13517,14839,20200124,28356
20200121,B,매교,2676,2632,20200124,5308
20200122,B,선릉,15053,24242,20200125,39295
20200122,B,한티,17580,18454,20200125,36034
20200122,B,도곡,7827,7847,20200125,15674
20200122,B,구룡,1610,1584,20200125,3194
20200122,B,개포동,4581,4769,20200125,9350
20200122,B,대모산입구,4006,3651,20200125,7657
20200122,B,수서,15618,16771,20200125,32389
20200122,B,복정,1,0,20200125,1
20200122,B,수원,9333,6765,20200125,16098
20200122,B,서울숲,9712,9759,20200125,19471
20200122,B,압구정로데오,19443,21879,20200125,41322
20200122,B,강남구청,11875,13612,20200125,25487
20200122,B,선정릉,9653,10283,20200125,19936
20200122,B,가천대,7486,8212,20200125,15698
20200122,B,태평,16209,15820,20200125,32029
20200122,B,모란,23743,23945,20200125,47688
20200122,B,야탑,33546,35539,20200125,69085
20200122,B,서현,32498,32863,20200125,65361
20200122,B,수내,16630,16723,20200125,33353
20200122,B,정자,20730,21846,20200125,42576
20200122,B,미금,20311,21514,20200125,41825
20200122,B,오리,14974,12766,20200125,27740
20200122,B,이매,6727,6504,20200125,13231
20200122,B,보정,2971,2522,20200125,5493
20200122,B,죽전,16524,18119,20200125,34643
20200122,B,구성,5797,5827,20200125,11624
20200122,B,신갈,5787,5598,20200125,11385
20200122,B,기흥,11360,10701,20200125,22061
20200122,B,상갈,6599,6054,20200125,12653
20200122,B,청명,5020,4519,20200125,9539
20200122,B,영통,10439,10336,20200125,20775
20200122,B,망포,16266,14783,20200125,31049
20200122,B,매탄권선,5074,4773,20200125,9847
20200122,B,수원시청,13371,14656,20200125,28027
20200122,B,매교,2582,2671,20200125,5253
20200123,B,선릉,12850,20624,20200126,33474
20200123,B,한티,16750,17350,20200126,34100
20200123,B,도곡,7484,7145,20200126,14629
20200123,B,구룡,1435,1334,20200126,2769
20200123,B,개포동,3884,3954,20200126,7838
20200123,B,대모산입구,3624,3278,20200126,6902
20200123,B,수서,14718,18357,20200126,33075
20200123,B,수원,9635,7360,20200126,16995
20200123,B,서울숲,8923,8567,20200126,17490
20200123,B,압구정로데오,18443,21003,20200126,39446
20200123,B,강남구청,10520,11627,20200126,22147
20200123,B,선정릉,8445,9030,20200126,17475
20200123,B,가천대,6944,7058,20200126,14002
20200123,B,태평,16153,15546,20200126,31699
20200123,B,모란,23473,23766,20200126,47239
20200123,B,야탑,32123,36956,20200126,69079
20200123,B,서현,31405,30538,20200126,61943
20200123,B,수내,15462,15157,20200126,30619
20200123,B,정자,19356,20303,20200126,39659
20200123,B,미금,19176,19811,20200126,38987
20200123,B,오리,14125,12051,20200126,26176
20200123,B,이매,6310,5933,20200126,12243
20200123,B,보정,2738,2339,20200126,5077
20200123,B,죽전,16593,17412,20200126,34005
20200123,B,구성,5466,5300,20200126,10766
20200123,B,신갈,5469,5158,20200126,10627
20200123,B,기흥,11034,10382,20200126,21416
20200123,B,상갈,6390,5673,20200126,12063
20200123,B,청명,4659,4218,20200126,8877
20200123,B,영통,10109,9877,20200126,19986
20200123,B,망포,16381,14101,20200126,30482
20200123,B,매탄권선,5629,4581,20200126,10210
20200123,B,수원시청,13113,15770,20200126,28883
20200123,B,매교,2365,2443,20200126,4808
20200124,B,매교,964,987,20200127,1951
20200124,B,수원시청,5504,5331,20200127,10835
20200124,B,매탄권선,2023,1715,20200127,3738
20200124,B,망포,5437,4299,20200127,9736
20200124,B,영통,4170,3527,20200127,7697
20200124,B,청명,1775,1459,20200127,3234
20200124,B,상갈,2707,2738,20200127,5445
20200124,B,기흥,4377,4332,20200127,8709
20200124,B,신갈,1872,1820,20200127,3692
20200124,B,구성,2026,2287,20200127,4313
20200124,B,죽전,6349,6425,20200127,12774
20200124,B,보정,1045,919,20200127,1964
20200124,B,이매,2673,2556,20200127,5229
20200124,B,오리,5862,4793,20200127,10655
20200124,B,미금,7616,6998,20200127,14614
20200124,B,정자,6452,5780,20200127,12232
20200124,B,수내,5690,4993,20200127,10683
20200124,B,서현,11077,10870,20200127,21947
20200124,B,야탑,13290,16373,20200127,29663
20200124,B,모란,14718,15264,20200127,29982
20200124,B,태평,8480,8026,20200127,16506
20200124,B,가천대,3118,2845,20200127,5963
20200124,B,선정릉,1596,1305,20200127,2901
20200124,B,강남구청,2045,2152,20200127,4197
20200124,B,압구정로데오,5916,6626,20200127,12542
20200124,B,서울숲,2828,2615,20200127,5443
20200124,B,수원,4618,3304,20200127,7922
20200124,B,수서,6273,9943,20200127,16216
20200124,B,대모산입구,1321,1075,20200127,2396
20200124,B,개포동,1613,1413,20200127,3026
20200124,B,구룡,511,437,20200127,948
20200124,B,도곡,2292,2035,20200127,4327
20200124,B,한티,5814,4971,20200127,10785
20200124,B,선릉,1899,2599,20200127,4498
20200125,B,선릉,1098,1746,20200128,2844
20200125,B,한티,3891,3825,20200128,7716
20200125,B,도곡,1345,1326,20200128,2671
20200125,B,구룡,363,396,20200128,759
20200125,B,개포동,1042,1127,20200128,2169
20200125,B,대모산입구,1051,1009,20200128,2060
20200125,B,수서,7221,6885,20200128,14106
20200125,B,수원,4224,2355,20200128,6579
20200125,B,서울숲,1961,2163,20200128,4124
20200125,B,압구정로데오,2244,2724,20200128,4968
20200125,B,강남구청,1180,1370,20200128,2550
20200125,B,선정릉,996,1027,20200128,2023
20200125,B,가천대,2331,2818,20200128,5149
20200125,B,태평,6724,6489,20200128,13213
20200125,B,모란,8000,8403,20200128,16403
20200125,B,야탑,9849,9770,20200128,19619
20200125,B,서현,7050,7461,20200128,14511
20200125,B,수내,2768,2642,20200128,5410
20200125,B,정자,4095,4302,20200128,8397
20200125,B,미금,4712,5099,20200128,9811
20200125,B,오리,3790,3254,20200128,7044
20200125,B,이매,2079,2182,20200128,4261
20200125,B,보정,863,728,20200128,1591
20200125,B,죽전,4298,4886,20200128,9184
20200125,B,구성,1803,1712,20200128,3515
20200125,B,신갈,1541,1531,20200128,3072
20200125,B,기흥,4022,3669,20200128,7691
20200125,B,상갈,2373,2285,20200128,4658
20200125,B,청명,1430,1316,20200128,2746
20200125,B,영통,2755,2830,20200128,5585
20200125,B,망포,3830,3535,20200128,7365
20200125,B,매탄권선,1609,1556,20200128,3165
20200125,B,수원시청,3539,4856,20200128,8395
20200125,B,매교,794,860,20200128,1654
20200126,B,선릉,1623,2777,20200129,4400
20200126,B,한티,6525,6804,20200129,13329
20200126,B,도곡,1972,1958,20200129,3930
20200126,B,구룡,513,453,20200129,966
20200126,B,개포동,1863,1898,20200129,3761
20200126,B,대모산입구,1338,1262,20200129,2600
20200126,B,수서,9496,6226,20200129,15722
20200126,B,복정,1,0,20200129,1
20200126,B,수원,6288,3541,20200129,9829
20200126,B,서울숲,3180,3371,20200129,6551
20200126,B,압구정로데오,4444,5430,20200129,9874
20200126,B,강남구청,1914,2314,20200129,4228
20200126,B,선정릉,1307,1515,20200129,2822
20200126,B,가천대,2668,3581,20200129,6249
20200126,B,태평,8167,7689,20200129,15856
20200126,B,모란,11007,11613,20200129,22620
20200126,B,야탑,16055,14857,20200129,30912
20200126,B,서현,14294,14960,20200129,29254
20200126,B,수내,4466,4569,20200129,9035
20200126,B,정자,6364,7221,20200129,13585
20200126,B,미금,7910,8482,20200129,16392
20200126,B,오리,5472,4810,20200129,10282
20200126,B,이매,3502,3655,20200129,7157
20200126,B,보정,1177,1091,20200129,2268
20200126,B,죽전,7570,8906,20200129,16476
20200126,B,구성,2317,2454,20200129,4771
20200126,B,신갈,2021,2043,20200129,4064
20200126,B,기흥,5256,4892,20200129,10148
20200126,B,상갈,3208,3120,20200129,6328
20200126,B,청명,1958,1864,20200129,3822
20200126,B,영통,3916,4334,20200129,8250
20200126,B,망포,5714,5714,20200129,11428
20200126,B,매탄권선,2189,2136,20200129,4325
20200126,B,수원시청,5765,7745,20200129,13510
20200126,B,매교,1112,1098,20200129,2210
20200127,B,선릉,2539,4321,20200130,6860
20200127,B,한티,7352,7787,20200130,15139
20200127,B,도곡,2775,2749,20200130,5524
20200127,B,구룡,485,555,20200130,1040
20200127,B,개포동,1782,1768,20200130,3550
20200127,B,대모산입구,1372,1298,20200130,2670
20200127,B,수서,10733,7212,20200130,17945
20200127,B,수원,6296,3980,20200130,10276
20200127,B,서울숲,3151,3479,20200130,6630
20200127,B,압구정로데오,7497,8281,20200130,15778
20200127,B,강남구청,2418,3040,20200130,5458
20200127,B,선정릉,1771,1939,20200130,3710
20200127,B,가천대,3112,4083,20200130,7195
20200127,B,태평,8495,8357,20200130,16852
20200127,B,모란,12091,12809,20200130,24900
20200127,B,야탑,17548,16674,20200130,34222
20200127,B,서현,17358,17345,20200130,34703
20200127,B,수내,6462,6549,20200130,13011
20200127,B,정자,7573,8382,20200130,15955
20200127,B,미금,8600,9572,20200130,18172
20200127,B,오리,6067,5528,20200130,11595
20200127,B,이매,2987,3095,20200130,6082
20200127,B,보정,1167,1135,20200130,2302
20200127,B,죽전,8624,10119,20200130,18743
20200127,B,구성,2604,2650,20200130,5254
20200127,B,신갈,2223,2268,20200130,4491
20200127,B,기흥,5663,5673,20200130,11336
20200127,B,상갈,3255,3216,20200130,6471
20200127,B,청명,2029,2041,20200130,4070
20200127,B,영통,5077,5456,20200130,10533
20200127,B,망포,6450,6993,20200130,13443
20200127,B,매탄권선,2335,2341,20200130,4676
20200127,B,수원시청,7092,7528,20200130,14620
20200127,B,매교,1113,1172,20200130,2285
20200128,B,선릉,13262,21307,20200131,34569
20200128,B,한티,15031,15976,20200131,31007
20200128,B,도곡,6796,6934,20200131,13730
20200128,B,구룡,1417,1432,20200131,2849
20200128,B,개포동,3834,3981,20200131,7815
20200128,B,대모산입구,3469,3274,20200131,6743
20200128,B,수서,14899,13629,20200131,28528
20200128,B,수원,8318,5858,20200131,14176
20200128,B,서울숲,8563,8760,20200131,17323
20200128,B,압구정로데오,17113,19154,20200131,36267
20200128,B,강남구청,10046,11533,20200131,21579
20200128,B,선정릉,8698,9138,20200131,17836
20200128,B,가천대,6306,7674,20200131,13980
20200128,B,태평,14440,14300,20200131,28740
20200128,B,모란,21105,21505,20200131,42610
20200128,B,야탑,29570,30401,20200131,59971
20200128,B,서현,28740,28963,20200131,57703
20200128,B,수내,14080,14197,20200131,28277
20200128,B,정자,18062,19218,20200131,37280
20200128,B,미금,17725,18947,20200131,36672
20200128,B,오리,12687,11049,20200131,23736
20200128,B,이매,5852,5602,20200131,11454
20200128,B,보정,2650,2254,20200131,4904
20200128,B,죽전,14293,15895,20200131,30188
20200128,B,구성,4987,5107,20200131,10094
20200128,B,신갈,5064,4923,20200131,9987
20200128,B,기흥,9998,9516,20200131,19514
20200128,B,상갈,5714,5214,20200131,10928
20200128,B,청명,4213,3952,20200131,8165
20200128,B,영통,8700,9096,20200131,17796
20200128,B,망포,13673,13061,20200131,26734
20200128,B,매탄권선,4531,4297,20200131,8828
20200128,B,수원시청,11617,12991,20200131,24608
20200128,B,매교,2232,2239,20200131,4471
20200129,B,선릉,14616,23611,20200201,38227
20200129,B,한티,15680,16545,20200201,32225
20200129,B,도곡,7227,7453,20200201,14680
20200129,B,구룡,1464,1448,20200201,2912
20200129,B,개포동,4117,4276,20200201,8393
20200129,B,대모산입구,3790,3622,20200201,7412
20200129,B,수서,15445,15216,20200201,30661
20200129,B,수원,8623,5958,20200201,14581
20200129,B,서울숲,9432,9547,20200201,18979
20200129,B,압구정로데오,17795,19989,20200201,37784
20200129,B,강남구청,10825,12538,20200201,23363
20200129,B,선정릉,9371,9938,20200201,19309
20200129,B,가천대,6695,7879,20200201,14574
20200129,B,태평,15173,14908,20200201,30081
20200129,B,모란,26484,27565,20200201,54049
20200129,B,야탑,30985,32355,20200201,63340
20200129,B,서현,30047,30451,20200201,60498
20200129,B,수내,15092,15056,20200201,30148
20200129,B,정자,19260,20601,20200201,39861
20200129,B,미금,18627,19624,20200201,38251
20200129,B,오리,13749,11452,20200201,25201
20200129,B,이매,6303,6121,20200201,12424
20200129,B,보정,2719,2372,20200201,5091
20200129,B,죽전,15227,16661,20200201,31888
20200129,B,구성,5285,5387,20200201,10672
20200129,B,신갈,5336,5195,20200201,10531
20200129,B,기흥,10416,9949,20200201,20365
20200129,B,상갈,6059,5673,20200201,11732
20200129,B,청명,4532,4201,20200201,8733
20200129,B,영통,8894,9222,20200201,18116
20200129,B,망포,14749,13779,20200201,28528
20200129,B,매탄권선,4643,4487,20200201,9130
20200129,B,수원시청,12333,13580,20200201,25913
20200129,B,매교,2350,2364,20200201,4714
20200130,B,매교,2422,2384,20200202,4806
20200130,B,수원시청,12230,13545,20200202,25775
20200130,B,매탄권선,4662,4414,20200202,9076
20200130,B,망포,14870,13953,20200202,28823
20200130,B,영통,9115,9165,20200202,18280
20200130,B,청명,4509,4227,20200202,8736
20200130,B,상갈,5945,5478,20200202,11423
20200130,B,기흥,10408,9880,20200202,20288
20200130,B,신갈,5198,5028,20200202,10226
20200130,B,구성,5435,5356,20200202,10791
20200130,B,죽전,14993,16473,20200202,31466
20200130,B,보정,2660,2293,20200202,4953
20200130,B,이매,6466,6203,20200202,12669
20200130,B,오리,13729,11613,20200202,25342
20200130,B,미금,18204,19308,20200202,37512
20200130,B,정자,19188,20623,20200202,39811
20200130,B,수내,15229,15215,20200202,30444
20200130,B,서현,29852,30381,20200202,60233
20200130,B,야탑,30642,32005,20200202,62647
20200130,B,모란,22449,22551,20200202,45000
20200130,B,태평,14812,14629,20200202,29441
20200130,B,가천대,6831,7915,20200202,14746
20200130,B,선정릉,9250,10040,20200202,19290
20200130,B,강남구청,10831,12440,20200202,23271
20200130,B,압구정로데오,18182,20609,20200202,38791
20200130,B,서울숲,9298,9493,20200202,18791
20200130,B,수원,8501,5913,20200202,14414
20200130,B,수서,15137,15453,20200202,30590
20200130,B,대모산입구,3738,3470,20200202,7208
20200130,B,개포동,4082,4217,20200202,8299
20200130,B,구룡,1547,1491,20200202,3038
20200130,B,도곡,7346,7499,20200202,14845
20200130,B,한티,15485,16427,20200202,31912
20200130,B,선릉,14703,23597,20200202,38300
20200131,B,선릉,14315,23336,20200203,37651
20200131,B,한티,16092,17146,20200203,33238
20200131,B,도곡,7500,7402,20200203,14902
20200131,B,구룡,1460,1477,20200203,2937
20200131,B,개포동,4149,4298,20200203,8447
20200131,B,대모산입구,3741,3473,20200203,7214
20200131,B,수서,16794,16836,20200203,33630
20200131,B,수원,9231,6351,20200203,15582
20200131,B,서울숲,9370,9445,20200203,18815
20200131,B,압구정로데오,18580,21845,20200203,40425
20200131,B,강남구청,11115,12681,20200203,23796
20200131,B,선정릉,9207,9817,20200203,19024
20200131,B,가천대,6955,7694,20200203,14649
20200131,B,태평,15153,14696,20200203,29849
20200131,B,모란,23009,23462,20200203,46471
20200131,B,야탑,31204,33017,20200203,64221
20200131,B,서현,31865,32450,20200203,64315
20200131,B,수내,15468,15552,20200203,31020
20200131,B,정자,19921,21288,20200203,41209
20200131,B,미금,18440,19717,20200203,38157
20200131,B,오리,13782,11570,20200203,25352
20200131,B,이매,6562,6197,20200203,12759
20200131,B,보정,2736,2263,20200203,4999
20200131,B,죽전,15900,16915,20200203,32815
20200131,B,구성,5370,5330,20200203,10700
20200131,B,신갈,5487,5290,20200203,10777
20200131,B,기흥,10720,10041,20200203,20761
20200131,B,상갈,6245,5636,20200203,11881
20200131,B,청명,4709,4229,20200203,8938
20200131,B,영통,9772,9876,20200203,19648
20200131,B,망포,15701,14134,20200203,29835
20200131,B,매탄권선,5015,4556,20200203,9571
20200131,B,수원시청,12465,15409,20200203,27874
20200131,B,매교,2564,2595,20200203,5159
20200201,B,선릉,5028,8499,20200204,13527
20200201,B,한티,12036,11462,20200204,23498
20200201,B,도곡,4091,3740,20200204,7831
20200201,B,구룡,906,891,20200204,1797
20200201,B,개포동,2474,2531,20200204,5005
20200201,B,대모산입구,2158,1970,20200204,4128
20200201,B,수서,10186,10418,20200204,20604
20200201,B,수원,6372,4245,20200204,10617
20200201,B,서울숲,5684,5867,20200204,11551
20200201,B,압구정로데오,14038,16174,20200204,30212
20200201,B,강남구청,5326,6472,20200204,11798
20200201,B,선정릉,3501,3677,20200204,7178
20200201,B,가천대,4688,5250,20200204,9938
20200201,B,태평,10764,10418,20200204,21182
20200201,B,모란,16894,17032,20200204,33926
20200201,B,야탑,19504,20778,20200204,40282
20200201,B,서현,21237,21818,20200204,43055
20200201,B,수내,9321,8575,20200204,17896
20200201,B,정자,11023,11195,20200204,22218
20200201,B,미금,11508,11961,20200204,23469
20200201,B,오리,8136,6737,20200204,14873
20200201,B,이매,4342,4337,20200204,8679
20200201,B,보정,1678,1468,20200204,3146
20200201,B,죽전,10183,11497,20200204,21680
20200201,B,구성,3055,3063,20200204,6118
20200201,B,신갈,2745,2682,20200204,5427
20200201,B,기흥,6619,6437,20200204,13056
20200201,B,상갈,3734,3652,20200204,7386
20200201,B,청명,2593,2515,20200204,5108
20200201,B,영통,6969,6857,20200204,13826
20200201,B,망포,8591,7666,20200204,16257
20200201,B,매탄권선,3063,2804,20200204,5867
20200201,B,수원시청,10120,12218,20200204,22338
20200201,B,매교,1603,1680,20200204,3283
20200202,B,선릉,2535,4219,20200205,6754
20200202,B,한티,8586,8078,20200205,16664
20200202,B,도곡,2502,2537,20200205,5039
20200202,B,구룡,560,673,20200205,1233
20200202,B,개포동,2260,2290,20200205,4550
20200202,B,대모산입구,1437,1425,20200205,2862
20200202,B,수서,8213,7702,20200205,15915
20200202,B,수원,4543,3031,20200205,7574
20200202,B,서울숲,3586,3777,20200205,7363
20200202,B,압구정로데오,7767,8458,20200205,16225
20200202,B,강남구청,3179,3767,20200205,6946
20200202,B,선정릉,2295,2431,20200205,4726
20200202,B,가천대,3246,4034,20200205,7280
20200202,B,태평,7967,7489,20200205,15456
20200202,B,모란,11580,11876,20200205,23456
20200202,B,야탑,14784,15079,20200205,29863
20200202,B,서현,16277,16019,20200205,32296
20200202,B,수내,6299,6102,20200205,12401
20200202,B,정자,7137,7530,20200205,14667
20200202,B,미금,8375,8849,20200205,17224
20200202,B,오리,5966,5163,20200205,11129
20200202,B,이매,3862,3947,20200205,7809
20200202,B,보정,1089,1036,20200205,2125
20200202,B,죽전,7924,9080,20200205,17004
20200202,B,구성,2180,2397,20200205,4577
20200202,B,신갈,1930,1968,20200205,3898
20200202,B,기흥,4744,4809,20200205,9553
20200202,B,상갈,2859,2873,20200205,5732
20200202,B,청명,1809,1803,20200205,3612
20200202,B,영통,4787,4713,20200205,9500
20200202,B,망포,5409,5750,20200205,11159
20200202,B,매탄권선,2047,2096,20200205,4143
20200202,B,수원시청,6869,6896,20200205,13765
20200202,B,매교,1205,1312,20200205,2517
20200203,B,선릉,14173,22705,20200206,36878
20200203,B,한티,14376,15519,20200206,29895
20200203,B,도곡,6795,7020,20200206,13815
20200203,B,구룡,1741,1726,20200206,3467
20200203,B,개포동,3785,3950,20200206,7735
20200203,B,대모산입구,3660,3307,20200206,6967
20200203,B,수서,14216,14832,20200206,29048
20200203,B,수원,7312,4987,20200206,12299
20200203,B,서울숲,8455,8463,20200206,16918
20200203,B,압구정로데오,15887,17724,20200206,33611
20200203,B,강남구청,10274,11811,20200206,22085
20200203,B,선정릉,9095,9616,20200206,18711
20200203,B,가천대,6489,7533,20200206,14022
20200203,B,태평,13975,13857,20200206,27832
20200203,B,모란,20805,20947,20200206,41752
20200203,B,야탑,27806,29281,20200206,57087
20200203,B,서현,28580,28833,20200206,57413
20200203,B,수내,13926,13880,20200206,27806
20200203,B,정자,17728,19024,20200206,36752
20200203,B,미금,17517,18635,20200206,36152
20200203,B,오리,12595,10680,20200206,23275
20200203,B,이매,5845,5476,20200206,11321
20200203,B,보정,2613,2347,20200206,4960
20200203,B,죽전,13846,15075,20200206,28921
20200203,B,구성,5034,5061,20200206,10095
20200203,B,신갈,4894,4693,20200206,9587
20200203,B,기흥,9867,9309,20200206,19176
20200203,B,상갈,5468,5149,20200206,10617
20200203,B,청명,4009,3727,20200206,7736
20200203,B,영통,8407,8522,20200206,16929
20200203,B,망포,13314,12782,20200206,26096
20200203,B,매탄권선,4179,4015,20200206,8194
20200203,B,수원시청,10767,11603,20200206,22370
20200203,B,매교,2291,2281,20200206,4572
20200204,B,선릉,14304,22741,20200207,37045
20200204,B,한티,14693,15864,20200207,30557
20200204,B,도곡,7103,7295,20200207,14398
20200204,B,구룡,1718,1703,20200207,3421
20200204,B,개포동,3881,4109,20200207,7990
20200204,B,대모산입구,3620,3476,20200207,7096
20200204,B,수서,14573,14764,20200207,29337
20200204,B,복정,1,0,20200207,1
20200204,B,수원,7471,5268,20200207,12739
20200204,B,서울숲,8958,9046,20200207,18004
20200204,B,압구정로데오,17362,19116,20200207,36478
20200204,B,강남구청,10733,12291,20200207,23024
20200204,B,선정릉,9123,9519,20200207,18642
20200204,B,가천대,6612,7710,20200207,14322
20200204,B,태평,14452,14205,20200207,28657
20200204,B,모란,24878,25417,20200207,50295
20200204,B,야탑,28243,29559,20200207,57802
20200204,B,서현,28424,28715,20200207,57139
20200204,B,수내,14657,14547,20200207,29204
20200204,B,정자,18314,19590,20200207,37904
20200204,B,미금,17599,18847,20200207,36446
20200204,B,오리,12787,10889,20200207,23676
20200204,B,이매,5790,5590,20200207,11380
20200204,B,보정,2628,2228,20200207,4856
20200204,B,죽전,13856,15322,20200207,29178
20200204,B,구성,5112,5165,20200207,10277
20200204,B,신갈,4935,4871,20200207,9806
20200204,B,기흥,9939,9526,20200207,19465
20200204,B,상갈,5642,5306,20200207,10948
20200204,B,청명,4176,3913,20200207,8089
20200204,B,영통,8264,8410,20200207,16674
20200204,B,망포,13434,12797,20200207,26231
20200204,B,매탄권선,4262,4138,20200207,8400
20200204,B,수원시청,10972,11909,20200207,22881
20200204,B,매교,2136,2167,20200207,4303
20200205,B,선릉,13964,22417,20200208,36381
20200205,B,한티,14362,15681,20200208,30043
20200205,B,도곡,6720,6998,20200208,13718
20200205,B,구룡,1683,1668,20200208,3351
20200205,B,개포동,3924,4197,20200208,8121
20200205,B,대모산입구,3534,3294,20200208,6828
20200205,B,수서,14079,14329,20200208,28408
20200205,B,복정,1,0,20200208,1
20200205,B,수원,7384,5175,20200208,12559
20200205,B,서울숲,8784,8910,20200208,17694
20200205,B,압구정로데오,16641,18657,20200208,35298
20200205,B,강남구청,10563,12152,20200208,22715
20200205,B,선정릉,9049,9606,20200208,18655
20200205,B,가천대,6462,7510,20200208,13972
20200205,B,태평,13801,13504,20200208,27305
20200205,B,모란,20457,20125,20200208,40582
20200205,B,야탑,28367,29885,20200208,58252
20200205,B,서현,27671,27994,20200208,55665
20200205,B,수내,14054,14087,20200208,28141
20200205,B,정자,18117,19189,20200208,37306
20200205,B,미금,17122,18216,20200208,35338
20200205,B,오리,12355,10392,20200208,22747
20200205,B,이매,5496,5357,20200208,10853
20200205,B,보정,2448,2062,20200208,4510
20200205,B,죽전,13410,15008,20200208,28418
20200205,B,구성,4877,5003,20200208,9880
20200205,B,신갈,4728,4596,20200208,9324
20200205,B,기흥,9874,9208,20200208,19082
20200205,B,상갈,5625,5100,20200208,10725
20200205,B,청명,4095,3818,20200208,7913
20200205,B,영통,8039,8146,20200208,16185
20200205,B,망포,13560,12853,20200208,26413
20200205,B,매탄권선,4206,3968,20200208,8174
20200205,B,수원시청,10696,11872,20200208,22568
20200205,B,매교,2053,2032,20200208,4085
20200206,B,선릉,13735,22333,20200209,36068
20200206,B,한티,14220,15309,20200209,29529
20200206,B,도곡,6797,6997,20200209,13794
20200206,B,구룡,1636,1605,20200209,3241
20200206,B,개포동,3723,4003,20200209,7726
20200206,B,대모산입구,3407,3151,20200209,6558
20200206,B,수서,14320,14252,20200209,28572
20200206,B,복정,2,0,20200209,2
20200206,B,수원,7330,5163,20200209,12493
20200206,B,서울숲,8713,8806,20200209,17519
20200206,B,압구정로데오,16981,19024,20200209,36005
20200206,B,강남구청,10141,11832,20200209,21973
20200206,B,선정릉,8692,9326,20200209,18018
20200206,B,가천대,6389,7432,20200209,13821
20200206,B,태평,13599,13317,20200209,26916
20200206,B,모란,20270,20358,20200209,40628
20200206,B,야탑,27597,28970,20200209,56567
20200206,B,서현,27456,27956,20200209,55412
20200206,B,수내,13854,13924,20200209,27778
20200206,B,정자,17596,19048,20200209,36644
20200206,B,미금,16710,17648,20200209,34358
20200206,B,오리,12416,10715,20200209,23131
20200206,B,이매,5507,5234,20200209,10741
20200206,B,보정,2438,2002,20200209,4440
20200206,B,죽전,13139,14493,20200209,27632
20200206,B,구성,4768,4803,20200209,9571
20200206,B,신갈,4726,4570,20200209,9296
20200206,B,기흥,9627,9170,20200209,18797
20200206,B,상갈,5329,5004,20200209,10333
20200206,B,청명,3905,3643,20200209,7548
20200206,B,영통,8148,8256,20200209,16404
20200206,B,망포,13091,12340,20200209,25431
20200206,B,매탄권선,4123,4003,20200209,8126
20200206,B,수원시청,10616,11759,20200209,22375
20200206,B,매교,1993,1996,20200209,3989
20200207,B,선릉,13750,22186,20200210,35936
20200207,B,한티,15032,16075,20200210,31107
20200207,B,도곡,7099,7300,20200210,14399
20200207,B,구룡,1860,1712,20200210,3572
20200207,B,개포동,3774,4115,20200210,7889
20200207,B,대모산입구,3566,3217,20200210,6783
20200207,B,수서,15837,16316,20200210,32153
20200207,B,수원,8204,5580,20200210,13784
20200207,B,서울숲,9049,9174,20200210,18223
20200207,B,압구정로데오,18133,20991,20200210,39124
20200207,B,강남구청,10635,11967,20200210,22602
20200207,B,선정릉,8777,9456,20200210,18233
20200207,B,가천대,6522,7309,20200210,13831
20200207,B,태평,14369,14045,20200210,28414
20200207,B,모란,21991,22444,20200210,44435
20200207,B,야탑,29296,31170,20200210,60466
20200207,B,서현,30267,30786,20200210,61053
20200207,B,수내,14125,13938,20200210,28063
20200207,B,정자,18680,20001,20200210,38681
20200207,B,미금,17563,18824,20200210,36387
20200207,B,오리,12936,10758,20200210,23694
20200207,B,이매,5738,5547,20200210,11285
20200207,B,보정,2688,2210,20200210,4898
20200207,B,죽전,14884,15797,20200210,30681
20200207,B,구성,4950,5048,20200210,9998
20200207,B,신갈,4995,4732,20200210,9727
20200207,B,기흥,10311,9711,20200210,20022
20200207,B,상갈,5752,5227,20200210,10979
20200207,B,청명,4338,3969,20200210,8307
20200207,B,영통,9013,9237,20200210,18250
20200207,B,망포,14518,13171,20200210,27689
20200207,B,매탄권선,4542,4274,20200210,8816
20200207,B,수원시청,11595,14053,20200210,25648
20200207,B,매교,2149,2095,20200210,4244
20200208,B,선릉,5030,8725,20200211,13755
20200208,B,한티,11937,11394,20200211,23331
20200208,B,도곡,4143,3717,20200211,7860
20200208,B,구룡,1144,1013,20200211,2157
20200208,B,개포동,2394,2455,20200211,4849
20200208,B,대모산입구,2349,2193,20200211,4542
20200208,B,수서,9478,9762,20200211,19240
20200208,B,수원,6013,4050,20200211,10063
20200208,B,서울숲,5774,5989,20200211,11763
20200208,B,압구정로데오,14334,16444,20200211,30778
20200208,B,강남구청,5087,6385,20200211,11472
20200208,B,선정릉,3664,3798,20200211,7462
20200208,B,가천대,5059,5565,20200211,10624
20200208,B,태평,10359,9949,20200211,20308
20200208,B,모란,15713,16067,20200211,31780
20200208,B,야탑,18429,19816,20200211,38245
20200208,B,서현,19975,20307,20200211,40282
20200208,B,수내,7735,7247,20200211,14982
20200208,B,정자,10188,10447,20200211,20635
20200208,B,미금,11263,11643,20200211,22906
20200208,B,오리,7948,6501,20200211,14449
20200208,B,이매,3843,3626,20200211,7469
20200208,B,보정,1549,1431,20200211,2980
20200208,B,죽전,9711,11096,20200211,20807
20200208,B,구성,2930,2847,20200211,5777
20200208,B,신갈,2765,2811,20200211,5576
20200208,B,기흥,6513,6107,20200211,12620
20200208,B,상갈,3583,3515,20200211,7098
20200208,B,청명,2554,2501,20200211,5055
20200208,B,영통,6613,6536,20200211,13149
20200208,B,망포,8234,7329,20200211,15563
20200208,B,매탄권선,2950,2701,20200211,5651
20200208,B,수원시청,9261,11505,20200211,20766
20200208,B,매교,1506,1591,20200211,3097
20200209,B,선릉,2537,4200,20200212,6737
20200209,B,한티,8734,8287,20200212,17021
20200209,B,도곡,2208,2126,20200212,4334
20200209,B,구룡,596,654,20200212,1250
20200209,B,개포동,2150,2020,20200212,4170
20200209,B,대모산입구,1728,1660,20200212,3388
20200209,B,수서,8043,7826,20200212,15869
20200209,B,수원,4642,3030,20200212,7672
20200209,B,서울숲,3726,3799,20200212,7525
20200209,B,압구정로데오,8555,9526,20200212,18081
20200209,B,강남구청,3277,3821,20200212,7098
20200209,B,선정릉,2264,2423,20200212,4687
20200209,B,가천대,3373,4187,20200212,7560
20200209,B,태평,7797,7444,20200212,15241
20200209,B,모란,15273,15925,20200212,31198
20200209,B,야탑,14428,14632,20200212,29060
20200209,B,서현,16085,15918,20200212,32003
20200209,B,수내,5560,5486,20200212,11046
20200209,B,정자,7207,7684,20200212,14891
20200209,B,미금,8057,8664,20200212,16721
20200209,B,오리,5955,5152,20200212,11107
20200209,B,이매,3878,3820,20200212,7698
20200209,B,보정,1000,947,20200212,1947
20200209,B,죽전,7424,8723,20200212,16147
20200209,B,구성,2238,2427,20200212,4665
20200209,B,신갈,2035,1999,20200212,4034
20200209,B,기흥,4735,4856,20200212,9591
20200209,B,상갈,2808,2963,20200212,5771
20200209,B,청명,2003,1952,20200212,3955
20200209,B,영통,4541,4494,20200212,9035
20200209,B,망포,5645,5866,20200212,11511
20200209,B,매탄권선,2060,1979,20200212,4039
20200209,B,수원시청,6673,6951,20200212,13624
20200209,B,매교,1032,1110,20200212,2142
20200210,B,선릉,14070,22642,20200213,36712
20200210,B,한티,13565,14573,20200213,28138
20200210,B,도곡,6984,7163,20200213,14147
20200210,B,구룡,1665,1677,20200213,3342
20200210,B,개포동,3630,3881,20200213,7511
20200210,B,대모산입구,3511,3310,20200213,6821
20200210,B,수서,14050,14248,20200213,28298
20200210,B,복정,1,0,20200213,1
20200210,B,수원,7710,5423,20200213,13133
20200210,B,서울숲,8718,8710,20200213,17428
20200210,B,압구정로데오,15903,17896,20200213,33799
20200210,B,강남구청,10261,11730,20200213,21991
20200210,B,선정릉,8543,9296,20200213,17839
20200210,B,가천대,6442,7617,20200213,14059
20200210,B,태평,13856,13564,20200213,27420
20200210,B,모란,20316,20413,20200213,40729
20200210,B,야탑,27635,29313,20200213,56948
20200210,B,서현,27164,27356,20200213,54520
20200210,B,수내,12886,12621,20200213,25507
20200210,B,정자,17625,18872,20200213,36497
20200210,B,미금,16914,18118,20200213,35032
20200210,B,오리,12549,10722,20200213,23271
20200210,B,이매,5636,5269,20200213,10905
20200210,B,보정,2493,2274,20200213,4767
20200210,B,죽전,12856,14026,20200213,26882
20200210,B,구성,4986,5068,20200213,10054
20200210,B,신갈,4986,4882,20200213,9868
20200210,B,기흥,9853,9413,20200213,19266
20200210,B,상갈,5590,5154,20200213,10744
20200210,B,청명,4090,3843,20200213,7933
20200210,B,영통,8450,8664,20200213,17114
20200210,B,망포,13737,12976,20200213,26713
20200210,B,매탄권선,4168,4063,20200213,8231
20200210,B,수원시청,11388,12287,20200213,23675
20200210,B,매교,2179,2210,20200213,4389
20200211,B,선릉,14469,23218,20200214,37687
20200211,B,한티,14980,15941,20200214,30921
20200211,B,도곡,7059,7195,20200214,14254
20200211,B,구룡,1666,1655,20200214,3321
20200211,B,개포동,3799,3927,20200214,7726
20200211,B,대모산입구,3522,3277,20200214,6799
20200211,B,수서,14120,14228,20200214,28348
20200211,B,수원,8018,5486,20200214,13504
20200211,B,서울숲,9354,9650,20200214,19004
20200211,B,압구정로데오,17332,19504,20200214,36836
20200211,B,강남구청,10631,12360,20200214,22991
20200211,B,선정릉,8745,9510,20200214,18255
20200211,B,가천대,6697,7682,20200214,14379
20200211,B,태평,14291,13985,20200214,28276
20200211,B,모란,21594,21357,20200214,42951
20200211,B,야탑,28239,29850,20200214,58089
20200211,B,서현,28828,29320,20200214,58148
20200211,B,수내,14392,14498,20200214,28890
20200211,B,정자,18262,19636,20200214,37898
20200211,B,미금,17605,18645,20200214,36250
20200211,B,오리,13046,10971,20200214,24017
20200211,B,이매,5778,5539,20200214,11317
20200211,B,보정,2619,2308,20200214,4927
20200211,B,죽전,14511,16012,20200214,30523
20200211,B,구성,5115,5071,20200214,10186
20200211,B,신갈,4957,4783,20200214,9740
20200211,B,기흥,10190,9641,20200214,19831
20200211,B,상갈,5783,5448,20200214,11231
20200211,B,청명,4306,4019,20200214,8325
20200211,B,영통,8726,8850,20200214,17576
20200211,B,망포,14171,13488,20200214,27659
20200211,B,매탄권선,4522,4204,20200214,8726
20200211,B,수원시청,11534,12727,20200214,24261
20200211,B,매교,2207,2252,20200214,4459
20200212,B,선릉,14283,22690,20200215,36973
20200212,B,한티,14830,15779,20200215,30609
20200212,B,도곡,6858,7040,20200215,13898
20200212,B,구룡,1621,1586,20200215,3207
20200212,B,개포동,3765,4042,20200215,7807
20200212,B,대모산입구,3333,3108,20200215,6441
20200212,B,수서,13924,14189,20200215,28113
20200212,B,복정,1,0,20200215,1
20200212,B,수원,7744,5402,20200215,13146
20200212,B,서울숲,9013,9156,20200215,18169
20200212,B,압구정로데오,16736,18871,20200215,35607
20200212,B,강남구청,10532,11993,20200215,22525
20200212,B,선정릉,8822,9393,20200215,18215
20200212,B,가천대,6524,7542,20200215,14066
20200212,B,태평,13788,13463,20200215,27251
20200212,B,모란,20405,20585,20200215,40990
20200212,B,야탑,28486,30084,20200215,58570
20200212,B,서현,28157,28321,20200215,56478
20200212,B,수내,13889,13876,20200215,27765
20200212,B,정자,18254,19326,20200215,37580
20200212,B,미금,17088,18199,20200215,35287
20200212,B,오리,12600,10808,20200215,23408
20200212,B,이매,5548,5283,20200215,10831
20200212,B,보정,2570,2178,20200215,4748
20200212,B,죽전,13896,15367,20200215,29263
20200212,B,구성,4862,4986,20200215,9848
20200212,B,신갈,4795,4660,20200215,9455
20200212,B,기흥,9860,9390,20200215,19250
20200212,B,상갈,5585,5222,20200215,10807
20200212,B,청명,4243,3903,20200215,8146
20200212,B,영통,8348,8576,20200215,16924
20200212,B,망포,13866,13110,20200215,26976
20200212,B,매탄권선,4392,4205,20200215,8597
20200212,B,수원시청,11210,12313,20200215,23523
20200212,B,매교,2171,2223,20200215,4394
20200213,B,선릉,14332,23266,20200216,37598
20200213,B,한티,15464,16317,20200216,31781
20200213,B,도곡,6927,7114,20200216,14041
20200213,B,구룡,1766,1687,20200216,3453
20200213,B,개포동,3802,3951,20200216,7753
20200213,B,대모산입구,3450,3257,20200216,6707
20200213,B,수서,14597,14618,20200216,29215
20200213,B,복정,1,0,20200216,1
20200213,B,수원,8174,5776,20200216,13950
20200213,B,서울숲,9271,9381,20200216,18652
20200213,B,압구정로데오,17639,20266,20200216,37905
20200213,B,강남구청,10607,12310,20200216,22917
20200213,B,선정릉,8930,9584,20200216,18514
20200213,B,가천대,6642,7691,20200216,14333
20200213,B,태평,14595,14225,20200216,28820
20200213,B,모란,21699,21645,20200216,43344
20200213,B,야탑,29569,30952,20200216,60521
20200213,B,서현,29434,29935,20200216,59369
20200213,B,수내,14493,14535,20200216,29028
20200213,B,정자,18863,20066,20200216,38929
20200213,B,미금,17603,18699,20200216,36302
20200213,B,오리,13169,11243,20200216,24412
20200213,B,이매,5905,5721,20200216,11626
20200213,B,보정,2658,2198,20200216,4856
20200213,B,죽전,14961,16384,20200216,31345
20200213,B,구성,5211,5106,20200216,10317
20200213,B,신갈,5013,4739,20200216,9752
20200213,B,기흥,10306,9742,20200216,20048
20200213,B,상갈,5849,5420,20200216,11269
20200213,B,청명,4439,4139,20200216,8578
20200213,B,영통,8827,9036,20200216,17863
20200213,B,망포,14385,13599,20200216,27984
20200213,B,매탄권선,4559,4295,20200216,8854
20200213,B,수원시청,11962,13312,20200216,25274
20200213,B,매교,2242,2128,20200216,4370
20200214,B,선릉,14270,23208,20200217,37478
20200214,B,한티,16187,17107,20200217,33294
20200214,B,도곡,7317,7263,20200217,14580
20200214,B,구룡,1918,1854,20200217,3772
20200214,B,개포동,3961,4141,20200217,8102
20200214,B,대모산입구,3599,3356,20200217,6955
20200214,B,수서,16572,16960,20200217,33532
20200214,B,수원,9285,6507,20200217,15792
20200214,B,서울숲,9973,9935,20200217,19908
20200214,B,압구정로데오,19380,22791,20200217,42171
20200214,B,강남구청,11136,12740,20200217,23876
20200214,B,선정릉,8888,9622,20200217,18510
20200214,B,가천대,6867,7709,20200217,14576
20200214,B,태평,15497,14917,20200217,30414
20200214,B,모란,28489,29865,20200217,58354
20200214,B,야탑,31563,33122,20200217,64685
20200214,B,서현,32411,32941,20200217,65352
20200214,B,수내,15198,15138,20200217,30336
20200214,B,정자,19941,21356,20200217,41297
20200214,B,미금,18757,20023,20200217,38780
20200214,B,오리,13854,11678,20200217,25532
20200214,B,이매,6353,5999,20200217,12352
20200214,B,보정,2887,2323,20200217,5210
20200214,B,죽전,16467,17496,20200217,33963
20200214,B,구성,5591,5502,20200217,11093
20200214,B,신갈,5367,5067,20200217,10434
20200214,B,기흥,11026,10455,20200217,21481
20200214,B,상갈,6240,5582,20200217,11822
20200214,B,청명,4733,4302,20200217,9035
20200214,B,영통,10204,10112,20200217,20316
20200214,B,망포,16067,14480,20200217,30547
20200214,B,매탄권선,5239,4603,20200217,9842
20200214,B,수원시청,13018,16219,20200217,29237
20200214,B,매교,2409,2455,20200217,4864
20200215,B,선릉,5522,9433,20200218,14955
20200215,B,한티,12735,12227,20200218,24962
20200215,B,도곡,4844,4568,20200218,9412
20200215,B,구룡,1003,916,20200218,1919
20200215,B,개포동,2555,2611,20200218,5166
20200215,B,대모산입구,2355,2115,20200218,4470
20200215,B,수서,10761,11112,20200218,21873
20200215,B,수원,7161,4986,20200218,12147
20200215,B,서울숲,6838,6931,20200218,13769
20200215,B,압구정로데오,15454,17833,20200218,33287
20200215,B,강남구청,5685,6999,20200218,12684
20200215,B,선정릉,4246,4478,20200218,8724
20200215,B,가천대,5077,5709,20200218,10786
20200215,B,태평,11369,10764,20200218,22133
20200215,B,모란,17452,17765,20200218,35217
20200215,B,야탑,21212,22561,20200218,43773
20200215,B,서현,22188,22495,20200218,44683
20200215,B,수내,9073,8620,20200218,17693
20200215,B,정자,11425,11697,20200218,23122
20200215,B,미금,12180,12656,20200218,24836
20200215,B,오리,9327,7644,20200218,16971
20200215,B,이매,4213,4043,20200218,8256
20200215,B,보정,1761,1541,20200218,3302
20200215,B,죽전,11270,12576,20200218,23846
20200215,B,구성,3358,3376,20200218,6734
20200215,B,신갈,3074,2927,20200218,6001
20200215,B,기흥,7432,7067,20200218,14499
20200215,B,상갈,4110,4043,20200218,8153
20200215,B,청명,2964,2971,20200218,5935
20200215,B,영통,7396,7164,20200218,14560
20200215,B,망포,9582,8410,20200218,17992
20200215,B,매탄권선,3595,3270,20200218,6865
20200215,B,수원시청,10777,13242,20200218,24019
20200215,B,매교,1623,1802,20200218,3425
20200216,B,선릉,2800,4630,20200219,7430
20200216,B,한티,9232,8703,20200219,17935
20200216,B,도곡,2575,2529,20200219,5104
20200216,B,구룡,574,622,20200219,1196
20200216,B,개포동,2051,2015,20200219,4066
20200216,B,대모산입구,1568,1412,20200219,2980
20200216,B,수서,9001,8423,20200219,17424
20200216,B,수원,5059,3471,20200219,8530
20200216,B,서울숲,3814,3964,20200219,7778
20200216,B,압구정로데오,7868,8521,20200219,16389
20200216,B,강남구청,3301,3906,20200219,7207
20200216,B,선정릉,2299,2478,20200219,4777
20200216,B,가천대,3209,4048,20200219,7257
20200216,B,태평,8093,7858,20200219,15951
20200216,B,모란,11593,12223,20200219,23816
20200216,B,야탑,15763,16006,20200219,31769
20200216,B,서현,17219,16762,20200219,33981
20200216,B,수내,6294,6237,20200219,12531
20200216,B,정자,7611,7897,20200219,15508
20200216,B,미금,8857,9393,20200219,18250
20200216,B,오리,6286,5531,20200219,11817
20200216,B,이매,4134,4154,20200219,8288
20200216,B,보정,1135,1038,20200219,2173
20200216,B,죽전,8124,9574,20200219,17698
20200216,B,구성,2272,2480,20200219,4752
20200216,B,신갈,2117,2081,20200219,4198
20200216,B,기흥,5173,5217,20200219,10390
20200216,B,상갈,2939,3057,20200219,5996
20200216,B,청명,2002,1966,20200219,3968
20200216,B,영통,4979,4999,20200219,9978
20200216,B,망포,6276,6589,20200219,12865
20200216,B,매탄권선,2360,2313,20200219,4673
20200216,B,수원시청,7294,7564,20200219,14858
20200216,B,매교,1066,1100,20200219,2166
20200217,B,선릉,14593,23447,20200220,38040
20200217,B,한티,15436,16575,20200220,32011
20200217,B,도곡,7047,7242,20200220,14289
20200217,B,구룡,1467,1414,20200220,2881
20200217,B,개포동,3938,4074,20200220,8012
20200217,B,대모산입구,3751,3360,20200220,7111
20200217,B,수서,15388,15877,20200220,31265
20200217,B,수원,8260,5759,20200220,14019
20200217,B,서울숲,9058,9109,20200220,18167
20200217,B,압구정로데오,16421,18681,20200220,35102
20200217,B,강남구청,10533,12111,20200220,22644
20200217,B,선정릉,9122,9775,20200220,18897
20200217,B,가천대,6548,7838,20200220,14386
20200217,B,태평,14722,14240,20200220,28962
20200217,B,모란,21553,21586,20200220,43139
20200217,B,야탑,29748,31504,20200220,61252
20200217,B,서현,30583,30671,20200220,61254
20200217,B,수내,15318,15131,20200220,30449
20200217,B,정자,20048,21090,20200220,41138
20200217,B,미금,18688,19864,20200220,38552
20200217,B,오리,14255,11751,20200220,26006
20200217,B,이매,6478,6215,20200220,12693
20200217,B,보정,2975,2375,20200220,5350
20200217,B,죽전,15090,16334,20200220,31424
20200217,B,구성,5562,5434,20200220,10996
20200217,B,신갈,5069,4885,20200220,9954
20200217,B,기흥,10946,10315,20200220,21261
20200217,B,상갈,6081,5705,20200220,11786
20200217,B,청명,4643,4356,20200220,8999
20200217,B,영통,8995,9245,20200220,18240
20200217,B,망포,14906,14251,20200220,29157
20200217,B,매탄권선,4809,4576,20200220,9385
20200217,B,수원시청,12097,13019,20200220,25116
20200217,B,매교,2294,2274,20200220,4568
20200218,B,선릉,14556,23498,20200221,38054
20200218,B,한티,15458,16315,20200221,31773
20200218,B,도곡,6982,7013,20200221,13995
20200218,B,구룡,1404,1389,20200221,2793
20200218,B,개포동,3551,3762,20200221,7313
20200218,B,대모산입구,3490,3206,20200221,6696
20200218,B,수서,14758,14777,20200221,29535
20200218,B,수원,8292,5649,20200221,13941
20200218,B,서울숲,9259,9370,20200221,18629
20200218,B,압구정로데오,17849,19939,20200221,37788
20200218,B,강남구청,10665,12308,20200221,22973
20200218,B,선정릉,8896,9573,20200221,18469
20200218,B,가천대,6973,8220,20200221,15193
20200218,B,태평,14354,13997,20200221,28351
20200218,B,모란,21166,21300,20200221,42466
20200218,B,야탑,29114,30436,20200221,59550
20200218,B,서현,29337,29588,20200221,58925
20200218,B,수내,14679,14705,20200221,29384
20200218,B,정자,18950,20213,20200221,39163
20200218,B,미금,17928,19150,20200221,37078
20200218,B,오리,13266,11240,20200221,24506
20200218,B,이매,6036,5839,20200221,11875
20200218,B,보정,2716,2337,20200221,5053
20200218,B,죽전,14655,16129,20200221,30784
20200218,B,구성,5119,5113,20200221,10232
20200218,B,신갈,5093,4937,20200221,10030
20200218,B,기흥,10409,9901,20200221,20310
20200218,B,상갈,5832,5485,20200221,11317
20200218,B,청명,4323,4110,20200221,8433
20200218,B,영통,8975,9181,20200221,18156
20200218,B,망포,14653,13781,20200221,28434
20200218,B,매탄권선,4651,4414,20200221,9065
20200218,B,수원시청,11970,13069,20200221,25039
20200218,B,매교,2284,2350,20200221,4634
20200219,B,선릉,14628,23502,20200222,38130
20200219,B,한티,15223,16143,20200222,31366
20200219,B,도곡,6929,7101,20200222,14030
20200219,B,구룡,1451,1426,20200222,2877
20200219,B,개포동,3742,3855,20200222,7597
20200219,B,대모산입구,3612,3304,20200222,6916
20200219,B,수서,14929,15199,20200222,30128
20200219,B,수원,8404,5769,20200222,14173
20200219,B,서울숲,9231,9494,20200222,18725
20200219,B,압구정로데오,17823,19831,20200222,37654
20200219,B,강남구청,10848,12383,20200222,23231
20200219,B,선정릉,8808,9632,20200222,18440
20200219,B,가천대,6995,8050,20200222,15045
20200219,B,태평,14797,14361,20200222,29158
20200219,B,모란,26222,26866,20200222,53088
20200219,B,야탑,30250,31708,20200222,61958
20200219,B,서현,29559,29832,20200222,59391
20200219,B,수내,15095,15013,20200222,30108
20200219,B,정자,19163,20467,20200222,39630
20200219,B,미금,18165,19246,20200222,37411
20200219,B,오리,13344,11345,20200222,24689
20200219,B,이매,6205,5973,20200222,12178
20200219,B,보정,2849,2379,20200222,5228
20200219,B,죽전,14888,16302,20200222,31190
20200219,B,구성,5279,5219,20200222,10498
20200219,B,신갈,5141,5025,20200222,10166
20200219,B,기흥,10532,9934,20200222,20466
20200219,B,상갈,5977,5517,20200222,11494
20200219,B,청명,4465,4246,20200222,8711
20200219,B,영통,9208,9426,20200222,18634
20200219,B,망포,14872,14085,20200222,28957
20200219,B,매탄권선,4727,4486,20200222,9213
20200219,B,수원시청,12256,13580,20200222,25836
20200219,B,매교,2696,2661,20200222,5357
20200220,B,선릉,14164,23091,20200223,37255
20200220,B,한티,14940,15800,20200223,30740
20200220,B,도곡,6671,6808,20200223,13479
20200220,B,구룡,1407,1357,20200223,2764
20200220,B,개포동,3464,3716,20200223,7180
20200220,B,대모산입구,3503,3295,20200223,6798
20200220,B,수서,14584,14772,20200223,29356
20200220,B,복정,1,0,20200223,1
20200220,B,수원,8130,5561,20200223,13691
20200220,B,서울숲,9191,9297,20200223,18488
20200220,B,압구정로데오,17689,20137,20200223,37826
20200220,B,강남구청,10340,12110,20200223,22450
20200220,B,선정릉,8681,9454,20200223,18135
20200220,B,가천대,7237,8317,20200223,15554
20200220,B,태평,14308,14195,20200223,28503
20200220,B,모란,21090,21092,20200223,42182
20200220,B,야탑,29216,30436,20200223,59652
20200220,B,서현,28383,28788,20200223,57171
20200220,B,수내,14380,14338,20200223,28718
20200220,B,정자,18993,19998,20200223,38991
20200220,B,미금,17573,18552,20200223,36125
20200220,B,오리,13076,11113,20200223,24189
20200220,B,이매,5831,5627,20200223,11458
20200220,B,보정,2690,2248,20200223,4938
20200220,B,죽전,14963,16341,20200223,31304
20200220,B,구성,5074,5210,20200223,10284
20200220,B,신갈,4985,4807,20200223,9792
20200220,B,기흥,10181,9792,20200223,19973
20200220,B,상갈,5777,5320,20200223,11097
20200220,B,청명,4284,4055,20200223,8339
20200220,B,영통,8926,9091,20200223,18017
20200220,B,망포,14514,13685,20200223,28199
20200220,B,매탄권선,4669,4396,20200223,9065
20200220,B,수원시청,11913,13051,20200223,24964
20200220,B,매교,2571,2596,20200223,5167
20200221,B,선릉,13913,21629,20200224,35542
20200221,B,한티,14794,15716,20200224,30510
20200221,B,도곡,6558,6601,20200224,13159
20200221,B,구룡,1342,1310,20200224,2652
20200221,B,개포동,3410,3619,20200224,7029
20200221,B,대모산입구,3352,3036,20200224,6388
20200221,B,수서,14903,15279,20200224,30182
20200221,B,수원,8582,5842,20200224,14424
20200221,B,서울숲,8689,8441,20200224,17130
20200221,B,압구정로데오,18003,20725,20200224,38728
20200221,B,강남구청,10138,11595,20200224,21733
20200221,B,선정릉,8513,9099,20200224,17612
20200221,B,가천대,6441,7262,20200224,13703
20200221,B,태평,14386,13922,20200224,28308
20200221,B,모란,20845,21342,20200224,42187
20200221,B,야탑,28336,30224,20200224,58560
20200221,B,서현,28866,29119,20200224,57985
20200221,B,수내,13927,13984,20200224,27911
20200221,B,정자,18322,19898,20200224,38220
20200221,B,미금,16889,17665,20200224,34554
20200221,B,오리,12589,10673,20200224,23262
20200221,B,이매,5656,5385,20200224,11041
20200221,B,보정,2535,2110,20200224,4645
20200221,B,죽전,14599,15558,20200224,30157
20200221,B,구성,5098,4999,20200224,10097
20200221,B,신갈,4776,4601,20200224,9377
20200221,B,기흥,9926,9276,20200224,19202
20200221,B,상갈,5674,5282,20200224,10956
20200221,B,청명,4371,3988,20200224,8359
20200221,B,영통,9202,9277,20200224,18479
20200221,B,망포,14760,13328,20200224,28088
20200221,B,매탄권선,4778,4268,20200224,9046
20200221,B,수원시청,11691,14445,20200224,26136
20200221,B,매교,2204,2238,20200224,4442
20200222,B,선릉,4618,7657,20200225,12275
20200222,B,한티,10829,10400,20200225,21229
20200222,B,도곡,3845,3358,20200225,7203
20200222,B,구룡,1011,912,20200225,1923
20200222,B,개포동,1994,1940,20200225,3934
20200222,B,대모산입구,1958,1773,20200225,3731
20200222,B,수서,7919,7726,20200225,15645
20200222,B,복정,1,0,20200225,1
20200222,B,수원,5818,3936,20200225,9754
20200222,B,서울숲,4842,4925,20200225,9767
20200222,B,압구정로데오,12702,14860,20200225,27562
20200222,B,강남구청,4750,5790,20200225,10540
20200222,B,선정릉,3446,3737,20200225,7183
20200222,B,가천대,4180,4635,20200225,8815
20200222,B,태평,9610,9281,20200225,18891
20200222,B,모란,14177,14525,20200225,28702
20200222,B,야탑,16778,17826,20200225,34604
20200222,B,서현,17677,18280,20200225,35957
20200222,B,수내,7526,7052,20200225,14578
20200222,B,정자,9161,9556,20200225,18717
20200222,B,미금,9979,10209,20200225,20188
20200222,B,오리,7393,6105,20200225,13498
20200222,B,이매,3448,3254,20200225,6702
20200222,B,보정,1293,1138,20200225,2431
20200222,B,죽전,8597,9748,20200225,18345
20200222,B,구성,2626,2610,20200225,5236
20200222,B,신갈,2333,2372,20200225,4705
20200222,B,기흥,5870,5587,20200225,11457
20200222,B,상갈,3278,3127,20200225,6405
20200222,B,청명,2497,2381,20200225,4878
20200222,B,영통,6174,6006,20200225,12180
20200222,B,망포,7662,6864,20200225,14526
20200222,B,매탄권선,2589,2417,20200225,5006
20200222,B,수원시청,8823,10701,20200225,19524
20200222,B,매교,1283,1319,20200225,2602
20200223,B,선릉,2137,3488,20200226,5625
20200223,B,한티,6963,6647,20200226,13610
20200223,B,도곡,1823,1812,20200226,3635
20200223,B,구룡,498,474,20200226,972
20200223,B,개포동,1373,1342,20200226,2715
20200223,B,대모산입구,1095,1062,20200226,2157
20200223,B,수서,5863,5640,20200226,11503
20200223,B,수원,3726,2382,20200226,6108
20200223,B,서울숲,3142,3240,20200226,6382
20200223,B,압구정로데오,6743,7459,20200226,14202
20200223,B,강남구청,2582,3110,20200226,5692
20200223,B,선정릉,1925,1956,20200226,3881
20200223,B,가천대,2615,3231,20200226,5846
20200223,B,태평,6446,6006,20200226,12452
20200223,B,모란,9046,9256,20200226,18302
20200223,B,야탑,11099,11457,20200226,22556
20200223,B,서현,11382,11166,20200226,22548
20200223,B,수내,4860,4735,20200226,9595
20200223,B,정자,5789,6023,20200226,11812
20200223,B,미금,5952,6390,20200226,12342
20200223,B,오리,4599,4098,20200226,8697
20200223,B,이매,2192,2276,20200226,4468
20200223,B,보정,736,717,20200226,1453
20200223,B,죽전,5748,6627,20200226,12375
20200223,B,구성,1575,1788,20200226,3363
20200223,B,신갈,1476,1510,20200226,2986
20200223,B,기흥,3731,3724,20200226,7455
20200223,B,상갈,2150,2282,20200226,4432
20200223,B,청명,1358,1386,20200226,2744
20200223,B,영통,3552,3472,20200226,7024
20200223,B,망포,4534,4790,20200226,9324
20200223,B,매탄권선,1635,1612,20200226,3247
20200223,B,수원시청,5682,5629,20200226,11311
20200223,B,매교,838,870,20200226,1708
20200224,B,선릉,12769,19818,20200227,32587
20200224,B,한티,11417,12190,20200227,23607
20200224,B,도곡,5585,5684,20200227,11269
20200224,B,구룡,1197,1192,20200227,2389
20200224,B,개포동,2872,3025,20200227,5897
20200224,B,대모산입구,3058,2799,20200227,5857
20200224,B,수서,11168,11219,20200227,22387
20200224,B,수원,6477,4425,20200227,10902
20200224,B,서울숲,7692,7653,20200227,15345
20200224,B,압구정로데오,13866,15483,20200227,29349
20200224,B,강남구청,8607,9914,20200227,18521
20200224,B,선정릉,7751,8312,20200227,16063
20200224,B,가천대,5458,6441,20200227,11899
20200224,B,태평,12462,12257,20200227,24719
20200224,B,모란,19289,19388,20200227,38677
20200224,B,야탑,22772,24036,20200227,46808
20200224,B,서현,22238,22407,20200227,44645
20200224,B,수내,10770,10888,20200227,21658
20200224,B,정자,14745,15804,20200227,30549
20200224,B,미금,13257,14163,20200227,27420
20200224,B,오리,10263,8837,20200227,19100
20200224,B,이매,4463,4309,20200227,8772
20200224,B,보정,1880,1635,20200227,3515
20200224,B,죽전,10454,11232,20200227,21686
20200224,B,구성,4019,4021,20200227,8040
20200224,B,신갈,3792,3692,20200227,7484
20200224,B,기흥,7807,7484,20200227,15291
20200224,B,상갈,4349,4084,20200227,8433
20200224,B,청명,3356,3118,20200227,6474
20200224,B,영통,6474,6592,20200227,13066
20200224,B,망포,11403,10846,20200227,22249
20200224,B,매탄권선,3677,3407,20200227,7084
20200224,B,수원시청,9225,10131,20200227,19356
20200224,B,매교,1893,1869,20200227,3762
20200225,B,선릉,11779,18592,20200228,30371
20200225,B,한티,10067,10813,20200228,20880
20200225,B,도곡,4854,5042,20200228,9896
20200225,B,구룡,1033,1024,20200228,2057
20200225,B,개포동,2539,2720,20200228,5259
20200225,B,대모산입구,2637,2407,20200228,5044
20200225,B,수서,9559,9706,20200228,19265
20200225,B,복정,1,0,20200228,1
20200225,B,수원,5752,3948,20200228,9700
20200225,B,서울숲,7163,7255,20200228,14418
20200225,B,압구정로데오,13976,15718,20200228,29694
20200225,B,강남구청,8108,9392,20200228,17500
20200225,B,선정릉,7314,7976,20200228,15290
20200225,B,가천대,5027,5908,20200228,10935
20200225,B,태평,11185,11003,20200228,22188
20200225,B,모란,15882,15967,20200228,31849
20200225,B,야탑,19164,20019,20200228,39183
20200225,B,서현,19429,19855,20200228,39284
20200225,B,수내,9931,10071,20200228,20002
20200225,B,정자,13530,14427,20200228,27957
20200225,B,미금,11755,12751,20200228,24506
20200225,B,오리,9412,8003,20200228,17415
20200225,B,이매,3918,3826,20200228,7744
20200225,B,보정,1765,1500,20200228,3265
20200225,B,죽전,9515,10268,20200228,19783
20200225,B,구성,3575,3508,20200228,7083
20200225,B,신갈,3364,3303,20200228,6667
20200225,B,기흥,7145,6749,20200228,13894
20200225,B,상갈,3963,3678,20200228,7641
20200225,B,청명,3118,2861,20200228,5979
20200225,B,영통,5728,5888,20200228,11616
20200225,B,망포,10506,10110,20200228,20616
20200225,B,매탄권선,3307,3078,20200228,6385
20200225,B,수원시청,8453,9092,20200228,17545
20200225,B,매교,1651,1639,20200228,3290
20200226,B,선릉,11530,17888,20200229,29418
20200226,B,한티,9822,10293,20200229,20115
20200226,B,도곡,4871,5006,20200229,9877
20200226,B,구룡,1044,1057,20200229,2101
20200226,B,개포동,2467,2638,20200229,5105
20200226,B,대모산입구,2744,2564,20200229,5308
20200226,B,수서,9401,9587,20200229,18988
20200226,B,수원,5939,4038,20200229,9977
20200226,B,서울숲,7355,7378,20200229,14733
20200226,B,압구정로데오,13647,15123,20200229,28770
20200226,B,강남구청,7999,9224,20200229,17223
20200226,B,선정릉,7016,7574,20200229,14590
20200226,B,가천대,4928,5857,20200229,10785
20200226,B,태평,11291,11107,20200229,22398
20200226,B,모란,16083,16164,20200229,32247
20200226,B,야탑,18679,19380,20200229,38059
20200226,B,서현,19076,19289,20200229,38365
20200226,B,수내,9661,9688,20200229,19349
20200226,B,정자,12139,13169,20200229,25308
20200226,B,미금,11854,12600,20200229,24454
20200226,B,오리,9283,7933,20200229,17216
20200226,B,이매,3687,3531,20200229,7218
20200226,B,보정,1733,1480,20200229,3213
20200226,B,죽전,9264,9940,20200229,19204
20200226,B,구성,3564,3618,20200229,7182
20200226,B,신갈,3321,3274,20200229,6595
20200226,B,기흥,7136,6834,20200229,13970
20200226,B,상갈,3976,3687,20200229,7663
20200226,B,청명,3023,2852,20200229,5875
20200226,B,영통,5693,5901,20200229,11594
20200226,B,망포,10454,10011,20200229,20465
20200226,B,매탄권선,3337,3090,20200229,6427
20200226,B,수원시청,8564,9374,20200229,17938
20200226,B,매교,1673,1720,20200229,3393
20200227,B,선릉,11248,17216,20200301,28464
20200227,B,한티,9270,9930,20200301,19200
20200227,B,도곡,4711,4729,20200301,9440
20200227,B,구룡,1024,978,20200301,2002
20200227,B,개포동,2383,2558,20200301,4941
20200227,B,대모산입구,2647,2410,20200301,5057
20200227,B,수서,8986,9302,20200301,18288
20200227,B,복정,1,0,20200301,1
20200227,B,수원,5599,3742,20200301,9341
20200227,B,서울숲,7121,7258,20200301,14379
20200227,B,압구정로데오,13078,14791,20200301,27869
20200227,B,강남구청,7409,8574,20200301,15983
20200227,B,선정릉,6713,7387,20200301,14100
20200227,B,가천대,4766,5589,20200301,10355
20200227,B,태평,11044,10757,20200301,21801
20200227,B,모란,15671,15701,20200301,31372
20200227,B,야탑,18333,19047,20200301,37380
20200227,B,서현,18337,18748,20200301,37085
20200227,B,수내,9207,9302,20200301,18509
20200227,B,정자,11672,12536,20200301,24208
20200227,B,미금,10649,11556,20200301,22205
20200227,B,오리,8582,7244,20200301,15826
20200227,B,이매,3591,3532,20200301,7123
20200227,B,보정,1545,1327,20200301,2872
20200227,B,죽전,8977,9358,20200301,18335
20200227,B,구성,3290,3366,20200301,6656
20200227,B,신갈,3081,3001,20200301,6082
20200227,B,기흥,6608,6238,20200301,12846
20200227,B,상갈,3745,3502,20200301,7247
20200227,B,청명,2803,2599,20200301,5402
20200227,B,영통,5516,5554,20200301,11070
20200227,B,망포,9930,9510,20200301,19440
20200227,B,매탄권선,3126,3001,20200301,6127
20200227,B,수원시청,8156,8905,20200301,17061
20200227,B,매교,1632,1647,20200301,3279
20200228,B,선릉,10563,16317,20200302,26880
20200228,B,한티,9286,9777,20200302,19063
20200228,B,도곡,4654,4777,20200302,9431
20200228,B,구룡,907,929,20200302,1836
20200228,B,개포동,2240,2411,20200302,4651
20200228,B,대모산입구,2428,2289,20200302,4717
20200228,B,수서,9299,9677,20200302,18976
20200228,B,수원,5502,3868,20200302,9370
20200228,B,서울숲,6606,6746,20200302,13352
20200228,B,압구정로데오,12827,14630,20200302,27457
20200228,B,강남구청,7413,8510,20200302,15923
20200228,B,선정릉,6529,6953,20200302,13482
20200228,B,가천대,4690,5297,20200302,9987
20200228,B,태평,10735,10436,20200302,21171
20200228,B,모란,15055,14974,20200302,30029
20200228,B,야탑,18198,18834,20200302,37032
20200228,B,서현,18029,18608,20200302,36637
20200228,B,수내,8978,9003,20200302,17981
20200228,B,정자,10869,11704,20200302,22573
20200228,B,미금,10483,11136,20200302,21619
20200228,B,오리,8480,7239,20200302,15719
20200228,B,이매,3428,3368,20200302,6796
20200228,B,보정,1483,1238,20200302,2721
20200228,B,죽전,8703,9074,20200302,17777
20200228,B,구성,3066,3080,20200302,6146
20200228,B,신갈,2940,2875,20200302,5815
20200228,B,기흥,6427,5983,20200302,12410
20200228,B,상갈,3533,3182,20200302,6715
20200228,B,청명,2776,2564,20200302,5340
20200228,B,영통,5490,5629,20200302,11119
20200228,B,망포,10234,9093,20200302,19327
20200228,B,매탄권선,3199,2919,20200302,6118
20200228,B,수원시청,7973,9547,20200302,17520
20200228,B,매교,1505,1559,20200302,3064
20200229,B,선릉,2769,4615,20200303,7384
20200229,B,한티,5528,5600,20200303,11128
20200229,B,도곡,2254,2133,20200303,4387
20200229,B,구룡,604,564,20200303,1168
20200229,B,개포동,1259,1190,20200303,2449
20200229,B,대모산입구,1377,1304,20200303,2681
20200229,B,수서,4530,4610,20200303,9140
20200229,B,복정,1,0,20200303,1
20200229,B,수원,3582,2380,20200303,5962
20200229,B,서울숲,3577,3662,20200303,7239
20200229,B,압구정로데오,8702,10241,20200303,18943
20200229,B,강남구청,2991,3522,20200303,6513
20200229,B,선정릉,2157,2295,20200303,4452
20200229,B,가천대,2708,2960,20200303,5668
20200229,B,태평,7116,6845,20200303,13961
20200229,B,모란,11248,11616,20200303,22864
20200229,B,야탑,9455,9919,20200303,19374
20200229,B,서현,11020,11211,20200303,22231
20200229,B,수내,4726,4574,20200303,9300
20200229,B,정자,5684,5911,20200303,11595
20200229,B,미금,6202,6375,20200303,12577
20200229,B,오리,4533,3775,20200303,8308
20200229,B,이매,1982,1966,20200303,3948
20200229,B,보정,775,673,20200303,1448
20200229,B,죽전,5255,5872,20200303,11127
20200229,B,구성,1535,1598,20200303,3133
20200229,B,신갈,1406,1427,20200303,2833
20200229,B,기흥,3514,3305,20200303,6819
20200229,B,상갈,1988,1890,20200303,3878
20200229,B,청명,1244,1181,20200303,2425
20200229,B,영통,3566,3523,20200303,7089
20200229,B,망포,4784,4393,20200303,9177
20200229,B,매탄권선,1720,1504,20200303,3224
20200229,B,수원시청,5348,6377,20200303,11725
20200229,B,매교,934,982,20200303,1916
20200301,B,선릉,1309,2141,20200304,3450
20200301,B,한티,3657,3772,20200304,7429
20200301,B,도곡,1256,1222,20200304,2478
20200301,B,구룡,320,331,20200304,651
20200301,B,개포동,826,792,20200304,1618
20200301,B,대모산입구,665,649,20200304,1314
20200301,B,수서,3330,3374,20200304,6704
20200301,B,복정,1,0,20200304,1
20200301,B,수원,2429,1630,20200304,4059
20200301,B,서울숲,2140,2179,20200304,4319
20200301,B,압구정로데오,4739,5229,20200304,9968
20200301,B,강남구청,1574,1933,20200304,3507
20200301,B,선정릉,1176,1263,20200304,2439
20200301,B,가천대,1818,2191,20200304,4009
20200301,B,태평,4664,4321,20200304,8985
20200301,B,모란,6205,6263,20200304,12468
20200301,B,야탑,6594,6976,20200304,13570
20200301,B,서현,7445,7272,20200304,14717
20200301,B,수내,2985,3002,20200304,5987
20200301,B,정자,3723,3839,20200304,7562
20200301,B,미금,3787,3919,20200304,7706
20200301,B,오리,3133,2801,20200304,5934
20200301,B,이매,1235,1250,20200304,2485
20200301,B,보정,475,450,20200304,925
20200301,B,죽전,3874,4315,20200304,8189
20200301,B,구성,958,1090,20200304,2048
20200301,B,신갈,865,874,20200304,1739
20200301,B,기흥,2327,2402,20200304,4729
20200301,B,상갈,1327,1345,20200304,2672
20200301,B,청명,853,835,20200304,1688
20200301,B,영통,2146,2134,20200304,4280
20200301,B,망포,2881,3076,20200304,5957
20200301,B,매탄권선,1154,1084,20200304,2238
20200301,B,수원시청,3542,3558,20200304,7100
20200301,B,매교,561,587,20200304,1148
20200302,B,선릉,10518,16417,20200305,26935
20200302,B,한티,8268,8960,20200305,17228
20200302,B,도곡,4580,4814,20200305,9394
20200302,B,구룡,979,974,20200305,1953
20200302,B,개포동,2309,2479,20200305,4788
20200302,B,대모산입구,2528,2294,20200305,4822
20200302,B,수서,8772,9026,20200305,17798
20200302,B,수원,5296,3659,20200305,8955
20200302,B,서울숲,6783,6819,20200305,13602
20200302,B,압구정로데오,11805,13068,20200305,24873
20200302,B,강남구청,6993,8083,20200305,15076
20200302,B,선정릉,6524,6955,20200305,13479
20200302,B,가천대,4675,5515,20200305,10190
20200302,B,태평,10698,10516,20200305,21214
20200302,B,모란,15405,15454,20200305,30859
20200302,B,야탑,18145,19089,20200305,37234
20200302,B,서현,18488,18358,20200305,36846
20200302,B,수내,8418,8305,20200305,16723
20200302,B,정자,11115,12091,20200305,23206
20200302,B,미금,10978,11824,20200305,22802
20200302,B,오리,8696,7555,20200305,16251
20200302,B,이매,3569,3478,20200305,7047
20200302,B,보정,1637,1405,20200305,3042
20200302,B,죽전,8959,9567,20200305,18526
20200302,B,구성,3271,3348,20200305,6619
20200302,B,신갈,3067,2963,20200305,6030
20200302,B,기흥,6516,6237,20200305,12753
20200302,B,상갈,3523,3299,20200305,6822
20200302,B,청명,2730,2556,20200305,5286
20200302,B,영통,5294,5418,20200305,10712
20200302,B,망포,9479,9081,20200305,18560
20200302,B,매탄권선,3089,2890,20200305,5979
20200302,B,수원시청,7682,8323,20200305,16005
20200302,B,매교,1587,1535,20200305,3122
20200303,B,선릉,10422,16188,20200306,26610
20200303,B,한티,9361,9987,20200306,19348
20200303,B,도곡,4527,4554,20200306,9081
20200303,B,구룡,952,948,20200306,1900
20200303,B,개포동,2281,2459,20200306,4740
20200303,B,대모산입구,2497,2371,20200306,4868
20200303,B,수서,8335,8677,20200306,17012
20200303,B,수원,5156,3652,20200306,8808
20200303,B,서울숲,6865,7041,20200306,13906
20200303,B,압구정로데오,12475,13862,20200306,26337
20200303,B,강남구청,7207,8212,20200306,15419
20200303,B,선정릉,6355,6874,20200306,13229
20200303,B,가천대,4662,5727,20200306,10389
20200303,B,태평,10680,10271,20200306,20951
20200303,B,모란,15215,15271,20200306,30486
20200303,B,야탑,18581,19366,20200306,37947
20200303,B,서현,18019,17518,20200306,35537
20200303,B,수내,8975,8999,20200306,17974
20200303,B,정자,11280,11894,20200306,23174
20200303,B,미금,10928,11723,20200306,22651
20200303,B,오리,8904,7475,20200306,16379
20200303,B,이매,3522,3481,20200306,7003
20200303,B,보정,1562,1357,20200306,2919
20200303,B,죽전,8851,9513,20200306,18364
20200303,B,구성,3188,3233,20200306,6421
20200303,B,신갈,3054,2918,20200306,5972
20200303,B,기흥,6503,6271,20200306,12774
20200303,B,상갈,3599,3405,20200306,7004
20200303,B,청명,2708,2627,20200306,5335
20200303,B,영통,5182,5237,20200306,10419
20200303,B,망포,9235,8834,20200306,18069
20200303,B,매탄권선,3081,2912,20200306,5993
20200303,B,수원시청,7613,8380,20200306,15993
20200303,B,매교,1531,1544,20200306,3075
20200304,B,선릉,10380,16231,20200307,26611
20200304,B,한티,9332,10020,20200307,19352
20200304,B,도곡,4553,4677,20200307,9230
20200304,B,구룡,984,986,20200307,1970
20200304,B,개포동,2324,2483,20200307,4807
20200304,B,대모산입구,2546,2402,20200307,4948
20200304,B,수서,8532,8798,20200307,17330
20200304,B,수원,5271,3676,20200307,8947
20200304,B,서울숲,6932,6931,20200307,13863
20200304,B,압구정로데오,12152,13771,20200307,25923
20200304,B,강남구청,7125,8323,20200307,15448
20200304,B,선정릉,6251,6773,20200307,13024
20200304,B,가천대,4551,5379,20200307,9930
20200304,B,태평,10742,10567,20200307,21309
20200304,B,모란,16436,16737,20200307,33173
20200304,B,야탑,18603,19562,20200307,38165
20200304,B,서현,18277,18402,20200307,36679
20200304,B,수내,9049,9140,20200307,18189
20200304,B,정자,11331,12093,20200307,23424
20200304,B,미금,11165,12044,20200307,23209
20200304,B,오리,8855,7532,20200307,16387
20200304,B,이매,3495,3402,20200307,6897
20200304,B,보정,1584,1333,20200307,2917
20200304,B,죽전,8800,9487,20200307,18287
20200304,B,구성,3191,3284,20200307,6475
20200304,B,신갈,2976,2905,20200307,5881
20200304,B,기흥,6553,6213,20200307,12766
20200304,B,상갈,3572,3379,20200307,6951
20200304,B,청명,2798,2553,20200307,5351
20200304,B,영통,5239,5390,20200307,10629
20200304,B,망포,9178,8817,20200307,17995
20200304,B,매탄권선,2963,2924,20200307,5887
20200304,B,수원시청,7771,8384,20200307,16155
20200304,B,매교,1462,1501,20200307,2963
20200305,B,선릉,10635,16259,20200308,26894
20200305,B,한티,9381,9941,20200308,19322
20200305,B,도곡,4552,4667,20200308,9219
20200305,B,구룡,955,964,20200308,1919
20200305,B,개포동,2319,2454,20200308,4773
20200305,B,대모산입구,2481,2354,20200308,4835
20200305,B,수서,8554,8907,20200308,17461
20200305,B,수원,5305,3683,20200308,8988
20200305,B,서울숲,6824,6863,20200308,13687
20200305,B,압구정로데오,12438,14027,20200308,26465
20200305,B,강남구청,7039,8272,20200308,15311
20200305,B,선정릉,6386,6812,20200308,13198
20200305,B,가천대,4538,5440,20200308,9978
20200305,B,태평,10694,10432,20200308,21126
20200305,B,모란,15332,15437,20200308,30769
20200305,B,야탑,18282,19027,20200308,37309
20200305,B,서현,18261,18470,20200308,36731
20200305,B,수내,8816,8904,20200308,17720
20200305,B,정자,11404,12072,20200308,23476
20200305,B,미금,11020,11768,20200308,22788
20200305,B,오리,8934,7730,20200308,16664
20200305,B,이매,3565,3360,20200308,6925
20200305,B,보정,1547,1341,20200308,2888
20200305,B,죽전,8966,9457,20200308,18423
20200305,B,구성,3211,3320,20200308,6531
20200305,B,신갈,2994,2932,20200308,5926
20200305,B,기흥,6620,6333,20200308,12953
20200305,B,상갈,3637,3293,20200308,6930
20200305,B,청명,2756,2637,20200308,5393
20200305,B,영통,5253,5203,20200308,10456
20200305,B,망포,9286,8837,20200308,18123
20200305,B,매탄권선,3081,2906,20200308,5987
20200305,B,수원시청,7555,8351,20200308,15906
20200305,B,매교,1524,1552,20200308,3076
20200306,B,선릉,10492,16398,20200309,26890
20200306,B,한티,9876,10461,20200309,20337
20200306,B,도곡,4699,4727,20200309,9426
20200306,B,구룡,1041,991,20200309,2032
20200306,B,개포동,2426,2535,20200309,4961
20200306,B,대모산입구,2520,2353,20200309,4873
20200306,B,수서,9818,10056,20200309,19874
20200306,B,수원,5850,3925,20200309,9775
20200306,B,서울숲,7012,6925,20200309,13937
20200306,B,압구정로데오,13394,15570,20200309,28964
20200306,B,강남구청,7373,8344,20200309,15717
20200306,B,선정릉,6373,6848,20200309,13221
20200306,B,가천대,4724,5436,20200309,10160
20200306,B,태평,10899,10557,20200309,21456
20200306,B,모란,15929,16160,20200309,32089
20200306,B,야탑,18836,19654,20200309,38490
20200306,B,서현,17555,17829,20200309,35384
20200306,B,수내,9161,9239,20200309,18400
20200306,B,정자,11815,12715,20200309,24530
20200306,B,미금,11244,12051,20200309,23295
20200306,B,오리,8995,7588,20200309,16583
20200306,B,이매,3661,3427,20200309,7088
20200306,B,보정,1626,1361,20200309,2987
20200306,B,죽전,9712,9732,20200309,19444
20200306,B,구성,3358,3384,20200309,6742
20200306,B,신갈,3107,3065,20200309,6172
20200306,B,기흥,6885,6391,20200309,13276
20200306,B,상갈,3813,3444,20200309,7257
20200306,B,청명,2907,2698,20200309,5605
20200306,B,영통,5605,5795,20200309,11400
20200306,B,망포,10107,9257,20200309,19364
20200306,B,매탄권선,3231,3056,20200309,6287
20200306,B,수원시청,8231,10022,20200309,18253
20200306,B,매교,1631,1619,20200309,3250
20200307,B,선릉,3144,5094,20200310,8238
20200307,B,한티,6258,6297,20200310,12555
20200307,B,도곡,2571,2417,20200310,4988
20200307,B,구룡,616,618,20200310,1234
20200307,B,개포동,1386,1339,20200310,2725
20200307,B,대모산입구,1444,1332,20200310,2776
20200307,B,수서,4899,5011,20200310,9910
20200307,B,수원,3868,2615,20200310,6483
20200307,B,서울숲,3828,3937,20200310,7765
20200307,B,압구정로데오,9709,11270,20200310,20979
20200307,B,강남구청,3085,3676,20200310,6761
20200307,B,선정릉,2254,2314,20200310,4568
20200307,B,가천대,2870,3183,20200310,6053
20200307,B,태평,7163,6888,20200310,14051
20200307,B,모란,10199,10473,20200310,20672
20200307,B,야탑,9990,10299,20200310,20289
20200307,B,서현,9886,10140,20200310,20026
20200307,B,수내,5059,4799,20200310,9858
20200307,B,정자,6300,6626,20200310,12926
20200307,B,미금,6757,6826,20200310,13583
20200307,B,오리,4806,4006,20200310,8812
20200307,B,이매,2000,1967,20200310,3967
20200307,B,보정,785,731,20200310,1516
20200307,B,죽전,5605,6125,20200310,11730
20200307,B,구성,1731,1888,20200310,3619
20200307,B,신갈,1464,1488,20200310,2952
20200307,B,기흥,3952,3778,20200310,7730
20200307,B,상갈,2105,2113,20200310,4218
20200307,B,청명,1440,1389,20200310,2829
20200307,B,영통,3576,3536,20200310,7112
20200307,B,망포,5153,4593,20200310,9746
20200307,B,매탄권선,1923,1720,20200310,3643
20200307,B,수원시청,5883,7033,20200310,12916
20200307,B,매교,860,941,20200310,1801
20200308,B,선릉,1614,2490,20200311,4104
20200308,B,한티,4112,4143,20200311,8255
20200308,B,도곡,1287,1356,20200311,2643
20200308,B,구룡,360,387,20200311,747
20200308,B,개포동,972,937,20200311,1909
20200308,B,대모산입구,844,776,20200311,1620
20200308,B,수서,3967,4026,20200311,7993
20200308,B,수원,2738,1704,20200311,4442
20200308,B,서울숲,3087,3149,20200311,6236
20200308,B,압구정로데오,5524,6163,20200311,11687
20200308,B,강남구청,1777,2006,20200311,3783
20200308,B,선정릉,1244,1395,20200311,2639
20200308,B,가천대,1943,2316,20200311,4259
20200308,B,태평,4923,4654,20200311,9577
20200308,B,모란,6855,6902,20200311,13757
20200308,B,야탑,6971,7251,20200311,14222
20200308,B,서현,6867,6801,20200311,13668
20200308,B,수내,3376,3326,20200311,6702
20200308,B,정자,4254,4389,20200311,8643
20200308,B,미금,4109,4331,20200311,8440
20200308,B,오리,3231,2846,20200311,6077
20200308,B,이매,1350,1357,20200311,2707
20200308,B,보정,511,512,20200311,1023
20200308,B,죽전,4106,4586,20200311,8692
20200308,B,구성,1177,1277,20200311,2454
20200308,B,신갈,1040,1031,20200311,2071
20200308,B,기흥,2730,2667,20200311,5397
20200308,B,상갈,1587,1569,20200311,3156
20200308,B,청명,955,935,20200311,1890
20200308,B,영통,2366,2337,20200311,4703
20200308,B,망포,3335,3501,20200311,6836
20200308,B,매탄권선,1271,1185,20200311,2456
20200308,B,수원시청,3782,3935,20200311,7717
20200308,B,매교,593,604,20200311,1197
20200309,B,선릉,11336,17723,20200312,29059
20200309,B,한티,9436,10012,20200312,19448
20200309,B,도곡,4971,5079,20200312,10050
20200309,B,구룡,992,991,20200312,1983
20200309,B,개포동,2453,2615,20200312,5068
20200309,B,대모산입구,2695,2521,20200312,5216
20200309,B,수서,9558,9766,20200312,19324
20200309,B,수원,5807,3933,20200312,9740
20200309,B,서울숲,7044,7301,20200312,14345
20200309,B,압구정로데오,12066,13521,20200312,25587
20200309,B,강남구청,7416,8562,20200312,15978
20200309,B,선정릉,6792,7371,20200312,14163
20200309,B,가천대,4999,5810,20200312,10809
20200309,B,태평,10974,10746,20200312,21720
20200309,B,모란,17511,17860,20200312,35371
20200309,B,야탑,18987,20011,20200312,38998
20200309,B,서현,17393,17375,20200312,34768
20200309,B,수내,9300,9318,20200312,18618
20200309,B,정자,11709,12587,20200312,24296
20200309,B,미금,11430,12299,20200312,23729
20200309,B,오리,9136,7784,20200312,16920
20200309,B,이매,3714,3532,20200312,7246
20200309,B,보정,1741,1452,20200312,3193
20200309,B,죽전,9450,10197,20200312,19647
20200309,B,구성,3480,3623,20200312,7103
20200309,B,신갈,3256,3182,20200312,6438
20200309,B,기흥,6988,6665,20200312,13653
20200309,B,상갈,3867,3608,20200312,7475
20200309,B,청명,2945,2741,20200312,5686
20200309,B,영통,5516,5744,20200312,11260
20200309,B,망포,9932,9542,20200312,19474
20200309,B,매탄권선,3307,3056,20200312,6363
20200309,B,수원시청,8086,8763,20200312,16849
20200309,B,매교,1764,1734,20200312,3498
20200310,B,선릉,11138,17210,20200313,28348
20200310,B,한티,9366,9999,20200313,19365
20200310,B,도곡,4631,4763,20200313,9394
20200310,B,구룡,936,955,20200313,1891
20200310,B,개포동,2341,2498,20200313,4839
20200310,B,대모산입구,2511,2308,20200313,4819
20200310,B,수서,8948,9104,20200313,18052
20200310,B,복정,1,0,20200313,1
20200310,B,수원,5450,3749,20200313,9199
20200310,B,서울숲,6743,6839,20200313,13582
20200310,B,압구정로데오,12704,14208,20200313,26912
20200310,B,강남구청,7465,8629,20200313,16094
20200310,B,선정릉,6914,7320,20200313,14234
20200310,B,가천대,4604,5552,20200313,10156
20200310,B,태평,10562,10277,20200313,20839
20200310,B,모란,14943,14894,20200313,29837
20200310,B,야탑,18468,19269,20200313,37737
20200310,B,서현,16801,16847,20200313,33648
20200310,B,수내,9035,9200,20200313,18235
20200310,B,정자,11482,12297,20200313,23779
20200310,B,미금,10818,11609,20200313,22427
20200310,B,오리,8849,7390,20200313,16239
20200310,B,이매,3505,3361,20200313,6866
20200310,B,보정,1621,1338,20200313,2959
20200310,B,죽전,9002,9781,20200313,18783
20200310,B,구성,3317,3370,20200313,6687
20200310,B,신갈,3148,3082,20200313,6230
20200310,B,기흥,6723,6422,20200313,13145
20200310,B,상갈,3742,3472,20200313,7214
20200310,B,청명,2797,2617,20200313,5414
20200310,B,영통,5153,5329,20200313,10482
20200310,B,망포,9719,9363,20200313,19082
20200310,B,매탄권선,3053,2935,20200313,5988
20200310,B,수원시청,7817,8561,20200313,16378
20200310,B,매교,1608,1581,20200313,3189
20200311,B,선릉,11150,17361,20200314,28511
20200311,B,한티,9492,10135,20200314,19627
20200311,B,도곡,4671,4745,20200314,9416
20200311,B,구룡,998,1008,20200314,2006
20200311,B,개포동,2452,2661,20200314,5113
20200311,B,대모산입구,2580,2421,20200314,5001
20200311,B,수서,9155,9392,20200314,18547
20200311,B,수원,5782,3998,20200314,9780
20200311,B,서울숲,7303,7506,20200314,14809
20200311,B,압구정로데오,13051,14561,20200314,27612
20200311,B,강남구청,7667,9044,20200314,16711
20200311,B,선정릉,6827,7397,20200314,14224
20200311,B,가천대,4850,5819,20200314,10669
20200311,B,태평,11152,10705,20200314,21857
20200311,B,모란,15761,16022,20200314,31783
20200311,B,야탑,19252,20132,20200314,39384
20200311,B,서현,17852,17827,20200314,35679
20200311,B,수내,9459,9521,20200314,18980
20200311,B,정자,11947,12876,20200314,24823
20200311,B,미금,11641,12499,20200314,24140
20200311,B,오리,9309,7905,20200314,17214
20200311,B,이매,3544,3436,20200314,6980
20200311,B,보정,1710,1394,20200314,3104
20200311,B,죽전,9681,10341,20200314,20022
20200311,B,구성,3476,3550,20200314,7026
20200311,B,신갈,3264,3170,20200314,6434
20200311,B,기흥,7037,6676,20200314,13713
20200311,B,상갈,3980,3626,20200314,7606
20200311,B,청명,2913,2740,20200314,5653
20200311,B,영통,5575,5733,20200314,11308
20200311,B,망포,10094,9562,20200314,19656
20200311,B,매탄권선,3186,3027,20200314,6213
20200311,B,수원시청,8278,9236,20200314,17514
20200311,B,매교,1619,1639,20200314,3258
20200312,B,선릉,10791,17068,20200315,27859
20200312,B,한티,9347,9989,20200315,19336
20200312,B,도곡,4629,4725,20200315,9354
20200312,B,구룡,1062,1033,20200315,2095
20200312,B,개포동,2424,2585,20200315,5009
20200312,B,대모산입구,2509,2332,20200315,4841
20200312,B,수서,9312,9413,20200315,18725
20200312,B,복정,1,0,20200315,1
20200312,B,수원,5781,3925,20200315,9706
20200312,B,서울숲,7249,7378,20200315,14627
20200312,B,압구정로데오,12803,14526,20200315,27329
20200312,B,강남구청,7312,8473,20200315,15785
20200312,B,선정릉,6650,7142,20200315,13792
20200312,B,가천대,4771,5602,20200315,10373
20200312,B,태평,10954,10693,20200315,21647
20200312,B,모란,15572,15748,20200315,31320
20200312,B,야탑,18745,19714,20200315,38459
20200312,B,서현,17350,17563,20200315,34913
20200312,B,수내,9139,9204,20200315,18343
20200312,B,정자,11811,12772,20200315,24583
20200312,B,미금,11283,12147,20200315,23430
20200312,B,오리,9220,7613,20200315,16833
20200312,B,이매,3582,3417,20200315,6999
20200312,B,보정,1694,1383,20200315,3077
20200312,B,죽전,9600,10541,20200315,20141
20200312,B,구성,3382,3479,20200315,6861
20200312,B,신갈,3091,3017,20200315,6108
20200312,B,기흥,6957,6574,20200315,13531
20200312,B,상갈,3853,3593,20200315,7446
20200312,B,청명,2901,2682,20200315,5583
20200312,B,영통,5650,5782,20200315,11432
20200312,B,망포,9858,9418,20200315,19276
20200312,B,매탄권선,3273,3059,20200315,6332
20200312,B,수원시청,8254,9125,20200315,17379
20200312,B,매교,1588,1619,20200315,3207
20200313,B,선릉,10844,17039,20200316,27883
20200313,B,한티,9934,10426,20200316,20360
20200313,B,도곡,4805,4821,20200316,9626
20200313,B,구룡,1041,1022,20200316,2063
20200313,B,개포동,2457,2609,20200316,5066
20200313,B,대모산입구,2634,2376,20200316,5010
20200313,B,수서,10227,10562,20200316,20789
20200313,B,수원,6390,4427,20200316,10817
20200313,B,서울숲,7258,7295,20200316,14553
20200313,B,압구정로데오,13821,16076,20200316,29897
20200313,B,강남구청,7644,8757,20200316,16401
20200313,B,선정릉,6722,7282,20200316,14004
20200313,B,가천대,4983,5558,20200316,10541
20200313,B,태평,11273,10814,20200316,22087
20200313,B,모란,16327,16609,20200316,32936
20200313,B,야탑,19966,20927,20200316,40893
20200313,B,서현,18569,18986,20200316,37555
20200313,B,수내,9748,9696,20200316,19444
20200313,B,정자,12421,13335,20200316,25756
20200313,B,미금,11748,12594,20200316,24342
20200313,B,오리,9280,7830,20200316,17110
20200313,B,이매,3724,3515,20200316,7239
20200313,B,보정,1718,1399,20200316,3117
20200313,B,죽전,10374,10739,20200316,21113
20200313,B,구성,3507,3495,20200316,7002
20200313,B,신갈,3314,3245,20200316,6559
20200313,B,기흥,7228,6858,20200316,14086
20200313,B,상갈,4189,3725,20200316,7914
20200313,B,청명,3078,2845,20200316,5923
20200313,B,영통,6057,6235,20200316,12292
20200313,B,망포,10961,9949,20200316,20910
20200313,B,매탄권선,3493,3207,20200316,6700
20200313,B,수원시청,8805,11049,20200316,19854
20200313,B,매교,1692,1694,20200316,3386
20200314,B,선릉,3466,5423,20200317,8889
20200314,B,한티,6558,6531,20200317,13089
20200314,B,도곡,2545,2423,20200317,4968
20200314,B,구룡,666,626,20200317,1292
20200314,B,개포동,1502,1511,20200317,3013
20200314,B,대모산입구,1590,1440,20200317,3030
20200314,B,수서,5290,5614,20200317,10904
20200314,B,수원,4385,2987,20200317,7372
20200314,B,서울숲,4377,4497,20200317,8874
20200314,B,압구정로데오,10125,11710,20200317,21835
20200314,B,강남구청,3212,3929,20200317,7141
20200314,B,선정릉,2464,2566,20200317,5030
20200314,B,가천대,3083,3382,20200317,6465
20200314,B,태평,7889,7433,20200317,15322
20200314,B,모란,13664,14214,20200317,27878
20200314,B,야탑,11186,11818,20200317,23004
20200314,B,서현,11626,11791,20200317,23417
20200314,B,수내,5508,5180,20200317,10688
20200314,B,정자,7023,7079,20200317,14102
20200314,B,미금,7463,7610,20200317,15073
20200314,B,오리,5153,4400,20200317,9553
20200314,B,이매,2197,2213,20200317,4410
20200314,B,보정,907,851,20200317,1758
20200314,B,죽전,6425,7280,20200317,13705
20200314,B,구성,1922,1963,20200317,3885
20200314,B,신갈,1684,1695,20200317,3379
20200314,B,기흥,4331,4129,20200317,8460
20200314,B,상갈,2457,2371,20200317,4828
20200314,B,청명,1558,1447,20200317,3005
20200314,B,영통,4259,4184,20200317,8443
20200314,B,망포,5920,5291,20200317,11211
20200314,B,매탄권선,2048,1860,20200317,3908
20200314,B,수원시청,6620,7912,20200317,14532
20200314,B,매교,1108,1132,20200317,2240
20200315,B,선릉,1598,2534,20200318,4132
20200315,B,한티,4490,4491,20200318,8981
20200315,B,도곡,1381,1420,20200318,2801
20200315,B,구룡,351,408,20200318,759
20200315,B,개포동,905,927,20200318,1832
20200315,B,대모산입구,823,802,20200318,1625
20200315,B,수서,4321,4290,20200318,8611
20200315,B,수원,2903,1928,20200318,4831
20200315,B,서울숲,2496,2538,20200318,5034
20200315,B,압구정로데오,5521,6071,20200318,11592
20200315,B,강남구청,1771,2134,20200318,3905
20200315,B,선정릉,1310,1417,20200318,2727
20200315,B,가천대,2013,2587,20200318,4600
20200315,B,태평,5008,4758,20200318,9766
20200315,B,모란,7081,7308,20200318,14389
20200315,B,야탑,7730,7837,20200318,15567
20200315,B,서현,7691,7556,20200318,15247
20200315,B,수내,3706,3554,20200318,7260
20200315,B,정자,4430,4587,20200318,9017
20200315,B,미금,4286,4485,20200318,8771
20200315,B,오리,3437,3008,20200318,6445
20200315,B,이매,1425,1468,20200318,2893
20200315,B,보정,589,560,20200318,1149
20200315,B,죽전,4560,5368,20200318,9928
20200315,B,구성,1245,1350,20200318,2595
20200315,B,신갈,1028,1071,20200318,2099
20200315,B,기흥,2922,2867,20200318,5789
20200315,B,상갈,1569,1734,20200318,3303
20200315,B,청명,1101,1008,20200318,2109
20200315,B,영통,2774,2731,20200318,5505
20200315,B,망포,3583,3752,20200318,7335
20200315,B,매탄권선,1361,1296,20200318,2657
20200315,B,수원시청,4215,4091,20200318,8306
20200315,B,매교,660,632,20200318,1292
20200316,B,선릉,11331,17748,20200319,29079
20200316,B,한티,9609,10207,20200319,19816
20200316,B,도곡,4717,4950,20200319,9667
20200316,B,구룡,1035,1032,20200319,2067
20200316,B,개포동,2427,2614,20200319,5041
20200316,B,대모산입구,2661,2474,20200319,5135
20200316,B,수서,9592,9712,20200319,19304
20200316,B,수원,5792,4137,20200319,9929
20200316,B,서울숲,6966,7012,20200319,13978
20200316,B,압구정로데오,12442,13722,20200319,26164
20200316,B,강남구청,7392,8584,20200319,15976
20200316,B,선정릉,6919,7449,20200319,14368
20200316,B,가천대,4846,5650,20200319,10496
20200316,B,태평,10821,10623,20200319,21444
20200316,B,모란,15396,15629,20200319,31025
20200316,B,야탑,19297,19978,20200319,39275
20200316,B,서현,17381,17378,20200319,34759
20200316,B,수내,9590,9547,20200319,19137
20200316,B,정자,11818,12654,20200319,24472
20200316,B,미금,11630,12579,20200319,24209
20200316,B,오리,9001,7782,20200319,16783
20200316,B,이매,3685,3515,20200319,7200
20200316,B,보정,1755,1394,20200319,3149
20200316,B,죽전,8880,9582,20200319,18462
20200316,B,구성,3493,3583,20200319,7076
20200316,B,신갈,3284,3205,20200319,6489
20200316,B,기흥,6990,6704,20200319,13694
20200316,B,상갈,3981,3702,20200319,7683
20200316,B,청명,2996,2747,20200319,5743
20200316,B,영통,5608,5763,20200319,11371
20200316,B,망포,10204,9697,20200319,19901
20200316,B,매탄권선,3242,3126,20200319,6368
20200316,B,수원시청,8362,8960,20200319,17322
20200316,B,매교,1722,1735,20200319,3457
20200317,B,선릉,11241,17648,20200320,28889
20200317,B,한티,9675,10298,20200320,19973
20200317,B,도곡,4660,4814,20200320,9474
20200317,B,구룡,1030,1084,20200320,2114
20200317,B,개포동,2416,2575,20200320,4991
20200317,B,대모산입구,2660,2475,20200320,5135
20200317,B,수서,9157,9252,20200320,18409
20200317,B,수원,5724,3908,20200320,9632
20200317,B,서울숲,7032,7121,20200320,14153
20200317,B,압구정로데오,13139,14674,20200320,27813
20200317,B,강남구청,7542,8612,20200320,16154
20200317,B,선정릉,6859,7459,20200320,14318
20200317,B,가천대,4864,5649,20200320,10513
20200317,B,태평,10774,10460,20200320,21234
20200317,B,모란,15164,15211,20200320,30375
20200317,B,야탑,18776,19536,20200320,38312
20200317,B,서현,16893,17133,20200320,34026
20200317,B,수내,9251,9392,20200320,18643
20200317,B,정자,11914,12664,20200320,24578
20200317,B,미금,11312,12198,20200320,23510
20200317,B,오리,8901,7656,20200320,16557
20200317,B,이매,3684,3498,20200320,7182
20200317,B,보정,1681,1384,20200320,3065
20200317,B,죽전,9492,10269,20200320,19761
20200317,B,구성,3461,3532,20200320,6993
20200317,B,신갈,3112,3058,20200320,6170
20200317,B,기흥,6898,6558,20200320,13456
20200317,B,상갈,4050,3758,20200320,7808
20200317,B,청명,2872,2710,20200320,5582
20200317,B,영통,5449,5728,20200320,11177
20200317,B,망포,10138,9676,20200320,19814
20200317,B,매탄권선,3267,3025,20200320,6292
20200317,B,수원시청,8109,8969,20200320,17078
20200317,B,매교,1690,1689,20200320,3379
20200318,B,선릉,11338,17658,20200321,28996
20200318,B,한티,9960,10567,20200321,20527
20200318,B,도곡,4722,4800,20200321,9522
20200318,B,구룡,993,1063,20200321,2056
20200318,B,개포동,2516,2660,20200321,5176
20200318,B,대모산입구,2692,2516,20200321,5208
20200318,B,수서,9274,9435,20200321,18709
20200318,B,수원,5998,4087,20200321,10085
20200318,B,서울숲,7530,7503,20200321,15033
20200318,B,압구정로데오,12967,14703,20200321,27670
20200318,B,강남구청,7518,8826,20200321,16344
20200318,B,선정릉,6888,7332,20200321,14220
20200318,B,가천대,4971,5833,20200321,10804
20200318,B,태평,10938,10492,20200321,21430
20200318,B,모란,15676,15768,20200321,31444
20200318,B,야탑,19012,20050,20200321,39062
20200318,B,서현,17290,17502,20200321,34792
20200318,B,수내,9510,9498,20200321,19008
20200318,B,정자,12035,12835,20200321,24870
20200318,B,미금,11606,12374,20200321,23980
20200318,B,오리,9152,7814,20200321,16966
20200318,B,이매,3769,3632,20200321,7401
20200318,B,보정,1789,1509,20200321,3298
20200318,B,죽전,9835,10573,20200321,20408
20200318,B,구성,3544,3634,20200321,7178
20200318,B,신갈,3364,3275,20200321,6639
20200318,B,기흥,7106,6767,20200321,13873
20200318,B,상갈,4058,3806,20200321,7864
20200318,B,청명,3008,2858,20200321,5866
20200318,B,영통,5865,5935,20200321,11800
20200318,B,망포,10369,9817,20200321,20186
20200318,B,매탄권선,3312,3185,20200321,6497
20200318,B,수원시청,8610,9489,20200321,18099
20200318,B,매교,1717,1764,20200321,3481
20200319,B,선릉,10888,17041,20200322,27929
20200319,B,한티,9449,9943,20200322,19392
20200319,B,도곡,4599,4691,20200322,9290
20200319,B,구룡,954,986,20200322,1940
20200319,B,개포동,2325,2495,20200322,4820
20200319,B,대모산입구,2599,2437,20200322,5036
20200319,B,수서,9307,9535,20200322,18842
20200319,B,수원,5526,3750,20200322,9276
20200319,B,서울숲,6817,6804,20200322,13621
20200319,B,압구정로데오,12801,14302,20200322,27103
20200319,B,강남구청,7356,8644,20200322,16000
20200319,B,선정릉,6885,7441,20200322,14326
20200319,B,가천대,4796,5684,20200322,10480
20200319,B,태평,10610,10266,20200322,20876
20200319,B,모란,16495,16789,20200322,33284
20200319,B,야탑,18622,19268,20200322,37890
20200319,B,서현,16433,16647,20200322,33080
20200319,B,수내,9212,9310,20200322,18522
20200319,B,정자,11538,12328,20200322,23866
20200319,B,미금,10847,11727,20200322,22574
20200319,B,오리,8774,7493,20200322,16267
20200319,B,이매,3517,3352,20200322,6869
20200319,B,보정,1706,1368,20200322,3074
20200319,B,죽전,9299,10098,20200322,19397
20200319,B,구성,3289,3392,20200322,6681
20200319,B,신갈,3121,3047,20200322,6168
20200319,B,기흥,6782,6399,20200322,13181
20200319,B,상갈,3808,3578,20200322,7386
20200319,B,청명,2840,2723,20200322,5563
20200319,B,영통,5448,5536,20200322,10984
20200319,B,망포,9823,9343,20200322,19166
20200319,B,매탄권선,3185,3063,20200322,6248
20200319,B,수원시청,8233,9024,20200322,17257
20200319,B,매교,1604,1572,20200322,3176
20200320,B,상갈,4190,3763,20200323,7953
20200320,B,선릉,11049,17469,20200323,28518
20200320,B,한티,10367,10879,20200323,21246
20200320,B,도곡,5021,5008,20200323,10029
20200320,B,구룡,1091,1064,20200323,2155
20200320,B,개포동,2615,2772,20200323,5387
20200320,B,대모산입구,2739,2518,20200323,5257
20200320,B,수서,10757,11328,20200323,22085
20200320,B,수원,6448,4310,20200323,10758
20200320,B,서울숲,7582,7735,20200323,15317
20200320,B,압구정로데오,14245,16757,20200323,31002
20200320,B,강남구청,7893,9220,20200323,17113
20200320,B,선정릉,6930,7464,20200323,14394
20200320,B,가천대,5044,5642,20200323,10686
20200320,B,태평,11392,10858,20200323,22250
20200320,B,모란,16459,16725,20200323,33184
20200320,B,야탑,19955,21003,20200323,40958
20200320,B,서현,18406,18873,20200323,37279
20200320,B,수내,9892,9872,20200323,19764
20200320,B,정자,12479,13280,20200323,25759
20200320,B,미금,12042,12751,20200323,24793
20200320,B,오리,9440,7959,20200323,17399
20200320,B,이매,3832,3720,20200323,7552
20200320,B,보정,1810,1477,20200323,3287
20200320,B,죽전,10713,11056,20200323,21769
20200320,B,구성,3595,3782,20200323,7377
20200320,B,신갈,3518,3341,20200323,6859
20200320,B,기흥,7517,7129,20200323,14646
20200320,B,청명,3235,2923,20200323,6158
20200320,B,영통,6499,6679,20200323,13178
20200320,B,망포,11603,10314,20200323,21917
20200320,B,매탄권선,3685,3312,20200323,6997
20200320,B,수원시청,9247,11475,20200323,20722
20200320,B,매교,1770,1819,20200323,3589
20200321,B,선릉,3419,5449,20200324,8868
20200321,B,한티,6807,6835,20200324,13642
20200321,B,도곡,2536,2379,20200324,4915
20200321,B,구룡,679,691,20200324,1370
20200321,B,개포동,1538,1512,20200324,3050
20200321,B,대모산입구,1606,1487,20200324,3093
20200321,B,수서,5578,5682,20200324,11260
20200321,B,수원,4509,2374,20200324,6883
20200321,B,서울숲,5028,5454,20200324,10482
20200321,B,압구정로데오,10451,12277,20200324,22728
20200321,B,강남구청,3247,3983,20200324,7230
20200321,B,선정릉,2478,2619,20200324,5097
20200321,B,가천대,3000,3310,20200324,6310
20200321,B,태평,7630,7181,20200324,14811
20200321,B,모란,10869,11346,20200324,22215
20200321,B,야탑,11060,11559,20200324,22619
20200321,B,서현,10945,11211,20200324,22156
20200321,B,수내,5616,5228,20200324,10844
20200321,B,정자,6938,7101,20200324,14039
20200321,B,미금,7236,7388,20200324,14624
20200321,B,오리,5157,4267,20200324,9424
20200321,B,이매,2387,2215,20200324,4602
20200321,B,보정,945,888,20200324,1833
20200321,B,죽전,6463,7429,20200324,13892
20200321,B,구성,1963,2048,20200324,4011
20200321,B,신갈,1772,1789,20200324,3561
20200321,B,기흥,4488,4255,20200324,8743
20200321,B,상갈,2540,2457,20200324,4997
20200321,B,청명,1684,1562,20200324,3246
20200321,B,영통,4319,4338,20200324,8657
20200321,B,망포,6068,5310,20200324,11378
20200321,B,매탄권선,2197,2010,20200324,4207
20200321,B,수원시청,6449,8038,20200324,14487
20200321,B,매교,1078,1123,20200324,2201
20200322,B,선릉,1736,2585,20200325,4321
20200322,B,한티,4606,4609,20200325,9215
20200322,B,도곡,1363,1350,20200325,2713
20200322,B,구룡,378,379,20200325,757
20200322,B,개포동,1047,1045,20200325,2092
20200322,B,대모산입구,928,847,20200325,1775
20200322,B,수서,4636,4671,20200325,9307
20200322,B,수원,3062,1753,20200325,4815
20200322,B,서울숲,3889,4165,20200325,8054
20200322,B,압구정로데오,5772,6512,20200325,12284
20200322,B,강남구청,1920,2190,20200325,4110
20200322,B,선정릉,1490,1503,20200325,2993
20200322,B,가천대,2131,2544,20200325,4675
20200322,B,태평,5035,4945,20200325,9980
20200322,B,모란,7259,7490,20200325,14749
20200322,B,야탑,7570,7669,20200325,15239
20200322,B,서현,7812,7558,20200325,15370
20200322,B,수내,3845,3699,20200325,7544
20200322,B,정자,4658,4737,20200325,9395
20200322,B,미금,4247,4666,20200325,8913
20200322,B,오리,3516,3081,20200325,6597
20200322,B,이매,1514,1635,20200325,3149
20200322,B,보정,605,563,20200325,1168
20200322,B,죽전,4444,5059,20200325,9503
20200322,B,구성,1299,1426,20200325,2725
20200322,B,신갈,1125,1116,20200325,2241
20200322,B,기흥,2948,2879,20200325,5827
20200322,B,상갈,1713,1748,20200325,3461
20200322,B,청명,1051,1003,20200325,2054
20200322,B,영통,2829,2882,20200325,5711
20200322,B,망포,3786,3980,20200325,7766
20200322,B,매탄권선,1419,1334,20200325,2753
20200322,B,수원시청,4523,4409,20200325,8932
20200322,B,매교,726,734,20200325,1460
20200323,B,선릉,11341,17914,20200326,29255
20200323,B,한티,9904,10477,20200326,20381
20200323,B,도곡,4896,5048,20200326,9944
20200323,B,구룡,1001,1009,20200326,2010
20200323,B,개포동,2434,2665,20200326,5099
20200323,B,대모산입구,2764,2566,20200326,5330
20200323,B,수서,10031,10086,20200326,20117
20200323,B,수원,5974,4041,20200326,10015
20200323,B,서울숲,7406,7630,20200326,15036
20200323,B,압구정로데오,12420,13845,20200326,26265
20200323,B,강남구청,7541,8675,20200326,16216
20200323,B,선정릉,7036,7554,20200326,14590
20200323,B,가천대,5022,5899,20200326,10921
20200323,B,태평,11168,10883,20200326,22051
20200323,B,모란,15805,15979,20200326,31784
20200323,B,야탑,19340,20089,20200326,39429
20200323,B,서현,17743,17706,20200326,35449
20200323,B,수내,9615,9492,20200326,19107
20200323,B,정자,11903,12769,20200326,24672
20200323,B,미금,11619,12578,20200326,24197
20200323,B,오리,9131,7709,20200326,16840
20200323,B,이매,3820,3538,20200326,7358
20200323,B,보정,1806,1428,20200326,3234
20200323,B,죽전,9704,10413,20200326,20117
20200323,B,구성,3462,3603,20200326,7065
20200323,B,신갈,3450,3350,20200326,6800
20200323,B,기흥,7088,6795,20200326,13883
20200323,B,상갈,4010,3744,20200326,7754
20200323,B,청명,2985,2785,20200326,5770
20200323,B,영통,5842,5980,20200326,11822
20200323,B,망포,10224,9791,20200326,20015
20200323,B,매탄권선,3321,3241,20200326,6562
20200323,B,수원시청,8676,9446,20200326,18122
20200323,B,매교,1755,1756,20200326,3511
20200324,B,선릉,11343,17708,20200327,29051
20200324,B,한티,9664,10190,20200327,19854
20200324,B,도곡,4778,4911,20200327,9689
20200324,B,구룡,1011,1047,20200327,2058
20200324,B,개포동,2478,2636,20200327,5114
20200324,B,대모산입구,2795,2596,20200327,5391
20200324,B,수서,9682,9911,20200327,19593
20200324,B,복정,1,0,20200327,1
20200324,B,수원,6037,3985,20200327,10022
20200324,B,서울숲,7636,7942,20200327,15578
20200324,B,압구정로데오,12989,14594,20200327,27583
20200324,B,강남구청,7680,8874,20200327,16554
20200324,B,선정릉,6943,7556,20200327,14499
20200324,B,가천대,5033,5887,20200327,10920
20200324,B,태평,11343,11027,20200327,22370
20200324,B,모란,18088,18447,20200327,36535
20200324,B,야탑,19450,20472,20200327,39922
20200324,B,서현,17408,17735,20200327,35143
20200324,B,수내,9653,9711,20200327,19364
20200324,B,정자,12117,13015,20200327,25132
20200324,B,미금,11705,12647,20200327,24352
20200324,B,오리,8980,7578,20200327,16558
20200324,B,이매,3847,3632,20200327,7479
20200324,B,보정,1746,1444,20200327,3190
20200324,B,죽전,9725,10476,20200327,20201
20200324,B,구성,3610,3688,20200327,7298
20200324,B,신갈,3347,3273,20200327,6620
20200324,B,기흥,7216,6891,20200327,14107
20200324,B,상갈,4086,3760,20200327,7846
20200324,B,청명,3027,2852,20200327,5879
20200324,B,영통,5801,5968,20200327,11769
20200324,B,망포,10236,9785,20200327,20021
20200324,B,매탄권선,3361,3179,20200327,6540
20200324,B,수원시청,8458,9217,20200327,17675
20200324,B,매교,1709,1740,20200327,3449
20200325,B,선릉,11444,17833,20200328,29277
20200325,B,한티,10125,10658,20200328,20783
20200325,B,도곡,4837,4833,20200328,9670
20200325,B,구룡,1025,1105,20200328,2130
20200325,B,개포동,2495,2670,20200328,5165
20200325,B,대모산입구,2685,2583,20200328,5268
20200325,B,수서,9539,9834,20200328,19373
20200325,B,수원,6188,4101,20200328,10289
20200325,B,서울숲,8080,8301,20200328,16381
20200325,B,압구정로데오,13046,14660,20200328,27706
20200325,B,강남구청,7733,9156,20200328,16889
20200325,B,선정릉,7036,7651,20200328,14687
20200325,B,가천대,5064,5912,20200328,10976
20200325,B,태평,11263,10794,20200328,22057
20200325,B,모란,16105,16195,20200328,32300
20200325,B,야탑,19672,20653,20200328,40325
20200325,B,서현,18144,18262,20200328,36406
20200325,B,수내,9728,9721,20200328,19449
20200325,B,정자,12136,13012,20200328,25148
20200325,B,미금,11837,12719,20200328,24556
20200325,B,오리,9324,8005,20200328,17329
20200325,B,이매,3854,3736,20200328,7590
20200325,B,보정,1847,1518,20200328,3365
20200325,B,죽전,10028,10685,20200328,20713
20200325,B,구성,3612,3742,20200328,7354
20200325,B,신갈,3322,3278,20200328,6600
20200325,B,기흥,7204,6798,20200328,14002
20200325,B,상갈,4074,3891,20200328,7965
20200325,B,청명,3125,2949,20200328,6074
20200325,B,영통,6010,6077,20200328,12087
20200325,B,망포,10524,10062,20200328,20586
20200325,B,매탄권선,3424,3153,20200328,6577
20200325,B,수원시청,8626,9592,20200328,18218
20200325,B,매교,1710,1780,20200328,3490
20200326,B,선릉,11251,17721,20200329,28972
20200326,B,한티,9771,10308,20200329,20079
20200326,B,도곡,4613,4681,20200329,9294
20200326,B,구룡,995,971,20200329,1966
20200326,B,개포동,2428,2605,20200329,5033
20200326,B,대모산입구,2664,2485,20200329,5149
20200326,B,수서,9580,9858,20200329,19438
20200326,B,복정,2,0,20200329,2
20200326,B,수원,5908,3973,20200329,9881
20200326,B,서울숲,7492,7564,20200329,15056
20200326,B,압구정로데오,13026,14845,20200329,27871
20200326,B,강남구청,7696,8936,20200329,16632
20200326,B,선정릉,6968,7528,20200329,14496
20200326,B,가천대,5100,5983,20200329,11083
20200326,B,태평,10986,10570,20200329,21556
20200326,B,모란,15675,15856,20200329,31531
20200326,B,야탑,18986,19875,20200329,38861
20200326,B,서현,17753,17887,20200329,35640
20200326,B,수내,9588,9610,20200329,19198
20200326,B,정자,12029,13090,20200329,25119
20200326,B,미금,11575,12391,20200329,23966
20200326,B,오리,9057,7666,20200329,16723
20200326,B,이매,3727,3450,20200329,7177
20200326,B,보정,1756,1466,20200329,3222
20200326,B,죽전,9684,10551,20200329,20235
20200326,B,구성,3475,3615,20200329,7090
20200326,B,신갈,3273,3223,20200329,6496
20200326,B,기흥,7100,6732,20200329,13832
20200326,B,상갈,4018,3704,20200329,7722
20200326,B,청명,3033,2834,20200329,5867
20200326,B,영통,5791,5913,20200329,11704
20200326,B,망포,10259,9748,20200329,20007
20200326,B,매탄권선,3332,3092,20200329,6424
20200326,B,수원시청,8314,9351,20200329,17665
20200326,B,매교,1657,1686,20200329,3343
20200327,B,선릉,11057,17710,20200330,28767
20200327,B,한티,10422,10841,20200330,21263
20200327,B,도곡,4858,4799,20200330,9657
20200327,B,구룡,1032,1031,20200330,2063
20200327,B,개포동,2504,2693,20200330,5197
20200327,B,대모산입구,2628,2459,20200330,5087
20200327,B,수서,10845,11398,20200330,22243
20200327,B,복정,1,0,20200330,1
20200327,B,수원,6527,4499,20200330,11026
20200327,B,서울숲,8049,8018,20200330,16067
20200327,B,압구정로데오,14250,16492,20200330,30742
20200327,B,강남구청,7833,8980,20200330,16813
20200327,B,선정릉,6832,7465,20200330,14297
20200327,B,가천대,5371,5915,20200330,11286
20200327,B,태평,11409,10823,20200330,22232
20200327,B,모란,16477,16866,20200330,33343
20200327,B,야탑,20046,21031,20200330,41077
20200327,B,서현,18750,19367,20200330,38117
20200327,B,수내,9928,9844,20200330,19772
20200327,B,정자,12628,13612,20200330,26240
20200327,B,미금,12025,12852,20200330,24877
20200327,B,오리,9266,7885,20200330,17151
20200327,B,이매,3821,3568,20200330,7389
20200327,B,보정,1780,1478,20200330,3258
20200327,B,죽전,10715,11047,20200330,21762
20200327,B,구성,3590,3692,20200330,7282
20200327,B,신갈,3372,3289,20200330,6661
20200327,B,기흥,7403,6926,20200330,14329
20200327,B,상갈,4220,3819,20200330,8039
20200327,B,청명,3177,2946,20200330,6123
20200327,B,영통,6500,6661,20200330,13161
20200327,B,망포,11460,10603,20200330,22063
20200327,B,매탄권선,3686,3333,20200330,7019
20200327,B,수원시청,9144,11124,20200330,20268
20200327,B,매교,1748,1639,20200330,3387
20200328,B,선릉,3480,5418,20200331,8898
20200328,B,한티,6895,6933,20200331,13828
20200328,B,도곡,2575,2400,20200331,4975
20200328,B,구룡,614,625,20200331,1239
20200328,B,개포동,1521,1577,20200331,3098
20200328,B,대모산입구,1700,1560,20200331,3260
20200328,B,수서,5787,5988,20200331,11775
20200328,B,수원,4434,3056,20200331,7490
20200328,B,서울숲,5815,6220,20200331,12035
20200328,B,압구정로데오,10364,12176,20200331,22540
20200328,B,강남구청,3222,3969,20200331,7191
20200328,B,선정릉,2513,2631,20200331,5144
20200328,B,가천대,3218,3626,20200331,6844
20200328,B,태평,8098,7664,20200331,15762
20200328,B,모란,11266,11695,20200331,22961
20200328,B,야탑,11558,12299,20200331,23857
20200328,B,서현,11865,12145,20200331,24010
20200328,B,수내,5757,5324,20200331,11081
20200328,B,정자,7332,7386,20200331,14718
20200328,B,미금,7647,7778,20200331,15425
20200328,B,오리,5233,4372,20200331,9605
20200328,B,이매,2405,2289,20200331,4694
20200328,B,보정,983,892,20200331,1875
20200328,B,죽전,6770,7582,20200331,14352
20200328,B,구성,2018,2071,20200331,4089
20200328,B,신갈,1772,1733,20200331,3505
20200328,B,기흥,4634,4339,20200331,8973
20200328,B,상갈,2478,2516,20200331,4994
20200328,B,청명,1646,1570,20200331,3216
20200328,B,영통,4385,4317,20200331,8702
20200328,B,망포,6229,5497,20200331,11726
20200328,B,매탄권선,2124,1965,20200331,4089
20200328,B,수원시청,6543,7673,20200331,14216
20200328,B,매교,1072,1137,20200331,2209
20200329,B,선릉,1815,2729,20200401,4544
20200329,B,한티,4555,4542,20200401,9097
20200329,B,도곡,1619,1530,20200401,3149
20200329,B,구룡,397,388,20200401,785
20200329,B,개포동,1051,1027,20200401,2078
20200329,B,대모산입구,967,933,20200401,1900
20200329,B,수서,5077,4972,20200401,10049
20200329,B,수원,3128,2141,20200401,5269
20200329,B,서울숲,4370,4862,20200401,9232
20200329,B,압구정로데오,5767,6421,20200401,12188
20200329,B,강남구청,1929,2266,20200401,4195
20200329,B,선정릉,1478,1620,20200401,3098
20200329,B,가천대,2324,2888,20200401,5212
20200329,B,태평,5565,5355,20200401,10920
20200329,B,모란,10415,10768,20200401,21183
20200329,B,야탑,8320,8458,20200401,16778
20200329,B,서현,8366,8257,20200401,16623
20200329,B,수내,3962,3807,20200401,7769
20200329,B,정자,4759,4925,20200401,9684
20200329,B,미금,4624,5039,20200401,9663
20200329,B,오리,3686,3183,20200401,6869
20200329,B,이매,1641,1675,20200401,3316
20200329,B,보정,637,623,20200401,1260
20200329,B,죽전,4879,5636,20200401,10515
20200329,B,구성,1425,1562,20200401,2987
20200329,B,신갈,1189,1189,20200401,2378
20200329,B,기흥,3046,3014,20200401,6060
20200329,B,상갈,1757,1910,20200401,3667
20200329,B,청명,1090,1061,20200401,2151
20200329,B,영통,2910,2967,20200401,5877
20200329,B,망포,3905,4136,20200401,8041
20200329,B,매탄권선,1434,1407,20200401,2841
20200329,B,수원시청,4391,4146,20200401,8537
20200329,B,매교,722,742,20200401,1464
20200330,B,선릉,11457,18049,20200402,29506
20200330,B,한티,9826,10423,20200402,20249
20200330,B,도곡,4874,4941,20200402,9815
20200330,B,구룡,1027,1041,20200402,2068
20200330,B,개포동,2429,2674,20200402,5103
20200330,B,대모산입구,2745,2535,20200402,5280
20200330,B,수서,10120,10185,20200402,20305
20200330,B,수원,5981,4224,20200402,10205
20200330,B,서울숲,7883,8082,20200402,15965
20200330,B,압구정로데오,12414,13822,20200402,26236
20200330,B,강남구청,7442,8644,20200402,16086
20200330,B,선정릉,7167,7602,20200402,14769
20200330,B,가천대,5131,6112,20200402,11243
20200330,B,태평,11334,10962,20200402,22296
20200330,B,모란,15898,16242,20200402,32140
20200330,B,야탑,19861,20633,20200402,40494
20200330,B,서현,18019,18030,20200402,36049
20200330,B,수내,9727,9595,20200402,19322
20200330,B,정자,12137,13046,20200402,25183
20200330,B,미금,11755,12672,20200402,24427
20200330,B,오리,9108,7520,20200402,16628
20200330,B,이매,3841,3742,20200402,7583
20200330,B,보정,1789,1408,20200402,3197
20200330,B,죽전,9874,10654,20200402,20528
20200330,B,구성,3680,3674,20200402,7354
20200330,B,신갈,3497,3395,20200402,6892
20200330,B,기흥,7158,6901,20200402,14059
20200330,B,상갈,4108,3787,20200402,7895
20200330,B,청명,3083,2903,20200402,5986
20200330,B,영통,5832,6065,20200402,11897
20200330,B,망포,10517,10111,20200402,20628
20200330,B,매탄권선,3339,3064,20200402,6403
20200330,B,수원시청,8690,9298,20200402,17988
20200330,B,매교,1737,1815,20200402,3552
20200331,B,선릉,11555,18056,20200403,29611
20200331,B,한티,10113,10632,20200403,20745
20200331,B,도곡,4846,4749,20200403,9595
20200331,B,구룡,999,1000,20200403,1999
20200331,B,개포동,2429,2709,20200403,5138
20200331,B,대모산입구,2698,2505,20200403,5203
20200331,B,수서,9735,9844,20200403,19579
20200331,B,수원,5943,4174,20200403,10117
20200331,B,서울숲,8296,8607,20200403,16903
20200331,B,압구정로데오,13196,14910,20200403,28106
20200331,B,강남구청,7640,9055,20200403,16695
20200331,B,선정릉,6994,7683,20200403,14677
20200331,B,가천대,5155,5976,20200403,11131
20200331,B,태평,11327,10941,20200403,22268
20200331,B,모란,16120,16208,20200403,32328
20200331,B,야탑,19895,20815,20200403,40710
20200331,B,서현,17995,18197,20200403,36192
20200331,B,수내,9628,9763,20200403,19391
20200331,B,정자,12485,13425,20200403,25910
20200331,B,미금,12000,12758,20200403,24758
20200331,B,오리,9297,7780,20200403,17077
20200331,B,이매,3837,3633,20200403,7470
20200331,B,보정,1766,1499,20200403,3265
20200331,B,죽전,10122,10902,20200403,21024
20200331,B,구성,3620,3737,20200403,7357
20200331,B,신갈,3369,3303,20200403,6672
20200331,B,기흥,7318,6957,20200403,14275
20200331,B,상갈,4206,3812,20200403,8018
20200331,B,청명,3085,2972,20200403,6057
20200331,B,영통,5920,6057,20200403,11977
20200331,B,망포,10577,10064,20200403,20641
20200331,B,매탄권선,3435,3207,20200403,6642
20200331,B,수원시청,8400,9109,20200403,17509
20200331,B,매교,1742,1758,20200403,3500
20200401,B,선릉,11293,17757,20200404,29050
20200401,B,한티,10002,10700,20200404,20702
20200401,B,도곡,4958,4943,20200404,9901
20200401,B,구룡,1067,1051,20200404,2118
20200401,B,개포동,2579,2754,20200404,5333
20200401,B,대모산입구,2749,2581,20200404,5330
20200401,B,수서,9737,9923,20200404,19660
20200401,B,수원,6037,4090,20200404,10127
20200401,B,서울숲,8390,8544,20200404,16934
20200401,B,압구정로데오,13450,15099,20200404,28549
20200401,B,강남구청,7735,9119,20200404,16854
20200401,B,선정릉,7095,7642,20200404,14737
20200401,B,가천대,5266,6228,20200404,11494
20200401,B,태평,11249,10924,20200404,22173
20200401,B,모란,16228,16278,20200404,32506
20200401,B,야탑,19992,20880,20200404,40872
20200401,B,서현,18223,18477,20200404,36700
20200401,B,수내,9894,9921,20200404,19815
20200401,B,정자,12516,13494,20200404,26010
20200401,B,미금,12011,12794,20200404,24805
20200401,B,오리,9389,7814,20200404,17203
20200401,B,이매,3867,3655,20200404,7522
20200401,B,보정,1862,1541,20200404,3403
20200401,B,죽전,10024,10885,20200404,20909
20200401,B,구성,3700,3880,20200404,7580
20200401,B,신갈,3368,3266,20200404,6634
20200401,B,기흥,7469,7102,20200404,14571
20200401,B,상갈,4107,3860,20200404,7967
20200401,B,청명,3044,2855,20200404,5899
20200401,B,영통,5970,6137,20200404,12107
20200401,B,망포,10563,10119,20200404,20682
20200401,B,매탄권선,3448,3242,20200404,6690
20200401,B,수원시청,8440,9267,20200404,17707
20200401,B,매교,1734,1781,20200404,3515
20200402,B,선릉,11338,17916,20200405,29254
20200402,B,한티,10052,10591,20200405,20643
20200402,B,도곡,4898,4896,20200405,9794
20200402,B,구룡,1063,1045,20200405,2108
20200402,B,개포동,2517,2668,20200405,5185
20200402,B,대모산입구,2706,2556,20200405,5262
20200402,B,수서,10095,10287,20200405,20382
20200402,B,수원,6026,4252,20200405,10278
20200402,B,서울숲,8702,9010,20200405,17712
20200402,B,압구정로데오,13616,15301,20200405,28917
20200402,B,강남구청,7585,8868,20200405,16453
20200402,B,선정릉,7075,7664,20200405,14739
20200402,B,가천대,5364,6133,20200405,11497
20200402,B,태평,11245,10935,20200405,22180
20200402,B,모란,16148,16375,20200405,32523
20200402,B,야탑,20030,20983,20200405,41013
20200402,B,서현,18354,18373,20200405,36727
20200402,B,수내,9787,9958,20200405,19745
20200402,B,정자,12779,13544,20200405,26323
20200402,B,미금,11968,12757,20200405,24725
20200402,B,오리,9516,8123,20200405,17639
20200402,B,이매,3986,3708,20200405,7694
20200402,B,보정,1825,1490,20200405,3315
20200402,B,죽전,10266,11143,20200405,21409
20200402,B,구성,3669,3740,20200405,7409
20200402,B,신갈,3371,3318,20200405,6689
20200402,B,기흥,7397,6974,20200405,14371
20200402,B,상갈,4139,3848,20200405,7987
20200402,B,청명,3063,2859,20200405,5922
20200402,B,영통,5954,6092,20200405,12046
20200402,B,망포,10511,10073,20200405,20584
20200402,B,매탄권선,3357,3268,20200405,6625
20200402,B,수원시청,8384,9239,20200405,17623
20200402,B,매교,1741,1779,20200405,3520
20200403,B,선릉,11379,17860,20200406,29239
20200403,B,한티,10599,11182,20200406,21781
20200403,B,도곡,5227,5102,20200406,10329
20200403,B,구룡,1129,1139,20200406,2268
20200403,B,개포동,2644,2875,20200406,5519
20200403,B,대모산입구,2788,2612,20200406,5400
20200403,B,수서,11221,11834,20200406,23055
20200403,B,수원,6620,4626,20200406,11246
20200403,B,서울숲,9205,9559,20200406,18764
20200403,B,압구정로데오,14600,16779,20200406,31379
20200403,B,강남구청,7834,9070,20200406,16904
20200403,B,선정릉,7023,7517,20200406,14540
20200403,B,가천대,5766,6362,20200406,12128
20200403,B,태평,11563,11073,20200406,22636
20200403,B,모란,17273,17925,20200406,35198
20200403,B,야탑,21182,22111,20200406,43293
20200403,B,서현,19133,19490,20200406,38623
20200403,B,수내,10374,10327,20200406,20701
20200403,B,정자,13118,14249,20200406,27367
20200403,B,미금,12491,13368,20200406,25859
20200403,B,오리,9892,8300,20200406,18192
20200403,B,이매,4152,3987,20200406,8139
20200403,B,보정,1875,1563,20200406,3438
20200403,B,죽전,11082,11736,20200406,22818
20200403,B,구성,3804,3792,20200406,7596
20200403,B,신갈,3590,3477,20200406,7067
20200403,B,기흥,7767,7252,20200406,15019
20200403,B,상갈,4287,3966,20200406,8253
20200403,B,청명,3313,3072,20200406,6385
20200403,B,영통,6658,6716,20200406,13374
20200403,B,망포,11593,10502,20200406,22095
20200403,B,매탄권선,3711,3371,20200406,7082
20200403,B,수원시청,9029,11077,20200406,20106
20200403,B,매교,1832,1821,20200406,3653
20200404,B,선릉,3511,5739,20200407,9250
20200404,B,한티,7266,7076,20200407,14342
20200404,B,도곡,2601,2340,20200407,4941
20200404,B,구룡,650,659,20200407,1309
20200404,B,개포동,1565,1497,20200407,3062
20200404,B,대모산입구,1730,1538,20200407,3268
20200404,B,수서,6037,6436,20200407,12473
20200404,B,수원,4615,3045,20200407,7660
20200404,B,서울숲,7539,8699,20200407,16238
20200404,B,압구정로데오,10758,12268,20200407,23026
20200404,B,강남구청,3539,4170,20200407,7709
20200404,B,선정릉,2329,2394,20200407,4723
20200404,B,가천대,3364,3783,20200407,7147
20200404,B,태평,8300,7993,20200407,16293
20200404,B,모란,15093,15787,20200407,30880
20200404,B,야탑,12163,12828,20200407,24991
20200404,B,서현,12742,12991,20200407,25733
20200404,B,수내,6147,5791,20200407,11938
20200404,B,정자,7590,7701,20200407,15291
20200404,B,미금,7971,8280,20200407,16251
20200404,B,오리,5465,4575,20200407,10040
20200404,B,이매,2696,2538,20200407,5234
20200404,B,보정,965,868,20200407,1833
20200404,B,죽전,7171,7920,20200407,15091
20200404,B,구성,2194,2190,20200407,4384
20200404,B,신갈,1840,1876,20200407,3716
20200404,B,기흥,4658,4563,20200407,9221
20200404,B,상갈,2602,2575,20200407,5177
20200404,B,청명,1812,1726,20200407,3538
20200404,B,영통,4561,4518,20200407,9079
20200404,B,망포,6155,5346,20200407,11501
20200404,B,매탄권선,2179,2038,20200407,4217
20200404,B,수원시청,6470,7634,20200407,14104
20200404,B,매교,1032,1190,20200407,2222
20200405,B,선릉,1880,2893,20200408,4773
20200405,B,한티,4670,4755,20200408,9425
20200405,B,도곡,1429,1423,20200408,2852
20200405,B,구룡,377,410,20200408,787
20200405,B,개포동,1025,993,20200408,2018
20200405,B,대모산입구,878,853,20200408,1731
20200405,B,수서,5243,4996,20200408,10239
20200405,B,수원,3282,2197,20200408,5479
20200405,B,서울숲,5351,6035,20200408,11386
20200405,B,압구정로데오,5798,6590,20200408,12388
20200405,B,강남구청,1955,2303,20200408,4258
20200405,B,선정릉,1359,1438,20200408,2797
20200405,B,가천대,2400,2968,20200408,5368
20200405,B,태평,5624,5420,20200408,11044
20200405,B,모란,7606,7893,20200408,15499
20200405,B,야탑,8603,8814,20200408,17417
20200405,B,서현,8893,8754,20200408,17647
20200405,B,수내,4164,3875,20200408,8039
20200405,B,정자,4914,5104,20200408,10018
20200405,B,미금,4727,4966,20200408,9693
20200405,B,오리,3767,3340,20200408,7107
20200405,B,이매,1691,1774,20200408,3465
20200405,B,보정,644,626,20200408,1270
20200405,B,죽전,5200,5949,20200408,11149
20200405,B,구성,1441,1582,20200408,3023
20200405,B,신갈,1222,1239,20200408,2461
20200405,B,기흥,3228,3096,20200408,6324
20200405,B,상갈,1717,1850,20200408,3567
20200405,B,청명,1145,1147,20200408,2292
20200405,B,영통,3138,3057,20200408,6195
20200405,B,망포,3974,4187,20200408,8161
20200405,B,매탄권선,1513,1477,20200408,2990
20200405,B,수원시청,4503,4331,20200408,8834
20200405,B,매교,789,798,20200408,1587
20200406,B,선릉,11986,18714,20200409,30700
20200406,B,한티,10199,10837,20200409,21036
20200406,B,도곡,5008,5172,20200409,10180
20200406,B,구룡,1145,1170,20200409,2315
20200406,B,개포동,2621,2831,20200409,5452
20200406,B,대모산입구,2855,2589,20200409,5444
20200406,B,수서,10705,10777,20200409,21482
20200406,B,수원,6231,4369,20200409,10600
20200406,B,서울숲,8235,8492,20200409,16727
20200406,B,압구정로데오,13001,14434,20200409,27435
20200406,B,강남구청,7805,9017,20200409,16822
20200406,B,선정릉,7137,7814,20200409,14951
20200406,B,가천대,5606,6354,20200409,11960
20200406,B,태평,11462,11179,20200409,22641
20200406,B,모란,16545,16806,20200409,33351
20200406,B,야탑,20704,21677,20200409,42381
20200406,B,서현,18973,19087,20200409,38060
20200406,B,수내,10179,10123,20200409,20302
20200406,B,정자,12837,13737,20200409,26574
20200406,B,미금,12220,13293,20200409,25513
20200406,B,오리,9471,8102,20200409,17573
20200406,B,이매,4287,3990,20200409,8277
20200406,B,보정,1882,1599,20200409,3481
20200406,B,죽전,10170,10992,20200409,21162
20200406,B,구성,3866,3992,20200409,7858
20200406,B,신갈,3661,3609,20200409,7270
20200406,B,기흥,7533,7298,20200409,14831
20200406,B,상갈,4238,3991,20200409,8229
20200406,B,청명,3190,3009,20200409,6199
20200406,B,영통,6282,6357,20200409,12639
20200406,B,망포,10825,10483,20200409,21308
20200406,B,매탄권선,3434,3245,20200409,6679
20200406,B,수원시청,8982,9664,20200409,18646
20200406,B,매교,1867,1902,20200409,3769
20200407,B,선릉,11788,18589,20200410,30377
20200407,B,한티,10635,11286,20200410,21921
20200407,B,도곡,5038,5055,20200410,10093
20200407,B,구룡,1180,1184,20200410,2364
20200407,B,개포동,2611,2844,20200410,5455
20200407,B,대모산입구,2822,2608,20200410,5430
20200407,B,수서,10217,10484,20200410,20701
20200407,B,수원,6151,4290,20200410,10441
20200407,B,서울숲,8525,8697,20200410,17222
20200407,B,압구정로데오,13859,15493,20200410,29352
20200407,B,강남구청,8026,9181,20200410,17207
20200407,B,선정릉,7196,7777,20200410,14973
20200407,B,가천대,5488,6378,20200410,11866
20200407,B,태평,11522,11268,20200410,22790
20200407,B,모란,16411,16659,20200410,33070
20200407,B,야탑,20794,21914,20200410,42708
20200407,B,서현,18866,19253,20200410,38119
20200407,B,수내,10253,10274,20200410,20527
20200407,B,정자,13190,14116,20200410,27306
20200407,B,미금,12580,13372,20200410,25952
20200407,B,오리,9648,8111,20200410,17759
20200407,B,이매,4305,4127,20200410,8432
20200407,B,보정,1906,1607,20200410,3513
20200407,B,죽전,10337,11336,20200410,21673
20200407,B,구성,3873,3939,20200410,7812
20200407,B,신갈,3575,3502,20200410,7077
20200407,B,기흥,7525,7164,20200410,14689
20200407,B,상갈,4200,3964,20200410,8164
20200407,B,청명,3274,3113,20200410,6387
20200407,B,영통,5990,6134,20200410,12124
20200407,B,망포,10840,10311,20200410,21151
20200407,B,매탄권선,3443,3285,20200410,6728
20200407,B,수원시청,8815,9642,20200410,18457
20200407,B,매교,1775,1836,20200410,3611
20200408,B,선릉,11790,18526,20200411,30316
20200408,B,한티,10486,11261,20200411,21747
20200408,B,도곡,5011,5018,20200411,10029
20200408,B,구룡,1112,1138,20200411,2250
20200408,B,개포동,2692,2872,20200411,5564
20200408,B,대모산입구,2816,2636,20200411,5452
20200408,B,수서,10341,10500,20200411,20841
20200408,B,복정,1,0,20200411,1
20200408,B,수원,6342,4379,20200411,10721
20200408,B,서울숲,8594,8761,20200411,17355
20200408,B,압구정로데오,13796,15448,20200411,29244
20200408,B,강남구청,7998,9366,20200411,17364
20200408,B,선정릉,7217,7832,20200411,15049
20200408,B,가천대,5497,6297,20200411,11794
20200408,B,태평,11479,11268,20200411,22747
20200408,B,모란,16418,16509,20200411,32927
20200408,B,야탑,20866,21877,20200411,42743
20200408,B,서현,19265,19286,20200411,38551
20200408,B,수내,10296,10349,20200411,20645
20200408,B,정자,13233,14201,20200411,27434
20200408,B,미금,12584,13461,20200411,26045
20200408,B,오리,9747,8203,20200411,17950
20200408,B,이매,4278,4085,20200411,8363
20200408,B,보정,1952,1642,20200411,3594
20200408,B,죽전,10414,11364,20200411,21778
20200408,B,구성,3929,4011,20200411,7940
20200408,B,신갈,3617,3595,20200411,7212
20200408,B,기흥,7661,7245,20200411,14906
20200408,B,상갈,4256,3978,20200411,8234
20200408,B,청명,3174,3032,20200411,6206
20200408,B,영통,6136,6398,20200411,12534
20200408,B,망포,10895,10453,20200411,21348
20200408,B,매탄권선,3504,3399,20200411,6903
20200408,B,수원시청,9077,9941,20200411,19018
20200408,B,매교,1793,1835,20200411,3628
20200409,B,선릉,11900,18733,20200412,30633
20200409,B,한티,10442,11116,20200412,21558
20200409,B,도곡,4884,4967,20200412,9851
20200409,B,구룡,1159,1156,20200412,2315
20200409,B,개포동,2667,2924,20200412,5591
20200409,B,대모산입구,2839,2692,20200412,5531
20200409,B,수서,10777,10926,20200412,21703
20200409,B,수원,6377,4407,20200412,10784
20200409,B,서울숲,8271,8411,20200412,16682
20200409,B,압구정로데오,14176,15788,20200412,29964
20200409,B,강남구청,8037,9320,20200412,17357
20200409,B,선정릉,7139,7855,20200412,14994
20200409,B,가천대,5543,6420,20200412,11963
20200409,B,태평,11732,11441,20200412,23173
20200409,B,모란,20629,21394,20200412,42023
20200409,B,야탑,21112,22109,20200412,43221
20200409,B,서현,19301,19533,20200412,38834
20200409,B,수내,10305,10434,20200412,20739
20200409,B,정자,13361,14366,20200412,27727
20200409,B,미금,12542,13455,20200412,25997
20200409,B,오리,9718,8252,20200412,17970
20200409,B,이매,4419,4036,20200412,8455
20200409,B,보정,1895,1573,20200412,3468
20200409,B,죽전,10590,11429,20200412,22019
20200409,B,구성,3843,3996,20200412,7839
20200409,B,신갈,3619,3485,20200412,7104
20200409,B,기흥,7596,7308,20200412,14904
20200409,B,상갈,4259,4022,20200412,8281
20200409,B,청명,3284,3086,20200412,6370
20200409,B,영통,6208,6339,20200412,12547
20200409,B,망포,11014,10370,20200412,21384
20200409,B,매탄권선,3513,3378,20200412,6891
20200409,B,수원시청,8935,9981,20200412,18916
20200409,B,매교,1796,1820,20200412,3616
20200410,B,선릉,11852,18739,20200413,30591
20200410,B,한티,11034,11623,20200413,22657
20200410,B,도곡,5272,5237,20200413,10509
20200410,B,구룡,1151,1152,20200413,2303
20200410,B,개포동,2701,2899,20200413,5600
20200410,B,대모산입구,2862,2704,20200413,5566
20200410,B,수서,11936,12689,20200413,24625
20200410,B,수원,6932,4921,20200413,11853
20200410,B,서울숲,8443,8561,20200413,17004
20200410,B,압구정로데오,15216,17547,20200413,32763
20200410,B,강남구청,8296,9455,20200413,17751
20200410,B,선정릉,7289,7899,20200413,15188
20200410,B,가천대,5823,6344,20200413,12167
20200410,B,태평,12136,11606,20200413,23742
20200410,B,모란,17593,18064,20200413,35657
20200410,B,야탑,21983,23168,20200413,45151
20200410,B,서현,20299,20993,20200413,41292
20200410,B,수내,10859,10779,20200413,21638
20200410,B,정자,13814,15055,20200413,28869
20200410,B,미금,13085,13972,20200413,27057
20200410,B,오리,10040,8389,20200413,18429
20200410,B,이매,4390,4087,20200413,8477
20200410,B,보정,1952,1568,20200413,3520
20200410,B,죽전,11496,11982,20200413,23478
20200410,B,구성,3955,4038,20200413,7993
20200410,B,신갈,3613,3611,20200413,7224
20200410,B,기흥,7978,7420,20200413,15398
20200410,B,상갈,4515,4087,20200413,8602
20200410,B,청명,3523,3139,20200413,6662
20200410,B,영통,6992,7102,20200413,14094
20200410,B,망포,12175,11012,20200413,23187
20200410,B,매탄권선,3760,3510,20200413,7270
20200410,B,수원시청,9759,11948,20200413,21707
20200410,B,매교,1821,1878,20200413,3699
20200411,B,선릉,3603,5804,20200414,9407
20200411,B,한티,8022,7734,20200414,15756
20200411,B,도곡,2714,2400,20200414,5114
20200411,B,구룡,668,673,20200414,1341
20200411,B,개포동,1722,1627,20200414,3349
20200411,B,대모산입구,1725,1574,20200414,3299
20200411,B,수서,6105,6546,20200414,12651
20200411,B,복정,1,0,20200414,1
20200411,B,수원,4882,3358,20200414,8240
20200411,B,서울숲,5944,6383,20200414,12327
20200411,B,압구정로데오,11008,12907,20200414,23915
20200411,B,강남구청,3509,4131,20200414,7640
20200411,B,선정릉,2718,2784,20200414,5502
20200411,B,가천대,3335,3787,20200414,7122
20200411,B,태평,8509,7985,20200414,16494
20200411,B,모란,12169,12526,20200414,24695
20200411,B,야탑,12663,13359,20200414,26022
20200411,B,서현,13175,13530,20200414,26705
20200411,B,수내,6309,5809,20200414,12118
20200411,B,정자,7901,8110,20200414,16011
20200411,B,미금,8246,8431,20200414,16677
20200411,B,오리,5688,4779,20200414,10467
20200411,B,이매,2833,2653,20200414,5486
20200411,B,보정,1077,979,20200414,2056
20200411,B,죽전,7537,8326,20200414,15863
20200411,B,구성,2257,2335,20200414,4592
20200411,B,신갈,1971,1993,20200414,3964
20200411,B,기흥,4952,4742,20200414,9694
20200411,B,상갈,2822,2718,20200414,5540
20200411,B,청명,1794,1734,20200414,3528
20200411,B,영통,4702,4500,20200414,9202
20200411,B,망포,6451,5928,20200414,12379
20200411,B,매탄권선,2287,2097,20200414,4384
20200411,B,수원시청,7438,8760,20200414,16198
20200411,B,매교,1083,1185,20200414,2268
20200412,B,선릉,1819,2852,20200415,4671
20200412,B,한티,5645,5514,20200415,11159
20200412,B,도곡,1400,1420,20200415,2820
20200412,B,구룡,435,411,20200415,846
20200412,B,개포동,1163,1076,20200415,2239
20200412,B,대모산입구,1010,933,20200415,1943
20200412,B,수서,5581,5338,20200415,10919
20200412,B,수원,3383,2263,20200415,5646
20200412,B,서울숲,3663,3866,20200415,7529
20200412,B,압구정로데오,6454,7169,20200415,13623
20200412,B,강남구청,2142,2494,20200415,4636
20200412,B,선정릉,1551,1586,20200415,3137
20200412,B,가천대,2499,3041,20200415,5540
20200412,B,태평,5642,5366,20200415,11008
20200412,B,모란,8046,8313,20200415,16359
20200412,B,야탑,8996,9154,20200415,18150
20200412,B,서현,9191,9223,20200415,18414
20200412,B,수내,4216,4113,20200415,8329
20200412,B,정자,5150,5274,20200415,10424
20200412,B,미금,5030,5411,20200415,10441
20200412,B,오리,3938,3494,20200415,7432
20200412,B,이매,1860,1836,20200415,3696
20200412,B,보정,633,595,20200415,1228
20200412,B,죽전,5180,5836,20200415,11016
20200412,B,구성,1461,1607,20200415,3068
20200412,B,신갈,1249,1304,20200415,2553
20200412,B,기흥,3314,3274,20200415,6588
20200412,B,상갈,1877,1939,20200415,3816
20200412,B,청명,1177,1239,20200415,2416
20200412,B,영통,3028,3045,20200415,6073
20200412,B,망포,4169,4336,20200415,8505
20200412,B,매탄권선,1468,1411,20200415,2879
20200412,B,수원시청,5002,4796,20200415,9798
20200412,B,매교,749,764,20200415,1513
20200413,B,선릉,12042,19035,20200416,31077
20200413,B,한티,10536,11197,20200416,21733
20200413,B,도곡,5248,5299,20200416,10547
20200413,B,구룡,1121,1129,20200416,2250
20200413,B,개포동,2735,2847,20200416,5582
20200413,B,대모산입구,2923,2644,20200416,5567
20200413,B,수서,11008,11202,20200416,22210
20200413,B,복정,1,0,20200416,1
20200413,B,수원,6560,4431,20200416,10991
20200413,B,서울숲,7973,8159,20200416,16132
20200413,B,압구정로데오,12998,14530,20200416,27528
20200413,B,강남구청,7750,9022,20200416,16772
20200413,B,선정릉,7272,7948,20200416,15220
20200413,B,가천대,5417,6309,20200416,11726
20200413,B,태평,11642,11339,20200416,22981
20200413,B,모란,16843,17084,20200416,33927
20200413,B,야탑,21217,22325,20200416,43542
20200413,B,서현,19476,19609,20200416,39085
20200413,B,수내,10401,10347,20200416,20748
20200413,B,정자,13540,14511,20200416,28051
20200413,B,미금,12922,13928,20200416,26850
20200413,B,오리,9713,8351,20200416,18064
20200413,B,이매,4322,4028,20200416,8350
20200413,B,보정,1948,1593,20200416,3541
20200413,B,죽전,10724,11688,20200416,22412
20200413,B,구성,3987,4116,20200416,8103
20200413,B,신갈,3710,3554,20200416,7264
20200413,B,기흥,7997,7420,20200416,15417
20200413,B,상갈,4435,4158,20200416,8593
20200413,B,청명,3311,3160,20200416,6471
20200413,B,영통,6330,6437,20200416,12767
20200413,B,망포,11080,10622,20200416,21702
20200413,B,매탄권선,3541,3404,20200416,6945
20200413,B,수원시청,9363,10016,20200416,19379
20200413,B,매교,1931,1976,20200416,3907
20200414,B,선릉,11921,19173,20200417,31094
20200414,B,한티,10995,11618,20200417,22613
20200414,B,도곡,5275,5186,20200417,10461
20200414,B,구룡,1184,1175,20200417,2359
20200414,B,개포동,2777,2930,20200417,5707
20200414,B,대모산입구,2969,2721,20200417,5690
20200414,B,수서,11446,11763,20200417,23209
20200414,B,수원,6961,4723,20200417,11684
20200414,B,서울숲,8459,8461,20200417,16920
20200414,B,압구정로데오,14895,16923,20200417,31818
20200414,B,강남구청,8319,9605,20200417,17924
20200414,B,선정릉,7328,8162,20200417,15490
20200414,B,가천대,5644,6268,20200417,11912
20200414,B,태평,12478,11802,20200417,24280
20200414,B,모란,21850,22971,20200417,44821
20200414,B,야탑,22636,23627,20200417,46263
20200414,B,서현,20416,20792,20200417,41208
20200414,B,수내,10868,10813,20200417,21681
20200414,B,정자,14241,15568,20200417,29809
20200414,B,미금,13464,14319,20200417,27783
20200414,B,오리,10322,8579,20200417,18901
20200414,B,이매,4532,4311,20200417,8843
20200414,B,보정,2022,1696,20200417,3718
20200414,B,죽전,11444,12288,20200417,23732
20200414,B,구성,4163,4194,20200417,8357
20200414,B,신갈,3828,3684,20200417,7512
20200414,B,기흥,8168,7586,20200417,15754
20200414,B,상갈,4613,4271,20200417,8884
20200414,B,청명,3459,3189,20200417,6648
20200414,B,영통,6630,6819,20200417,13449
20200414,B,망포,11920,10851,20200417,22771
20200414,B,매탄권선,3823,3508,20200417,7331
20200414,B,수원시청,9589,11416,20200417,21005
20200414,B,매교,1976,1976,20200417,3952
20200415,B,선릉,2980,4829,20200418,7809
20200415,B,한티,6507,6591,20200418,13098
20200415,B,도곡,2377,2296,20200418,4673
20200415,B,구룡,607,649,20200418,1256
20200415,B,개포동,1504,1476,20200418,2980
20200415,B,대모산입구,1494,1395,20200418,2889
20200415,B,수서,5287,5390,20200418,10677
20200415,B,복정,2,0,20200418,2
20200415,B,수원,4182,2771,20200418,6953
20200415,B,서울숲,5401,5904,20200418,11305
20200415,B,압구정로데오,8665,9908,20200418,18573
20200415,B,강남구청,2900,3370,20200418,6270
20200415,B,선정릉,2190,2252,20200418,4442
20200415,B,가천대,2985,3566,20200418,6551
20200415,B,태평,7674,7250,20200418,14924
20200415,B,모란,10771,11000,20200418,21771
20200415,B,야탑,10959,11700,20200418,22659
20200415,B,서현,11521,11475,20200418,22996
20200415,B,수내,5366,5276,20200418,10642
20200415,B,정자,6948,7147,20200418,14095
20200415,B,미금,7008,7422,20200418,14430
20200415,B,오리,4926,4110,20200418,9036
20200415,B,이매,2463,2380,20200418,4843
20200415,B,보정,903,840,20200418,1743
20200415,B,죽전,6564,7365,20200418,13929
20200415,B,구성,1987,2115,20200418,4102
20200415,B,신갈,1769,1821,20200418,3590
20200415,B,기흥,4344,4284,20200418,8628
20200415,B,상갈,2498,2539,20200418,5037
20200415,B,청명,1501,1536,20200418,3037
20200415,B,영통,4148,4082,20200418,8230
20200415,B,망포,5673,5571,20200418,11244
20200415,B,매탄권선,1989,1930,20200418,3919
20200415,B,수원시청,5778,5997,20200418,11775
20200415,B,매교,1006,1080,20200418,2086
20200416,B,선릉,12070,18983,20200419,31053
20200416,B,한티,10682,11313,20200419,21995
20200416,B,도곡,5119,5136,20200419,10255
20200416,B,구룡,1169,1098,20200419,2267
20200416,B,개포동,2737,2890,20200419,5627
20200416,B,대모산입구,2853,2721,20200419,5574
20200416,B,수서,11213,11227,20200419,22440
20200416,B,복정,1,0,20200419,1
20200416,B,수원,6482,4570,20200419,11052
20200416,B,서울숲,8528,8632,20200419,17160
20200416,B,압구정로데오,14530,16218,20200419,30748
20200416,B,강남구청,8132,9430,20200419,17562
20200416,B,선정릉,7301,7877,20200419,15178
20200416,B,가천대,5464,6392,20200419,11856
20200416,B,태평,11810,11623,20200419,23433
20200416,B,모란,17031,17253,20200419,34284
20200416,B,야탑,21760,22519,20200419,44279
20200416,B,서현,19757,20007,20200419,39764
20200416,B,수내,10557,10722,20200419,21279
20200416,B,정자,13347,14310,20200419,27657
20200416,B,미금,12925,13845,20200419,26770
20200416,B,오리,9932,8578,20200419,18510
20200416,B,이매,4299,4079,20200419,8378
20200416,B,보정,1901,1626,20200419,3527
20200416,B,죽전,10971,11842,20200419,22813
20200416,B,구성,4015,4049,20200419,8064
20200416,B,신갈,3694,3621,20200419,7315
20200416,B,기흥,7987,7551,20200419,15538
20200416,B,상갈,4403,4141,20200419,8544
20200416,B,청명,3346,3125,20200419,6471
20200416,B,영통,6473,6600,20200419,13073
20200416,B,망포,11115,10513,20200419,21628
20200416,B,매탄권선,3635,3469,20200419,7104
20200416,B,수원시청,9289,10185,20200419,19474
20200416,B,매교,1882,1912,20200419,3794
20200417,B,선릉,11986,18996,20200420,30982
20200417,B,한티,11153,11871,20200420,23024
20200417,B,도곡,5260,5289,20200420,10549
20200417,B,구룡,1156,1104,20200420,2260
20200417,B,개포동,2698,2979,20200420,5677
20200417,B,대모산입구,2827,2576,20200420,5403
20200417,B,수서,12045,12563,20200420,24608
20200417,B,수원,6890,4861,20200420,11751
20200417,B,서울숲,7725,7803,20200420,15528
20200417,B,압구정로데오,14725,17326,20200420,32051
20200417,B,강남구청,8314,9520,20200420,17834
20200417,B,선정릉,7313,7813,20200420,15126
20200417,B,가천대,5783,6346,20200420,12129
20200417,B,태평,11945,11464,20200420,23409
20200417,B,모란,17183,17488,20200420,34671
20200417,B,야탑,21832,23242,20200420,45074
20200417,B,서현,20374,21075,20200420,41449
20200417,B,수내,10793,10833,20200420,21626
20200417,B,정자,13708,14846,20200420,28554
20200417,B,미금,12979,13807,20200420,26786
20200417,B,오리,10165,8511,20200420,18676
20200417,B,이매,4346,4095,20200420,8441
20200417,B,보정,1956,1677,20200420,3633
20200417,B,죽전,11509,12172,20200420,23681
20200417,B,구성,4054,4101,20200420,8155
20200417,B,신갈,3640,3565,20200420,7205
20200417,B,기흥,8105,7492,20200420,15597
20200417,B,상갈,4507,4050,20200420,8557
20200417,B,청명,3453,3102,20200420,6555
20200417,B,영통,6721,6858,20200420,13579
20200417,B,망포,12096,10907,20200420,23003
20200417,B,매탄권선,3883,3523,20200420,7406
20200417,B,수원시청,9615,11765,20200420,21380
20200417,B,매교,1809,1843,20200420,3652
20200418,B,선릉,3996,6470,20200421,10466
20200418,B,한티,8741,8375,20200421,17116
20200418,B,도곡,2937,2672,20200421,5609
20200418,B,구룡,695,705,20200421,1400
20200418,B,개포동,1731,1718,20200421,3449
20200418,B,대모산입구,1884,1674,20200421,3558
20200418,B,수서,6991,7149,20200421,14140
20200418,B,수원,5261,3575,20200421,8836
20200418,B,서울숲,6706,7275,20200421,13981
20200418,B,압구정로데오,11807,13930,20200421,25737
20200418,B,강남구청,3816,4685,20200421,8501
20200418,B,선정릉,2675,2877,20200421,5552
20200418,B,가천대,3638,3987,20200421,7625
20200418,B,태평,8978,8406,20200421,17384
20200418,B,모란,13092,13637,20200421,26729
20200418,B,야탑,13783,14453,20200421,28236
20200418,B,서현,14248,14983,20200421,29231
20200418,B,수내,7048,6536,20200421,13584
20200418,B,정자,8754,8685,20200421,17439
20200418,B,미금,8779,9143,20200421,17922
20200418,B,오리,6205,5135,20200421,11340
20200418,B,이매,3002,2766,20200421,5768
20200418,B,보정,1158,1032,20200421,2190
20200418,B,죽전,8063,8911,20200421,16974
20200418,B,구성,2522,2564,20200421,5086
20200418,B,신갈,2040,2129,20200421,4169
20200418,B,기흥,5213,4998,20200421,10211
20200418,B,상갈,2927,2931,20200421,5858
20200418,B,청명,2032,1901,20200421,3933
20200418,B,영통,5250,5155,20200421,10405
20200418,B,망포,7198,6350,20200421,13548
20200418,B,매탄권선,2596,2394,20200421,4990
20200418,B,수원시청,7617,9380,20200421,16997
20200418,B,매교,1226,1284,20200421,2510
20200419,B,선릉,1970,3003,20200422,4973
20200419,B,한티,5940,5614,20200422,11554
20200419,B,도곡,1578,1563,20200422,3141
20200419,B,구룡,385,381,20200422,766
20200419,B,개포동,1124,1131,20200422,2255
20200419,B,대모산입구,1089,1044,20200422,2133
20200419,B,수서,6099,5745,20200422,11844
20200419,B,수원,3474,2295,20200422,5769
20200419,B,서울숲,3022,3070,20200422,6092
20200419,B,압구정로데오,6018,6774,20200422,12792
20200419,B,강남구청,2150,2513,20200422,4663
20200419,B,선정릉,1436,1533,20200422,2969
20200419,B,가천대,2507,3245,20200422,5752
20200419,B,태평,6221,5910,20200422,12131
20200419,B,모란,13584,14050,20200422,27634
20200419,B,야탑,9186,9603,20200422,18789
20200419,B,서현,9778,9653,20200422,19431
20200419,B,수내,4411,4264,20200422,8675
20200419,B,정자,5266,5538,20200422,10804
20200419,B,미금,5323,5656,20200422,10979
20200419,B,오리,4044,3555,20200422,7599
20200419,B,이매,2049,2123,20200422,4172
20200419,B,보정,733,677,20200422,1410
20200419,B,죽전,5619,6397,20200422,12016
20200419,B,구성,1570,1775,20200422,3345
20200419,B,신갈,1377,1407,20200422,2784
20200419,B,기흥,3390,3499,20200422,6889
20200419,B,상갈,1994,2046,20200422,4040
20200419,B,청명,1215,1210,20200422,2425
20200419,B,영통,3187,3170,20200422,6357
20200419,B,망포,4193,4665,20200422,8858
20200419,B,매탄권선,1706,1552,20200422,3258
20200419,B,수원시청,5047,4838,20200422,9885
20200419,B,매교,778,762,20200422,1540
20200420,B,선릉,12308,19896,20200423,32204
20200420,B,한티,10902,11566,20200423,22468
20200420,B,도곡,5412,5485,20200423,10897
20200420,B,구룡,1144,1166,20200423,2310
20200420,B,개포동,2763,2975,20200423,5738
20200420,B,대모산입구,2924,2818,20200423,5742
20200420,B,수서,11376,11582,20200423,22958
20200420,B,수원,6474,4508,20200423,10982
20200420,B,서울숲,7649,7711,20200423,15360
20200420,B,압구정로데오,13487,14823,20200423,28310
20200420,B,강남구청,8044,9258,20200423,17302
20200420,B,선정릉,7401,8074,20200423,15475
20200420,B,가천대,5924,6925,20200423,12849
20200420,B,태평,12030,11897,20200423,23927
20200420,B,모란,17315,17498,20200423,34813
20200420,B,야탑,22319,23216,20200423,45535
20200420,B,서현,20737,20691,20200423,41428
20200420,B,수내,11094,11002,20200423,22096
20200420,B,정자,14191,15135,20200423,29326
20200420,B,미금,13365,14376,20200423,27741
20200420,B,오리,10035,8582,20200423,18617
20200420,B,이매,4436,4236,20200423,8672
20200420,B,보정,2026,1668,20200423,3694
20200420,B,죽전,10877,11856,20200423,22733
20200420,B,구성,4196,4182,20200423,8378
20200420,B,신갈,3867,3752,20200423,7619
20200420,B,기흥,8058,7516,20200423,15574
20200420,B,상갈,4441,4226,20200423,8667
20200420,B,청명,3358,3123,20200423,6481
20200420,B,영통,6434,6709,20200423,13143
20200420,B,망포,11268,10767,20200423,22035
20200420,B,매탄권선,3702,3540,20200423,7242
20200420,B,수원시청,9364,10090,20200423,19454
20200420,B,매교,1872,1922,20200423,3794
20200421,B,선릉,12452,19757,20200424,32209
20200421,B,한티,11157,11826,20200424,22983
20200421,B,도곡,5404,5529,20200424,10933
20200421,B,구룡,1148,1159,20200424,2307
20200421,B,개포동,2800,3009,20200424,5809
20200421,B,대모산입구,2996,2781,20200424,5777
20200421,B,수서,11453,11608,20200424,23061
20200421,B,복정,1,0,20200424,1
20200421,B,수원,6548,4543,20200424,11091
20200421,B,서울숲,8233,8360,20200424,16593
20200421,B,압구정로데오,14720,16359,20200424,31079
20200421,B,강남구청,8496,9947,20200424,18443
20200421,B,선정릉,7675,8073,20200424,15748
20200421,B,가천대,6242,7151,20200424,13393
20200421,B,태평,12093,11876,20200424,23969
20200421,B,모란,17537,17943,20200424,35480
20200421,B,야탑,22380,23670,20200424,46050
20200421,B,서현,21125,21262,20200424,42387
20200421,B,수내,11111,11104,20200424,22215
20200421,B,정자,14680,15645,20200424,30325
20200421,B,미금,13514,14621,20200424,28135
20200421,B,오리,10364,8649,20200424,19013
20200421,B,이매,4611,4433,20200424,9044
20200421,B,보정,2013,1685,20200424,3698
20200421,B,죽전,11266,12289,20200424,23555
20200421,B,구성,4189,4403,20200424,8592
20200421,B,신갈,3926,3825,20200424,7751
20200421,B,기흥,8173,7682,20200424,15855
20200421,B,상갈,4588,4309,20200424,8897
20200421,B,청명,3395,3273,20200424,6668
20200421,B,영통,6515,6685,20200424,13200
20200421,B,망포,11525,11046,20200424,22571
20200421,B,매탄권선,3733,3549,20200424,7282
20200421,B,수원시청,9607,10466,20200424,20073
20200421,B,매교,1936,1975,20200424,3911
20200422,B,선릉,12411,19628,20200425,32039
20200422,B,한티,11358,12001,20200425,23359
20200422,B,도곡,5244,5452,20200425,10696
20200422,B,구룡,1192,1157,20200425,2349
20200422,B,개포동,2834,3075,20200425,5909
20200422,B,대모산입구,3002,2807,20200425,5809
20200422,B,수서,11178,11577,20200425,22755
20200422,B,수원,6513,4556,20200425,11069
20200422,B,서울숲,8015,8130,20200425,16145
20200422,B,압구정로데오,14451,16206,20200425,30657
20200422,B,강남구청,8539,9951,20200425,18490
20200422,B,선정릉,7630,8160,20200425,15790
20200422,B,가천대,6066,7035,20200425,13101
20200422,B,태평,12150,11842,20200425,23992
20200422,B,모란,17493,17708,20200425,35201
20200422,B,야탑,22940,24277,20200425,47217
20200422,B,서현,21000,21253,20200425,42253
20200422,B,수내,10921,11115,20200425,22036
20200422,B,정자,14667,15751,20200425,30418
20200422,B,미금,13732,14619,20200425,28351
20200422,B,오리,10421,8660,20200425,19081
20200422,B,이매,4606,4349,20200425,8955
20200422,B,보정,2081,1735,20200425,3816
20200422,B,죽전,11183,12167,20200425,23350
20200422,B,구성,4120,4224,20200425,8344
20200422,B,신갈,3821,3754,20200425,7575
20200422,B,기흥,7965,7660,20200425,15625
20200422,B,상갈,4473,4247,20200425,8720
20200422,B,청명,3485,3306,20200425,6791
20200422,B,영통,6514,6599,20200425,13113
20200422,B,망포,11415,10864,20200425,22279
20200422,B,매탄권선,3681,3561,20200425,7242
20200422,B,수원시청,9639,10321,20200425,19960
20200422,B,매교,1864,1875,20200425,3739
20200423,B,선릉,12665,20120,20200426,32785
20200423,B,한티,11318,12109,20200426,23427
20200423,B,도곡,5440,5492,20200426,10932
20200423,B,구룡,1240,1218,20200426,2458
20200423,B,개포동,2800,3037,20200426,5837
20200423,B,대모산입구,3029,2904,20200426,5933
20200423,B,수서,11690,11922,20200426,23612
20200423,B,수원,6697,4617,20200426,11314
20200423,B,서울숲,8241,8201,20200426,16442
20200423,B,압구정로데오,15034,16769,20200426,31803
20200423,B,강남구청,8484,9791,20200426,18275
20200423,B,선정릉,7600,8140,20200426,15740
20200423,B,가천대,6261,6973,20200426,13234
20200423,B,태평,12349,11950,20200426,24299
20200423,B,모란,17616,17875,20200426,35491
20200423,B,야탑,22978,24104,20200426,47082
20200423,B,서현,21397,21749,20200426,43146
20200423,B,수내,11221,11226,20200426,22447
20200423,B,정자,14977,15859,20200426,30836
20200423,B,미금,13536,14383,20200426,27919
20200423,B,오리,10413,8817,20200426,19230
20200423,B,이매,4558,4302,20200426,8860
20200423,B,보정,2031,1689,20200426,3720
20200423,B,죽전,11436,12522,20200426,23958
20200423,B,구성,4208,4272,20200426,8480
20200423,B,신갈,3919,3823,20200426,7742
20200423,B,기흥,8147,7680,20200426,15827
20200423,B,상갈,4664,4407,20200426,9071
20200423,B,청명,3471,3256,20200426,6727
20200423,B,영통,6588,6744,20200426,13332
20200423,B,망포,11658,11053,20200426,22711
20200423,B,매탄권선,3715,3533,20200426,7248
20200423,B,수원시청,9493,10473,20200426,19966
20200423,B,매교,1924,1934,20200426,3858
20200424,B,선릉,12651,20373,20200427,33024
20200424,B,한티,12148,12795,20200427,24943
20200424,B,도곡,5734,5759,20200427,11493
20200424,B,구룡,1365,1289,20200427,2654
20200424,B,개포동,2975,3147,20200427,6122
20200424,B,대모산입구,3074,2903,20200427,5977
20200424,B,수서,13341,13896,20200427,27237
20200424,B,수원,7600,5352,20200427,12952
20200424,B,서울숲,8802,8827,20200427,17629
20200424,B,압구정로데오,16270,19245,20200427,35515
20200424,B,강남구청,8867,10224,20200427,19091
20200424,B,선정릉,7748,8297,20200427,16045
20200424,B,가천대,6627,7029,20200427,13656
20200424,B,태평,13129,12698,20200427,25827
20200424,B,모란,24415,25597,20200427,50012
20200424,B,야탑,24229,25528,20200427,49757
20200424,B,서현,23457,23910,20200427,47367
20200424,B,수내,11769,11771,20200427,23540
20200424,B,정자,15621,16991,20200427,32612
20200424,B,미금,14600,15522,20200427,30122
20200424,B,오리,11126,9286,20200427,20412
20200424,B,이매,4967,4710,20200427,9677
20200424,B,보정,2230,1815,20200427,4045
20200424,B,죽전,12746,13447,20200427,26193
20200424,B,구성,4490,4512,20200427,9002
20200424,B,신갈,4150,4041,20200427,8191
20200424,B,기흥,8623,8158,20200427,16781
20200424,B,상갈,4992,4569,20200427,9561
20200424,B,청명,3704,3421,20200427,7125
20200424,B,영통,7415,7591,20200427,15006
20200424,B,망포,13193,11837,20200427,25030
20200424,B,매탄권선,4296,3871,20200427,8167
20200424,B,수원시청,10342,12979,20200427,23321
20200424,B,매교,2042,2135,20200427,4177
20200425,B,선릉,4353,7271,20200428,11624
20200425,B,한티,9348,8994,20200428,18342
20200425,B,도곡,3299,3034,20200428,6333
20200425,B,구룡,707,672,20200428,1379
20200425,B,개포동,1908,1799,20200428,3707
20200425,B,대모산입구,1942,1773,20200428,3715
20200425,B,수서,7715,7782,20200428,15497
20200425,B,수원,5719,3920,20200428,9639
20200425,B,서울숲,6834,7341,20200428,14175
20200425,B,압구정로데오,12571,14826,20200428,27397
20200425,B,강남구청,4248,5330,20200428,9578
20200425,B,선정릉,2946,3128,20200428,6074
20200425,B,가천대,3987,4386,20200428,8373
20200425,B,태평,9283,8601,20200428,17884
20200425,B,모란,14047,14216,20200428,28263
20200425,B,야탑,14884,15801,20200428,30685
20200425,B,서현,15279,15827,20200428,31106
20200425,B,수내,7208,6713,20200428,13921
20200425,B,정자,9192,9349,20200428,18541
20200425,B,미금,9238,9615,20200428,18853
20200425,B,오리,6599,5430,20200428,12029
20200425,B,이매,3307,3143,20200428,6450
20200425,B,보정,1380,1255,20200428,2635
20200425,B,죽전,8577,9581,20200428,18158
20200425,B,구성,2679,2719,20200428,5398
20200425,B,신갈,2345,2291,20200428,4636
20200425,B,기흥,5763,5556,20200428,11319
20200425,B,상갈,3216,3094,20200428,6310
20200425,B,청명,2188,2095,20200428,4283
20200425,B,영통,5467,5392,20200428,10859
20200425,B,망포,7417,6664,20200428,14081
20200425,B,매탄권선,2779,2497,20200428,5276
20200425,B,수원시청,8741,10395,20200428,19136
20200425,B,매교,1349,1374,20200428,2723
20200426,B,선릉,2248,3565,20200429,5813
20200426,B,한티,6573,6287,20200429,12860
20200426,B,도곡,1837,1720,20200429,3557
20200426,B,구룡,432,447,20200429,879
20200426,B,개포동,1309,1279,20200429,2588
20200426,B,대모산입구,1182,1168,20200429,2350
20200426,B,수서,6424,6258,20200429,12682
20200426,B,복정,1,0,20200429,1
20200426,B,수원,4137,2797,20200429,6934
20200426,B,서울숲,5136,5471,20200429,10607
20200426,B,압구정로데오,6956,7887,20200429,14843
20200426,B,강남구청,2576,2967,20200429,5543
20200426,B,선정릉,1643,1683,20200429,3326
20200426,B,가천대,2788,3442,20200429,6230
20200426,B,태평,6752,6265,20200429,13017
20200426,B,모란,9459,9840,20200429,19299
20200426,B,야탑,10619,10931,20200429,21550
20200426,B,서현,10624,10679,20200429,21303
20200426,B,수내,4911,4809,20200429,9720
20200426,B,정자,6099,6354,20200429,12453
20200426,B,미금,5832,6319,20200429,12151
20200426,B,오리,4632,4032,20200429,8664
20200426,B,이매,2227,2259,20200429,4486
20200426,B,보정,926,926,20200429,1852
20200426,B,죽전,5999,6935,20200429,12934
20200426,B,구성,1827,1947,20200429,3774
20200426,B,신갈,1524,1524,20200429,3048
20200426,B,기흥,3960,3985,20200429,7945
20200426,B,상갈,2236,2417,20200429,4653
20200426,B,청명,1532,1451,20200429,2983
20200426,B,영통,3475,3395,20200429,6870
20200426,B,망포,4857,5048,20200429,9905
20200426,B,매탄권선,1816,1774,20200429,3590
20200426,B,수원시청,5850,5746,20200429,11596
20200426,B,매교,891,925,20200429,1816
20200427,B,선릉,12847,20455,20200430,33302
20200427,B,한티,11460,12232,20200430,23692
20200427,B,도곡,5864,5900,20200430,11764
20200427,B,구룡,1246,1267,20200430,2513
20200427,B,개포동,2896,3125,20200430,6021
20200427,B,대모산입구,3059,2898,20200430,5957
20200427,B,수서,12122,12202,20200430,24324
20200427,B,수원,6757,4674,20200430,11431
20200427,B,서울숲,8230,8508,20200430,16738
20200427,B,압구정로데오,14132,15933,20200430,30065
20200427,B,강남구청,8440,9878,20200430,18318
20200427,B,선정릉,7671,8326,20200430,15997
20200427,B,가천대,6433,7327,20200430,13760
20200427,B,태평,12621,12299,20200430,24920
20200427,B,모란,18257,18558,20200430,36815
20200427,B,야탑,23461,24378,20200430,47839
20200427,B,서현,21932,22027,20200430,43959
20200427,B,수내,11264,11402,20200430,22666
20200427,B,정자,15178,16271,20200430,31449
20200427,B,미금,14217,15154,20200430,29371
20200427,B,오리,10664,9131,20200430,19795
20200427,B,이매,4784,4521,20200430,9305
20200427,B,보정,2123,1821,20200430,3944
20200427,B,죽전,11778,12830,20200430,24608
20200427,B,구성,4306,4390,20200430,8696
20200427,B,신갈,3970,3944,20200430,7914
20200427,B,기흥,8515,8079,20200430,16594
20200427,B,상갈,4807,4493,20200430,9300
20200427,B,청명,3494,3309,20200430,6803
20200427,B,영통,6823,6861,20200430,13684
20200427,B,망포,11886,11209,20200430,23095
20200427,B,매탄권선,3855,3687,20200430,7542
20200427,B,수원시청,9833,10670,20200430,20503
20200427,B,매교,2030,2015,20200430,4045
20200428,B,선릉,13173,20611,20200501,33784
20200428,B,한티,12044,12550,20200501,24594
20200428,B,도곡,5909,5855,20200501,11764
20200428,B,구룡,1561,1569,20200501,3130
20200428,B,개포동,2962,3100,20200501,6062
20200428,B,대모산입구,3088,2957,20200501,6045
20200428,B,수서,12203,12545,20200501,24748
20200428,B,복정,1,0,20200501,1
20200428,B,수원,6875,4688,20200501,11563
20200428,B,서울숲,8858,9101,20200501,17959
20200428,B,압구정로데오,15494,17455,20200501,32949
20200428,B,강남구청,8773,10129,20200501,18902
20200428,B,선정릉,7868,8509,20200501,16377
20200428,B,가천대,6585,7367,20200501,13952
20200428,B,태평,12723,12297,20200501,25020
20200428,B,모란,18511,18637,20200501,37148
20200428,B,야탑,24073,25245,20200501,49318
20200428,B,서현,22050,22630,20200501,44680
20200428,B,수내,11738,11754,20200501,23492
20200428,B,정자,15569,16677,20200501,32246
20200428,B,미금,14572,15448,20200501,30020
20200428,B,오리,10914,9192,20200501,20106
20200428,B,이매,4796,4588,20200501,9384
20200428,B,보정,2166,1805,20200501,3971
20200428,B,죽전,12241,13130,20200501,25371
20200428,B,구성,4450,4466,20200501,8916
20200428,B,신갈,4058,3982,20200501,8040
20200428,B,기흥,8637,8169,20200501,16806
20200428,B,상갈,4989,4682,20200501,9671
20200428,B,청명,3615,3409,20200501,7024
20200428,B,영통,6826,7048,20200501,13874
20200428,B,망포,12026,11367,20200501,23393
20200428,B,매탄권선,3950,3740,20200501,7690
20200428,B,수원시청,9899,10724,20200501,20623
20200428,B,매교,2055,2038,20200501,4093
20200429,B,선릉,12886,20936,20200502,33822
20200429,B,한티,12505,13057,20200502,25562
20200429,B,도곡,5988,6022,20200502,12010
20200429,B,구룡,1318,1363,20200502,2681
20200429,B,개포동,3165,3348,20200502,6513
20200429,B,대모산입구,3245,3099,20200502,6344
20200429,B,수서,13811,15504,20200502,29315
20200429,B,복정,1,0,20200502,1
20200429,B,수원,7759,5419,20200502,13178
20200429,B,서울숲,9689,9680,20200502,19369
20200429,B,압구정로데오,15967,18859,20200502,34826
20200429,B,강남구청,9085,10551,20200502,19636
20200429,B,선정릉,7861,8511,20200502,16372
20200429,B,가천대,6958,7534,20200502,14492
20200429,B,태평,13563,13112,20200502,26675
20200429,B,모란,26171,27371,20200502,53542
20200429,B,야탑,25769,27060,20200502,52829
20200429,B,서현,23999,24500,20200502,48499
20200429,B,수내,12295,12210,20200502,24505
20200429,B,정자,16314,17569,20200502,33883
20200429,B,미금,15847,16825,20200502,32672
20200429,B,오리,11650,9654,20200502,21304
20200429,B,이매,5182,4820,20200502,10002
20200429,B,보정,2331,1904,20200502,4235
20200429,B,죽전,13481,14171,20200502,27652
20200429,B,구성,4656,4678,20200502,9334
20200429,B,신갈,4306,4166,20200502,8472
20200429,B,기흥,9144,8498,20200502,17642
20200429,B,상갈,5241,4791,20200502,10032
20200429,B,청명,3953,3605,20200502,7558
20200429,B,영통,7714,7865,20200502,15579
20200429,B,망포,13422,12048,20200502,25470
20200429,B,매탄권선,4411,3941,20200502,8352
20200429,B,수원시청,10512,12699,20200502,23211
20200429,B,매교,2020,2071,20200502,4091
20200430,B,선릉,3177,5030,20200503,8207
20200430,B,한티,6865,6675,20200503,13540
20200430,B,도곡,2644,2437,20200503,5081
20200430,B,구룡,663,625,20200503,1288
20200430,B,개포동,1666,1602,20200503,3268
20200430,B,대모산입구,1729,1528,20200503,3257
20200430,B,수서,6600,8887,20200503,15487
20200430,B,수원,4978,3516,20200503,8494
20200430,B,서울숲,7249,8044,20200503,15293
20200430,B,압구정로데오,9851,11792,20200503,21643
20200430,B,강남구청,3188,4121,20200503,7309
20200430,B,선정릉,2343,2428,20200503,4771
20200430,B,가천대,3766,3928,20200503,7694
20200430,B,태평,8662,7948,20200503,16610
20200430,B,모란,12323,12552,20200503,24875
20200430,B,야탑,13193,14107,20200503,27300
20200430,B,서현,13401,13695,20200503,27096
20200430,B,수내,6264,6054,20200503,12318
20200430,B,정자,8076,8027,20200503,16103
20200430,B,미금,8176,8281,20200503,16457
20200430,B,오리,5771,4614,20200503,10385
20200430,B,이매,3030,2891,20200503,5921
20200430,B,보정,1176,1032,20200503,2208
20200430,B,죽전,8377,8912,20200503,17289
20200430,B,구성,2513,2539,20200503,5052
20200430,B,신갈,2147,2121,20200503,4268
20200430,B,기흥,5278,4896,20200503,10174
20200430,B,상갈,3094,2960,20200503,6054
20200430,B,청명,1970,1801,20200503,3771
20200430,B,영통,4547,4542,20200503,9089
20200430,B,망포,6687,5799,20200503,12486
20200430,B,매탄권선,2423,2221,20200503,4644
20200430,B,수원시청,6101,6877,20200503,12978
20200430,B,매교,1165,1225,20200503,2390
20200501,B,매교,1327,1367,20200504,2694
20200501,B,수원시청,7202,8555,20200504,15757
20200501,B,매탄권선,2589,2359,20200504,4948
20200501,B,망포,7062,6484,20200504,13546
20200501,B,영통,5566,5398,20200504,10964
20200501,B,청명,2185,2107,20200504,4292
20200501,B,상갈,3314,3112,20200504,6426
20200501,B,기흥,5644,5521,20200504,11165
20200501,B,신갈,2402,2298,20200504,4700
20200501,B,구성,2778,2833,20200504,5611
20200501,B,죽전,8719,9677,20200504,18396
20200501,B,보정,1250,1098,20200504,2348
20200501,B,이매,3214,3147,20200504,6361
20200501,B,오리,6409,5290,20200504,11699
20200501,B,미금,9759,10036,20200504,19795
20200501,B,정자,8671,8902,20200504,17573
20200501,B,수내,7148,6892,20200504,14040
20200501,B,서현,15344,15749,20200504,31093
20200501,B,야탑,15279,16143,20200504,31422
20200501,B,모란,13566,14034,20200504,27600
20200501,B,태평,9577,8824,20200504,18401
20200501,B,가천대,4533,4648,20200504,9181
20200501,B,선정릉,2816,2919,20200504,5735
20200501,B,강남구청,4141,4961,20200504,9102
20200501,B,압구정로데오,11079,13242,20200504,24321
20200501,B,서울숲,6455,6846,20200504,13301
20200501,B,수원,5603,2995,20200504,8598
20200501,B,수서,7668,8724,20200504,16392
20200501,B,대모산입구,1675,1566,20200504,3241
20200501,B,개포동,1982,1987,20200504,3969
20200501,B,구룡,681,708,20200504,1389
20200501,B,도곡,3513,3281,20200504,6794
20200501,B,한티,8385,8670,20200504,17055
20200501,B,선릉,4325,6839,20200504,11164
20200502,B,모란,12876,13607,20200505,26483
20200502,B,가천대,3661,4038,20200505,7699
20200502,B,태평,8928,8478,20200505,17406
20200502,B,선정릉,2583,2626,20200505,5209
20200502,B,강남구청,3672,4468,20200505,8140
20200502,B,압구정로데오,10855,12837,20200505,23692
20200502,B,서울숲,6302,6860,20200505,13162
20200502,B,수원,5314,3132,20200505,8446
20200502,B,수서,8345,8112,20200505,16457
20200502,B,대모산입구,1692,1545,20200505,3237
20200502,B,개포동,1806,1778,20200505,3584
20200502,B,구룡,677,651,20200505,1328
20200502,B,도곡,3054,2816,20200505,5870
20200502,B,한티,9146,8630,20200505,17776
20200502,B,선릉,3740,5877,20200505,9617
20200502,B,야탑,14215,14874,20200505,29089
20200502,B,서현,14545,15004,20200505,29549
20200502,B,수내,7116,6629,20200505,13745
20200502,B,정자,8517,8811,20200505,17328
20200502,B,미금,8950,9343,20200505,18293
20200502,B,오리,6207,5257,20200505,11464
20200502,B,이매,3192,3123,20200505,6315
20200502,B,보정,1160,1087,20200505,2247
20200502,B,죽전,8268,9215,20200505,17483
20200502,B,구성,2660,2575,20200505,5235
20200502,B,신갈,2194,2179,20200505,4373
20200502,B,기흥,5395,5096,20200505,10491
20200502,B,상갈,3098,3097,20200505,6195
20200502,B,청명,1931,2022,20200505,3953
20200502,B,영통,4857,4798,20200505,9655
20200502,B,망포,6394,5893,20200505,12287
20200502,B,매탄권선,2390,2176,20200505,4566
20200502,B,수원시청,7559,8829,20200505,16388
20200502,B,매교,1217,1253,20200505,2470
20200503,B,매교,968,944,20200506,1912
20200503,B,수원시청,5136,5481,20200506,10617
20200503,B,매탄권선,1932,1890,20200506,3822
20200503,B,망포,4804,4941,20200506,9745
20200503,B,영통,3673,3697,20200506,7370
20200503,B,청명,1503,1442,20200506,2945
20200503,B,상갈,2298,2372,20200506,4670
20200503,B,기흥,4041,3988,20200506,8029
20200503,B,신갈,1573,1573,20200506,3146
20200503,B,구성,1968,2176,20200506,4144
20200503,B,죽전,6573,7571,20200506,14144
20200503,B,보정,856,829,20200506,1685
20200503,B,이매,2464,2400,20200506,4864
20200503,B,오리,4577,3975,20200506,8552
20200503,B,미금,6060,6563,20200506,12623
20200503,B,정자,5805,6203,20200506,12008
20200503,B,수내,5121,4948,20200506,10069
20200503,B,서현,10964,11353,20200506,22317
20200503,B,야탑,11146,11480,20200506,22626
20200503,B,모란,9728,10031,20200506,19759
20200503,B,태평,6807,6385,20200506,13192
20200503,B,가천대,2749,3480,20200506,6229
20200503,B,선정릉,1798,1805,20200506,3603
20200503,B,강남구청,2447,2888,20200506,5335
20200503,B,압구정로데오,6413,7376,20200506,13789
20200503,B,서울숲,4842,5095,20200506,9937
20200503,B,수원,4170,2293,20200506,6463
20200503,B,복정,1,0,20200506,1
20200503,B,수서,7920,6495,20200506,14415
20200503,B,대모산입구,1520,1479,20200506,2999
20200503,B,개포동,1376,1350,20200506,2726
20200503,B,구룡,503,529,20200506,1032
20200503,B,도곡,1967,1906,20200506,3873
20200503,B,한티,6836,6641,20200506,13477
20200503,B,선릉,2078,3308,20200506,5386
20200504,B,매교,1819,1823,20200507,3642
20200504,B,수원시청,9721,11703,20200507,21424
20200504,B,매탄권선,3462,3219,20200507,6681
20200504,B,망포,10168,9452,20200507,19620
20200504,B,영통,6797,7044,20200507,13841
20200504,B,청명,3140,2897,20200507,6037
20200504,B,상갈,4345,4096,20200507,8441
20200504,B,기흥,7636,7119,20200507,14755
20200504,B,신갈,3757,3581,20200507,7338
20200504,B,구성,3857,3880,20200507,7737
20200504,B,죽전,11192,12259,20200507,23451
20200504,B,보정,1905,1623,20200507,3528
20200504,B,이매,4488,4161,20200507,8649
20200504,B,오리,9264,7778,20200507,17042
20200504,B,미금,13968,14758,20200507,28726
20200504,B,정자,12864,13834,20200507,26698
20200504,B,수내,9842,9966,20200507,19808
20200504,B,서현,21300,21666,20200507,42966
20200504,B,야탑,21270,22222,20200507,43492
20200504,B,모란,22917,24400,20200507,47317
20200504,B,태평,12405,11879,20200507,24284
20200504,B,가천대,5965,6571,20200507,12536
20200504,B,선정릉,5379,5828,20200507,11207
20200504,B,강남구청,6704,7654,20200507,14358
20200504,B,압구정로데오,12498,14655,20200507,27153
20200504,B,서울숲,7840,7946,20200507,15786
20200504,B,수원,6852,4322,20200507,11174
20200504,B,수서,11110,10298,20200507,21408
20200504,B,대모산입구,2919,2636,20200507,5555
20200504,B,개포동,2708,2795,20200507,5503
20200504,B,구룡,1129,1052,20200507,2181
20200504,B,도곡,5052,4908,20200507,9960
20200504,B,한티,10976,11425,20200507,22401
20200504,B,선릉,9113,14805,20200507,23918
20200505,B,청명,1631,1542,20200508,3173
20200505,B,선릉,2620,4279,20200508,6899
20200505,B,한티,6292,6446,20200508,12738
20200505,B,도곡,2388,2327,20200508,4715
20200505,B,구룡,547,612,20200508,1159
20200505,B,개포동,1428,1378,20200508,2806
20200505,B,대모산입구,1540,1465,20200508,3005
20200505,B,수서,7394,6098,20200508,13492
20200505,B,복정,1,0,20200508,1
20200505,B,수원,4333,2638,20200508,6971
20200505,B,서울숲,5607,6041,20200508,11648
20200505,B,압구정로데오,8195,9453,20200508,17648
20200505,B,강남구청,2790,3345,20200508,6135
20200505,B,선정릉,1942,2038,20200508,3980
20200505,B,가천대,3369,3917,20200508,7286
20200505,B,태평,7715,7431,20200508,15146
20200505,B,모란,10806,11259,20200508,22065
20200505,B,야탑,11751,12239,20200508,23990
20200505,B,서현,12486,12623,20200508,25109
20200505,B,수내,5538,5606,20200508,11144
20200505,B,정자,6867,7149,20200508,14016
20200505,B,미금,7298,7868,20200508,15166
20200505,B,오리,4967,4253,20200508,9220
20200505,B,이매,2483,2514,20200508,4997
20200505,B,보정,912,835,20200508,1747
20200505,B,죽전,7162,8221,20200508,15383
20200505,B,구성,2123,2262,20200508,4385
20200505,B,신갈,1865,1854,20200508,3719
20200505,B,기흥,4626,4453,20200508,9079
20200505,B,매교,1028,973,20200508,2001
20200505,B,수원시청,5269,5504,20200508,10773
20200505,B,매탄권선,2037,1930,20200508,3967
20200505,B,망포,5195,5353,20200508,10548
20200505,B,영통,3882,3964,20200508,7846
20200505,B,상갈,2711,2748,20200508,5459
20200506,B,선릉,13377,21151,20200509,34528
20200506,B,한티,12596,13432,20200509,26028
20200506,B,도곡,6124,6231,20200509,12355
20200506,B,구룡,1327,1368,20200509,2695
20200506,B,개포동,3326,3474,20200509,6800
20200506,B,대모산입구,3265,3102,20200509,6367
20200506,B,수서,12679,12657,20200509,25336
20200506,B,복정,1,0,20200509,1
20200506,B,수원,7445,4766,20200509,12211
20200506,B,서울숲,9302,9503,20200509,18805
20200506,B,압구정로데오,15681,17609,20200509,33290
20200506,B,강남구청,9112,10587,20200509,19699
20200506,B,선정릉,8228,8832,20200509,17060
20200506,B,가천대,6790,7633,20200509,14423
20200506,B,태평,13257,12918,20200509,26175
20200506,B,모란,19292,19458,20200509,38750
20200506,B,야탑,25164,26446,20200509,51610
20200506,B,서현,23870,24304,20200509,48174
20200506,B,수내,12377,12528,20200509,24905
20200506,B,정자,16198,17535,20200509,33733
20200506,B,미금,15413,16353,20200509,31766
20200506,B,오리,11604,9758,20200509,21362
20200506,B,이매,5195,4835,20200509,10030
20200506,B,보정,2361,1969,20200509,4330
20200506,B,죽전,12929,14061,20200509,26990
20200506,B,구성,4805,4852,20200509,9657
20200506,B,신갈,4444,4332,20200509,8776
20200506,B,기흥,9162,8719,20200509,17881
20200506,B,상갈,5183,4887,20200509,10070
20200506,B,청명,3930,3663,20200509,7593
20200506,B,영통,7477,7716,20200509,15193
20200506,B,망포,12614,12004,20200509,24618
20200506,B,매탄권선,4050,3904,20200509,7954
20200506,B,수원시청,10401,11291,20200509,21692
20200506,B,매교,2186,2181,20200509,4367
20200507,B,선릉,13390,21166,20200510,34556
20200507,B,한티,12616,13465,20200510,26081
20200507,B,도곡,6219,6332,20200510,12551
20200507,B,구룡,1374,1286,20200510,2660
20200507,B,개포동,3131,3367,20200510,6498
20200507,B,대모산입구,3398,3150,20200510,6548
20200507,B,수서,13035,13477,20200510,26512
20200507,B,수원,7503,5215,20200510,12718
20200507,B,서울숲,9275,9411,20200510,18686
20200507,B,압구정로데오,15925,18148,20200510,34073
20200507,B,강남구청,9218,10801,20200510,20019
20200507,B,선정릉,8123,8801,20200510,16924
20200507,B,가천대,6983,7755,20200510,14738
20200507,B,태평,13448,13061,20200510,26509
20200507,B,모란,19398,19599,20200510,38997
20200507,B,야탑,25647,26949,20200510,52596
20200507,B,서현,24441,24637,20200510,49078
20200507,B,수내,12437,12745,20200510,25182
20200507,B,정자,16605,17866,20200510,34471
20200507,B,미금,15594,16530,20200510,32124
20200507,B,오리,11465,9727,20200510,21192
20200507,B,이매,5241,4904,20200510,10145
20200507,B,보정,2389,2017,20200510,4406
20200507,B,죽전,13378,14290,20200510,27668
20200507,B,구성,4770,4877,20200510,9647
20200507,B,신갈,4452,4367,20200510,8819
20200507,B,기흥,9240,8759,20200510,17999
20200507,B,상갈,5268,4952,20200510,10220
20200507,B,청명,3963,3664,20200510,7627
20200507,B,영통,7747,7799,20200510,15546
20200507,B,망포,12901,12149,20200510,25050
20200507,B,매탄권선,4277,4005,20200510,8282
20200507,B,수원시청,10351,11381,20200510,21732
20200507,B,매교,2084,2043,20200510,4127
20200508,B,선릉,13659,20717,20200511,34376
20200508,B,한티,13555,14342,20200511,27897
20200508,B,도곡,6409,6731,20200511,13140
20200508,B,구룡,1312,1334,20200511,2646
20200508,B,개포동,3297,3555,20200511,6852
20200508,B,대모산입구,3293,3187,20200511,6480
20200508,B,수서,14364,15735,20200511,30099
20200508,B,수원,8031,5727,20200511,13758
20200508,B,서울숲,9292,9133,20200511,18425
20200508,B,압구정로데오,17421,19307,20200511,36728
20200508,B,강남구청,9861,10959,20200511,20820
20200508,B,선정릉,8589,8847,20200511,17436
20200508,B,가천대,7158,7464,20200511,14622
20200508,B,태평,13505,13486,20200511,26991
20200508,B,모란,19691,19955,20200511,39646
20200508,B,야탑,26010,28196,20200511,54206
20200508,B,서현,24876,25484,20200511,50360
20200508,B,수내,12747,12848,20200511,25595
20200508,B,정자,16680,18175,20200511,34855
20200508,B,미금,15503,16607,20200511,32110
20200508,B,오리,11690,9795,20200511,21485
20200508,B,이매,5223,5009,20200511,10232
20200508,B,보정,2299,1943,20200511,4242
20200508,B,죽전,13836,14619,20200511,28455
20200508,B,구성,4861,4950,20200511,9811
20200508,B,신갈,4501,4460,20200511,8961
20200508,B,기흥,9480,9017,20200511,18497
20200508,B,상갈,5363,5000,20200511,10363
20200508,B,청명,4049,3847,20200511,7896
20200508,B,영통,8043,8253,20200511,16296
20200508,B,망포,13800,12738,20200511,26538
20200508,B,매탄권선,4451,4216,20200511,8667
20200508,B,수원시청,10605,12518,20200511,23123
20200508,B,매교,2192,2171,20200511,4363
20200509,B,선릉,4396,7402,20200512,11798
20200509,B,한티,9800,9287,20200512,19087
20200509,B,도곡,3413,3133,20200512,6546
20200509,B,구룡,968,880,20200512,1848
20200509,B,개포동,1935,1923,20200512,3858
20200509,B,대모산입구,1974,1717,20200512,3691
20200509,B,수서,8497,8729,20200512,17226
20200509,B,수원,5202,3495,20200512,8697
20200509,B,서울숲,4553,4639,20200512,9192
20200509,B,압구정로데오,11723,13545,20200512,25268
20200509,B,강남구청,4194,5218,20200512,9412
20200509,B,선정릉,3198,3396,20200512,6594
20200509,B,가천대,3719,4263,20200512,7982
20200509,B,태평,9091,8586,20200512,17677
20200509,B,모란,15162,15953,20200512,31115
20200509,B,야탑,14557,15319,20200512,29876
20200509,B,서현,14736,14979,20200512,29715
20200509,B,수내,6972,6581,20200512,13553
20200509,B,정자,8710,8833,20200512,17543
20200509,B,미금,8898,9277,20200512,18175
20200509,B,오리,6043,4943,20200512,10986
20200509,B,이매,3364,2970,20200512,6334
20200509,B,보정,1200,1137,20200512,2337
20200509,B,죽전,7727,8784,20200512,16511
20200509,B,구성,2597,2595,20200512,5192
20200509,B,신갈,2112,2108,20200512,4220
20200509,B,기흥,5267,4957,20200512,10224
20200509,B,상갈,2902,2870,20200512,5772
20200509,B,청명,2231,2115,20200512,4346
20200509,B,영통,5115,5193,20200512,10308
20200509,B,망포,7101,6375,20200512,13476
20200509,B,매탄권선,2523,2271,20200512,4794
20200509,B,수원시청,7913,9435,20200512,17348
20200509,B,매교,1180,1183,20200512,2363
20200510,B,선릉,2359,3777,20200513,6136
20200510,B,한티,7072,6892,20200513,13964
20200510,B,도곡,2004,2053,20200513,4057
20200510,B,구룡,490,492,20200513,982
20200510,B,개포동,1420,1574,20200513,2994
20200510,B,대모산입구,1299,1246,20200513,2545
20200510,B,수서,7822,6806,20200513,14628
20200510,B,복정,2,0,20200513,2
20200510,B,수원,4428,3011,20200513,7439
20200510,B,서울숲,4387,4640,20200513,9027
20200510,B,압구정로데오,7147,8016,20200513,15163
20200510,B,강남구청,2549,3178,20200513,5727
20200510,B,선정릉,1932,2114,20200513,4046
20200510,B,가천대,3010,3928,20200513,6938
20200510,B,태평,7050,6685,20200513,13735
20200510,B,모란,9872,10196,20200513,20068
20200510,B,야탑,11727,12080,20200513,23807
20200510,B,서현,11648,11736,20200513,23384
20200510,B,수내,5159,5017,20200513,10176
20200510,B,정자,6179,6528,20200513,12707
20200510,B,미금,6113,6623,20200513,12736
20200510,B,오리,4760,4092,20200513,8852
20200510,B,이매,2446,2576,20200513,5022
20200510,B,보정,880,830,20200513,1710
20200510,B,죽전,6549,7542,20200513,14091
20200510,B,구성,1975,2059,20200513,4034
20200510,B,신갈,1661,1691,20200513,3352
20200510,B,기흥,4226,3911,20200513,8137
20200510,B,상갈,2427,2515,20200513,4942
20200510,B,청명,1581,1581,20200513,3162
20200510,B,영통,3661,3737,20200513,7398
20200510,B,망포,5146,5452,20200513,10598
20200510,B,매탄권선,1914,1888,20200513,3802
20200510,B,수원시청,5800,5935,20200513,11735
20200510,B,매교,960,950,20200513,1910
20200511,B,매교,2217,2197,20200514,4414
20200511,B,수원시청,10088,10934,20200514,21022
20200511,B,매탄권선,4066,3917,20200514,7983
20200511,B,망포,12437,11866,20200514,24303
20200511,B,영통,7344,7652,20200514,14996
20200511,B,청명,3843,3582,20200514,7425
20200511,B,상갈,5091,4806,20200514,9897
20200511,B,기흥,9019,8489,20200514,17508
20200511,B,신갈,4354,4148,20200514,8502
20200511,B,구성,4597,4841,20200514,9438
20200511,B,죽전,12339,13516,20200514,25855
20200511,B,보정,2302,1940,20200514,4242
20200511,B,이매,5015,4708,20200514,9723
20200511,B,오리,11174,9304,20200514,20478
20200511,B,미금,14790,15701,20200514,30491
20200511,B,정자,15814,17033,20200514,32847
20200511,B,수내,11790,11834,20200514,23624
20200511,B,서현,23080,23349,20200514,46429
20200511,B,야탑,24534,25693,20200514,50227
20200511,B,모란,18824,19185,20200514,38009
20200511,B,태평,13004,12794,20200514,25798
20200511,B,가천대,7083,8054,20200514,15137
20200511,B,선정릉,8067,8631,20200514,16698
20200511,B,강남구청,9003,10385,20200514,19388
20200511,B,압구정로데오,14584,16286,20200514,30870
20200511,B,서울숲,8514,8645,20200514,17159
20200511,B,수원,7310,5086,20200514,12396
20200511,B,복정,1,0,20200514,1
20200511,B,수서,12764,12940,20200514,25704
20200511,B,대모산입구,3297,3107,20200514,6404
20200511,B,개포동,3082,3333,20200514,6415
20200511,B,구룡,1360,1302,20200514,2662
20200511,B,도곡,6129,6287,20200514,12416
20200511,B,한티,12035,13012,20200514,25047
20200511,B,선릉,13321,20954,20200514,34275
20200512,B,선릉,13112,20755,20200515,33867
20200512,B,한티,12203,12941,20200515,25144
20200512,B,도곡,6145,6103,20200515,12248
20200512,B,구룡,1306,1293,20200515,2599
20200512,B,개포동,3037,3198,20200515,6235
20200512,B,대모산입구,3282,3061,20200515,6343
20200512,B,수서,12494,12565,20200515,25059
20200512,B,수원,7084,4945,20200515,12029
20200512,B,서울숲,8700,8906,20200515,17606
20200512,B,압구정로데오,15632,17569,20200515,33201
20200512,B,강남구청,9183,10568,20200515,19751
20200512,B,선정릉,7863,8478,20200515,16341
20200512,B,가천대,6918,7732,20200515,14650
20200512,B,태평,12943,12701,20200515,25644
20200512,B,모란,18679,18977,20200515,37656
20200512,B,야탑,24496,25674,20200515,50170
20200512,B,서현,22665,23228,20200515,45893
20200512,B,수내,11705,11743,20200515,23448
20200512,B,정자,16013,17070,20200515,33083
20200512,B,미금,14794,15714,20200515,30508
20200512,B,오리,11110,9373,20200515,20483
20200512,B,이매,5029,4864,20200515,9893
20200512,B,보정,2292,1911,20200515,4203
20200512,B,죽전,12625,13473,20200515,26098
20200512,B,구성,4677,4736,20200515,9413
20200512,B,신갈,4302,4269,20200515,8571
20200512,B,기흥,8851,8409,20200515,17260
20200512,B,상갈,5068,4748,20200515,9816
20200512,B,청명,3720,3569,20200515,7289
20200512,B,영통,7095,7409,20200515,14504
20200512,B,망포,12374,11730,20200515,24104
20200512,B,매탄권선,4009,3815,20200515,7824
20200512,B,수원시청,10047,10963,20200515,21010
20200512,B,매교,2172,2232,20200515,4404
20200513,B,선릉,13232,20766,20200516,33998
20200513,B,한티,12176,13121,20200516,25297
20200513,B,도곡,6128,6210,20200516,12338
20200513,B,구룡,1306,1312,20200516,2618
20200513,B,개포동,3245,3487,20200516,6732
20200513,B,대모산입구,3251,3094,20200516,6345
20200513,B,수서,12635,12955,20200516,25590
20200513,B,수원,7316,5029,20200516,12345
20200513,B,서울숲,9417,9485,20200516,18902
20200513,B,압구정로데오,15643,17439,20200516,33082
20200513,B,강남구청,9254,10657,20200516,19911
20200513,B,선정릉,7973,8667,20200516,16640
20200513,B,가천대,7115,7836,20200516,14951
20200513,B,태평,12933,12568,20200516,25501
20200513,B,모란,18718,19030,20200516,37748
20200513,B,야탑,24767,26042,20200516,50809
20200513,B,서현,23286,23435,20200516,46721
20200513,B,수내,12065,12140,20200516,24205
20200513,B,정자,15856,17177,20200516,33033
20200513,B,미금,14818,15787,20200516,30605
20200513,B,오리,11220,9325,20200516,20545
20200513,B,이매,5041,4835,20200516,9876
20200513,B,보정,2300,1937,20200516,4237
20200513,B,죽전,12614,13792,20200516,26406
20200513,B,구성,4620,4696,20200516,9316
20200513,B,신갈,4241,4138,20200516,8379
20200513,B,기흥,8846,8435,20200516,17281
20200513,B,상갈,5108,4756,20200516,9864
20200513,B,청명,3760,3504,20200516,7264
20200513,B,영통,7197,7378,20200516,14575
20200513,B,망포,12439,11981,20200516,24420
20200513,B,매탄권선,4052,3831,20200516,7883
20200513,B,수원시청,10233,11272,20200516,21505
20200513,B,매교,2109,2181,20200516,4290
20200514,B,매교,2093,2131,20200517,4224
20200514,B,수원시청,10071,10993,20200517,21064
20200514,B,매탄권선,3990,3822,20200517,7812
20200514,B,망포,12403,11701,20200517,24104
20200514,B,영통,7163,7384,20200517,14547
20200514,B,청명,3695,3586,20200517,7281
20200514,B,상갈,5145,4755,20200517,9900
20200514,B,기흥,8837,8393,20200517,17230
20200514,B,신갈,4312,4218,20200517,8530
20200514,B,구성,4636,4722,20200517,9358
20200514,B,죽전,13035,13967,20200517,27002
20200514,B,보정,2308,1903,20200517,4211
20200514,B,이매,5239,4850,20200517,10089
20200514,B,오리,11108,9439,20200517,20547
20200514,B,미금,14701,15782,20200517,30483
20200514,B,정자,15785,17290,20200517,33075
20200514,B,수내,11882,11969,20200517,23851
20200514,B,서현,23243,23647,20200517,46890
20200514,B,야탑,24825,25855,20200517,50680
20200514,B,모란,24735,25671,20200517,50406
20200514,B,태평,13246,12840,20200517,26086
20200514,B,가천대,7112,7904,20200517,15016
20200514,B,선정릉,7843,8501,20200517,16344
20200514,B,강남구청,9042,10483,20200517,19525
20200514,B,압구정로데오,15596,17729,20200517,33325
20200514,B,서울숲,8951,9206,20200517,18157
20200514,B,수원,7137,4939,20200517,12076
20200514,B,수서,13101,13124,20200517,26225
20200514,B,대모산입구,3349,3092,20200517,6441
20200514,B,개포동,3063,3314,20200517,6377
20200514,B,구룡,1331,1292,20200517,2623
20200514,B,도곡,6091,6159,20200517,12250
20200514,B,한티,12032,13068,20200517,25100
20200514,B,선릉,13065,20518,20200517,33583
20200515,B,매교,2099,2098,20200518,4197
20200515,B,수원시청,10230,11835,20200518,22065
20200515,B,매탄권선,4065,3889,20200518,7954
20200515,B,망포,13002,12023,20200518,25025
20200515,B,영통,7556,7773,20200518,15329
20200515,B,청명,3732,3526,20200518,7258
20200515,B,상갈,4943,4697,20200518,9640
20200515,B,기흥,8965,8255,20200518,17220
20200515,B,신갈,4123,4024,20200518,8147
20200515,B,구성,4476,4602,20200518,9078
20200515,B,죽전,12889,13649,20200518,26538
20200515,B,보정,2249,1844,20200518,4093
20200515,B,이매,5041,4654,20200518,9695
20200515,B,오리,10933,9334,20200518,20267
20200515,B,미금,14559,15378,20200518,29937
20200515,B,정자,16290,17512,20200518,33802
20200515,B,수내,11945,12240,20200518,24185
20200515,B,서현,23565,24346,20200518,47911
20200515,B,야탑,24471,26106,20200518,50577
20200515,B,모란,18364,18943,20200518,37307
20200515,B,태평,12807,12393,20200518,25200
20200515,B,가천대,6936,7459,20200518,14395
20200515,B,선정릉,8117,8563,20200518,16680
20200515,B,강남구청,9289,10612,20200518,19901
20200515,B,압구정로데오,16490,19067,20200518,35557
20200515,B,서울숲,8219,8055,20200518,16274
20200515,B,수원,7192,5158,20200518,12350
20200515,B,복정,1,0,20200518,1
20200515,B,수서,13883,14766,20200518,28649
20200515,B,대모산입구,3104,2888,20200518,5992
20200515,B,개포동,3207,3472,20200518,6679
20200515,B,구룡,1254,1232,20200518,2486
20200515,B,도곡,6126,6271,20200518,12397
20200515,B,한티,12686,13608,20200518,26294
20200515,B,선릉,13109,20633,20200518,33742
20200516,B,매교,1389,1467,20200519,2856
20200516,B,수원시청,8391,9718,20200519,18109
20200516,B,매탄권선,2784,2566,20200519,5350
20200516,B,망포,7550,6823,20200519,14373
20200516,B,영통,5433,5537,20200519,10970
20200516,B,청명,2163,2075,20200519,4238
20200516,B,상갈,3217,3237,20200519,6454
20200516,B,기흥,5807,5605,20200519,11412
20200516,B,신갈,2379,2318,20200519,4697
20200516,B,구성,2727,2729,20200519,5456
20200516,B,죽전,9031,10251,20200519,19282
20200516,B,보정,1440,1313,20200519,2753
20200516,B,이매,3696,3410,20200519,7106
20200516,B,오리,6925,5965,20200519,12890
20200516,B,미금,9927,10192,20200519,20119
20200516,B,정자,9756,9957,20200519,19713
20200516,B,수내,7761,7072,20200519,14833
20200516,B,서현,16484,16923,20200519,33407
20200516,B,야탑,15735,16819,20200519,32554
20200516,B,모란,13897,14467,20200519,28364
20200516,B,태평,9749,9125,20200519,18874
20200516,B,가천대,4371,4788,20200519,9159
20200516,B,선정릉,3214,3255,20200519,6469
20200516,B,강남구청,4524,5641,20200519,10165
20200516,B,압구정로데오,12593,14736,20200519,27329
20200516,B,서울숲,6208,6289,20200519,12497
20200516,B,수원,5614,3814,20200519,9428
20200516,B,수서,8671,9253,20200519,17924
20200516,B,대모산입구,2646,2393,20200519,5039
20200516,B,개포동,2022,2006,20200519,4028
20200516,B,구룡,777,717,20200519,1494
20200516,B,도곡,3631,3324,20200519,6955
20200516,B,한티,9704,9365,20200519,19069
20200516,B,선릉,4871,7940,20200519,12811
20200517,B,복정,1,0,20200520,1
20200517,B,매교,1036,1006,20200520,2042
20200517,B,수원시청,5839,5879,20200520,11718
20200517,B,매탄권선,2048,1887,20200520,3935
20200517,B,망포,5247,5319,20200520,10566
20200517,B,영통,3858,3966,20200520,7824
20200517,B,청명,1626,1544,20200520,3170
20200517,B,상갈,2475,2485,20200520,4960
20200517,B,기흥,4291,4142,20200520,8433
20200517,B,신갈,1658,1675,20200520,3333
20200517,B,구성,1992,2160,20200520,4152
20200517,B,죽전,7019,7953,20200520,14972
20200517,B,보정,924,878,20200520,1802
20200517,B,이매,2645,2596,20200520,5241
20200517,B,오리,4722,4247,20200520,8969
20200517,B,미금,6466,6829,20200520,13295
20200517,B,정자,6386,6631,20200520,13017
20200517,B,수내,5346,5235,20200520,10581
20200517,B,서현,11616,11793,20200520,23409
20200517,B,야탑,11687,12067,20200520,23754
20200517,B,모란,10291,10579,20200520,20870
20200517,B,태평,7237,6732,20200520,13969
20200517,B,가천대,3121,3789,20200520,6910
20200517,B,선정릉,2002,2081,20200520,4083
20200517,B,강남구청,2488,3084,20200520,5572
20200517,B,압구정로데오,7201,8184,20200520,15385
20200517,B,서울숲,4671,4929,20200520,9600
20200517,B,수원,4257,2834,20200520,7091
20200517,B,수서,7329,7038,20200520,14367
20200517,B,대모산입구,1399,1355,20200520,2754
20200517,B,개포동,1557,1551,20200520,3108
20200517,B,구룡,535,548,20200520,1083
20200517,B,도곡,2116,2024,20200520,4140
20200517,B,한티,6756,6594,20200520,13350
20200517,B,선릉,2422,3742,20200520,6164
20200518,B,망포,11823,11436,20200521,23259
20200518,B,선릉,13338,20644,20200521,33982
20200518,B,한티,11960,12950,20200521,24910
20200518,B,도곡,6044,6289,20200521,12333
20200518,B,구룡,1261,1236,20200521,2497
20200518,B,개포동,3007,3298,20200521,6305
20200518,B,대모산입구,3226,3028,20200521,6254
20200518,B,수서,12499,12867,20200521,25366
20200518,B,수원,6718,4793,20200521,11511
20200518,B,서울숲,8033,8144,20200521,16177
20200518,B,압구정로데오,14395,15634,20200521,30029
20200518,B,강남구청,8837,10173,20200521,19010
20200518,B,선정릉,8049,8401,20200521,16450
20200518,B,가천대,6580,7523,20200521,14103
20200518,B,태평,12681,12266,20200521,24947
20200518,B,모란,18015,18120,20200521,36135
20200518,B,야탑,23848,24852,20200521,48700
20200518,B,서현,22772,23115,20200521,45887
20200518,B,수내,11793,11928,20200521,23721
20200518,B,정자,15299,16707,20200521,32006
20200518,B,미금,14266,15407,20200521,29673
20200518,B,오리,10782,9160,20200521,19942
20200518,B,이매,4927,4705,20200521,9632
20200518,B,보정,2206,1838,20200521,4044
20200518,B,죽전,11840,13077,20200521,24917
20200518,B,구성,4517,4640,20200521,9157
20200518,B,신갈,4140,4106,20200521,8246
20200518,B,기흥,8693,8152,20200521,16845
20200518,B,상갈,4869,4671,20200521,9540
20200518,B,청명,3599,3548,20200521,7147
20200518,B,영통,6796,7125,20200521,13921
20200518,B,매탄권선,3766,3624,20200521,7390
20200518,B,수원시청,9677,10415,20200521,20092
20200518,B,매교,2140,2161,20200521,4301
20200519,B,구룡,1253,1233,20200522,2486
20200519,B,도곡,6061,6139,20200522,12200
20200519,B,한티,11961,12898,20200522,24859
20200519,B,선릉,13204,20917,20200522,34121
20200519,B,대모산입구,3260,2955,20200522,6215
20200519,B,수서,12511,12563,20200522,25074
20200519,B,수원,6815,4741,20200522,11556
20200519,B,서울숲,8492,8510,20200522,17002
20200519,B,압구정로데오,15229,17357,20200522,32586
20200519,B,강남구청,9128,10518,20200522,19646
20200519,B,선정릉,7888,8573,20200522,16461
20200519,B,가천대,6733,7600,20200522,14333
20200519,B,태평,12883,12532,20200522,25415
20200519,B,모란,21292,22271,20200522,43563
20200519,B,야탑,23968,25218,20200522,49186
20200519,B,서현,22869,23106,20200522,45975
20200519,B,수내,11760,11754,20200522,23514
20200519,B,정자,15777,16946,20200522,32723
20200519,B,미금,14438,15386,20200522,29824
20200519,B,오리,11008,9231,20200522,20239
20200519,B,이매,5001,4758,20200522,9759
20200519,B,보정,2294,1867,20200522,4161
20200519,B,죽전,12036,13192,20200522,25228
20200519,B,구성,4553,4687,20200522,9240
20200519,B,신갈,4214,4048,20200522,8262
20200519,B,기흥,8661,8050,20200522,16711
20200519,B,상갈,4968,4623,20200522,9591
20200519,B,청명,3724,3582,20200522,7306
20200519,B,영통,6857,7271,20200522,14128
20200519,B,망포,12071,11374,20200522,23445
20200519,B,매탄권선,3900,3695,20200522,7595
20200519,B,수원시청,9959,10775,20200522,20734
20200519,B,매교,2080,2076,20200522,4156
20200519,B,개포동,3030,3250,20200522,6280
20200520,B,매교,2361,2340,20200523,4701
20200520,B,수원시청,10461,11358,20200523,21819
20200520,B,매탄권선,4100,3947,20200523,8047
20200520,B,망포,12679,12220,20200523,24899
20200520,B,영통,7500,7822,20200523,15322
20200520,B,청명,3854,3713,20200523,7567
20200520,B,상갈,5277,4984,20200523,10261
20200520,B,기흥,9170,8585,20200523,17755
20200520,B,신갈,4398,4327,20200523,8725
20200520,B,구성,4839,4947,20200523,9786
20200520,B,죽전,13166,14081,20200523,27247
20200520,B,보정,2440,1999,20200523,4439
20200520,B,이매,5330,5093,20200523,10423
20200520,B,오리,11490,9633,20200523,21123
20200520,B,미금,15630,16476,20200523,32106
20200520,B,정자,16414,17728,20200523,34142
20200520,B,수내,12569,12495,20200523,25064
20200520,B,서현,24044,24618,20200523,48662
20200520,B,야탑,25298,26779,20200523,52077
20200520,B,모란,19111,19624,20200523,38735
20200520,B,태평,13457,13008,20200523,26465
20200520,B,가천대,6884,7744,20200523,14628
20200520,B,선정릉,8068,8782,20200523,16850
20200520,B,강남구청,9421,10661,20200523,20082
20200520,B,압구정로데오,15929,17985,20200523,33914
20200520,B,서울숲,9289,9506,20200523,18795
20200520,B,수원,7382,5099,20200523,12481
20200520,B,수서,12760,13140,20200523,25900
20200520,B,대모산입구,3383,3105,20200523,6488
20200520,B,개포동,3225,3512,20200523,6737
20200520,B,구룡,1522,1499,20200523,3021
20200520,B,도곡,6245,6400,20200523,12645
20200520,B,한티,12539,13507,20200523,26046
20200520,B,선릉,13417,21045,20200523,34462
20200521,B,매교,2296,2260,20200524,4556
20200521,B,수원시청,10208,11167,20200524,21375
20200521,B,매탄권선,4168,3921,20200524,8089
20200521,B,망포,12572,11939,20200524,24511
20200521,B,영통,7324,7655,20200524,14979
20200521,B,청명,3921,3637,20200524,7558
20200521,B,상갈,5157,4853,20200524,10010
20200521,B,기흥,8995,8401,20200524,17396
20200521,B,신갈,4311,4200,20200524,8511
20200521,B,구성,4742,4906,20200524,9648
20200521,B,죽전,13070,14163,20200524,27233
20200521,B,보정,2384,2111,20200524,4495
20200521,B,이매,5418,5040,20200524,10458
20200521,B,오리,11444,9670,20200524,21114
20200521,B,미금,15181,16196,20200524,31377
20200521,B,정자,16420,17771,20200524,34191
20200521,B,수내,12250,12433,20200524,24683
20200521,B,서현,23977,24328,20200524,48305
20200521,B,야탑,25216,26528,20200524,51744
20200521,B,모란,19277,19443,20200524,38720
20200521,B,태평,13229,12868,20200524,26097
20200521,B,가천대,6890,7662,20200524,14552
20200521,B,선정릉,8002,8626,20200524,16628
20200521,B,강남구청,9162,10564,20200524,19726
20200521,B,압구정로데오,16122,18437,20200524,34559
20200521,B,서울숲,9333,9669,20200524,19002
20200521,B,수원,7265,5039,20200524,12304
20200521,B,복정,1,0,20200524,1
20200521,B,수서,13282,13352,20200524,26634
20200521,B,대모산입구,3363,3082,20200524,6445
20200521,B,개포동,3190,3349,20200524,6539
20200521,B,구룡,1478,1421,20200524,2899
20200521,B,도곡,6262,6439,20200524,12701
20200521,B,한티,12347,13270,20200524,25617
20200521,B,선릉,13344,21155,20200524,34499
20200522,B,선릉,13339,21124,20200525,34463
20200522,B,한티,13136,13937,20200525,27073
20200522,B,도곡,6690,6593,20200525,13283
20200522,B,구룡,1461,1451,20200525,2912
20200522,B,개포동,3357,3603,20200525,6960
20200522,B,대모산입구,3373,3121,20200525,6494
20200522,B,수서,14462,15452,20200525,29914
20200522,B,수원,7971,5700,20200525,13671
20200522,B,서울숲,9483,9461,20200525,18944
20200522,B,압구정로데오,17057,20420,20200525,37477
20200522,B,강남구청,9583,10968,20200525,20551
20200522,B,선정릉,8056,8631,20200525,16687
20200522,B,가천대,6878,7377,20200525,14255
20200522,B,태평,13534,13043,20200525,26577
20200522,B,모란,19753,20296,20200525,40049
20200522,B,야탑,25768,27420,20200525,53188
20200522,B,서현,25203,26205,20200525,51408
20200522,B,수내,12796,12896,20200525,25692
20200522,B,정자,16863,18466,20200525,35329
20200522,B,미금,15930,16891,20200525,32821
20200522,B,오리,11738,9857,20200525,21595
20200522,B,이매,5503,5148,20200525,10651
20200522,B,보정,2478,2080,20200525,4558
20200522,B,죽전,13926,14664,20200525,28590
20200522,B,구성,4767,4890,20200525,9657
20200522,B,신갈,4435,4336,20200525,8771
20200522,B,기흥,9414,8888,20200525,18302
20200522,B,상갈,5418,4959,20200525,10377
20200522,B,청명,4138,3827,20200525,7965
20200522,B,영통,8117,8364,20200525,16481
20200522,B,망포,13799,12680,20200525,26479
20200522,B,매탄권선,4447,4117,20200525,8564
20200522,B,수원시청,10881,13019,20200525,23900
20200522,B,매교,2337,2368,20200525,4705
20200523,B,선릉,5321,8775,20200526,14096
20200523,B,한티,9933,9679,20200526,19612
20200523,B,도곡,3849,3614,20200526,7463
20200523,B,구룡,843,829,20200526,1672
20200523,B,개포동,2322,2217,20200526,4539
20200523,B,대모산입구,2240,1972,20200526,4212
20200523,B,수서,9488,9907,20200526,19395
20200523,B,수원,6137,4210,20200526,10347
20200523,B,서울숲,8424,8956,20200526,17380
20200523,B,압구정로데오,14024,16796,20200526,30820
20200523,B,강남구청,4784,5804,20200526,10588
20200523,B,선정릉,3554,3654,20200526,7208
20200523,B,가천대,4921,5331,20200526,10252
20200523,B,태평,10226,9658,20200526,19884
20200523,B,모란,15579,15856,20200526,31435
20200523,B,야탑,16522,17630,20200526,34152
20200523,B,서현,17533,17703,20200526,35236
20200523,B,수내,8407,7883,20200526,16290
20200523,B,정자,10422,10726,20200526,21148
20200523,B,미금,10302,10213,20200526,20515
20200523,B,오리,7687,6479,20200526,14166
20200523,B,이매,3923,3627,20200526,7550
20200523,B,보정,1573,1379,20200526,2952
20200523,B,죽전,10014,11106,20200526,21120
20200523,B,구성,3140,3147,20200526,6287
20200523,B,신갈,2553,2568,20200526,5121
20200523,B,기흥,6387,6039,20200526,12426
20200523,B,상갈,3630,3543,20200526,7173
20200523,B,청명,2689,2578,20200526,5267
20200523,B,영통,6072,6197,20200526,12269
20200523,B,망포,8202,7205,20200526,15407
20200523,B,매탄권선,3231,2868,20200526,6099
20200523,B,수원시청,9002,10300,20200526,19302
20200523,B,매교,1482,1499,20200526,2981
20200524,B,영통,3655,3618,20200527,7273
20200524,B,청명,1576,1637,20200527,3213
20200524,B,상갈,2390,2455,20200527,4845
20200524,B,기흥,4103,4047,20200527,8150
20200524,B,신갈,1538,1617,20200527,3155
20200524,B,구성,2007,2062,20200527,4069
20200524,B,죽전,6546,7387,20200527,13933
20200524,B,보정,876,898,20200527,1774
20200524,B,이매,2493,2537,20200527,5030
20200524,B,오리,4746,4216,20200527,8962
20200524,B,미금,6434,7078,20200527,13512
20200524,B,정자,6413,6737,20200527,13150
20200524,B,수내,5431,5141,20200527,10572
20200524,B,서현,11594,11718,20200527,23312
20200524,B,야탑,11517,11690,20200527,23207
20200524,B,모란,15500,16285,20200527,31785
20200524,B,태평,7138,6895,20200527,14033
20200524,B,가천대,3137,3838,20200527,6975
20200524,B,선정릉,2055,2113,20200527,4168
20200524,B,강남구청,2614,3193,20200527,5807
20200524,B,압구정로데오,7433,8607,20200527,16040
20200524,B,서울숲,4806,4805,20200527,9611
20200524,B,수원,4056,2690,20200527,6746
20200524,B,수서,7795,7187,20200527,14982
20200524,B,대모산입구,1649,1556,20200527,3205
20200524,B,개포동,1541,1606,20200527,3147
20200524,B,구룡,517,540,20200527,1057
20200524,B,도곡,1966,1975,20200527,3941
20200524,B,한티,6577,6440,20200527,13017
20200524,B,선릉,2325,3609,20200527,5934
20200524,B,매교,945,1017,20200527,1962
20200524,B,수원시청,5519,5467,20200527,10986
20200524,B,매탄권선,1897,1856,20200527,3753
20200524,B,망포,4991,5194,20200527,10185
20200525,B,매교,2369,2267,20200528,4636
20200525,B,수원시청,10350,11254,20200528,21604
20200525,B,매탄권선,4171,4010,20200528,8181
20200525,B,망포,12687,12235,20200528,24922
20200525,B,영통,7444,7726,20200528,15170
20200525,B,청명,3876,3591,20200528,7467
20200525,B,상갈,5121,4905,20200528,10026
20200525,B,기흥,9204,8561,20200528,17765
20200525,B,신갈,4336,4153,20200528,8489
20200525,B,구성,4793,4933,20200528,9726
20200525,B,죽전,12938,14095,20200528,27033
20200525,B,보정,2455,2057,20200528,4512
20200525,B,이매,5335,4993,20200528,10328
20200525,B,오리,11230,9500,20200528,20730
20200525,B,미금,15347,16387,20200528,31734
20200525,B,정자,16132,17285,20200528,33417
20200525,B,수내,12282,12200,20200528,24482
20200525,B,서현,24055,24288,20200528,48343
20200525,B,야탑,24887,26182,20200528,51069
20200525,B,모란,19298,19227,20200528,38525
20200525,B,태평,13409,13119,20200528,26528
20200525,B,가천대,9415,10272,20200528,19687
20200525,B,선정릉,7984,8588,20200528,16572
20200525,B,강남구청,9029,10376,20200528,19405
20200525,B,압구정로데오,14928,16626,20200528,31554
20200525,B,서울숲,8917,9100,20200528,18017
20200525,B,수원,7284,5108,20200528,12392
20200525,B,수서,13093,13410,20200528,26503
20200525,B,대모산입구,3379,3135,20200528,6514
20200525,B,개포동,3198,3392,20200528,6590
20200525,B,구룡,1432,1455,20200528,2887
20200525,B,도곡,6306,6447,20200528,12753
20200525,B,한티,12378,13225,20200528,25603
20200525,B,선릉,13392,21225,20200528,34617
20200526,B,매교,2233,2287,20200529,4520
20200526,B,수원시청,10218,11034,20200529,21252
20200526,B,매탄권선,4122,4020,20200529,8142
20200526,B,망포,12598,11970,20200529,24568
20200526,B,영통,7410,7636,20200529,15046
20200526,B,청명,3857,3788,20200529,7645
20200526,B,상갈,5154,4836,20200529,9990
20200526,B,기흥,9117,8700,20200529,17817
20200526,B,신갈,4376,4215,20200529,8591
20200526,B,구성,4863,4887,20200529,9750
20200526,B,죽전,12903,14001,20200529,26904
20200526,B,보정,2477,2038,20200529,4515
20200526,B,이매,5478,5198,20200529,10676
20200526,B,오리,11518,9820,20200529,21338
20200526,B,미금,15298,16475,20200529,31773
20200526,B,정자,16195,17700,20200529,33895
20200526,B,수내,12384,12616,20200529,25000
20200526,B,서현,23851,24324,20200529,48175
20200526,B,야탑,25014,26168,20200529,51182
20200526,B,모란,18875,19043,20200529,37918
20200526,B,태평,13113,12789,20200529,25902
20200526,B,가천대,9446,10277,20200529,19723
20200526,B,선정릉,8056,8734,20200529,16790
20200526,B,강남구청,9537,10984,20200529,20521
20200526,B,압구정로데오,16276,18371,20200529,34647
20200526,B,서울숲,9026,8986,20200529,18012
20200526,B,수원,7180,4964,20200529,12144
20200526,B,수서,12878,13050,20200529,25928
20200526,B,대모산입구,3383,3194,20200529,6577
20200526,B,개포동,3166,3374,20200529,6540
20200526,B,구룡,1487,1526,20200529,3013
20200526,B,도곡,6213,6365,20200529,12578
20200526,B,한티,12630,13420,20200529,26050
20200526,B,선릉,13655,21367,20200529,35022
20200527,B,매교,2506,2457,20200530,4963
20200527,B,수원시청,10573,11620,20200530,22193
20200527,B,매탄권선,4339,4074,20200530,8413
20200527,B,망포,12824,12243,20200530,25067
20200527,B,영통,7742,8158,20200530,15900
20200527,B,청명,4015,3831,20200530,7846
20200527,B,상갈,5271,4941,20200530,10212
20200527,B,기흥,9367,8666,20200530,18033
20200527,B,신갈,4434,4320,20200530,8754
20200527,B,구성,4824,5031,20200530,9855
20200527,B,죽전,13314,14389,20200530,27703
20200527,B,보정,2567,2138,20200530,4705
20200527,B,이매,5576,5242,20200530,10818
20200527,B,오리,11735,10038,20200530,21773
20200527,B,미금,15711,16699,20200530,32410
20200527,B,정자,16771,17980,20200530,34751
20200527,B,수내,12606,12782,20200530,25388
20200527,B,서현,24682,25004,20200530,49686
20200527,B,야탑,25476,26875,20200530,52351
20200527,B,모란,19285,19419,20200530,38704
20200527,B,태평,13337,13075,20200530,26412
20200527,B,가천대,9503,10250,20200530,19753
20200527,B,선정릉,8014,8753,20200530,16767
20200527,B,강남구청,9433,10899,20200530,20332
20200527,B,압구정로데오,15909,18429,20200530,34338
20200527,B,서울숲,9556,9624,20200530,19180
20200527,B,수원,7416,5093,20200530,12509
20200527,B,수서,13045,13229,20200530,26274
20200527,B,대모산입구,3344,3199,20200530,6543
20200527,B,개포동,3357,3556,20200530,6913
20200527,B,구룡,1647,1605,20200530,3252
20200527,B,도곡,6257,6532,20200530,12789
20200527,B,한티,12962,13927,20200530,26889
20200527,B,선릉,13536,21313,20200530,34849
20200528,B,매교,2465,2485,20200531,4950
20200528,B,수원시청,10381,11418,20200531,21799
20200528,B,매탄권선,4285,4060,20200531,8345
20200528,B,망포,12952,12218,20200531,25170
20200528,B,영통,7643,7915,20200531,15558
20200528,B,청명,3963,3826,20200531,7789
20200528,B,상갈,5158,4959,20200531,10117
20200528,B,기흥,9375,8849,20200531,18224
20200528,B,신갈,4470,4330,20200531,8800
20200528,B,구성,4702,4852,20200531,9554
20200528,B,죽전,13118,14253,20200531,27371
20200528,B,보정,2523,2102,20200531,4625
20200528,B,이매,5547,5128,20200531,10675
20200528,B,오리,11661,9886,20200531,21547
20200528,B,미금,15270,16439,20200531,31709
20200528,B,정자,16528,17845,20200531,34373
20200528,B,수내,12543,12456,20200531,24999
20200528,B,서현,23767,24434,20200531,48201
20200528,B,야탑,25256,26336,20200531,51592
20200528,B,모란,19280,19342,20200531,38622
20200528,B,태평,13196,12909,20200531,26105
20200528,B,가천대,9761,10489,20200531,20250
20200528,B,선정릉,7948,8781,20200531,16729
20200528,B,강남구청,9147,10736,20200531,19883
20200528,B,압구정로데오,16244,18388,20200531,34632
20200528,B,서울숲,9170,9285,20200531,18455
20200528,B,수원,7323,4983,20200531,12306
20200528,B,수서,13337,13616,20200531,26953
20200528,B,대모산입구,3369,3083,20200531,6452
20200528,B,개포동,3198,3297,20200531,6495
20200528,B,구룡,1586,1585,20200531,3171
20200528,B,도곡,6410,6475,20200531,12885
20200528,B,한티,12709,13451,20200531,26160
20200528,B,선릉,13372,21215,20200531,34587
20200529,B,선릉,13288,21103,20200601,34391
20200529,B,한티,13353,14365,20200601,27718
20200529,B,도곡,6435,6466,20200601,12901
20200529,B,구룡,1726,1631,20200601,3357
20200529,B,개포동,3339,3570,20200601,6909
20200529,B,대모산입구,3418,3224,20200601,6642
20200529,B,수서,14917,15767,20200601,30684
20200529,B,복정,1,0,20200601,1
20200529,B,수원,8163,5793,20200601,13956
20200529,B,서울숲,9518,9536,20200601,19054
20200529,B,압구정로데오,17174,20766,20200601,37940
20200529,B,강남구청,9704,11059,20200601,20763
20200529,B,선정릉,8000,8707,20200601,16707
20200529,B,가천대,9209,9388,20200601,18597
20200529,B,태평,13938,13365,20200601,27303
20200529,B,모란,25995,27335,20200601,53330
20200529,B,야탑,26394,27943,20200601,54337
20200529,B,서현,25677,26452,20200601,52129
20200529,B,수내,12932,13074,20200601,26006
20200529,B,정자,16908,18266,20200601,35174
20200529,B,미금,16046,17349,20200601,33395
20200529,B,오리,12080,10130,20200601,22210
20200529,B,이매,5791,5356,20200601,11147
20200529,B,보정,2562,2108,20200601,4670
20200529,B,죽전,14162,15132,20200601,29294
20200529,B,구성,5031,5100,20200601,10131
20200529,B,신갈,4502,4419,20200601,8921
20200529,B,기흥,9649,9100,20200601,18749
20200529,B,상갈,5420,5051,20200601,10471
20200529,B,청명,4331,3912,20200601,8243
20200529,B,영통,8300,8667,20200601,16967
20200529,B,망포,14145,12823,20200601,26968
20200529,B,매탄권선,4777,4386,20200601,9163
20200529,B,수원시청,11177,13440,20200601,24617
20200529,B,매교,2548,2561,20200601,5109
20200530,B,선릉,4673,7544,20200602,12217
20200530,B,한티,9729,9342,20200602,19071
20200530,B,도곡,3875,3598,20200602,7473
20200530,B,구룡,912,801,20200602,1713
20200530,B,개포동,2050,2080,20200602,4130
20200530,B,대모산입구,2329,2160,20200602,4489
20200530,B,수서,9063,9642,20200602,18705
20200530,B,수원,6027,4075,20200602,10102
20200530,B,서울숲,7361,7818,20200602,15179
20200530,B,압구정로데오,13271,16025,20200602,29296
20200530,B,강남구청,4488,5587,20200602,10075
20200530,B,선정릉,3496,3633,20200602,7129
20200530,B,가천대,4594,5017,20200602,9611
20200530,B,태평,10000,9239,20200602,19239
20200530,B,모란,14409,14771,20200602,29180
20200530,B,야탑,16207,17274,20200602,33481
20200530,B,서현,16752,17386,20200602,34138
20200530,B,수내,8021,7438,20200602,15459
20200530,B,정자,10293,10473,20200602,20766
20200530,B,미금,10178,10488,20200602,20666
20200530,B,오리,7378,6130,20200602,13508
20200530,B,이매,3829,3567,20200602,7396
20200530,B,보정,1402,1263,20200602,2665
20200530,B,죽전,9518,10432,20200602,19950
20200530,B,구성,3087,3102,20200602,6189
20200530,B,신갈,2551,2569,20200602,5120
20200530,B,기흥,6186,5888,20200602,12074
20200530,B,상갈,3404,3372,20200602,6776
20200530,B,청명,2550,2390,20200602,4940
20200530,B,영통,5686,5642,20200602,11328
20200530,B,망포,8000,7186,20200602,15186
20200530,B,매탄권선,2872,2581,20200602,5453
20200530,B,수원시청,8406,9764,20200602,18170
20200530,B,매교,1649,1715,20200602,3364
20200531,B,매교,961,980,20200603,1941
20200531,B,수원시청,5653,5592,20200603,11245
20200531,B,매탄권선,2032,1991,20200603,4023
20200531,B,망포,5019,5250,20200603,10269
20200531,B,영통,3873,3827,20200603,7700
20200531,B,청명,1625,1635,20200603,3260
20200531,B,상갈,2386,2505,20200603,4891
20200531,B,기흥,4183,4089,20200603,8272
20200531,B,신갈,1650,1609,20200603,3259
20200531,B,구성,2080,2152,20200603,4232
20200531,B,죽전,6870,7833,20200603,14703
20200531,B,보정,938,890,20200603,1828
20200531,B,이매,2559,2570,20200603,5129
20200531,B,오리,4797,4208,20200603,9005
20200531,B,미금,6249,6805,20200603,13054
20200531,B,정자,6435,6747,20200603,13182
20200531,B,수내,5336,5208,20200603,10544
20200531,B,서현,11291,11508,20200603,22799
20200531,B,야탑,11653,11820,20200603,23473
20200531,B,모란,9798,9884,20200603,19682
20200531,B,태평,6793,6384,20200603,13177
20200531,B,가천대,2657,3292,20200603,5949
20200531,B,선정릉,1956,2080,20200603,4036
20200531,B,강남구청,2514,3071,20200603,5585
20200531,B,압구정로데오,7240,8251,20200603,15491
20200531,B,서울숲,4667,4901,20200603,9568
20200531,B,수원,4221,2868,20200603,7089
20200531,B,수서,7437,6865,20200603,14302
20200531,B,대모산입구,1545,1412,20200603,2957
20200531,B,개포동,1616,1619,20200603,3235
20200531,B,구룡,483,523,20200603,1006
20200531,B,도곡,2131,2165,20200603,4296
20200531,B,한티,6228,6502,20200603,12730
20200531,B,선릉,2417,3549,20200603,5966
20200101,SU,인천,1109,1571,20200104,2680
20200101,SU,신포,1111,1117,20200104,2228
20200101,SU,숭의,1789,1605,20200104,3394
20200101,SU,인하대,2319,2306,20200104,4625
20200101,SU,송도,1598,1586,20200104,3184
20200101,SU,연수,3056,2945,20200104,6001
20200101,SU,원인재,2417,2516,20200104,4933
20200101,SU,남동인더스파크,477,476,20200104,953
20200101,SU,호구포,1629,1737,20200104,3366
20200101,SU,인천논현,2958,3138,20200104,6096
20200101,SU,소래포구,3483,3220,20200104,6703
20200101,SU,월곶,1615,1497,20200104,3112
20200101,SU,달월,39,37,20200104,76
20200102,SU,달월,76,51,20200105,127
20200102,SU,월곶,2607,2515,20200105,5122
20200102,SU,소래포구,4655,4213,20200105,8868
20200102,SU,인천논현,6285,6688,20200105,12973
20200102,SU,호구포,3713,3800,20200105,7513
20200102,SU,남동인더스파크,2157,2414,20200105,4571
20200102,SU,원인재,4506,4656,20200105,9162
20200102,SU,연수,4954,4948,20200105,9902
20200102,SU,송도,2754,2558,20200105,5312
20200102,SU,인하대,5524,5315,20200105,10839
20200102,SU,숭의,3985,3759,20200105,7744
20200102,SU,신포,1941,1956,20200105,3897
20200102,SU,인천,992,1675,20200105,2667
20200103,SU,달월,77,52,20200106,129
20200103,SU,월곶,2571,2330,20200106,4901
20200103,SU,소래포구,5053,4781,20200106,9834
20200103,SU,인천논현,6859,7234,20200106,14093
20200103,SU,호구포,4001,3954,20200106,7955
20200103,SU,남동인더스파크,2264,2437,20200106,4701
20200103,SU,원인재,4875,4929,20200106,9804
20200103,SU,연수,5535,5514,20200106,11049
20200103,SU,송도,2919,2648,20200106,5567
20200103,SU,인하대,5963,5591,20200106,11554
20200103,SU,숭의,4188,3928,20200106,8116
20200103,SU,신포,2088,2146,20200106,4234
20200103,SU,인천,1065,1785,20200106,2850
20200104,SU,달월,43,38,20200107,81
20200104,SU,월곶,2128,2068,20200107,4196
20200104,SU,소래포구,4893,4857,20200107,9750
20200104,SU,인천논현,5151,5183,20200107,10334
20200104,SU,호구포,2575,2500,20200107,5075
20200104,SU,남동인더스파크,970,822,20200107,1792
20200104,SU,원인재,3887,3919,20200107,7806
20200104,SU,연수,4884,4917,20200107,9801
20200104,SU,송도,2404,2275,20200107,4679
20200104,SU,인하대,4111,3793,20200107,7904
20200104,SU,숭의,2877,2659,20200107,5536
20200104,SU,신포,1553,1730,20200107,3283
20200104,SU,인천,1238,2167,20200107,3405
20200105,SU,달월,25,22,20200108,47
20200105,SU,월곶,1732,1616,20200108,3348
20200105,SU,소래포구,3808,3694,20200108,7502
20200105,SU,인천논현,3507,3721,20200108,7228
20200105,SU,호구포,2153,2164,20200108,4317
20200105,SU,남동인더스파크,612,702,20200108,1314
20200105,SU,원인재,3078,3254,20200108,6332
20200105,SU,연수,4035,4039,20200108,8074
20200105,SU,송도,1893,1835,20200108,3728
20200105,SU,인하대,4278,3712,20200108,7990
20200105,SU,숭의,2085,1964,20200108,4049
20200105,SU,신포,1368,1270,20200108,2638
20200105,SU,인천,1114,1792,20200108,2906
20200106,SU,달월,70,39,20200109,109
20200106,SU,월곶,2425,2351,20200109,4776
20200106,SU,소래포구,4463,4137,20200109,8600
20200106,SU,인천논현,6299,6603,20200109,12902
20200106,SU,호구포,3895,3983,20200109,7878
20200106,SU,남동인더스파크,2338,2505,20200109,4843
20200106,SU,원인재,4516,4600,20200109,9116
20200106,SU,연수,4837,4876,20200109,9713
20200106,SU,송도,2817,2513,20200109,5330
20200106,SU,인하대,5659,5385,20200109,11044
20200106,SU,숭의,4083,3769,20200109,7852
20200106,SU,신포,1791,1911,20200109,3702
20200106,SU,인천,938,1521,20200109,2459
20200107,SU,달월,76,46,20200110,122
20200107,SU,월곶,2322,2174,20200110,4496
20200107,SU,소래포구,4230,3854,20200110,8084
20200107,SU,인천논현,6050,6336,20200110,12386
20200107,SU,호구포,3642,3737,20200110,7379
20200107,SU,남동인더스파크,2385,2649,20200110,5034
20200107,SU,원인재,4232,4417,20200110,8649
20200107,SU,연수,4655,4635,20200110,9290
20200107,SU,송도,2606,2371,20200110,4977
20200107,SU,인하대,5478,5254,20200110,10732
20200107,SU,숭의,3791,3557,20200110,7348
20200107,SU,신포,1800,1771,20200110,3571
20200107,SU,인천,796,1419,20200110,2215
20200108,SU,달월,72,52,20200111,124
20200108,SU,월곶,2812,2652,20200111,5464
20200108,SU,소래포구,4823,4346,20200111,9169
20200108,SU,인천논현,6578,6948,20200111,13526
20200108,SU,호구포,3925,3947,20200111,7872
20200108,SU,남동인더스파크,2321,2554,20200111,4875
20200108,SU,원인재,4794,4918,20200111,9712
20200108,SU,연수,5260,5339,20200111,10599
20200108,SU,송도,2888,2703,20200111,5591
20200108,SU,인하대,6017,5647,20200111,11664
20200108,SU,숭의,4233,3983,20200111,8216
20200108,SU,신포,1897,2073,20200111,3970
20200108,SU,인천,951,1649,20200111,2600
20200109,SU,달월,69,49,20200112,118
20200109,SU,월곶,2762,2570,20200112,5332
20200109,SU,소래포구,5123,4658,20200112,9781
20200109,SU,인천논현,6599,7106,20200112,13705
20200109,SU,호구포,4059,3991,20200112,8050
20200109,SU,남동인더스파크,2332,2556,20200112,4888
20200109,SU,원인재,4739,4883,20200112,9622
20200109,SU,연수,5063,5070,20200112,10133
20200109,SU,송도,2805,2672,20200112,5477
20200109,SU,인하대,5859,5492,20200112,11351
20200109,SU,숭의,4174,3925,20200112,8099
20200109,SU,신포,1974,2015,20200112,3989
20200109,SU,인천,1085,1826,20200112,2911
20200110,SU,달월,75,43,20200113,118
20200110,SU,월곶,2642,2397,20200113,5039
20200110,SU,소래포구,5365,4952,20200113,10317
20200110,SU,인천논현,7008,7352,20200113,14360
20200110,SU,호구포,4158,4022,20200113,8180
20200110,SU,남동인더스파크,2320,2558,20200113,4878
20200110,SU,원인재,4998,5020,20200113,10018
20200110,SU,연수,5466,5698,20200113,11164
20200110,SU,송도,3084,2817,20200113,5901
20200110,SU,인하대,6101,5680,20200113,11781
20200110,SU,숭의,4306,3865,20200113,8171
20200110,SU,신포,1969,2074,20200113,4043
20200110,SU,인천,1158,1964,20200113,3122
20200111,SU,달월,50,32,20200114,82
20200111,SU,월곶,2380,2174,20200114,4554
20200111,SU,소래포구,5315,5288,20200114,10603
20200111,SU,인천논현,5119,5276,20200114,10395
20200111,SU,호구포,2732,2717,20200114,5449
20200111,SU,남동인더스파크,1000,897,20200114,1897
20200111,SU,원인재,4085,3999,20200114,8084
20200111,SU,연수,4926,4946,20200114,9872
20200111,SU,송도,2477,2366,20200114,4843
20200111,SU,인하대,4334,4134,20200114,8468
20200111,SU,숭의,2972,2749,20200114,5721
20200111,SU,신포,1605,1822,20200114,3427
20200111,SU,인천,1301,2453,20200114,3754
20200112,SU,달월,29,23,20200115,52
20200112,SU,월곶,1689,1608,20200115,3297
20200112,SU,소래포구,4107,4001,20200115,8108
20200112,SU,인천논현,3502,3678,20200115,7180
20200112,SU,호구포,2543,2477,20200115,5020
20200112,SU,남동인더스파크,580,616,20200115,1196
20200112,SU,원인재,3032,3287,20200115,6319
20200112,SU,연수,4042,4003,20200115,8045
20200112,SU,송도,1757,1795,20200115,3552
20200112,SU,인하대,3335,3164,20200115,6499
20200112,SU,숭의,2032,1912,20200115,3944
20200112,SU,신포,1399,1347,20200115,2746
20200112,SU,인천,1105,1701,20200115,2806
20200113,SU,달월,87,65,20200116,152
20200113,SU,월곶,2552,2390,20200116,4942
20200113,SU,소래포구,4788,4351,20200116,9139
20200113,SU,인천논현,6470,6848,20200116,13318
20200113,SU,호구포,3849,3950,20200116,7799
20200113,SU,남동인더스파크,2294,2527,20200116,4821
20200113,SU,원인재,4771,4811,20200116,9582
20200113,SU,연수,5095,5041,20200116,10136
20200113,SU,송도,2721,2577,20200116,5298
20200113,SU,인하대,5852,5490,20200116,11342
20200113,SU,숭의,4044,3890,20200116,7934
20200113,SU,신포,1840,1883,20200116,3723
20200113,SU,인천,1081,1873,20200116,2954
20200114,SU,인천,1049,1845,20200117,2894
20200114,SU,신포,1833,1960,20200117,3793
20200114,SU,숭의,4186,3925,20200117,8111
20200114,SU,인하대,5857,5597,20200117,11454
20200114,SU,송도,2841,2668,20200117,5509
20200114,SU,연수,5113,5183,20200117,10296
20200114,SU,원인재,4753,4768,20200117,9521
20200114,SU,남동인더스파크,2303,2579,20200117,4882
20200114,SU,호구포,3887,3856,20200117,7743
20200114,SU,인천논현,6423,6659,20200117,13082
20200114,SU,소래포구,4898,4548,20200117,9446
20200114,SU,월곶,2427,2333,20200117,4760
20200114,SU,달월,80,51,20200117,131
20200115,SU,달월,73,54,20200118,127
20200115,SU,월곶,2749,2533,20200118,5282
20200115,SU,소래포구,4715,4405,20200118,9120
20200115,SU,인천논현,6403,6661,20200118,13064
20200115,SU,호구포,3940,3917,20200118,7857
20200115,SU,남동인더스파크,2379,2626,20200118,5005
20200115,SU,원인재,4793,4863,20200118,9656
20200115,SU,연수,5229,5290,20200118,10519
20200115,SU,송도,2946,2753,20200118,5699
20200115,SU,인하대,5783,5540,20200118,11323
20200115,SU,숭의,4208,3974,20200118,8182
20200115,SU,신포,1929,2106,20200118,4035
20200115,SU,인천,1065,1799,20200118,2864
20200116,SU,인천,1031,1799,20200119,2830
20200116,SU,신포,1868,1935,20200119,3803
20200116,SU,숭의,4140,3922,20200119,8062
20200116,SU,인하대,5786,5407,20200119,11193
20200116,SU,송도,2826,2638,20200119,5464
20200116,SU,연수,5312,5295,20200119,10607
20200116,SU,원인재,4846,4956,20200119,9802
20200116,SU,남동인더스파크,2309,2568,20200119,4877
20200116,SU,호구포,3855,3971,20200119,7826
20200116,SU,인천논현,6470,6669,20200119,13139
20200116,SU,소래포구,4816,4469,20200119,9285
20200116,SU,월곶,2717,2565,20200119,5282
20200116,SU,달월,70,46,20200119,116
20200117,SU,달월,75,47,20200120,122
20200117,SU,월곶,2623,2475,20200120,5098
20200117,SU,소래포구,5122,4734,20200120,9856
20200117,SU,인천논현,6767,7119,20200120,13886
20200117,SU,호구포,3945,3985,20200120,7930
20200117,SU,남동인더스파크,2351,2581,20200120,4932
20200117,SU,원인재,5083,5115,20200120,10198
20200117,SU,연수,5687,5680,20200120,11367
20200117,SU,송도,2879,2670,20200120,5549
20200117,SU,인하대,5954,5488,20200120,11442
20200117,SU,숭의,4312,3974,20200120,8286
20200117,SU,신포,1889,2051,20200120,3940
20200117,SU,인천,1108,1855,20200120,2963
20200118,SU,달월,31,28,20200121,59
20200118,SU,월곶,2202,2167,20200121,4369
20200118,SU,소래포구,4917,4914,20200121,9831
20200118,SU,인천논현,5196,5322,20200121,10518
20200118,SU,호구포,2772,2708,20200121,5480
20200118,SU,남동인더스파크,1066,974,20200121,2040
20200118,SU,원인재,4090,4205,20200121,8295
20200118,SU,연수,4863,4920,20200121,9783
20200118,SU,송도,2430,2333,20200121,4763
20200118,SU,인하대,4243,3948,20200121,8191
20200118,SU,숭의,2972,2766,20200121,5738
20200118,SU,신포,1655,1869,20200121,3524
20200118,SU,인천,1298,2249,20200121,3547
20200119,SU,달월,24,19,20200122,43
20200119,SU,월곶,1651,1497,20200122,3148
20200119,SU,소래포구,3420,3354,20200122,6774
20200119,SU,인천논현,3540,3674,20200122,7214
20200119,SU,호구포,2095,2084,20200122,4179
20200119,SU,남동인더스파크,731,781,20200122,1512
20200119,SU,원인재,2987,3117,20200122,6104
20200119,SU,연수,3922,3844,20200122,7766
20200119,SU,송도,1828,1737,20200122,3565
20200119,SU,인하대,2924,2858,20200122,5782
20200119,SU,숭의,1987,1913,20200122,3900
20200119,SU,신포,1292,1290,20200122,2582
20200119,SU,인천,1127,1631,20200122,2758
20200120,SU,인천,982,1674,20200123,2656
20200120,SU,신포,1811,1898,20200123,3709
20200120,SU,숭의,4101,3925,20200123,8026
20200120,SU,인하대,5678,5319,20200123,10997
20200120,SU,송도,2875,2734,20200123,5609
20200120,SU,연수,5039,5004,20200123,10043
20200120,SU,원인재,4873,4830,20200123,9703
20200120,SU,남동인더스파크,2414,2607,20200123,5021
20200120,SU,호구포,3808,3859,20200123,7667
20200120,SU,인천논현,6429,6635,20200123,13064
20200120,SU,소래포구,4760,4310,20200123,9070
20200120,SU,월곶,2488,2341,20200123,4829
20200120,SU,달월,83,54,20200123,137
20200121,SU,달월,90,58,20200124,148
20200121,SU,월곶,2428,2326,20200124,4754
20200121,SU,소래포구,4770,4412,20200124,9182
20200121,SU,인천논현,6358,6657,20200124,13015
20200121,SU,호구포,3847,3851,20200124,7698
20200121,SU,남동인더스파크,2461,2663,20200124,5124
20200121,SU,원인재,4897,4967,20200124,9864
20200121,SU,연수,5049,5019,20200124,10068
20200121,SU,송도,2813,2671,20200124,5484
20200121,SU,인하대,5558,5212,20200124,10770
20200121,SU,숭의,4131,3919,20200124,8050
20200121,SU,신포,1909,1936,20200124,3845
20200121,SU,인천,1021,1696,20200124,2717
20200122,SU,달월,72,48,20200125,120
20200122,SU,월곶,2718,2616,20200125,5334
20200122,SU,소래포구,4793,4365,20200125,9158
20200122,SU,인천논현,6455,6828,20200125,13283
20200122,SU,호구포,3954,3862,20200125,7816
20200122,SU,남동인더스파크,2250,2533,20200125,4783
20200122,SU,원인재,4825,4887,20200125,9712
20200122,SU,연수,5086,5284,20200125,10370
20200122,SU,송도,2871,2621,20200125,5492
20200122,SU,인하대,5606,5203,20200125,10809
20200122,SU,숭의,4167,3842,20200125,8009
20200122,SU,신포,1852,1964,20200125,3816
20200122,SU,인천,957,1645,20200125,2602
20200123,SU,달월,84,62,20200126,146
20200123,SU,월곶,2765,2479,20200126,5244
20200123,SU,소래포구,4560,4346,20200126,8906
20200123,SU,인천논현,6328,6539,20200126,12867
20200123,SU,호구포,3692,3619,20200126,7311
20200123,SU,남동인더스파크,2187,2304,20200126,4491
20200123,SU,원인재,4766,4872,20200126,9638
20200123,SU,연수,4928,5078,20200126,10006
20200123,SU,송도,2766,2555,20200126,5321
20200123,SU,인하대,5192,4778,20200126,9970
20200123,SU,숭의,3952,3574,20200126,7526
20200123,SU,신포,1730,1803,20200126,3533
20200123,SU,인천,908,1532,20200126,2440
20200124,SU,인천,847,1328,20200127,2175
20200124,SU,신포,897,918,20200127,1815
20200124,SU,숭의,1617,1573,20200127,3190
20200124,SU,인하대,2043,1987,20200127,4030
20200124,SU,송도,1445,1393,20200127,2838
20200124,SU,연수,2734,2627,20200127,5361
20200124,SU,원인재,2492,2419,20200127,4911
20200124,SU,남동인더스파크,698,586,20200127,1284
20200124,SU,호구포,1770,1561,20200127,3331
20200124,SU,인천논현,2828,2881,20200127,5709
20200124,SU,소래포구,3106,3145,20200127,6251
20200124,SU,월곶,1670,1586,20200127,3256
20200124,SU,달월,37,34,20200127,71
20200125,SU,달월,29,21,20200128,50
20200125,SU,월곶,1054,965,20200128,2019
20200125,SU,소래포구,2668,2623,20200128,5291
20200125,SU,인천논현,2224,2369,20200128,4593
20200125,SU,호구포,1454,1463,20200128,2917
20200125,SU,남동인더스파크,489,471,20200128,960
20200125,SU,원인재,2216,2222,20200128,4438
20200125,SU,연수,2308,2399,20200128,4707
20200125,SU,송도,1278,1205,20200128,2483
20200125,SU,인하대,1707,1669,20200128,3376
20200125,SU,숭의,1484,1349,20200128,2833
20200125,SU,신포,615,657,20200128,1272
20200125,SU,인천,999,1354,20200128,2353
20200126,SU,달월,38,37,20200129,75
20200126,SU,월곶,1614,1555,20200129,3169
20200126,SU,소래포구,3785,3823,20200129,7608
20200126,SU,인천논현,2960,3147,20200129,6107
20200126,SU,호구포,1740,1857,20200129,3597
20200126,SU,남동인더스파크,531,608,20200129,1139
20200126,SU,원인재,2629,2834,20200129,5463
20200126,SU,연수,3141,3180,20200129,6321
20200126,SU,송도,1689,1562,20200129,3251
20200126,SU,인하대,2381,2310,20200129,4691
20200126,SU,숭의,1830,1722,20200129,3552
20200126,SU,신포,1024,1078,20200129,2102
20200126,SU,인천,1105,1700,20200129,2805
20200127,SU,달월,36,29,20200130,65
20200127,SU,월곶,1679,1559,20200130,3238
20200127,SU,소래포구,3225,3107,20200130,6332
20200127,SU,인천논현,3257,3428,20200130,6685
20200127,SU,호구포,1614,1727,20200130,3341
20200127,SU,남동인더스파크,605,657,20200130,1262
20200127,SU,원인재,2607,2642,20200130,5249
20200127,SU,연수,2998,3003,20200130,6001
20200127,SU,송도,1738,1601,20200130,3339
20200127,SU,인하대,2550,2487,20200130,5037
20200127,SU,숭의,1777,1741,20200130,3518
20200127,SU,신포,952,916,20200130,1868
20200127,SU,인천,823,1280,20200130,2103
20200128,SU,달월,75,54,20200131,129
20200128,SU,월곶,2239,2101,20200131,4340
20200128,SU,소래포구,4201,3826,20200131,8027
20200128,SU,인천논현,6212,6593,20200131,12805
20200128,SU,호구포,3504,3633,20200131,7137
20200128,SU,남동인더스파크,2153,2354,20200131,4507
20200128,SU,원인재,4375,4398,20200131,8773
20200128,SU,연수,4688,4744,20200131,9432
20200128,SU,송도,2602,2489,20200131,5091
20200128,SU,인하대,5015,4816,20200131,9831
20200128,SU,숭의,3785,3522,20200131,7307
20200128,SU,신포,1626,1652,20200131,3278
20200128,SU,인천,821,1445,20200131,2266
20200129,SU,달월,74,60,20200201,134
20200129,SU,월곶,2518,2347,20200201,4865
20200129,SU,소래포구,4432,4030,20200201,8462
20200129,SU,인천논현,6217,6567,20200201,12784
20200129,SU,호구포,3797,3840,20200201,7637
20200129,SU,남동인더스파크,2360,2611,20200201,4971
20200129,SU,원인재,4566,4652,20200201,9218
20200129,SU,연수,5171,5169,20200201,10340
20200129,SU,송도,2767,2588,20200201,5355
20200129,SU,인하대,5489,5114,20200201,10603
20200129,SU,숭의,4040,3724,20200201,7764
20200129,SU,신포,1733,1784,20200201,3517
20200129,SU,인천,933,1552,20200201,2485
20200130,SU,인천,825,1348,20200202,2173
20200130,SU,신포,1691,1778,20200202,3469
20200130,SU,숭의,3902,3593,20200202,7495
20200130,SU,인하대,5294,5142,20200202,10436
20200130,SU,송도,2701,2501,20200202,5202
20200130,SU,연수,4832,4877,20200202,9709
20200130,SU,원인재,4546,4623,20200202,9169
20200130,SU,남동인더스파크,2429,2636,20200202,5065
20200130,SU,호구포,3941,3909,20200202,7850
20200130,SU,인천논현,6214,6544,20200202,12758
20200130,SU,소래포구,4478,4079,20200202,8557
20200130,SU,월곶,2541,2421,20200202,4962
20200130,SU,달월,85,55,20200202,140
20200131,SU,달월,71,55,20200203,126
20200131,SU,월곶,2484,2294,20200203,4778
20200131,SU,소래포구,4493,4149,20200203,8642
20200131,SU,인천논현,6275,6579,20200203,12854
20200131,SU,호구포,3889,3830,20200203,7719
20200131,SU,남동인더스파크,2392,2644,20200203,5036
20200131,SU,원인재,4625,4681,20200203,9306
20200131,SU,연수,5204,5495,20200203,10699
20200131,SU,송도,2770,2481,20200203,5251
20200131,SU,인하대,5348,4951,20200203,10299
20200131,SU,숭의,3929,3599,20200203,7528
20200131,SU,신포,1775,1870,20200203,3645
20200131,SU,인천,928,1459,20200203,2387
20200201,SU,달월,31,28,20200204,59
20200201,SU,월곶,1813,1738,20200204,3551
20200201,SU,소래포구,3748,3611,20200204,7359
20200201,SU,인천논현,4548,4618,20200204,9166
20200201,SU,호구포,2244,2143,20200204,4387
20200201,SU,남동인더스파크,980,925,20200204,1905
20200201,SU,원인재,3454,3547,20200204,7001
20200201,SU,연수,4044,4239,20200204,8283
20200201,SU,송도,2123,2050,20200204,4173
20200201,SU,인하대,3475,3397,20200204,6872
20200201,SU,숭의,2491,2277,20200204,4768
20200201,SU,신포,1302,1331,20200204,2633
20200201,SU,인천,784,1242,20200204,2026
20200202,SU,달월,21,29,20200205,50
20200202,SU,월곶,1371,1294,20200205,2665
20200202,SU,소래포구,2747,2609,20200205,5356
20200202,SU,인천논현,2969,3080,20200205,6049
20200202,SU,호구포,1835,1919,20200205,3754
20200202,SU,남동인더스파크,529,519,20200205,1048
20200202,SU,원인재,2522,2587,20200205,5109
20200202,SU,연수,3368,3319,20200205,6687
20200202,SU,송도,1532,1536,20200205,3068
20200202,SU,인하대,2510,2433,20200205,4943
20200202,SU,숭의,1857,1706,20200205,3563
20200202,SU,신포,1007,1018,20200205,2025
20200202,SU,인천,719,985,20200205,1704
20200203,SU,달월,77,53,20200206,130
20200203,SU,월곶,2130,2087,20200206,4217
20200203,SU,소래포구,3915,3438,20200206,7353
20200203,SU,인천논현,5817,6017,20200206,11834
20200203,SU,호구포,3569,3690,20200206,7259
20200203,SU,남동인더스파크,2265,2484,20200206,4749
20200203,SU,원인재,4339,4357,20200206,8696
20200203,SU,연수,4440,4456,20200206,8896
20200203,SU,송도,2543,2350,20200206,4893
20200203,SU,인하대,4969,4774,20200206,9743
20200203,SU,숭의,3712,3483,20200206,7195
20200203,SU,신포,1534,1556,20200206,3090
20200203,SU,인천,755,1344,20200206,2099
20200204,SU,달월,86,48,20200207,134
20200204,SU,월곶,2174,2047,20200207,4221
20200204,SU,소래포구,3854,3613,20200207,7467
20200204,SU,인천논현,5700,5922,20200207,11622
20200204,SU,호구포,3590,3663,20200207,7253
20200204,SU,남동인더스파크,2400,2539,20200207,4939
20200204,SU,원인재,4070,4292,20200207,8362
20200204,SU,연수,4416,4499,20200207,8915
20200204,SU,송도,2537,2295,20200207,4832
20200204,SU,인하대,5127,4832,20200207,9959
20200204,SU,숭의,3587,3383,20200207,6970
20200204,SU,신포,1535,1577,20200207,3112
20200204,SU,인천,774,1332,20200207,2106
20200205,SU,달월,70,48,20200208,118
20200205,SU,월곶,2242,2078,20200208,4320
20200205,SU,소래포구,3635,3285,20200208,6920
20200205,SU,인천논현,5626,5803,20200208,11429
20200205,SU,호구포,3464,3530,20200208,6994
20200205,SU,남동인더스파크,2378,2556,20200208,4934
20200205,SU,원인재,4047,4168,20200208,8215
20200205,SU,연수,4437,4533,20200208,8970
20200205,SU,송도,2288,2141,20200208,4429
20200205,SU,인하대,4771,4658,20200208,9429
20200205,SU,숭의,3554,3220,20200208,6774
20200205,SU,신포,1499,1503,20200208,3002
20200205,SU,인천,772,1307,20200208,2079
20200206,SU,달월,72,52,20200209,124
20200206,SU,월곶,2164,2024,20200209,4188
20200206,SU,소래포구,3739,3490,20200209,7229
20200206,SU,인천논현,5510,5794,20200209,11304
20200206,SU,호구포,3450,3484,20200209,6934
20200206,SU,남동인더스파크,2279,2447,20200209,4726
20200206,SU,원인재,4078,4161,20200209,8239
20200206,SU,연수,4278,4392,20200209,8670
20200206,SU,송도,2288,2140,20200209,4428
20200206,SU,인하대,4761,4533,20200209,9294
20200206,SU,숭의,3410,3242,20200209,6652
20200206,SU,신포,1435,1425,20200209,2860
20200206,SU,인천,731,1259,20200209,1990
20200207,SU,달월,68,44,20200210,112
20200207,SU,월곶,2175,2069,20200210,4244
20200207,SU,소래포구,3814,3560,20200210,7374
20200207,SU,인천논현,5821,6095,20200210,11916
20200207,SU,호구포,3627,3657,20200210,7284
20200207,SU,남동인더스파크,2135,2342,20200210,4477
20200207,SU,원인재,4235,4385,20200210,8620
20200207,SU,연수,4658,4751,20200210,9409
20200207,SU,송도,2383,2256,20200210,4639
20200207,SU,인하대,4998,4646,20200210,9644
20200207,SU,숭의,3663,3323,20200210,6986
20200207,SU,신포,1563,1621,20200210,3184
20200207,SU,인천,800,1325,20200210,2125
20200208,SU,달월,39,32,20200211,71
20200208,SU,월곶,1679,1591,20200211,3270
20200208,SU,소래포구,3199,3220,20200211,6419
20200208,SU,인천논현,4206,4205,20200211,8411
20200208,SU,호구포,2188,2092,20200211,4280
20200208,SU,남동인더스파크,964,870,20200211,1834
20200208,SU,원인재,3196,3162,20200211,6358
20200208,SU,연수,3804,3916,20200211,7720
20200208,SU,송도,1806,1706,20200211,3512
20200208,SU,인하대,3164,2914,20200211,6078
20200208,SU,숭의,2331,2186,20200211,4517
20200208,SU,신포,1119,1252,20200211,2371
20200208,SU,인천,696,1099,20200211,1795
20200209,SU,달월,19,21,20200212,40
20200209,SU,월곶,1293,1304,20200212,2597
20200209,SU,소래포구,2540,2413,20200212,4953
20200209,SU,인천논현,2815,2992,20200212,5807
20200209,SU,호구포,1651,1657,20200212,3308
20200209,SU,남동인더스파크,575,555,20200212,1130
20200209,SU,원인재,2454,2510,20200212,4964
20200209,SU,연수,3211,3138,20200212,6349
20200209,SU,송도,1441,1404,20200212,2845
20200209,SU,인하대,2350,2343,20200212,4693
20200209,SU,숭의,1657,1578,20200212,3235
20200209,SU,신포,920,886,20200212,1806
20200209,SU,인천,682,911,20200212,1593
20200210,SU,달월,75,46,20200213,121
20200210,SU,월곶,2167,2032,20200213,4199
20200210,SU,소래포구,4004,3617,20200213,7621
20200210,SU,인천논현,5768,6014,20200213,11782
20200210,SU,호구포,3619,3663,20200213,7282
20200210,SU,남동인더스파크,2352,2604,20200213,4956
20200210,SU,원인재,4157,4246,20200213,8403
20200210,SU,연수,4614,4543,20200213,9157
20200210,SU,송도,2482,2307,20200213,4789
20200210,SU,인하대,4859,4717,20200213,9576
20200210,SU,숭의,3631,3327,20200213,6958
20200210,SU,신포,1553,1572,20200213,3125
20200210,SU,인천,790,1285,20200213,2075
20200211,SU,달월,83,54,20200214,137
20200211,SU,월곶,2170,2093,20200214,4263
20200211,SU,소래포구,4263,3906,20200214,8169
20200211,SU,인천논현,5912,6184,20200214,12096
20200211,SU,호구포,3606,3637,20200214,7243
20200211,SU,남동인더스파크,2357,2607,20200214,4964
20200211,SU,원인재,4345,4456,20200214,8801
20200211,SU,연수,4609,4593,20200214,9202
20200211,SU,송도,2578,2376,20200214,4954
20200211,SU,인하대,5196,4944,20200214,10140
20200211,SU,숭의,3730,3500,20200214,7230
20200211,SU,신포,1619,1652,20200214,3271
20200211,SU,인천,800,1343,20200214,2143
20200212,SU,달월,89,68,20200215,157
20200212,SU,월곶,2175,2094,20200215,4269
20200212,SU,소래포구,3768,3465,20200215,7233
20200212,SU,인천논현,5680,5974,20200215,11654
20200212,SU,호구포,3523,3540,20200215,7063
20200212,SU,남동인더스파크,2391,2538,20200215,4929
20200212,SU,원인재,4047,4110,20200215,8157
20200212,SU,연수,4498,4608,20200215,9106
20200212,SU,송도,2377,2175,20200215,4552
20200212,SU,인하대,4851,4584,20200215,9435
20200212,SU,숭의,3513,3326,20200215,6839
20200212,SU,신포,1477,1514,20200215,2991
20200212,SU,인천,732,1232,20200215,1964
20200213,SU,달월,71,56,20200216,127
20200213,SU,월곶,2403,2222,20200216,4625
20200213,SU,소래포구,4156,3864,20200216,8020
20200213,SU,인천논현,6029,6229,20200216,12258
20200213,SU,호구포,3587,3624,20200216,7211
20200213,SU,남동인더스파크,2341,2600,20200216,4941
20200213,SU,원인재,4249,4469,20200216,8718
20200213,SU,연수,4586,4586,20200216,9172
20200213,SU,송도,2608,2422,20200216,5030
20200213,SU,인하대,5163,4916,20200216,10079
20200213,SU,숭의,3742,3527,20200216,7269
20200213,SU,신포,1644,1654,20200216,3298
20200213,SU,인천,779,1361,20200216,2140
20200214,SU,달월,80,54,20200217,134
20200214,SU,월곶,2491,2302,20200217,4793
20200214,SU,소래포구,4658,4438,20200217,9096
20200214,SU,인천논현,6409,6758,20200217,13167
20200214,SU,호구포,3844,3793,20200217,7637
20200214,SU,남동인더스파크,2457,2646,20200217,5103
20200214,SU,원인재,4767,4747,20200217,9514
20200214,SU,연수,5245,5405,20200217,10650
20200214,SU,송도,2804,2531,20200217,5335
20200214,SU,인하대,5555,5130,20200217,10685
20200214,SU,숭의,3907,3680,20200217,7587
20200214,SU,신포,1717,1766,20200217,3483
20200214,SU,인천,980,1581,20200217,2561
20200215,SU,달월,46,27,20200218,73
20200215,SU,월곶,1984,1887,20200218,3871
20200215,SU,소래포구,4174,4221,20200218,8395
20200215,SU,인천논현,4765,4898,20200218,9663
20200215,SU,호구포,2362,2190,20200218,4552
20200215,SU,남동인더스파크,1007,970,20200218,1977
20200215,SU,원인재,3734,3757,20200218,7491
20200215,SU,연수,4161,4306,20200218,8467
20200215,SU,송도,2083,1916,20200218,3999
20200215,SU,인하대,3567,3393,20200218,6960
20200215,SU,숭의,2585,2378,20200218,4963
20200215,SU,신포,1311,1423,20200218,2734
20200215,SU,인천,749,1234,20200218,1983
20200216,SU,달월,23,26,20200219,49
20200216,SU,월곶,1315,1293,20200219,2608
20200216,SU,소래포구,2754,2657,20200219,5411
20200216,SU,인천논현,3008,3173,20200219,6181
20200216,SU,호구포,1797,1821,20200219,3618
20200216,SU,남동인더스파크,605,645,20200219,1250
20200216,SU,원인재,2645,2686,20200219,5331
20200216,SU,연수,3434,3359,20200219,6793
20200216,SU,송도,1436,1372,20200219,2808
20200216,SU,인하대,2479,2417,20200219,4896
20200216,SU,숭의,1652,1559,20200219,3211
20200216,SU,신포,978,947,20200219,1925
20200216,SU,인천,700,981,20200219,1681
20200217,SU,달월,75,41,20200220,116
20200217,SU,월곶,2160,1982,20200220,4142
20200217,SU,소래포구,3868,3603,20200220,7471
20200217,SU,인천논현,5720,6000,20200220,11720
20200217,SU,호구포,3560,3759,20200220,7319
20200217,SU,남동인더스파크,2373,2729,20200220,5102
20200217,SU,원인재,4221,4364,20200220,8585
20200217,SU,연수,4494,4389,20200220,8883
20200217,SU,송도,2401,2196,20200220,4597
20200217,SU,인하대,4867,4616,20200220,9483
20200217,SU,숭의,3657,3388,20200220,7045
20200217,SU,신포,1430,1449,20200220,2879
20200217,SU,인천,742,1305,20200220,2047
20200218,SU,달월,75,56,20200221,131
20200218,SU,월곶,2176,2036,20200221,4212
20200218,SU,소래포구,4069,3750,20200221,7819
20200218,SU,인천논현,5853,5941,20200221,11794
20200218,SU,호구포,3621,3641,20200221,7262
20200218,SU,남동인더스파크,2420,2660,20200221,5080
20200218,SU,원인재,4179,4288,20200221,8467
20200218,SU,연수,4424,4530,20200221,8954
20200218,SU,송도,2436,2216,20200221,4652
20200218,SU,인하대,4869,4662,20200221,9531
20200218,SU,숭의,3650,3426,20200221,7076
20200218,SU,신포,1542,1548,20200221,3090
20200218,SU,인천,770,1251,20200221,2021
20200219,SU,달월,76,50,20200222,126
20200219,SU,월곶,2478,2335,20200222,4813
20200219,SU,소래포구,4336,3990,20200222,8326
20200219,SU,인천논현,5973,6234,20200222,12207
20200219,SU,호구포,3663,3659,20200222,7322
20200219,SU,남동인더스파크,2428,2700,20200222,5128
20200219,SU,원인재,4405,4540,20200222,8945
20200219,SU,연수,4606,4772,20200222,9378
20200219,SU,송도,2642,2465,20200222,5107
20200219,SU,인하대,5234,4982,20200222,10216
20200219,SU,숭의,3849,3585,20200222,7434
20200219,SU,신포,1650,1720,20200222,3370
20200219,SU,인천,822,1356,20200222,2178
20200220,SU,달월,73,53,20200223,126
20200220,SU,월곶,2316,2197,20200223,4513
20200220,SU,소래포구,4249,3912,20200223,8161
20200220,SU,인천논현,5860,6085,20200223,11945
20200220,SU,호구포,3667,3612,20200223,7279
20200220,SU,남동인더스파크,2335,2580,20200223,4915
20200220,SU,원인재,4344,4462,20200223,8806
20200220,SU,연수,4514,4572,20200223,9086
20200220,SU,송도,2579,2415,20200223,4994
20200220,SU,인하대,5084,4842,20200223,9926
20200220,SU,숭의,3800,3494,20200223,7294
20200220,SU,신포,1675,1625,20200223,3300
20200220,SU,인천,801,1352,20200223,2153
20200221,SU,달월,76,51,20200224,127
20200221,SU,월곶,2278,2163,20200224,4441
20200221,SU,소래포구,3971,3653,20200224,7624
20200221,SU,인천논현,5864,6042,20200224,11906
20200221,SU,호구포,3666,3551,20200224,7217
20200221,SU,남동인더스파크,2339,2645,20200224,4984
20200221,SU,원인재,4262,4293,20200224,8555
20200221,SU,연수,4555,4731,20200224,9286
20200221,SU,송도,2461,2257,20200224,4718
20200221,SU,인하대,5087,4839,20200224,9926
20200221,SU,숭의,3613,3350,20200224,6963
20200221,SU,신포,1546,1614,20200224,3160
20200221,SU,인천,785,1339,20200224,2124
20200222,SU,달월,42,28,20200225,70
20200222,SU,월곶,1590,1489,20200225,3079
20200222,SU,소래포구,2965,2963,20200225,5928
20200222,SU,인천논현,3897,3980,20200225,7877
20200222,SU,호구포,2008,1940,20200225,3948
20200222,SU,남동인더스파크,830,825,20200225,1655
20200222,SU,원인재,2986,3160,20200225,6146
20200222,SU,연수,3643,3819,20200225,7462
20200222,SU,송도,1694,1655,20200225,3349
20200222,SU,인하대,2945,2726,20200225,5671
20200222,SU,숭의,2176,2037,20200225,4213
20200222,SU,신포,1036,1038,20200225,2074
20200222,SU,인천,566,969,20200225,1535
20200223,SU,달월,23,22,20200226,45
20200223,SU,월곶,1093,1077,20200226,2170
20200223,SU,소래포구,2087,1964,20200226,4051
20200223,SU,인천논현,2281,2355,20200226,4636
20200223,SU,호구포,1287,1339,20200226,2626
20200223,SU,남동인더스파크,395,444,20200226,839
20200223,SU,원인재,1961,2043,20200226,4004
20200223,SU,연수,2271,2261,20200226,4532
20200223,SU,송도,1094,1081,20200226,2175
20200223,SU,인하대,1812,1716,20200226,3528
20200223,SU,숭의,1361,1280,20200226,2641
20200223,SU,신포,720,727,20200226,1447
20200223,SU,인천,535,764,20200226,1299
20200224,SU,달월,80,46,20200227,126
20200224,SU,월곶,1831,1744,20200227,3575
20200224,SU,소래포구,3300,2933,20200227,6233
20200224,SU,인천논현,4795,4991,20200227,9786
20200224,SU,호구포,3156,3209,20200227,6365
20200224,SU,남동인더스파크,2131,2416,20200227,4547
20200224,SU,원인재,3601,3673,20200227,7274
20200224,SU,연수,3795,3826,20200227,7621
20200224,SU,송도,2128,1967,20200227,4095
20200224,SU,인하대,4270,4025,20200227,8295
20200224,SU,숭의,3259,3029,20200227,6288
20200224,SU,신포,1281,1361,20200227,2642
20200224,SU,인천,611,1058,20200227,1669
20200225,SU,달월,68,45,20200228,113
20200225,SU,월곶,1732,1604,20200228,3336
20200225,SU,소래포구,2794,2525,20200228,5319
20200225,SU,인천논현,4356,4487,20200228,8843
20200225,SU,호구포,3014,3001,20200228,6015
20200225,SU,남동인더스파크,2134,2384,20200228,4518
20200225,SU,원인재,3344,3308,20200228,6652
20200225,SU,연수,3320,3380,20200228,6700
20200225,SU,송도,1794,1680,20200228,3474
20200225,SU,인하대,3777,3606,20200228,7383
20200225,SU,숭의,3010,2794,20200228,5804
20200225,SU,신포,1141,1191,20200228,2332
20200225,SU,인천,537,934,20200228,1471
20200226,SU,달월,70,50,20200229,120
20200226,SU,월곶,1778,1648,20200229,3426
20200226,SU,소래포구,3006,2768,20200229,5774
20200226,SU,인천논현,4395,4685,20200229,9080
20200226,SU,호구포,3106,3103,20200229,6209
20200226,SU,남동인더스파크,2180,2351,20200229,4531
20200226,SU,원인재,3455,3470,20200229,6925
20200226,SU,연수,3534,3567,20200229,7101
20200226,SU,송도,2042,1867,20200229,3909
20200226,SU,인하대,3969,3720,20200229,7689
20200226,SU,숭의,3038,2861,20200229,5899
20200226,SU,신포,1276,1311,20200229,2587
20200226,SU,인천,577,995,20200229,1572
20200227,SU,달월,69,49,20200301,118
20200227,SU,월곶,1728,1657,20200301,3385
20200227,SU,소래포구,3027,2733,20200301,5760
20200227,SU,인천논현,4426,4686,20200301,9112
20200227,SU,호구포,3038,3108,20200301,6146
20200227,SU,남동인더스파크,2168,2383,20200301,4551
20200227,SU,원인재,3328,3424,20200301,6752
20200227,SU,연수,3452,3569,20200301,7021
20200227,SU,송도,1954,1797,20200301,3751
20200227,SU,인하대,4010,3784,20200301,7794
20200227,SU,숭의,3081,2806,20200301,5887
20200227,SU,신포,1237,1290,20200301,2527
20200227,SU,인천,627,1030,20200301,1657
20200228,SU,달월,63,41,20200302,104
20200228,SU,월곶,1672,1588,20200302,3260
20200228,SU,소래포구,2706,2500,20200302,5206
20200228,SU,인천논현,4109,4415,20200302,8524
20200228,SU,호구포,2930,2940,20200302,5870
20200228,SU,남동인더스파크,2040,2228,20200302,4268
20200228,SU,원인재,3079,3177,20200302,6256
20200228,SU,연수,3144,3341,20200302,6485
20200228,SU,송도,1831,1574,20200302,3405
20200228,SU,인하대,3817,3516,20200302,7333
20200228,SU,숭의,2911,2665,20200302,5576
20200228,SU,신포,1142,1243,20200302,2385
20200228,SU,인천,588,954,20200302,1542
20200229,SU,달월,34,29,20200303,63
20200229,SU,월곶,1187,1187,20200303,2374
20200229,SU,소래포구,2146,2165,20200303,4311
20200229,SU,인천논현,2842,2984,20200303,5826
20200229,SU,호구포,1508,1452,20200303,2960
20200229,SU,남동인더스파크,788,761,20200303,1549
20200229,SU,원인재,2199,2177,20200303,4376
20200229,SU,연수,2366,2408,20200303,4774
20200229,SU,송도,1234,1210,20200303,2444
20200229,SU,인하대,2268,2166,20200303,4434
20200229,SU,숭의,1693,1625,20200303,3318
20200229,SU,신포,797,836,20200303,1633
20200229,SU,인천,481,757,20200303,1238
20200301,SU,달월,22,22,20200304,44
20200301,SU,월곶,791,718,20200304,1509
20200301,SU,소래포구,1627,1526,20200304,3153
20200301,SU,인천논현,1802,1890,20200304,3692
20200301,SU,호구포,950,948,20200304,1898
20200301,SU,남동인더스파크,330,336,20200304,666
20200301,SU,원인재,1385,1508,20200304,2893
20200301,SU,연수,1702,1672,20200304,3374
20200301,SU,송도,873,887,20200304,1760
20200301,SU,인하대,1535,1514,20200304,3049
20200301,SU,숭의,1085,1063,20200304,2148
20200301,SU,신포,503,540,20200304,1043
20200301,SU,인천,398,565,20200304,963
20200302,SU,달월,66,43,20200305,109
20200302,SU,월곶,1646,1558,20200305,3204
20200302,SU,소래포구,2802,2547,20200305,5349
20200302,SU,인천논현,4172,4296,20200305,8468
20200302,SU,호구포,2878,2947,20200305,5825
20200302,SU,남동인더스파크,2016,2260,20200305,4276
20200302,SU,원인재,3200,3220,20200305,6420
20200302,SU,연수,3219,3228,20200305,6447
20200302,SU,송도,1907,1743,20200305,3650
20200302,SU,인하대,3875,3740,20200305,7615
20200302,SU,숭의,3064,2785,20200305,5849
20200302,SU,신포,1172,1233,20200305,2405
20200302,SU,인천,589,972,20200305,1561
20200303,SU,달월,68,44,20200306,112
20200303,SU,월곶,1699,1585,20200306,3284
20200303,SU,소래포구,2925,2738,20200306,5663
20200303,SU,인천논현,4255,4467,20200306,8722
20200303,SU,호구포,2963,2974,20200306,5937
20200303,SU,남동인더스파크,2059,2276,20200306,4335
20200303,SU,원인재,3194,3212,20200306,6406
20200303,SU,연수,3220,3300,20200306,6520
20200303,SU,송도,1883,1790,20200306,3673
20200303,SU,인하대,3836,3662,20200306,7498
20200303,SU,숭의,2904,2747,20200306,5651
20200303,SU,신포,1208,1253,20200306,2461
20200303,SU,인천,576,967,20200306,1543
20200304,SU,달월,71,47,20200307,118
20200304,SU,월곶,1693,1597,20200307,3290
20200304,SU,소래포구,2847,2593,20200307,5440
20200304,SU,인천논현,4168,4366,20200307,8534
20200304,SU,호구포,2886,3011,20200307,5897
20200304,SU,남동인더스파크,2080,2302,20200307,4382
20200304,SU,원인재,3106,3109,20200307,6215
20200304,SU,연수,3228,3263,20200307,6491
20200304,SU,송도,1872,1696,20200307,3568
20200304,SU,인하대,3808,3584,20200307,7392
20200304,SU,숭의,2902,2690,20200307,5592
20200304,SU,신포,1141,1251,20200307,2392
20200304,SU,인천,583,998,20200307,1581
20200305,SU,달월,66,41,20200308,107
20200305,SU,월곶,1691,1600,20200308,3291
20200305,SU,소래포구,2873,2617,20200308,5490
20200305,SU,인천논현,4189,4437,20200308,8626
20200305,SU,호구포,2946,3023,20200308,5969
20200305,SU,남동인더스파크,2004,2256,20200308,4260
20200305,SU,원인재,3174,3207,20200308,6381
20200305,SU,연수,3226,3319,20200308,6545
20200305,SU,송도,1852,1690,20200308,3542
20200305,SU,인하대,3944,3696,20200308,7640
20200305,SU,숭의,2960,2758,20200308,5718
20200305,SU,신포,1185,1269,20200308,2454
20200305,SU,인천,569,973,20200308,1542
20200306,SU,달월,62,45,20200309,107
20200306,SU,월곶,1827,1678,20200309,3505
20200306,SU,소래포구,3112,2856,20200309,5968
20200306,SU,인천논현,4469,4601,20200309,9070
20200306,SU,호구포,2958,3036,20200309,5994
20200306,SU,남동인더스파크,2005,2267,20200309,4272
20200306,SU,원인재,3254,3278,20200309,6532
20200306,SU,연수,3382,3517,20200309,6899
20200306,SU,송도,1997,1749,20200309,3746
20200306,SU,인하대,3994,3722,20200309,7716
20200306,SU,숭의,2959,2705,20200309,5664
20200306,SU,신포,1230,1346,20200309,2576
20200306,SU,인천,626,1002,20200309,1628
20200307,SU,달월,32,20,20200310,52
20200307,SU,월곶,1314,1239,20200310,2553
20200307,SU,소래포구,2431,2543,20200310,4974
20200307,SU,인천논현,3039,3179,20200310,6218
20200307,SU,호구포,1599,1545,20200310,3144
20200307,SU,남동인더스파크,758,731,20200310,1489
20200307,SU,원인재,2400,2436,20200310,4836
20200307,SU,연수,2628,2741,20200310,5369
20200307,SU,송도,1399,1319,20200310,2718
20200307,SU,인하대,2471,2320,20200310,4791
20200307,SU,숭의,1786,1663,20200310,3449
20200307,SU,신포,882,967,20200310,1849
20200307,SU,인천,508,790,20200310,1298
20200308,SU,달월,26,31,20200311,57
20200308,SU,월곶,972,901,20200311,1873
20200308,SU,소래포구,2206,2107,20200311,4313
20200308,SU,인천논현,2005,2063,20200311,4068
20200308,SU,호구포,1064,1060,20200311,2124
20200308,SU,남동인더스파크,352,362,20200311,714
20200308,SU,원인재,1675,1666,20200311,3341
20200308,SU,연수,1928,1907,20200311,3835
20200308,SU,송도,1058,1009,20200311,2067
20200308,SU,인하대,1782,1721,20200311,3503
20200308,SU,숭의,1200,1131,20200311,2331
20200308,SU,신포,650,661,20200311,1311
20200308,SU,인천,453,666,20200311,1119
20200309,SU,달월,84,59,20200312,143
20200309,SU,월곶,1740,1708,20200312,3448
20200309,SU,소래포구,3058,2822,20200312,5880
20200309,SU,인천논현,4477,4627,20200312,9104
20200309,SU,호구포,2925,3016,20200312,5941
20200309,SU,남동인더스파크,1987,2271,20200312,4258
20200309,SU,원인재,3353,3389,20200312,6742
20200309,SU,연수,3414,3443,20200312,6857
20200309,SU,송도,2007,1801,20200312,3808
20200309,SU,인하대,4099,3899,20200312,7998
20200309,SU,숭의,3010,2763,20200312,5773
20200309,SU,신포,1255,1284,20200312,2539
20200309,SU,인천,615,1062,20200312,1677
20200310,SU,달월,68,40,20200313,108
20200310,SU,월곶,1621,1567,20200313,3188
20200310,SU,소래포구,2743,2556,20200313,5299
20200310,SU,인천논현,4154,4290,20200313,8444
20200310,SU,호구포,2877,2883,20200313,5760
20200310,SU,남동인더스파크,2020,2249,20200313,4269
20200310,SU,원인재,3112,3123,20200313,6235
20200310,SU,연수,3128,3213,20200313,6341
20200310,SU,송도,1637,1470,20200313,3107
20200310,SU,인하대,3668,3498,20200313,7166
20200310,SU,숭의,2783,2554,20200313,5337
20200310,SU,신포,1057,1145,20200313,2202
20200310,SU,인천,535,942,20200313,1477
20200311,SU,달월,63,43,20200314,106
20200311,SU,월곶,1799,1704,20200314,3503
20200311,SU,소래포구,2843,2681,20200314,5524
20200311,SU,인천논현,4363,4543,20200314,8906
20200311,SU,호구포,2943,2976,20200314,5919
20200311,SU,남동인더스파크,2007,2243,20200314,4250
20200311,SU,원인재,3229,3294,20200314,6523
20200311,SU,연수,3294,3350,20200314,6644
20200311,SU,송도,1871,1691,20200314,3562
20200311,SU,인하대,3788,3585,20200314,7373
20200311,SU,숭의,2886,2616,20200314,5502
20200311,SU,신포,1246,1278,20200314,2524
20200311,SU,인천,567,966,20200314,1533
20200312,SU,달월,79,51,20200315,130
20200312,SU,월곶,1725,1648,20200315,3373
20200312,SU,소래포구,2875,2631,20200315,5506
20200312,SU,인천논현,4230,4408,20200315,8638
20200312,SU,호구포,2857,2981,20200315,5838
20200312,SU,남동인더스파크,1945,2258,20200315,4203
20200312,SU,원인재,3220,3288,20200315,6508
20200312,SU,연수,3242,3266,20200315,6508
20200312,SU,송도,1850,1613,20200315,3463
20200312,SU,인하대,3888,3658,20200315,7546
20200312,SU,숭의,2869,2640,20200315,5509
20200312,SU,신포,1153,1210,20200315,2363
20200312,SU,인천,618,1017,20200315,1635
20200313,SU,달월,69,49,20200316,118
20200313,SU,월곶,1767,1649,20200316,3416
20200313,SU,소래포구,3009,2824,20200316,5833
20200313,SU,인천논현,4406,4667,20200316,9073
20200313,SU,호구포,2870,2887,20200316,5757
20200313,SU,남동인더스파크,1970,2179,20200316,4149
20200313,SU,원인재,3295,3323,20200316,6618
20200313,SU,연수,3354,3502,20200316,6856
20200313,SU,송도,1867,1600,20200316,3467
20200313,SU,인하대,3927,3697,20200316,7624
20200313,SU,숭의,2951,2662,20200316,5613
20200313,SU,신포,1191,1269,20200316,2460
20200313,SU,인천,599,980,20200316,1579
20200314,SU,달월,35,33,20200317,68
20200314,SU,월곶,1350,1279,20200317,2629
20200314,SU,소래포구,2619,2634,20200317,5253
20200314,SU,인천논현,3205,3302,20200317,6507
20200314,SU,호구포,1676,1631,20200317,3307
20200314,SU,남동인더스파크,733,722,20200317,1455
20200314,SU,원인재,2567,2538,20200317,5105
20200314,SU,연수,2600,2682,20200317,5282
20200314,SU,송도,1333,1257,20200317,2590
20200314,SU,인하대,2552,2336,20200317,4888
20200314,SU,숭의,1824,1690,20200317,3514
20200314,SU,신포,827,972,20200317,1799
20200314,SU,인천,564,912,20200317,1476
20200315,SU,달월,20,17,20200318,37
20200315,SU,월곶,945,898,20200318,1843
20200315,SU,소래포구,1953,1887,20200318,3840
20200315,SU,인천논현,1753,1884,20200318,3637
20200315,SU,호구포,967,980,20200318,1947
20200315,SU,남동인더스파크,332,340,20200318,672
20200315,SU,원인재,1538,1591,20200318,3129
20200315,SU,연수,1869,1795,20200318,3664
20200315,SU,송도,975,966,20200318,1941
20200315,SU,인하대,1674,1524,20200318,3198
20200315,SU,숭의,1136,1083,20200318,2219
20200315,SU,신포,603,622,20200318,1225
20200315,SU,인천,444,591,20200318,1035
20200316,SU,달월,78,56,20200319,134
20200316,SU,월곶,1806,1718,20200319,3524
20200316,SU,소래포구,2966,2751,20200319,5717
20200316,SU,인천논현,4197,4271,20200319,8468
20200316,SU,호구포,2855,2905,20200319,5760
20200316,SU,남동인더스파크,1964,2224,20200319,4188
20200316,SU,원인재,3207,3216,20200319,6423
20200316,SU,연수,3340,3359,20200319,6699
20200316,SU,송도,1871,1720,20200319,3591
20200316,SU,인하대,4003,3816,20200319,7819
20200316,SU,숭의,2989,2709,20200319,5698
20200316,SU,신포,1166,1249,20200319,2415
20200316,SU,인천,615,1005,20200319,1620
20200317,SU,달월,76,57,20200320,133
20200317,SU,월곶,1736,1642,20200320,3378
20200317,SU,소래포구,2940,2720,20200320,5660
20200317,SU,인천논현,4019,4221,20200320,8240
20200317,SU,호구포,2806,2874,20200320,5680
20200317,SU,남동인더스파크,2041,2223,20200320,4264
20200317,SU,원인재,3176,3201,20200320,6377
20200317,SU,연수,3215,3279,20200320,6494
20200317,SU,송도,1746,1640,20200320,3386
20200317,SU,인하대,3915,3765,20200320,7680
20200317,SU,숭의,2975,2664,20200320,5639
20200317,SU,신포,1183,1226,20200320,2409
20200317,SU,인천,605,993,20200320,1598
20200318,SU,달월,82,55,20200321,137
20200318,SU,월곶,1797,1670,20200321,3467
20200318,SU,소래포구,3206,3008,20200321,6214
20200318,SU,인천논현,4378,4502,20200321,8880
20200318,SU,호구포,2897,2960,20200321,5857
20200318,SU,남동인더스파크,2000,2233,20200321,4233
20200318,SU,원인재,3331,3442,20200321,6773
20200318,SU,연수,3375,3431,20200321,6806
20200318,SU,송도,1966,1769,20200321,3735
20200318,SU,인하대,4005,3858,20200321,7863
20200318,SU,숭의,2980,2785,20200321,5765
20200318,SU,신포,1202,1312,20200321,2514
20200318,SU,인천,659,1118,20200321,1777
20200319,SU,달월,62,41,20200322,103
20200319,SU,월곶,1691,1574,20200322,3265
20200319,SU,소래포구,2694,2470,20200322,5164
20200319,SU,인천논현,4065,4223,20200322,8288
20200319,SU,호구포,2773,2854,20200322,5627
20200319,SU,남동인더스파크,2018,2245,20200322,4263
20200319,SU,원인재,3157,3192,20200322,6349
20200319,SU,연수,3150,3206,20200322,6356
20200319,SU,송도,1726,1541,20200322,3267
20200319,SU,인하대,3700,3509,20200322,7209
20200319,SU,숭의,2758,2571,20200322,5329
20200319,SU,신포,1160,1183,20200322,2343
20200319,SU,인천,550,965,20200322,1515
20200320,SU,달월,85,68,20200323,153
20200320,SU,월곶,1878,1816,20200323,3694
20200320,SU,소래포구,3200,3047,20200323,6247
20200320,SU,인천논현,4538,4809,20200323,9347
20200320,SU,호구포,2964,3011,20200323,5975
20200320,SU,남동인더스파크,1992,2182,20200323,4174
20200320,SU,원인재,3440,3470,20200323,6910
20200320,SU,연수,3486,3583,20200323,7069
20200320,SU,송도,2013,1859,20200323,3872
20200320,SU,인하대,4253,3985,20200323,8238
20200320,SU,숭의,3077,2760,20200323,5837
20200320,SU,신포,1309,1410,20200323,2719
20200320,SU,인천,631,1072,20200323,1703
20200321,SU,달월,47,49,20200324,96
20200321,SU,월곶,1390,1329,20200324,2719
20200321,SU,소래포구,2866,2906,20200324,5772
20200321,SU,인천논현,3196,3259,20200324,6455
20200321,SU,호구포,1686,1648,20200324,3334
20200321,SU,남동인더스파크,706,705,20200324,1411
20200321,SU,원인재,2524,2572,20200324,5096
20200321,SU,연수,2666,2708,20200324,5374
20200321,SU,송도,1422,1289,20200324,2711
20200321,SU,인하대,2541,2413,20200324,4954
20200321,SU,숭의,1772,1625,20200324,3397
20200321,SU,신포,957,1074,20200324,2031
20200321,SU,인천,558,954,20200324,1512
20200322,SU,달월,44,47,20200325,91
20200322,SU,월곶,1038,985,20200325,2023
20200322,SU,소래포구,2406,2325,20200325,4731
20200322,SU,인천논현,1993,2073,20200325,4066
20200322,SU,호구포,1102,1100,20200325,2202
20200322,SU,남동인더스파크,333,374,20200325,707
20200322,SU,원인재,1716,1791,20200325,3507
20200322,SU,연수,1975,1873,20200325,3848
20200322,SU,송도,1011,992,20200325,2003
20200322,SU,인하대,1781,1741,20200325,3522
20200322,SU,숭의,1255,1189,20200325,2444
20200322,SU,신포,638,664,20200325,1302
20200322,SU,인천,501,716,20200325,1217
20200323,SU,달월,90,64,20200326,154
20200323,SU,월곶,1793,1708,20200326,3501
20200323,SU,소래포구,3314,3077,20200326,6391
20200323,SU,인천논현,4341,4530,20200326,8871
20200323,SU,호구포,2874,2952,20200326,5826
20200323,SU,남동인더스파크,1937,2219,20200326,4156
20200323,SU,원인재,3285,3312,20200326,6597
20200323,SU,연수,3418,3318,20200326,6736
20200323,SU,송도,1936,1793,20200326,3729
20200323,SU,인하대,4057,3823,20200326,7880
20200323,SU,숭의,2988,2726,20200326,5714
20200323,SU,신포,1249,1284,20200326,2533
20200323,SU,인천,614,1073,20200326,1687
20200324,SU,달월,81,51,20200327,132
20200324,SU,월곶,1828,1733,20200327,3561
20200324,SU,소래포구,3367,3174,20200327,6541
20200324,SU,인천논현,4239,4432,20200327,8671
20200324,SU,호구포,2980,2927,20200327,5907
20200324,SU,남동인더스파크,1975,2303,20200327,4278
20200324,SU,원인재,3236,3327,20200327,6563
20200324,SU,연수,3351,3374,20200327,6725
20200324,SU,송도,1914,1727,20200327,3641
20200324,SU,인하대,4037,3843,20200327,7880
20200324,SU,숭의,3030,2812,20200327,5842
20200324,SU,신포,1235,1322,20200327,2557
20200324,SU,인천,677,1133,20200327,1810
20200325,SU,달월,88,73,20200328,161
20200325,SU,월곶,1844,1723,20200328,3567
20200325,SU,소래포구,3474,3275,20200328,6749
20200325,SU,인천논현,4445,4603,20200328,9048
20200325,SU,호구포,2944,3015,20200328,5959
20200325,SU,남동인더스파크,1987,2219,20200328,4206
20200325,SU,원인재,3364,3443,20200328,6807
20200325,SU,연수,3448,3501,20200328,6949
20200325,SU,송도,1993,1785,20200328,3778
20200325,SU,인하대,4127,3922,20200328,8049
20200325,SU,숭의,3131,2760,20200328,5891
20200325,SU,신포,1313,1325,20200328,2638
20200325,SU,인천,670,1094,20200328,1764
20200326,SU,달월,71,51,20200329,122
20200326,SU,월곶,1780,1679,20200329,3459
20200326,SU,소래포구,3243,3070,20200329,6313
20200326,SU,인천논현,4233,4358,20200329,8591
20200326,SU,호구포,2886,2920,20200329,5806
20200326,SU,남동인더스파크,2071,2357,20200329,4428
20200326,SU,원인재,3181,3346,20200329,6527
20200326,SU,연수,3395,3343,20200329,6738
20200326,SU,송도,1883,1722,20200329,3605
20200326,SU,인하대,4021,3832,20200329,7853
20200326,SU,숭의,2996,2835,20200329,5831
20200326,SU,신포,1181,1302,20200329,2483
20200326,SU,인천,609,1067,20200329,1676
20200327,SU,달월,82,55,20200330,137
20200327,SU,월곶,1884,1838,20200330,3722
20200327,SU,소래포구,3377,3219,20200330,6596
20200327,SU,인천논현,4534,4726,20200330,9260
20200327,SU,호구포,2974,2957,20200330,5931
20200327,SU,남동인더스파크,1970,2215,20200330,4185
20200327,SU,원인재,3356,3446,20200330,6802
20200327,SU,연수,3470,3524,20200330,6994
20200327,SU,송도,2005,1829,20200330,3834
20200327,SU,인하대,4143,3926,20200330,8069
20200327,SU,숭의,3016,2736,20200330,5752
20200327,SU,신포,1280,1424,20200330,2704
20200327,SU,인천,668,1107,20200330,1775
20200328,SU,달월,53,41,20200331,94
20200328,SU,월곶,1383,1350,20200331,2733
20200328,SU,소래포구,3069,3039,20200331,6108
20200328,SU,인천논현,3217,3283,20200331,6500
20200328,SU,호구포,1649,1555,20200331,3204
20200328,SU,남동인더스파크,718,710,20200331,1428
20200328,SU,원인재,2471,2553,20200331,5024
20200328,SU,연수,2600,2604,20200331,5204
20200328,SU,송도,1424,1388,20200331,2812
20200328,SU,인하대,2534,2454,20200331,4988
20200328,SU,숭의,1778,1643,20200331,3421
20200328,SU,신포,924,1016,20200331,1940
20200328,SU,인천,567,950,20200331,1517
20200329,SU,달월,29,44,20200401,73
20200329,SU,월곶,1077,1072,20200401,2149
20200329,SU,소래포구,2570,2513,20200401,5083
20200329,SU,인천논현,2155,2174,20200401,4329
20200329,SU,호구포,1143,1198,20200401,2341
20200329,SU,남동인더스파크,346,388,20200401,734
20200329,SU,원인재,1702,1736,20200401,3438
20200329,SU,연수,1972,1934,20200401,3906
20200329,SU,송도,1043,996,20200401,2039
20200329,SU,인하대,1926,1809,20200401,3735
20200329,SU,숭의,1260,1213,20200401,2473
20200329,SU,신포,711,724,20200401,1435
20200329,SU,인천,557,803,20200401,1360
20200330,SU,달월,78,54,20200402,132
20200330,SU,월곶,1860,1786,20200402,3646
20200330,SU,소래포구,3391,3168,20200402,6559
20200330,SU,인천논현,4449,4597,20200402,9046
20200330,SU,호구포,2859,2947,20200402,5806
20200330,SU,남동인더스파크,1954,2226,20200402,4180
20200330,SU,원인재,3348,3420,20200402,6768
20200330,SU,연수,3436,3360,20200402,6796
20200330,SU,송도,1918,1781,20200402,3699
20200330,SU,인하대,4017,3798,20200402,7815
20200330,SU,숭의,3075,2844,20200402,5919
20200330,SU,신포,1193,1314,20200402,2507
20200330,SU,인천,652,1129,20200402,1781
20200331,SU,달월,85,61,20200403,146
20200331,SU,월곶,1783,1715,20200403,3498
20200331,SU,소래포구,3345,3140,20200403,6485
20200331,SU,인천논현,4351,4520,20200403,8871
20200331,SU,호구포,2957,3025,20200403,5982
20200331,SU,남동인더스파크,1989,2229,20200403,4218
20200331,SU,원인재,3322,3402,20200403,6724
20200331,SU,연수,3343,3333,20200403,6676
20200331,SU,송도,1929,1790,20200403,3719
20200331,SU,인하대,4038,3820,20200403,7858
20200331,SU,숭의,3016,2906,20200403,5922
20200331,SU,신포,1282,1344,20200403,2626
20200331,SU,인천,639,1056,20200403,1695
20200401,SU,달월,72,56,20200404,128
20200401,SU,월곶,1862,1740,20200404,3602
20200401,SU,소래포구,3276,3119,20200404,6395
20200401,SU,인천논현,4467,4588,20200404,9055
20200401,SU,호구포,2907,2999,20200404,5906
20200401,SU,남동인더스파크,1968,2148,20200404,4116
20200401,SU,원인재,3399,3338,20200404,6737
20200401,SU,연수,3309,3356,20200404,6665
20200401,SU,송도,1961,1786,20200404,3747
20200401,SU,인하대,4063,3910,20200404,7973
20200401,SU,숭의,3016,2767,20200404,5783
20200401,SU,신포,1299,1354,20200404,2653
20200401,SU,인천,657,1178,20200404,1835
20200402,SU,달월,80,58,20200405,138
20200402,SU,월곶,1880,1759,20200405,3639
20200402,SU,소래포구,3368,3225,20200405,6593
20200402,SU,인천논현,4489,4640,20200405,9129
20200402,SU,호구포,2968,2981,20200405,5949
20200402,SU,남동인더스파크,1974,2211,20200405,4185
20200402,SU,원인재,3382,3399,20200405,6781
20200402,SU,연수,3260,3368,20200405,6628
20200402,SU,송도,1972,1778,20200405,3750
20200402,SU,인하대,4132,3881,20200405,8013
20200402,SU,숭의,3028,2832,20200405,5860
20200402,SU,신포,1285,1319,20200405,2604
20200402,SU,인천,659,1155,20200405,1814
20200403,SU,달월,85,62,20200406,147
20200403,SU,월곶,1951,1768,20200406,3719
20200403,SU,소래포구,3570,3338,20200406,6908
20200403,SU,인천논현,4582,4951,20200406,9533
20200403,SU,호구포,3081,3089,20200406,6170
20200403,SU,남동인더스파크,1978,2152,20200406,4130
20200403,SU,원인재,3667,3711,20200406,7378
20200403,SU,연수,3547,3538,20200406,7085
20200403,SU,송도,2037,1896,20200406,3933
20200403,SU,인하대,4163,4026,20200406,8189
20200403,SU,숭의,3121,2880,20200406,6001
20200403,SU,신포,1282,1395,20200406,2677
20200403,SU,인천,714,1199,20200406,1913
20200404,SU,달월,40,38,20200407,78
20200404,SU,월곶,1470,1383,20200407,2853
20200404,SU,소래포구,3267,3303,20200407,6570
20200404,SU,인천논현,3290,3399,20200407,6689
20200404,SU,호구포,1795,1707,20200407,3502
20200404,SU,남동인더스파크,707,639,20200407,1346
20200404,SU,원인재,2647,2729,20200407,5376
20200404,SU,연수,2634,2720,20200407,5354
20200404,SU,송도,1374,1365,20200407,2739
20200404,SU,인하대,2651,2494,20200407,5145
20200404,SU,숭의,1798,1707,20200407,3505
20200404,SU,신포,931,1000,20200407,1931
20200404,SU,인천,573,938,20200407,1511
20200405,SU,달월,36,38,20200408,74
20200405,SU,월곶,1076,999,20200408,2075
20200405,SU,소래포구,2623,2542,20200408,5165
20200405,SU,인천논현,2103,2159,20200408,4262
20200405,SU,호구포,1117,1207,20200408,2324
20200405,SU,남동인더스파크,359,384,20200408,743
20200405,SU,원인재,1939,2143,20200408,4082
20200405,SU,연수,2073,1952,20200408,4025
20200405,SU,송도,1093,1055,20200408,2148
20200405,SU,인하대,1894,1835,20200408,3729
20200405,SU,숭의,1304,1138,20200408,2442
20200405,SU,신포,679,703,20200408,1382
20200405,SU,인천,505,757,20200408,1262
20200406,SU,달월,70,56,20200409,126
20200406,SU,월곶,1844,1768,20200409,3612
20200406,SU,소래포구,3458,3236,20200409,6694
20200406,SU,인천논현,4513,4766,20200409,9279
20200406,SU,호구포,2974,3083,20200409,6057
20200406,SU,남동인더스파크,2083,2278,20200409,4361
20200406,SU,원인재,3511,3610,20200409,7121
20200406,SU,연수,3467,3330,20200409,6797
20200406,SU,송도,2004,1849,20200409,3853
20200406,SU,인하대,4102,3920,20200409,8022
20200406,SU,숭의,3146,2902,20200409,6048
20200406,SU,신포,1265,1310,20200409,2575
20200406,SU,인천,705,1118,20200409,1823
20200407,SU,달월,90,72,20200410,162
20200407,SU,월곶,1930,1848,20200410,3778
20200407,SU,소래포구,3771,3529,20200410,7300
20200407,SU,인천논현,4521,4773,20200410,9294
20200407,SU,호구포,3069,3138,20200410,6207
20200407,SU,남동인더스파크,2085,2288,20200410,4373
20200407,SU,원인재,3590,3743,20200410,7333
20200407,SU,연수,3515,3520,20200410,7035
20200407,SU,송도,2006,1808,20200410,3814
20200407,SU,인하대,4239,3917,20200410,8156
20200407,SU,숭의,3171,2913,20200410,6084
20200407,SU,신포,1298,1327,20200410,2625
20200407,SU,인천,593,1084,20200410,1677
20200408,SU,달월,73,52,20200411,125
20200408,SU,월곶,1909,1794,20200411,3703
20200408,SU,소래포구,3789,3511,20200411,7300
20200408,SU,인천논현,4647,4892,20200411,9539
20200408,SU,호구포,3124,3096,20200411,6220
20200408,SU,남동인더스파크,2087,2347,20200411,4434
20200408,SU,원인재,3635,3742,20200411,7377
20200408,SU,연수,3473,3548,20200411,7021
20200408,SU,송도,2022,1911,20200411,3933
20200408,SU,인하대,4299,4164,20200411,8463
20200408,SU,숭의,3110,2893,20200411,6003
20200408,SU,신포,1313,1405,20200411,2718
20200408,SU,인천,708,1167,20200411,1875
20200409,SU,달월,78,56,20200412,134
20200409,SU,월곶,1808,1742,20200412,3550
20200409,SU,소래포구,3660,3513,20200412,7173
20200409,SU,인천논현,4494,4711,20200412,9205
20200409,SU,호구포,3092,3098,20200412,6190
20200409,SU,남동인더스파크,2018,2246,20200412,4264
20200409,SU,원인재,3659,3774,20200412,7433
20200409,SU,연수,3391,3500,20200412,6891
20200409,SU,송도,1996,1877,20200412,3873
20200409,SU,인하대,4198,3983,20200412,8181
20200409,SU,숭의,3176,2889,20200412,6065
20200409,SU,신포,1317,1412,20200412,2729
20200409,SU,인천,666,1137,20200412,1803
20200410,SU,달월,83,69,20200413,152
20200410,SU,월곶,2026,1939,20200413,3965
20200410,SU,소래포구,3929,3757,20200413,7686
20200410,SU,인천논현,4860,5077,20200413,9937
20200410,SU,호구포,3234,3255,20200413,6489
20200410,SU,남동인더스파크,2056,2234,20200413,4290
20200410,SU,원인재,3769,3829,20200413,7598
20200410,SU,연수,3727,3787,20200413,7514
20200410,SU,송도,2139,1965,20200413,4104
20200410,SU,인하대,4490,4210,20200413,8700
20200410,SU,숭의,3151,2888,20200413,6039
20200410,SU,신포,1399,1498,20200413,2897
20200410,SU,인천,690,1206,20200413,1896
20200411,SU,달월,43,39,20200414,82
20200411,SU,월곶,1521,1424,20200414,2945
20200411,SU,소래포구,3579,3651,20200414,7230
20200411,SU,인천논현,3515,3563,20200414,7078
20200411,SU,호구포,1842,1751,20200414,3593
20200411,SU,남동인더스파크,783,759,20200414,1542
20200411,SU,원인재,2927,2918,20200414,5845
20200411,SU,연수,2894,2867,20200414,5761
20200411,SU,송도,1551,1515,20200414,3066
20200411,SU,인하대,2892,2701,20200414,5593
20200411,SU,숭의,1987,1833,20200414,3820
20200411,SU,신포,974,1106,20200414,2080
20200411,SU,인천,649,1037,20200414,1686
20200412,SU,달월,33,44,20200415,77
20200412,SU,월곶,1123,1068,20200415,2191
20200412,SU,소래포구,3169,2976,20200415,6145
20200412,SU,인천논현,2230,2238,20200415,4468
20200412,SU,호구포,1316,1350,20200415,2666
20200412,SU,남동인더스파크,350,368,20200415,718
20200412,SU,원인재,1913,2064,20200415,3977
20200412,SU,연수,2116,2072,20200415,4188
20200412,SU,송도,1158,1125,20200415,2283
20200412,SU,인하대,1948,1893,20200415,3841
20200412,SU,숭의,1372,1305,20200415,2677
20200412,SU,신포,748,753,20200415,1501
20200412,SU,인천,536,836,20200415,1372
20200413,SU,달월,80,64,20200416,144
20200413,SU,월곶,1926,1820,20200416,3746
20200413,SU,소래포구,3742,3464,20200416,7206
20200413,SU,인천논현,4676,4808,20200416,9484
20200413,SU,호구포,3060,3219,20200416,6279
20200413,SU,남동인더스파크,2064,2341,20200416,4405
20200413,SU,원인재,3594,3649,20200416,7243
20200413,SU,연수,3603,3558,20200416,7161
20200413,SU,송도,2115,1946,20200416,4061
20200413,SU,인하대,4211,3975,20200416,8186
20200413,SU,숭의,3187,2951,20200416,6138
20200413,SU,신포,1373,1418,20200416,2791
20200413,SU,인천,695,1113,20200416,1808
20200414,SU,달월,78,56,20200417,134
20200414,SU,월곶,2054,1897,20200417,3951
20200414,SU,소래포구,4098,3982,20200417,8080
20200414,SU,인천논현,4855,5079,20200417,9934
20200414,SU,호구포,3137,3177,20200417,6314
20200414,SU,남동인더스파크,2081,2303,20200417,4384
20200414,SU,원인재,3691,3877,20200417,7568
20200414,SU,연수,3750,3875,20200417,7625
20200414,SU,송도,2109,1910,20200417,4019
20200414,SU,인하대,4407,4161,20200417,8568
20200414,SU,숭의,3346,3019,20200417,6365
20200414,SU,신포,1416,1494,20200417,2910
20200414,SU,인천,676,1172,20200417,1848
20200415,SU,달월,47,51,20200418,98
20200415,SU,월곶,1531,1409,20200418,2940
20200415,SU,소래포구,3512,3563,20200418,7075
20200415,SU,인천논현,3238,3309,20200418,6547
20200415,SU,호구포,1820,1910,20200418,3730
20200415,SU,남동인더스파크,879,949,20200418,1828
20200415,SU,원인재,2643,2607,20200418,5250
20200415,SU,연수,2643,2632,20200418,5275
20200415,SU,송도,1476,1438,20200418,2914
20200415,SU,인하대,2694,2566,20200418,5260
20200415,SU,숭의,1832,1708,20200418,3540
20200415,SU,신포,987,1017,20200418,2004
20200415,SU,인천,635,980,20200418,1615
20200416,SU,달월,83,58,20200419,141
20200416,SU,월곶,1975,1840,20200419,3815
20200416,SU,소래포구,3895,3734,20200419,7629
20200416,SU,인천논현,4698,4878,20200419,9576
20200416,SU,호구포,3150,3205,20200419,6355
20200416,SU,남동인더스파크,2033,2287,20200419,4320
20200416,SU,원인재,3686,3861,20200419,7547
20200416,SU,연수,3518,3566,20200419,7084
20200416,SU,송도,2103,1925,20200419,4028
20200416,SU,인하대,4359,4090,20200419,8449
20200416,SU,숭의,3265,2967,20200419,6232
20200416,SU,신포,1435,1465,20200419,2900
20200416,SU,인천,673,1135,20200419,1808
20200417,SU,달월,72,55,20200420,127
20200417,SU,월곶,1911,1805,20200420,3716
20200417,SU,소래포구,3416,3189,20200420,6605
20200417,SU,인천논현,4643,4789,20200420,9432
20200417,SU,호구포,3119,3063,20200420,6182
20200417,SU,남동인더스파크,1948,2215,20200420,4163
20200417,SU,원인재,3637,3668,20200420,7305
20200417,SU,연수,3541,3745,20200420,7286
20200417,SU,송도,1949,1870,20200420,3819
20200417,SU,인하대,4225,3963,20200420,8188
20200417,SU,숭의,3117,2807,20200420,5924
20200417,SU,신포,1321,1415,20200420,2736
20200417,SU,인천,650,1064,20200420,1714
20200418,SU,달월,49,50,20200421,99
20200418,SU,월곶,1692,1636,20200421,3328
20200418,SU,소래포구,4607,4653,20200421,9260
20200418,SU,인천논현,3730,3761,20200421,7491
20200418,SU,호구포,1934,1911,20200421,3845
20200418,SU,남동인더스파크,780,712,20200421,1492
20200418,SU,원인재,3011,2939,20200421,5950
20200418,SU,연수,3052,3206,20200421,6258
20200418,SU,송도,1745,1700,20200421,3445
20200418,SU,인하대,3162,2963,20200421,6125
20200418,SU,숭의,2128,2001,20200421,4129
20200418,SU,신포,1140,1202,20200421,2342
20200418,SU,인천,759,1258,20200421,2017
20200419,SU,달월,48,49,20200422,97
20200419,SU,월곶,1049,1053,20200422,2102
20200419,SU,소래포구,3231,3024,20200422,6255
20200419,SU,인천논현,2157,2253,20200422,4410
20200419,SU,호구포,1268,1329,20200422,2597
20200419,SU,남동인더스파크,419,456,20200422,875
20200419,SU,원인재,1925,2016,20200422,3941
20200419,SU,연수,2139,2014,20200422,4153
20200419,SU,송도,1118,1178,20200422,2296
20200419,SU,인하대,1827,1788,20200422,3615
20200419,SU,숭의,1293,1233,20200422,2526
20200419,SU,신포,717,734,20200422,1451
20200419,SU,인천,552,820,20200422,1372
20200420,SU,달월,81,48,20200423,129
20200420,SU,월곶,1948,1837,20200423,3785
20200420,SU,소래포구,3799,3542,20200423,7341
20200420,SU,인천논현,4795,4916,20200423,9711
20200420,SU,호구포,3056,3178,20200423,6234
20200420,SU,남동인더스파크,2153,2393,20200423,4546
20200420,SU,원인재,3636,3690,20200423,7326
20200420,SU,연수,3609,3634,20200423,7243
20200420,SU,송도,2024,1905,20200423,3929
20200420,SU,인하대,4249,4048,20200423,8297
20200420,SU,숭의,3227,3003,20200423,6230
20200420,SU,신포,1331,1297,20200423,2628
20200420,SU,인천,691,1099,20200423,1790
20200421,SU,달월,102,82,20200424,184
20200421,SU,월곶,1968,1836,20200424,3804
20200421,SU,소래포구,4192,4016,20200424,8208
20200421,SU,인천논현,4762,4958,20200424,9720
20200421,SU,호구포,3089,3175,20200424,6264
20200421,SU,남동인더스파크,2214,2484,20200424,4698
20200421,SU,원인재,3645,3803,20200424,7448
20200421,SU,연수,3621,3712,20200424,7333
20200421,SU,송도,2007,1919,20200424,3926
20200421,SU,인하대,4381,4134,20200424,8515
20200421,SU,숭의,3300,3077,20200424,6377
20200421,SU,신포,1432,1438,20200424,2870
20200421,SU,인천,731,1180,20200424,1911
20200422,SU,달월,82,54,20200425,136
20200422,SU,월곶,1960,1801,20200425,3761
20200422,SU,소래포구,3743,3481,20200425,7224
20200422,SU,인천논현,4622,4899,20200425,9521
20200422,SU,호구포,3112,3106,20200425,6218
20200422,SU,남동인더스파크,2247,2400,20200425,4647
20200422,SU,원인재,3560,3562,20200425,7122
20200422,SU,연수,3543,3607,20200425,7150
20200422,SU,송도,1943,1819,20200425,3762
20200422,SU,인하대,4262,4042,20200425,8304
20200422,SU,숭의,3187,2956,20200425,6143
20200422,SU,신포,1340,1407,20200425,2747
20200422,SU,인천,672,1159,20200425,1831
20200423,SU,달월,84,67,20200426,151
20200423,SU,월곶,1972,1836,20200426,3808
20200423,SU,소래포구,4854,4634,20200426,9488
20200423,SU,인천논현,4766,4977,20200426,9743
20200423,SU,호구포,3172,3275,20200426,6447
20200423,SU,남동인더스파크,2250,2483,20200426,4733
20200423,SU,원인재,3639,3789,20200426,7428
20200423,SU,연수,3729,3750,20200426,7479
20200423,SU,송도,2099,1964,20200426,4063
20200423,SU,인하대,4541,4210,20200426,8751
20200423,SU,숭의,3228,3049,20200426,6277
20200423,SU,신포,1393,1531,20200426,2924
20200423,SU,인천,699,1188,20200426,1887
20200424,SU,달월,85,55,20200427,140
20200424,SU,월곶,2082,1947,20200427,4029
20200424,SU,소래포구,5054,4880,20200427,9934
20200424,SU,인천논현,5034,5345,20200427,10379
20200424,SU,호구포,3324,3252,20200427,6576
20200424,SU,남동인더스파크,2123,2331,20200427,4454
20200424,SU,원인재,3925,4068,20200427,7993
20200424,SU,연수,3866,3891,20200427,7757
20200424,SU,송도,2204,2058,20200427,4262
20200424,SU,인하대,4552,4251,20200427,8803
20200424,SU,숭의,3421,3114,20200427,6535
20200424,SU,신포,1456,1539,20200427,2995
20200424,SU,인천,743,1301,20200427,2044
20200425,SU,달월,74,46,20200428,120
20200425,SU,월곶,1655,1632,20200428,3287
20200425,SU,소래포구,4969,5110,20200428,10079
20200425,SU,인천논현,3890,3895,20200428,7785
20200425,SU,호구포,2035,1915,20200428,3950
20200425,SU,남동인더스파크,836,813,20200428,1649
20200425,SU,원인재,3026,3029,20200428,6055
20200425,SU,연수,3268,3287,20200428,6555
20200425,SU,송도,1763,1619,20200428,3382
20200425,SU,인하대,3225,2969,20200428,6194
20200425,SU,숭의,2207,2045,20200428,4252
20200425,SU,신포,1118,1268,20200428,2386
20200425,SU,인천,765,1246,20200428,2011
20200426,SU,달월,39,35,20200429,74
20200426,SU,월곶,1318,1253,20200429,2571
20200426,SU,소래포구,4629,4553,20200429,9182
20200426,SU,인천논현,2597,2651,20200429,5248
20200426,SU,호구포,1392,1495,20200429,2887
20200426,SU,남동인더스파크,460,455,20200429,915
20200426,SU,원인재,2277,2367,20200429,4644
20200426,SU,연수,2386,2366,20200429,4752
20200426,SU,송도,1370,1380,20200429,2750
20200426,SU,인하대,2204,2112,20200429,4316
20200426,SU,숭의,1573,1508,20200429,3081
20200426,SU,신포,934,922,20200429,1856
20200426,SU,인천,716,1081,20200429,1797
20200427,SU,달월,88,63,20200430,151
20200427,SU,월곶,2034,1903,20200430,3937
20200427,SU,소래포구,4922,4586,20200430,9508
20200427,SU,인천논현,4876,5195,20200430,10071
20200427,SU,호구포,3198,3203,20200430,6401
20200427,SU,남동인더스파크,2072,2339,20200430,4411
20200427,SU,원인재,3885,4019,20200430,7904
20200427,SU,연수,3809,3795,20200430,7604
20200427,SU,송도,2247,2059,20200430,4306
20200427,SU,인하대,4532,4314,20200430,8846
20200427,SU,숭의,3515,3140,20200430,6655
20200427,SU,신포,1426,1556,20200430,2982
20200427,SU,인천,750,1228,20200430,1978
20200428,SU,달월,85,64,20200501,149
20200428,SU,월곶,2084,1912,20200501,3996
20200428,SU,소래포구,5025,4850,20200501,9875
20200428,SU,인천논현,4904,5101,20200501,10005
20200428,SU,호구포,3211,3237,20200501,6448
20200428,SU,남동인더스파크,2128,2312,20200501,4440
20200428,SU,원인재,3867,3964,20200501,7831
20200428,SU,연수,3929,3906,20200501,7835
20200428,SU,송도,2181,2118,20200501,4299
20200428,SU,인하대,4582,4432,20200501,9014
20200428,SU,숭의,3534,3270,20200501,6804
20200428,SU,신포,1499,1492,20200501,2991
20200428,SU,인천,728,1268,20200501,1996
20200429,SU,달월,79,64,20200502,143
20200429,SU,월곶,2259,2082,20200502,4341
20200429,SU,소래포구,5204,4888,20200502,10092
20200429,SU,인천논현,5313,5554,20200502,10867
20200429,SU,호구포,3285,3299,20200502,6584
20200429,SU,남동인더스파크,2194,2333,20200502,4527
20200429,SU,원인재,4125,4154,20200502,8279
20200429,SU,연수,4050,4132,20200502,8182
20200429,SU,송도,2302,2168,20200502,4470
20200429,SU,인하대,4869,4539,20200502,9408
20200429,SU,숭의,3611,3261,20200502,6872
20200429,SU,신포,1512,1679,20200502,3191
20200429,SU,인천,784,1368,20200502,2152
20200430,SU,달월,62,54,20200503,116
20200430,SU,월곶,1744,1546,20200503,3290
20200430,SU,소래포구,5900,6016,20200503,11916
20200430,SU,인천논현,3380,3360,20200503,6740
20200430,SU,호구포,1895,1696,20200503,3591
20200430,SU,남동인더스파크,775,736,20200503,1511
20200430,SU,원인재,2782,2896,20200503,5678
20200430,SU,연수,2909,2932,20200503,5841
20200430,SU,송도,1814,1708,20200503,3522
20200430,SU,인하대,3101,2878,20200503,5979
20200430,SU,숭의,2033,1908,20200503,3941
20200430,SU,신포,1155,1230,20200503,2385
20200430,SU,인천,920,1654,20200503,2574
20200501,SU,인천,1012,1612,20200504,2624
20200501,SU,신포,1235,1410,20200504,2645
20200501,SU,숭의,2251,2023,20200504,4274
20200501,SU,인하대,3357,3151,20200504,6508
20200501,SU,송도,1733,1627,20200504,3360
20200501,SU,연수,3286,3213,20200504,6499
20200501,SU,원인재,3058,3084,20200504,6142
20200501,SU,남동인더스파크,698,670,20200504,1368
20200501,SU,호구포,1881,1756,20200504,3637
20200501,SU,인천논현,3844,4026,20200504,7870
20200501,SU,소래포구,5744,5675,20200504,11419
20200501,SU,월곶,1707,1644,20200504,3351
20200501,SU,달월,43,37,20200504,80
20200502,SU,달월,64,68,20200505,132
20200502,SU,월곶,1675,1558,20200505,3233
20200502,SU,소래포구,4764,4859,20200505,9623
20200502,SU,인천논현,3722,3836,20200505,7558
20200502,SU,호구포,1798,1721,20200505,3519
20200502,SU,남동인더스파크,658,646,20200505,1304
20200502,SU,원인재,2945,2977,20200505,5922
20200502,SU,연수,3010,3141,20200505,6151
20200502,SU,송도,1684,1565,20200505,3249
20200502,SU,인하대,2959,2844,20200505,5803
20200502,SU,숭의,2091,1829,20200505,3920
20200502,SU,신포,1225,1272,20200505,2497
20200502,SU,인천,1000,1552,20200505,2552
20200503,SU,인천,887,1269,20200506,2156
20200503,SU,신포,1070,989,20200506,2059
20200503,SU,숭의,1647,1448,20200506,3095
20200503,SU,인하대,2294,2300,20200506,4594
20200503,SU,송도,1412,1371,20200506,2783
20200503,SU,연수,2452,2419,20200506,4871
20200503,SU,원인재,2248,2352,20200506,4600
20200503,SU,남동인더스파크,438,463,20200506,901
20200503,SU,호구포,1373,1451,20200506,2824
20200503,SU,인천논현,2670,2773,20200506,5443
20200503,SU,소래포구,4560,4577,20200506,9137
20200503,SU,월곶,1399,1274,20200506,2673
20200503,SU,달월,39,47,20200506,86
20200504,SU,인천,894,1481,20200507,2375
20200504,SU,신포,1479,1503,20200507,2982
20200504,SU,숭의,3184,2847,20200507,6031
20200504,SU,인하대,4134,3899,20200507,8033
20200504,SU,송도,2130,2018,20200507,4148
20200504,SU,연수,3854,3870,20200507,7724
20200504,SU,원인재,3638,3674,20200507,7312
20200504,SU,남동인더스파크,1383,1523,20200507,2906
20200504,SU,호구포,2630,2632,20200507,5262
20200504,SU,인천논현,4805,5020,20200507,9825
20200504,SU,소래포구,4807,4669,20200507,9476
20200504,SU,월곶,1953,1825,20200507,3778
20200504,SU,달월,56,43,20200507,99
20200505,SU,인천,920,1464,20200508,2384
20200505,SU,신포,1033,1057,20200508,2090
20200505,SU,숭의,1747,1576,20200508,3323
20200505,SU,인하대,2623,2515,20200508,5138
20200505,SU,송도,1377,1389,20200508,2766
20200505,SU,연수,2608,2583,20200508,5191
20200505,SU,원인재,2393,2543,20200508,4936
20200505,SU,남동인더스파크,489,572,20200508,1061
20200505,SU,호구포,1503,1531,20200508,3034
20200505,SU,인천논현,2954,3110,20200508,6064
20200505,SU,소래포구,4742,4711,20200508,9453
20200505,SU,월곶,1435,1354,20200508,2789
20200505,SU,달월,45,41,20200508,86
20200506,SU,달월,87,54,20200509,141
20200506,SU,월곶,2187,2061,20200509,4248
20200506,SU,소래포구,5695,5444,20200509,11139
20200506,SU,인천논현,5190,5624,20200509,10814
20200506,SU,호구포,3322,3343,20200509,6665
20200506,SU,남동인더스파크,2206,2386,20200509,4592
20200506,SU,원인재,4094,4218,20200509,8312
20200506,SU,연수,4185,4084,20200509,8269
20200506,SU,송도,2385,2219,20200509,4604
20200506,SU,인하대,4854,4604,20200509,9458
20200506,SU,숭의,3517,3337,20200509,6854
20200506,SU,신포,1577,1617,20200509,3194
20200506,SU,인천,879,1489,20200509,2368
20200507,SU,달월,75,50,20200510,125
20200507,SU,월곶,2171,2072,20200510,4243
20200507,SU,소래포구,6582,6277,20200510,12859
20200507,SU,인천논현,5378,5602,20200510,10980
20200507,SU,호구포,3450,3393,20200510,6843
20200507,SU,남동인더스파크,2185,2388,20200510,4573
20200507,SU,원인재,4257,4268,20200510,8525
20200507,SU,연수,4135,4114,20200510,8249
20200507,SU,송도,2403,2294,20200510,4697
20200507,SU,인하대,4865,4703,20200510,9568
20200507,SU,숭의,3573,3360,20200510,6933
20200507,SU,신포,1571,1648,20200510,3219
20200507,SU,인천,855,1368,20200510,2223
20200508,SU,달월,87,55,20200511,142
20200508,SU,월곶,2214,2133,20200511,4347
20200508,SU,소래포구,5412,5272,20200511,10684
20200508,SU,인천논현,5460,5769,20200511,11229
20200508,SU,호구포,3474,3505,20200511,6979
20200508,SU,남동인더스파크,2273,2355,20200511,4628
20200508,SU,인천,850,1376,20200511,2226
20200508,SU,신포,1553,1652,20200511,3205
20200508,SU,숭의,3596,3289,20200511,6885
20200508,SU,인하대,4970,4679,20200511,9649
20200508,SU,송도,2283,2230,20200511,4513
20200508,SU,연수,4091,4255,20200511,8346
20200508,SU,원인재,4107,4320,20200511,8427
20200509,SU,달월,35,28,20200512,63
20200509,SU,월곶,1431,1361,20200512,2792
20200509,SU,소래포구,3149,3287,20200512,6436
20200509,SU,인천논현,3483,3534,20200512,7017
20200509,SU,호구포,1843,1807,20200512,3650
20200509,SU,남동인더스파크,715,733,20200512,1448
20200509,SU,원인재,2653,2701,20200512,5354
20200509,SU,연수,2846,3040,20200512,5886
20200509,SU,송도,1442,1439,20200512,2881
20200509,SU,인하대,2733,2522,20200512,5255
20200509,SU,숭의,1868,1757,20200512,3625
20200509,SU,신포,996,996,20200512,1992
20200509,SU,인천,565,949,20200512,1514
20200510,SU,달월,34,29,20200513,63
20200510,SU,월곶,1333,1242,20200513,2575
20200510,SU,소래포구,3794,3652,20200513,7446
20200510,SU,인천논현,2769,2820,20200513,5589
20200510,SU,호구포,1527,1573,20200513,3100
20200510,SU,남동인더스파크,503,520,20200513,1023
20200510,SU,원인재,2349,2439,20200513,4788
20200510,SU,연수,2666,2564,20200513,5230
20200510,SU,송도,1327,1324,20200513,2651
20200510,SU,인하대,2319,2326,20200513,4645
20200510,SU,숭의,1662,1594,20200513,3256
20200510,SU,신포,986,945,20200513,1931
20200510,SU,인천,821,1239,20200513,2060
20200511,SU,인천,865,1404,20200514,2269
20200511,SU,신포,1544,1627,20200514,3171
20200511,SU,숭의,3595,3355,20200514,6950
20200511,SU,인하대,4919,4668,20200514,9587
20200511,SU,송도,2310,2154,20200514,4464
20200511,SU,연수,4087,4088,20200514,8175
20200511,SU,원인재,3931,4143,20200514,8074
20200511,SU,남동인더스파크,2186,2409,20200514,4595
20200511,SU,호구포,3300,3403,20200514,6703
20200511,SU,인천논현,5291,5458,20200514,10749
20200511,SU,소래포구,4937,4477,20200514,9414
20200511,SU,월곶,2105,2055,20200514,4160
20200511,SU,달월,82,46,20200514,128
20200512,SU,달월,78,52,20200515,130
20200512,SU,월곶,2108,1989,20200515,4097
20200512,SU,소래포구,4740,4403,20200515,9143
20200512,SU,인천논현,5156,5389,20200515,10545
20200512,SU,호구포,3321,3328,20200515,6649
20200512,SU,남동인더스파크,2247,2463,20200515,4710
20200512,SU,원인재,3968,4174,20200515,8142
20200512,SU,연수,4023,4088,20200515,8111
20200512,SU,송도,2320,2209,20200515,4529
20200512,SU,인하대,4882,4634,20200515,9516
20200512,SU,숭의,3488,3281,20200515,6769
20200512,SU,신포,1525,1581,20200515,3106
20200512,SU,인천,776,1308,20200515,2084
20200513,SU,달월,88,61,20200516,149
20200513,SU,인천,768,1363,20200516,2131
20200513,SU,신포,1505,1596,20200516,3101
20200513,SU,숭의,3480,3216,20200516,6696
20200513,SU,인하대,4589,4427,20200516,9016
20200513,SU,송도,2354,2209,20200516,4563
20200513,SU,월곶,2208,2028,20200516,4236
20200513,SU,소래포구,4731,4415,20200516,9146
20200513,SU,인천논현,5161,5461,20200516,10622
20200513,SU,호구포,3293,3294,20200516,6587
20200513,SU,남동인더스파크,2325,2497,20200516,4822
20200513,SU,원인재,3910,4073,20200516,7983
20200513,SU,연수,3989,3983,20200516,7972
20200514,SU,인천,722,1212,20200517,1934
20200514,SU,신포,1492,1540,20200517,3032
20200514,SU,숭의,3353,3072,20200517,6425
20200514,SU,인하대,4317,4031,20200517,8348
20200514,SU,송도,2208,2064,20200517,4272
20200514,SU,연수,3856,3949,20200517,7805
20200514,SU,원인재,3765,3854,20200517,7619
20200514,SU,남동인더스파크,2144,2335,20200517,4479
20200514,SU,호구포,3177,3252,20200517,6429
20200514,SU,인천논현,4843,5012,20200517,9855
20200514,SU,소래포구,4529,4290,20200517,8819
20200514,SU,월곶,2053,1948,20200517,4001
20200514,SU,달월,79,57,20200517,136
20200515,SU,인천,665,1081,20200518,1746
20200515,SU,신포,1316,1442,20200518,2758
20200515,SU,숭의,3080,2749,20200518,5829
20200515,SU,인하대,4109,3842,20200518,7951
20200515,SU,송도,2013,1906,20200518,3919
20200515,SU,연수,3643,3811,20200518,7454
20200515,SU,원인재,3594,3767,20200518,7361
20200515,SU,남동인더스파크,2184,2263,20200518,4447
20200515,SU,호구포,3087,3091,20200518,6178
20200515,SU,인천논현,4469,4874,20200518,9343
20200515,SU,소래포구,3645,3500,20200518,7145
20200515,SU,월곶,1860,1827,20200518,3687
20200515,SU,달월,75,47,20200518,122
20200516,SU,인천,691,1046,20200519,1737
20200516,SU,신포,1107,1191,20200519,2298
20200516,SU,숭의,2151,1948,20200519,4099
20200516,SU,인하대,3053,2738,20200519,5791
20200516,SU,송도,1690,1652,20200519,3342
20200516,SU,연수,3181,3337,20200519,6518
20200516,SU,원인재,3030,3060,20200519,6090
20200516,SU,남동인더스파크,837,851,20200519,1688
20200516,SU,호구포,1995,1878,20200519,3873
20200516,SU,인천논현,3650,3665,20200519,7315
20200516,SU,소래포구,3974,3939,20200519,7913
20200516,SU,월곶,1660,1599,20200519,3259
20200516,SU,달월,54,49,20200519,103
20200517,SU,인천,753,1092,20200520,1845
20200517,SU,신포,961,939,20200520,1900
20200517,SU,숭의,1633,1512,20200520,3145
20200517,SU,인하대,2079,2046,20200520,4125
20200517,SU,송도,1283,1269,20200520,2552
20200517,SU,연수,2482,2378,20200520,4860
20200517,SU,원인재,2209,2331,20200520,4540
20200517,SU,남동인더스파크,497,548,20200520,1045
20200517,SU,호구포,1537,1481,20200520,3018
20200517,SU,인천논현,2518,2696,20200520,5214
20200517,SU,소래포구,3839,3683,20200520,7522
20200517,SU,월곶,1312,1249,20200520,2561
20200517,SU,달월,45,43,20200520,88
20200518,SU,달월,72,46,20200521,118
20200518,SU,월곶,2013,1867,20200521,3880
20200518,SU,소래포구,3819,3502,20200521,7321
20200518,SU,인천논현,4590,4725,20200521,9315
20200518,SU,호구포,3006,3178,20200521,6184
20200518,SU,남동인더스파크,1926,2236,20200521,4162
20200518,SU,원인재,3515,3596,20200521,7111
20200518,SU,연수,3681,3706,20200521,7387
20200518,SU,송도,2012,1846,20200521,3858
20200518,SU,인하대,4107,3802,20200521,7909
20200518,SU,숭의,3229,3024,20200521,6253
20200518,SU,신포,1270,1302,20200521,2572
20200518,SU,인천,699,1168,20200521,1867
20200519,SU,달월,67,48,20200522,115
20200519,SU,월곶,1956,1896,20200522,3852
20200519,SU,소래포구,3766,3540,20200522,7306
20200519,SU,인천논현,4830,5007,20200522,9837
20200519,SU,호구포,3127,3149,20200522,6276
20200519,SU,남동인더스파크,2150,2374,20200522,4524
20200519,SU,원인재,3742,3815,20200522,7557
20200519,SU,연수,3653,3716,20200522,7369
20200519,SU,송도,2009,1939,20200522,3948
20200519,SU,인하대,4109,3897,20200522,8006
20200519,SU,숭의,3194,2968,20200522,6162
20200519,SU,신포,1371,1408,20200522,2779
20200519,SU,인천,662,1066,20200522,1728
20200520,SU,인천,813,1382,20200523,2195
20200520,SU,신포,1511,1569,20200523,3080
20200520,SU,숭의,3413,3140,20200523,6553
20200520,SU,인하대,4332,4051,20200523,8383
20200520,SU,송도,2327,2196,20200523,4523
20200520,SU,연수,3961,4056,20200523,8017
20200520,SU,원인재,3893,3966,20200523,7859
20200520,SU,남동인더스파크,2151,2346,20200523,4497
20200520,SU,호구포,3333,3382,20200523,6715
20200520,SU,인천논현,5043,5367,20200523,10410
20200520,SU,소래포구,4979,4657,20200523,9636
20200520,SU,월곶,2089,1960,20200523,4049
20200520,SU,달월,87,56,20200523,143
20200521,SU,인천,772,1231,20200524,2003
20200521,SU,신포,1392,1483,20200524,2875
20200521,SU,숭의,3170,2953,20200524,6123
20200521,SU,인하대,3997,3769,20200524,7766
20200521,SU,송도,2252,2127,20200524,4379
20200521,SU,연수,3838,3857,20200524,7695
20200521,SU,원인재,3848,3960,20200524,7808
20200521,SU,남동인더스파크,2079,2352,20200524,4431
20200521,SU,호구포,3207,3241,20200524,6448
20200521,SU,인천논현,4850,5103,20200524,9953
20200521,SU,소래포구,5167,4869,20200524,10036
20200521,SU,월곶,2058,1927,20200524,3985
20200521,SU,달월,80,61,20200524,141
20200522,SU,달월,76,59,20200525,135
20200522,SU,월곶,2167,2017,20200525,4184
20200522,SU,소래포구,5249,5204,20200525,10453
20200522,SU,인천논현,4944,5282,20200525,10226
20200522,SU,호구포,3316,3263,20200525,6579
20200522,SU,남동인더스파크,1999,2199,20200525,4198
20200522,SU,원인재,4005,4086,20200525,8091
20200522,SU,연수,3893,4013,20200525,7906
20200522,SU,송도,2392,2144,20200525,4536
20200522,SU,인하대,4110,3846,20200525,7956
20200522,SU,숭의,3241,2968,20200525,6209
20200522,SU,신포,1433,1532,20200525,2965
20200522,SU,인천,769,1264,20200525,2033
20200523,SU,달월,61,56,20200526,117
20200523,SU,월곶,1727,1632,20200526,3359
20200523,SU,소래포구,5022,5168,20200526,10190
20200523,SU,인천논현,3805,3871,20200526,7676
20200523,SU,호구포,2057,1868,20200526,3925
20200523,SU,남동인더스파크,774,742,20200526,1516
20200523,SU,원인재,3029,3082,20200526,6111
20200523,SU,연수,3314,3302,20200526,6616
20200523,SU,송도,1793,1758,20200526,3551
20200523,SU,인하대,2815,2561,20200526,5376
20200523,SU,숭의,2161,1970,20200526,4131
20200523,SU,신포,1117,1231,20200526,2348
20200523,SU,인천,782,1327,20200526,2109
20200524,SU,신포,877,837,20200527,1714
20200524,SU,숭의,1437,1340,20200527,2777
20200524,SU,인하대,1814,1813,20200527,3627
20200524,SU,송도,1123,1117,20200527,2240
20200524,SU,연수,2269,2265,20200527,4534
20200524,SU,원인재,2137,2184,20200527,4321
20200524,SU,남동인더스파크,539,556,20200527,1095
20200524,SU,호구포,1405,1416,20200527,2821
20200524,SU,인천논현,2416,2532,20200527,4948
20200524,SU,소래포구,3277,3302,20200527,6579
20200524,SU,월곶,1177,1150,20200527,2327
20200524,SU,달월,13,15,20200527,28
20200524,SU,인천,662,989,20200527,1651
20200525,SU,인천,809,1310,20200528,2119
20200525,SU,신포,1546,1636,20200528,3182
20200525,SU,숭의,3564,3240,20200528,6804
20200525,SU,인하대,4511,4288,20200528,8799
20200525,SU,송도,2385,2151,20200528,4536
20200525,SU,연수,4127,4077,20200528,8204
20200525,SU,원인재,3919,4010,20200528,7929
20200525,SU,남동인더스파크,2119,2371,20200528,4490
20200525,SU,호구포,3265,3337,20200528,6602
20200525,SU,인천논현,5113,5312,20200528,10425
20200525,SU,소래포구,4726,4518,20200528,9244
20200525,SU,월곶,2035,1990,20200528,4025
20200525,SU,달월,78,56,20200528,134
20200526,SU,인천,732,1274,20200529,2006
20200526,SU,신포,1456,1527,20200529,2983
20200526,SU,숭의,3413,3202,20200529,6615
20200526,SU,인하대,4374,4130,20200529,8504
20200526,SU,송도,2298,2079,20200529,4377
20200526,SU,연수,3880,3994,20200529,7874
20200526,SU,원인재,3783,3993,20200529,7776
20200526,SU,남동인더스파크,2157,2359,20200529,4516
20200526,SU,호구포,3255,3310,20200529,6565
20200526,SU,인천논현,4953,5110,20200529,10063
20200526,SU,소래포구,4841,4629,20200529,9470
20200526,SU,월곶,2109,1944,20200529,4053
20200526,SU,달월,81,59,20200529,140
20200527,SU,인천,866,1403,20200530,2269
20200527,SU,신포,1636,1701,20200530,3337
20200527,SU,숭의,3648,3361,20200530,7009
20200527,SU,인하대,4682,4446,20200530,9128
20200527,SU,송도,2496,2274,20200530,4770
20200527,SU,연수,4333,4390,20200530,8723
20200527,SU,원인재,4143,4182,20200530,8325
20200527,SU,남동인더스파크,2151,2380,20200530,4531
20200527,SU,호구포,3367,3326,20200530,6693
20200527,SU,인천논현,5238,5501,20200530,10739
20200527,SU,소래포구,5091,4804,20200530,9895
20200527,SU,월곶,2212,2099,20200530,4311
20200527,SU,달월,83,57,20200530,140
20200528,SU,인천,827,1356,20200531,2183
20200528,SU,신포,1619,1683,20200531,3302
20200528,SU,숭의,3477,3306,20200531,6783
20200528,SU,인하대,4649,4221,20200531,8870
20200528,SU,송도,2370,2231,20200531,4601
20200528,SU,연수,4155,4227,20200531,8382
20200528,SU,원인재,3950,3998,20200531,7948
20200528,SU,남동인더스파크,2190,2366,20200531,4556
20200528,SU,호구포,3353,3352,20200531,6705
20200528,SU,인천논현,5090,5277,20200531,10367
20200528,SU,소래포구,4804,4569,20200531,9373
20200528,SU,월곶,2089,2024,20200531,4113
20200528,SU,달월,74,56,20200531,130
20200529,SU,달월,83,56,20200601,139
20200529,SU,월곶,2202,1999,20200601,4201
20200529,SU,소래포구,4592,4460,20200601,9052
20200529,SU,인천논현,5156,5592,20200601,10748
20200529,SU,호구포,3385,3334,20200601,6719
20200529,SU,남동인더스파크,2051,2227,20200601,4278
20200529,SU,원인재,4067,4086,20200601,8153
20200529,SU,연수,4367,4491,20200601,8858
20200529,SU,송도,2470,2328,20200601,4798
20200529,SU,인하대,4683,4372,20200601,9055
20200529,SU,숭의,3500,3147,20200601,6647
20200529,SU,신포,1653,1793,20200601,3446
20200529,SU,인천,798,1344,20200601,2142
20200530,SU,월곶,1609,1610,20200602,3219
20200530,SU,달월,55,50,20200602,105
20200530,SU,소래포구,4297,4373,20200602,8670
20200530,SU,인천논현,3777,3869,20200602,7646
20200530,SU,호구포,1945,1842,20200602,3787
20200530,SU,남동인더스파크,790,736,20200602,1526
20200530,SU,원인재,2992,3097,20200602,6089
20200530,SU,인천,718,1165,20200602,1883
20200530,SU,신포,1142,1301,20200602,2443
20200530,SU,숭의,2058,1954,20200602,4012
20200530,SU,인하대,2976,2655,20200602,5631
20200530,SU,송도,1883,1753,20200602,3636
20200530,SU,연수,3319,3361,20200602,6680
20200531,SU,인천,703,1013,20200603,1716
20200531,SU,신포,917,895,20200603,1812
20200531,SU,숭의,1555,1407,20200603,2962
20200531,SU,인하대,2026,1998,20200603,4024
20200531,SU,송도,1233,1183,20200603,2416
20200531,SU,연수,2332,2243,20200603,4575
20200531,SU,원인재,2040,2155,20200603,4195
20200531,SU,남동인더스파크,492,515,20200603,1007
20200531,SU,호구포,1389,1432,20200603,2821
20200531,SU,인천논현,2540,2606,20200603,5146
20200531,SU,소래포구,3605,3558,20200603,7163
20200531,SU,월곶,1194,1242,20200603,2436
20200531,SU,달월,23,31,20200603,54
20200101,4,수리산,1802,1692,20200104,3494
20200101,4,오이도,6132,6113,20200104,12245
20200101,4,정왕,4495,5231,20200104,9726
20200101,4,신길온천,897,824,20200104,1721
20200101,4,안산,10317,9716,20200104,20033
20200101,4,초지,1799,1776,20200104,3575
20200101,4,고잔,3561,3565,20200104,7126
20200101,4,중앙,10099,9904,20200104,20003
20200101,4,한대앞,3843,3899,20200104,7742
20200101,4,상록수,10107,10363,20200104,20470
20200101,4,반월,2352,2516,20200104,4868
20200101,4,대야미,2482,2274,20200104,4756
20200101,4,산본,8718,9525,20200104,18243
20200102,4,산본,19477,20505,20200105,39982
20200102,4,대야미,5246,4737,20200105,9983
20200102,4,반월,4938,4688,20200105,9626
20200102,4,상록수,19838,19386,20200105,39224
20200102,4,한대앞,8554,8459,20200105,17013
20200102,4,중앙,17402,18132,20200105,35534
20200102,4,고잔,8894,8590,20200105,17484
20200102,4,초지,4204,4047,20200105,8251
20200102,4,안산,13731,12224,20200105,25955
20200102,4,신길온천,1674,1515,20200105,3189
20200102,4,정왕,7355,8031,20200105,15386
20200102,4,오이도,10026,9411,20200105,19437
20200102,4,수리산,4548,3679,20200105,8227
20200103,4,산본,20969,22457,20200106,43426
20200103,4,대야미,5619,4912,20200106,10531
20200103,4,반월,5373,4935,20200106,10308
20200103,4,상록수,21192,20568,20200106,41760
20200103,4,한대앞,9213,8904,20200106,18117
20200103,4,중앙,18746,20768,20200106,39514
20200103,4,고잔,9344,9028,20200106,18372
20200103,4,초지,4558,4315,20200106,8873
20200103,4,안산,14419,12717,20200106,27136
20200103,4,신길온천,1770,1583,20200106,3353
20200103,4,정왕,8432,8604,20200106,17036
20200103,4,오이도,10850,10268,20200106,21118
20200103,4,수리산,4980,3683,20200106,8663
20200104,4,산본,15782,16761,20200107,32543
20200104,4,대야미,4212,3514,20200107,7726
20200104,4,반월,4267,3690,20200107,7957
20200104,4,상록수,16667,15921,20200107,32588
20200104,4,한대앞,7074,6845,20200107,13919
20200104,4,중앙,16613,17855,20200107,34468
20200104,4,고잔,7053,7018,20200107,14071
20200104,4,초지,3338,3254,20200107,6592
20200104,4,안산,12157,11969,20200107,24126
20200104,4,신길온천,1430,1315,20200107,2745
20200104,4,정왕,6623,6667,20200107,13290
20200104,4,오이도,8971,8697,20200107,17668
20200104,4,수리산,3295,2712,20200107,6007
20200105,4,산본,11521,12228,20200108,23749
20200105,4,대야미,3266,3025,20200108,6291
20200105,4,반월,3136,3128,20200108,6264
20200105,4,상록수,12777,12463,20200108,25240
20200105,4,한대앞,5092,4869,20200108,9961
20200105,4,중앙,12628,12620,20200108,25248
20200105,4,고잔,5119,5108,20200108,10227
20200105,4,초지,3077,3056,20200108,6133
20200105,4,안산,12256,11161,20200108,23417
20200105,4,신길온천,1112,1059,20200108,2171
20200105,4,정왕,5351,5800,20200108,11151
20200105,4,오이도,6661,6744,20200108,13405
20200105,4,수리산,2359,2240,20200108,4599
20200106,4,산본,19311,20569,20200109,39880
20200106,4,대야미,5325,4830,20200109,10155
20200106,4,반월,5078,4714,20200109,9792
20200106,4,상록수,20061,19933,20200109,39994
20200106,4,한대앞,8958,8620,20200109,17578
20200106,4,중앙,17463,18177,20200109,35640
20200106,4,고잔,9136,8886,20200109,18022
20200106,4,초지,4402,4308,20200109,8710
20200106,4,안산,13727,12321,20200109,26048
20200106,4,신길온천,1640,1459,20200109,3099
20200106,4,정왕,7572,8296,20200109,15868
20200106,4,오이도,10216,9608,20200109,19824
20200106,4,수리산,4749,3824,20200109,8573
20200107,4,산본,18764,19809,20200110,38573
20200107,4,대야미,5067,4579,20200110,9646
20200107,4,반월,4765,4406,20200110,9171
20200107,4,상록수,19266,19077,20200110,38343
20200107,4,한대앞,8512,8400,20200110,16912
20200107,4,중앙,16760,17564,20200110,34324
20200107,4,고잔,8724,8393,20200110,17117
20200107,4,초지,4258,4279,20200110,8537
20200107,4,안산,13111,11737,20200110,24848
20200107,4,신길온천,1591,1449,20200110,3040
20200107,4,정왕,7024,7510,20200110,14534
20200107,4,오이도,9573,9065,20200110,18638
20200107,4,수리산,4639,3686,20200110,8325
20200108,4,산본,20109,21356,20200111,41465
20200108,4,대야미,5384,4733,20200111,10117
20200108,4,반월,5116,4814,20200111,9930
20200108,4,상록수,20384,20212,20200111,40596
20200108,4,한대앞,9033,8901,20200111,17934
20200108,4,중앙,18274,18914,20200111,37188
20200108,4,고잔,9399,9366,20200111,18765
20200108,4,초지,4505,4548,20200111,9053
20200108,4,안산,13826,12336,20200111,26162
20200108,4,신길온천,1723,1510,20200111,3233
20200108,4,정왕,7404,8050,20200111,15454
20200108,4,오이도,10124,9725,20200111,19849
20200108,4,수리산,4800,3811,20200111,8611
20200109,4,산본,20155,21551,20200112,41706
20200109,4,대야미,5441,4875,20200112,10316
20200109,4,반월,5282,4978,20200112,10260
20200109,4,상록수,21155,20876,20200112,42031
20200109,4,한대앞,9028,8864,20200112,17892
20200109,4,중앙,18818,19446,20200112,38264
20200109,4,고잔,9171,9131,20200112,18302
20200109,4,초지,4439,4443,20200112,8882
20200109,4,안산,13927,12351,20200112,26278
20200109,4,신길온천,1772,1578,20200112,3350
20200109,4,정왕,7670,8183,20200112,15853
20200109,4,오이도,10410,10020,20200112,20430
20200109,4,수리산,4875,3788,20200112,8663
20200110,4,산본,21171,22854,20200113,44025
20200110,4,대야미,5779,5027,20200113,10806
20200110,4,반월,5314,4756,20200113,10070
20200110,4,상록수,21925,20955,20200113,42880
20200110,4,한대앞,9589,9386,20200113,18975
20200110,4,중앙,19468,21571,20200113,41039
20200110,4,고잔,9650,9357,20200113,19007
20200110,4,초지,5057,5047,20200113,10104
20200110,4,안산,14467,12788,20200113,27255
20200110,4,신길온천,1822,1650,20200113,3472
20200110,4,정왕,8621,8961,20200113,17582
20200110,4,오이도,11073,10282,20200113,21355
20200110,4,수리산,5041,3805,20200113,8846
20200111,4,산본,16322,17408,20200114,33730
20200111,4,대야미,4533,3753,20200114,8286
20200111,4,반월,4478,3913,20200114,8391
20200111,4,상록수,17871,17012,20200114,34883
20200111,4,한대앞,7435,7042,20200114,14477
20200111,4,중앙,17612,19027,20200114,36639
20200111,4,고잔,7411,7416,20200114,14827
20200111,4,초지,3654,3499,20200114,7153
20200111,4,안산,12962,13125,20200114,26087
20200111,4,신길온천,1551,1428,20200114,2979
20200111,4,정왕,6945,6941,20200114,13886
20200111,4,오이도,9473,9189,20200114,18662
20200111,4,수리산,3380,2770,20200114,6150
20200112,4,산본,11710,12322,20200115,24032
20200112,4,대야미,3177,2847,20200115,6024
20200112,4,반월,3291,3174,20200115,6465
20200112,4,상록수,12987,12676,20200115,25663
20200112,4,한대앞,5220,5226,20200115,10446
20200112,4,중앙,13396,13261,20200115,26657
20200112,4,고잔,5423,5525,20200115,10948
20200112,4,초지,2480,2391,20200115,4871
20200112,4,안산,13685,12565,20200115,26250
20200112,4,신길온천,1127,1104,20200115,2231
20200112,4,정왕,6219,6564,20200115,12783
20200112,4,오이도,6900,6887,20200115,13787
20200112,4,수리산,2427,2346,20200115,4773
20200113,4,산본,19765,20921,20200116,40686
20200113,4,대야미,5401,4846,20200116,10247
20200113,4,반월,4914,4639,20200116,9553
20200113,4,상록수,20257,20074,20200116,40331
20200113,4,한대앞,8860,8685,20200116,17545
20200113,4,중앙,18078,18757,20200116,36835
20200113,4,고잔,9368,8975,20200116,18343
20200113,4,초지,4435,4371,20200116,8806
20200113,4,안산,14336,12802,20200116,27138
20200113,4,신길온천,1731,1557,20200116,3288
20200113,4,정왕,7901,8594,20200116,16495
20200113,4,오이도,10269,9785,20200116,20054
20200113,4,수리산,4840,3782,20200116,8622
20200114,4,수리산,4936,3793,20200117,8729
20200114,4,오이도,10273,9614,20200117,19887
20200114,4,정왕,7586,8280,20200117,15866
20200114,4,신길온천,1684,1533,20200117,3217
20200114,4,안산,13993,12407,20200117,26400
20200114,4,초지,4457,4428,20200117,8885
20200114,4,고잔,9422,9249,20200117,18671
20200114,4,중앙,18217,19097,20200117,37314
20200114,4,한대앞,9009,8936,20200117,17945
20200114,4,상록수,20661,20416,20200117,41077
20200114,4,반월,4933,4643,20200117,9576
20200114,4,대야미,5448,4835,20200117,10283
20200114,4,산본,20058,21360,20200117,41418
20200115,4,산본,20193,21543,20200118,41736
20200115,4,대야미,5431,4860,20200118,10291
20200115,4,반월,4903,4678,20200118,9581
20200115,4,상록수,20688,20331,20200118,41019
20200115,4,한대앞,9137,8986,20200118,18123
20200115,4,중앙,18129,18991,20200118,37120
20200115,4,고잔,9400,9135,20200118,18535
20200115,4,초지,4901,4954,20200118,9855
20200115,4,안산,13985,12376,20200118,26361
20200115,4,신길온천,1761,1569,20200118,3330
20200115,4,정왕,7842,8452,20200118,16294
20200115,4,오이도,10370,9950,20200118,20320
20200115,4,수리산,4841,3758,20200118,8599
20200116,4,수리산,4851,3744,20200119,8595
20200116,4,오이도,10282,9712,20200119,19994
20200116,4,정왕,7641,8259,20200119,15900
20200116,4,신길온천,1748,1572,20200119,3320
20200116,4,안산,13709,12231,20200119,25940
20200116,4,초지,4402,4381,20200119,8783
20200116,4,고잔,9368,9336,20200119,18704
20200116,4,중앙,18254,19033,20200119,37287
20200116,4,한대앞,8720,8687,20200119,17407
20200116,4,상록수,21360,20946,20200119,42306
20200116,4,반월,4998,4608,20200119,9606
20200116,4,대야미,5445,4859,20200119,10304
20200116,4,산본,20076,21293,20200119,41369
20200117,4,산본,21289,22637,20200120,43926
20200117,4,대야미,5863,4919,20200120,10782
20200117,4,반월,5186,4730,20200120,9916
20200117,4,상록수,22061,20920,20200120,42981
20200117,4,한대앞,9340,9127,20200120,18467
20200117,4,중앙,19661,21655,20200120,41316
20200117,4,고잔,9626,9323,20200120,18949
20200117,4,초지,4700,4594,20200120,9294
20200117,4,안산,14367,12764,20200120,27131
20200117,4,신길온천,1798,1681,20200120,3479
20200117,4,정왕,8975,9226,20200120,18201
20200117,4,오이도,11056,10459,20200120,21515
20200117,4,수리산,4972,3725,20200120,8697
20200118,4,산본,16391,17448,20200121,33839
20200118,4,대야미,4431,3735,20200121,8166
20200118,4,반월,4434,3871,20200121,8305
20200118,4,상록수,17674,16821,20200121,34495
20200118,4,한대앞,7369,7130,20200121,14499
20200118,4,중앙,18261,19429,20200121,37690
20200118,4,고잔,7169,7144,20200121,14313
20200118,4,초지,3635,3457,20200121,7092
20200118,4,안산,12702,12524,20200121,25226
20200118,4,신길온천,1511,1299,20200121,2810
20200118,4,정왕,6906,6933,20200121,13839
20200118,4,오이도,9651,9156,20200121,18807
20200118,4,수리산,3478,2984,20200121,6462
20200119,4,산본,11415,12361,20200122,23776
20200119,4,대야미,3200,2882,20200122,6082
20200119,4,반월,3066,3057,20200122,6123
20200119,4,상록수,12818,12569,20200122,25387
20200119,4,한대앞,5161,4960,20200122,10121
20200119,4,중앙,13629,13375,20200122,27004
20200119,4,고잔,4799,4804,20200122,9603
20200119,4,초지,2414,2341,20200122,4755
20200119,4,안산,12663,11595,20200122,24258
20200119,4,신길온천,1084,1017,20200122,2101
20200119,4,정왕,5388,5966,20200122,11354
20200119,4,오이도,6399,6356,20200122,12755
20200119,4,수리산,2459,2192,20200122,4651
20200120,4,수리산,4898,3801,20200123,8699
20200120,4,오이도,10188,9690,20200123,19878
20200120,4,정왕,7779,8462,20200123,16241
20200120,4,신길온천,1682,1511,20200123,3193
20200120,4,안산,13995,12592,20200123,26587
20200120,4,초지,4952,5082,20200123,10034
20200120,4,고잔,9428,9085,20200123,18513
20200120,4,중앙,18686,19273,20200123,37959
20200120,4,한대앞,8851,8577,20200123,17428
20200120,4,상록수,20843,20045,20200123,40888
20200120,4,반월,5033,4657,20200123,9690
20200120,4,대야미,5485,4896,20200123,10381
20200120,4,산본,20042,21347,20200123,41389
20200121,4,산본,20044,21383,20200124,41427
20200121,4,대야미,5461,4825,20200124,10286
20200121,4,반월,4897,4541,20200124,9438
20200121,4,상록수,20489,20283,20200124,40772
20200121,4,한대앞,8671,8610,20200124,17281
20200121,4,중앙,18431,19110,20200124,37541
20200121,4,고잔,9192,8882,20200124,18074
20200121,4,초지,4339,4368,20200124,8707
20200121,4,안산,13763,12394,20200124,26157
20200121,4,신길온천,1691,1532,20200124,3223
20200121,4,정왕,7643,8186,20200124,15829
20200121,4,오이도,10068,9482,20200124,19550
20200121,4,수리산,4891,3793,20200124,8684
20200122,4,산본,20276,21579,20200125,41855
20200122,4,대야미,5588,4856,20200125,10444
20200122,4,반월,5039,4645,20200125,9684
20200122,4,상록수,20604,20283,20200125,40887
20200122,4,한대앞,8661,8570,20200125,17231
20200122,4,중앙,18348,19509,20200125,37857
20200122,4,고잔,9224,8983,20200125,18207
20200122,4,초지,4278,4323,20200125,8601
20200122,4,안산,13803,12522,20200125,26325
20200122,4,신길온천,1770,1597,20200125,3367
20200122,4,정왕,7843,8191,20200125,16034
20200122,4,오이도,10190,9671,20200125,19861
20200122,4,수리산,4806,3667,20200125,8473
20200123,4,산본,19535,20746,20200126,40281
20200123,4,대야미,5257,4306,20200126,9563
20200123,4,반월,5179,4657,20200126,9836
20200123,4,상록수,20262,19400,20200126,39662
20200123,4,한대앞,8353,8098,20200126,16451
20200123,4,중앙,17948,20620,20200126,38568
20200123,4,고잔,8900,8542,20200126,17442
20200123,4,초지,4059,4047,20200126,8106
20200123,4,안산,14973,14582,20200126,29555
20200123,4,신길온천,1613,1560,20200126,3173
20200123,4,정왕,8617,8371,20200126,16988
20200123,4,오이도,10105,9914,20200126,20019
20200123,4,수리산,4639,3307,20200126,7946
20200124,4,수리산,1819,1448,20200127,3267
20200124,4,오이도,5461,5871,20200127,11332
20200124,4,정왕,5829,5054,20200127,10883
20200124,4,신길온천,935,866,20200127,1801
20200124,4,안산,14443,15254,20200127,29697
20200124,4,초지,1847,2109,20200127,3956
20200124,4,고잔,3412,3663,20200127,7075
20200124,4,중앙,8965,10567,20200127,19532
20200124,4,한대앞,4064,3990,20200127,8054
20200124,4,상록수,10636,10516,20200127,21152
20200124,4,반월,2585,2446,20200127,5031
20200124,4,대야미,2346,2005,20200127,4351
20200124,4,산본,8036,8286,20200127,16322
20200125,4,산본,6265,7069,20200128,13334
20200125,4,대야미,2102,1755,20200128,3857
20200125,4,반월,2496,2227,20200128,4723
20200125,4,상록수,10340,9962,20200128,20302
20200125,4,한대앞,3740,3495,20200128,7235
20200125,4,중앙,8393,9001,20200128,17394
20200125,4,고잔,3513,3274,20200128,6787
20200125,4,초지,1992,1906,20200128,3898
20200125,4,안산,14251,14250,20200128,28501
20200125,4,신길온천,985,835,20200128,1820
20200125,4,정왕,4936,5072,20200128,10008
20200125,4,오이도,5323,5344,20200128,10667
20200125,4,수리산,1686,1472,20200128,3158
20200126,4,산본,9512,10441,20200129,19953
20200126,4,대야미,2852,2316,20200129,5168
20200126,4,반월,2984,2611,20200129,5595
20200126,4,상록수,11642,10526,20200129,22168
20200126,4,한대앞,4602,4300,20200129,8902
20200126,4,중앙,12234,12049,20200129,24283
20200126,4,고잔,3890,3697,20200129,7587
20200126,4,초지,2203,1983,20200129,4186
20200126,4,안산,14596,13967,20200129,28563
20200126,4,신길온천,1097,948,20200129,2045
20200126,4,정왕,5273,5850,20200129,11123
20200126,4,오이도,6628,6505,20200129,13133
20200126,4,수리산,2122,1939,20200129,4061
20200127,4,산본,10271,11192,20200130,21463
20200127,4,대야미,2672,2455,20200130,5127
20200127,4,반월,2746,2708,20200130,5454
20200127,4,상록수,11531,10840,20200130,22371
20200127,4,한대앞,4518,4212,20200130,8730
20200127,4,중앙,11988,11581,20200130,23569
20200127,4,고잔,3952,3805,20200130,7757
20200127,4,초지,2117,1920,20200130,4037
20200127,4,안산,10896,9410,20200130,20306
20200127,4,신길온천,1065,906,20200130,1971
20200127,4,정왕,4574,5336,20200130,9910
20200127,4,오이도,6542,6351,20200130,12893
20200127,4,수리산,2152,1856,20200130,4008
20200128,4,산본,18239,19749,20200131,37988
20200128,4,대야미,4998,4481,20200131,9479
20200128,4,반월,4609,4412,20200131,9021
20200128,4,상록수,18961,18842,20200131,37803
20200128,4,한대앞,7697,7666,20200131,15363
20200128,4,중앙,16847,17489,20200131,34336
20200128,4,고잔,8509,8162,20200131,16671
20200128,4,초지,4119,3862,20200131,7981
20200128,4,안산,12719,11160,20200131,23879
20200128,4,신길온천,1575,1444,20200131,3019
20200128,4,정왕,6994,7745,20200131,14739
20200128,4,오이도,9554,8847,20200131,18401
20200128,4,수리산,4323,3403,20200131,7726
20200129,4,산본,19198,20443,20200201,39641
20200129,4,대야미,5275,4688,20200201,9963
20200129,4,반월,4719,4456,20200201,9175
20200129,4,상록수,19490,19454,20200201,38944
20200129,4,한대앞,8091,8000,20200201,16091
20200129,4,중앙,16920,17927,20200201,34847
20200129,4,고잔,8636,8400,20200201,17036
20200129,4,초지,4184,4077,20200201,8261
20200129,4,안산,12749,11158,20200201,23907
20200129,4,신길온천,1652,1483,20200201,3135
20200129,4,정왕,7191,7834,20200201,15025
20200129,4,오이도,9615,9160,20200201,18775
20200129,4,수리산,4565,3722,20200201,8287
20200130,4,수리산,4582,3583,20200202,8165
20200130,4,오이도,9688,9234,20200202,18922
20200130,4,정왕,7138,7796,20200202,14934
20200130,4,신길온천,1659,1517,20200202,3176
20200130,4,안산,12455,10733,20200202,23188
20200130,4,초지,4498,4492,20200202,8990
20200130,4,고잔,8623,8497,20200202,17120
20200130,4,중앙,16985,17801,20200202,34786
20200130,4,한대앞,8182,8148,20200202,16330
20200130,4,상록수,19808,19638,20200202,39446
20200130,4,반월,4609,4369,20200202,8978
20200130,4,대야미,5257,4630,20200202,9887
20200130,4,산본,19319,20318,20200202,39637
20200131,4,산본,19465,20900,20200203,40365
20200131,4,대야미,5367,4623,20200203,9990
20200131,4,반월,4855,4468,20200203,9323
20200131,4,상록수,19885,19229,20200203,39114
20200131,4,한대앞,8416,8069,20200203,16485
20200131,4,중앙,17353,19279,20200203,36632
20200131,4,고잔,8722,8476,20200203,17198
20200131,4,초지,4238,4141,20200203,8379
20200131,4,안산,12912,11141,20200203,24053
20200131,4,신길온천,1668,1500,20200203,3168
20200131,4,정왕,7743,8132,20200203,15875
20200131,4,오이도,10042,9594,20200203,19636
20200131,4,수리산,4690,3422,20200203,8112
20200201,4,산본,13305,14266,20200204,27571
20200201,4,대야미,3661,3159,20200204,6820
20200201,4,반월,3508,3203,20200204,6711
20200201,4,상록수,14110,13515,20200204,27625
20200201,4,한대앞,5714,5749,20200204,11463
20200201,4,중앙,13529,14595,20200204,28124
20200201,4,고잔,5539,5455,20200204,10994
20200201,4,초지,2806,2616,20200204,5422
20200201,4,안산,8966,8667,20200204,17633
20200201,4,신길온천,1133,1014,20200204,2147
20200201,4,정왕,5389,5386,20200204,10775
20200201,4,오이도,7095,6835,20200204,13930
20200201,4,수리산,2778,2270,20200204,5048
20200202,4,산본,8687,9311,20200205,17998
20200202,4,대야미,2569,2437,20200205,5006
20200202,4,반월,2470,2390,20200205,4860
20200202,4,상록수,10517,10357,20200205,20874
20200202,4,한대앞,4058,3925,20200205,7983
20200202,4,중앙,10227,10199,20200205,20426
20200202,4,고잔,3745,3718,20200205,7463
20200202,4,초지,1803,1685,20200205,3488
20200202,4,안산,8224,7652,20200205,15876
20200202,4,신길온천,819,831,20200205,1650
20200202,4,정왕,4126,4491,20200205,8617
20200202,4,오이도,5131,5169,20200205,10300
20200202,4,수리산,1999,1851,20200205,3850
20200203,4,산본,16212,17142,20200206,33354
20200203,4,대야미,4653,4155,20200206,8808
20200203,4,반월,4233,4044,20200206,8277
20200203,4,상록수,18224,18107,20200206,36331
20200203,4,한대앞,7509,7468,20200206,14977
20200203,4,중앙,15610,16407,20200206,32017
20200203,4,고잔,8153,7859,20200206,16012
20200203,4,초지,3921,3849,20200206,7770
20200203,4,안산,12207,10737,20200206,22944
20200203,4,신길온천,1502,1355,20200206,2857
20200203,4,정왕,6844,7503,20200206,14347
20200203,4,오이도,9102,8540,20200206,17642
20200203,4,수리산,4036,3226,20200206,7262
20200204,4,산본,16489,17539,20200207,34028
20200204,4,대야미,4671,4154,20200207,8825
20200204,4,반월,4265,4034,20200207,8299
20200204,4,상록수,18178,18239,20200207,36417
20200204,4,한대앞,7433,7482,20200207,14915
20200204,4,중앙,15453,16187,20200207,31640
20200204,4,고잔,8135,7890,20200207,16025
20200204,4,초지,3889,3834,20200207,7723
20200204,4,안산,11859,10447,20200207,22306
20200204,4,신길온천,1481,1341,20200207,2822
20200204,4,정왕,6507,6992,20200207,13499
20200204,4,오이도,8916,8460,20200207,17376
20200204,4,수리산,4112,3268,20200207,7380
20200205,4,산본,16453,17412,20200208,33865
20200205,4,대야미,4616,4062,20200208,8678
20200205,4,반월,4209,3954,20200208,8163
20200205,4,상록수,17622,17385,20200208,35007
20200205,4,한대앞,7307,7227,20200208,14534
20200205,4,중앙,15279,16048,20200208,31327
20200205,4,고잔,7790,7610,20200208,15400
20200205,4,초지,3882,3944,20200208,7826
20200205,4,안산,11702,10117,20200208,21819
20200205,4,신길온천,1405,1293,20200208,2698
20200205,4,정왕,6094,6667,20200208,12761
20200205,4,오이도,8663,8174,20200208,16837
20200205,4,수리산,4102,3145,20200208,7247
20200206,4,산본,16232,17096,20200209,33328
20200206,4,대야미,4484,4015,20200209,8499
20200206,4,반월,4124,3849,20200209,7973
20200206,4,상록수,17584,17403,20200209,34987
20200206,4,한대앞,7205,7136,20200209,14341
20200206,4,중앙,15195,16112,20200209,31307
20200206,4,고잔,7801,7433,20200209,15234
20200206,4,초지,3714,3672,20200209,7386
20200206,4,안산,11237,9744,20200209,20981
20200206,4,신길온천,1391,1261,20200209,2652
20200206,4,정왕,6146,6724,20200209,12870
20200206,4,오이도,8545,8026,20200209,16571
20200206,4,수리산,3994,3115,20200209,7109
20200207,4,산본,17148,18458,20200210,35606
20200207,4,대야미,4855,4151,20200210,9006
20200207,4,반월,4458,4028,20200210,8486
20200207,4,상록수,18991,18093,20200210,37084
20200207,4,한대앞,7675,7664,20200210,15339
20200207,4,중앙,16339,17989,20200210,34328
20200207,4,고잔,8002,7847,20200210,15849
20200207,4,초지,4047,4278,20200210,8325
20200207,4,안산,12228,10566,20200210,22794
20200207,4,신길온천,1508,1367,20200210,2875
20200207,4,정왕,7035,7298,20200210,14333
20200207,4,오이도,9036,8483,20200210,17519
20200207,4,수리산,4267,3175,20200210,7442
20200208,4,산본,11950,12891,20200211,24841
20200208,4,대야미,3614,3012,20200211,6626
20200208,4,반월,3348,3023,20200211,6371
20200208,4,상록수,13311,13167,20200211,26478
20200208,4,한대앞,5568,5353,20200211,10921
20200208,4,중앙,13115,14132,20200211,27247
20200208,4,고잔,5731,5695,20200211,11426
20200208,4,초지,2609,2581,20200211,5190
20200208,4,안산,8604,8604,20200211,17208
20200208,4,신길온천,1106,967,20200211,2073
20200208,4,정왕,5017,5086,20200211,10103
20200208,4,오이도,6880,6808,20200211,13688
20200208,4,수리산,2643,2246,20200211,4889
20200209,4,산본,8896,9387,20200212,18283
20200209,4,대야미,2699,2389,20200212,5088
20200209,4,반월,2410,2334,20200212,4744
20200209,4,상록수,10242,9890,20200212,20132
20200209,4,한대앞,4053,3939,20200212,7992
20200209,4,중앙,10129,10197,20200212,20326
20200209,4,고잔,3668,3637,20200212,7305
20200209,4,초지,1825,1699,20200212,3524
20200209,4,안산,8237,7331,20200212,15568
20200209,4,신길온천,825,791,20200212,1616
20200209,4,정왕,4068,4441,20200212,8509
20200209,4,오이도,5080,4953,20200212,10033
20200209,4,수리산,1918,1952,20200212,3870
20200210,4,산본,16993,18290,20200213,35283
20200210,4,대야미,4867,4308,20200213,9175
20200210,4,반월,4497,4269,20200213,8766
20200210,4,상록수,18372,18105,20200213,36477
20200210,4,한대앞,7675,7614,20200213,15289
20200210,4,중앙,16068,16550,20200213,32618
20200210,4,고잔,8154,7913,20200213,16067
20200210,4,초지,4052,4069,20200213,8121
20200210,4,안산,12068,10506,20200213,22574
20200210,4,신길온천,1520,1382,20200213,2902
20200210,4,정왕,6450,7005,20200213,13455
20200210,4,오이도,8556,8115,20200213,16671
20200210,4,수리산,4248,3356,20200213,7604
20200211,4,산본,17785,19059,20200214,36844
20200211,4,대야미,5066,4476,20200214,9542
20200211,4,반월,4437,4231,20200214,8668
20200211,4,상록수,18729,18503,20200214,37232
20200211,4,한대앞,7706,7778,20200214,15484
20200211,4,중앙,16198,17063,20200214,33261
20200211,4,고잔,8336,8078,20200214,16414
20200211,4,초지,3994,4071,20200214,8065
20200211,4,안산,12031,10372,20200214,22403
20200211,4,신길온천,1527,1406,20200214,2933
20200211,4,정왕,6446,7002,20200214,13448
20200211,4,오이도,9054,8522,20200214,17576
20200211,4,수리산,4314,3414,20200214,7728
20200212,4,산본,17269,18465,20200215,35734
20200212,4,대야미,4668,4138,20200215,8806
20200212,4,반월,4252,4019,20200215,8271
20200212,4,상록수,17819,17609,20200215,35428
20200212,4,한대앞,7214,7324,20200215,14538
20200212,4,중앙,15182,16095,20200215,31277
20200212,4,고잔,7883,7592,20200215,15475
20200212,4,초지,3896,3743,20200215,7639
20200212,4,안산,11397,9978,20200215,21375
20200212,4,신길온천,1438,1325,20200215,2763
20200212,4,정왕,6192,6777,20200215,12969
20200212,4,오이도,8312,8013,20200215,16325
20200212,4,수리산,4190,3246,20200215,7436
20200213,4,산본,18165,19405,20200216,37570
20200213,4,대야미,4999,4418,20200216,9417
20200213,4,반월,4616,4300,20200216,8916
20200213,4,상록수,19244,19107,20200216,38351
20200213,4,한대앞,7901,7775,20200216,15676
20200213,4,중앙,16672,17451,20200216,34123
20200213,4,고잔,8374,8194,20200216,16568
20200213,4,초지,4040,3998,20200216,8038
20200213,4,안산,12088,10609,20200216,22697
20200213,4,신길온천,1520,1371,20200216,2891
20200213,4,정왕,6546,7065,20200216,13611
20200213,4,오이도,9101,8692,20200216,17793
20200213,4,수리산,4435,3427,20200216,7862
20200214,4,산본,19567,21002,20200217,40569
20200214,4,대야미,5473,4714,20200217,10187
20200214,4,반월,4944,4559,20200217,9503
20200214,4,상록수,20415,19836,20200217,40251
20200214,4,한대앞,8379,8154,20200217,16533
20200214,4,중앙,18152,19966,20200217,38118
20200214,4,고잔,8757,8590,20200217,17347
20200214,4,초지,4310,4214,20200217,8524
20200214,4,안산,13134,11231,20200217,24365
20200214,4,신길온천,1645,1503,20200217,3148
20200214,4,정왕,7786,7994,20200217,15780
20200214,4,오이도,9929,9518,20200217,19447
20200214,4,수리산,4615,3446,20200217,8061
20200215,4,산본,13992,14989,20200218,28981
20200215,4,대야미,4150,3439,20200218,7589
20200215,4,반월,3791,3357,20200218,7148
20200215,4,상록수,15318,14706,20200218,30024
20200215,4,한대앞,6272,6073,20200218,12345
20200215,4,중앙,14755,15956,20200218,30711
20200215,4,고잔,6435,6614,20200218,13049
20200215,4,초지,3281,3216,20200218,6497
20200215,4,안산,10141,10112,20200218,20253
20200215,4,신길온천,1258,1169,20200218,2427
20200215,4,정왕,5756,5699,20200218,11455
20200215,4,오이도,7808,7598,20200218,15406
20200215,4,수리산,3012,2603,20200218,5615
20200216,4,산본,9491,10296,20200219,19787
20200216,4,대야미,2602,2387,20200219,4989
20200216,4,반월,2521,2492,20200219,5013
20200216,4,상록수,10804,10700,20200219,21504
20200216,4,한대앞,4292,4092,20200219,8384
20200216,4,중앙,10604,10556,20200219,21160
20200216,4,고잔,3781,3797,20200219,7578
20200216,4,초지,1971,1871,20200219,3842
20200216,4,안산,9203,8271,20200219,17474
20200216,4,신길온천,765,746,20200219,1511
20200216,4,정왕,4048,4564,20200219,8612
20200216,4,오이도,5207,5216,20200219,10423
20200216,4,수리산,2061,1860,20200219,3921
20200217,4,산본,18179,19279,20200220,37458
20200217,4,대야미,5023,4479,20200220,9502
20200217,4,반월,4526,4295,20200220,8821
20200217,4,상록수,18788,18550,20200220,37338
20200217,4,한대앞,7813,7811,20200220,15624
20200217,4,중앙,16289,16932,20200220,33221
20200217,4,고잔,8332,8057,20200220,16389
20200217,4,초지,4069,4014,20200220,8083
20200217,4,안산,12374,11138,20200220,23512
20200217,4,신길온천,1456,1325,20200220,2781
20200217,4,정왕,6773,7549,20200220,14322
20200217,4,오이도,9058,8499,20200220,17557
20200217,4,수리산,4488,3533,20200220,8021
20200218,4,산본,17925,19080,20200221,37005
20200218,4,대야미,5012,4420,20200221,9432
20200218,4,반월,4410,4211,20200221,8621
20200218,4,상록수,18812,18591,20200221,37403
20200218,4,한대앞,7826,7672,20200221,15498
20200218,4,중앙,16241,17078,20200221,33319
20200218,4,고잔,8283,8034,20200221,16317
20200218,4,초지,4045,4043,20200221,8088
20200218,4,안산,12236,10696,20200221,22932
20200218,4,신길온천,1528,1361,20200221,2889
20200218,4,정왕,6421,6996,20200221,13417
20200218,4,오이도,9072,8606,20200221,17678
20200218,4,수리산,4412,3542,20200221,7954
20200219,4,산본,18486,19898,20200222,38384
20200219,4,대야미,5276,4521,20200222,9797
20200219,4,반월,4652,4376,20200222,9028
20200219,4,상록수,19108,18883,20200222,37991
20200219,4,한대앞,7926,7900,20200222,15826
20200219,4,중앙,16410,17390,20200222,33800
20200219,4,고잔,8354,8155,20200222,16509
20200219,4,초지,4081,4172,20200222,8253
20200219,4,안산,12237,10479,20200222,22716
20200219,4,신길온천,1551,1431,20200222,2982
20200219,4,정왕,6672,7334,20200222,14006
20200219,4,오이도,9393,8844,20200222,18237
20200219,4,수리산,4504,3614,20200222,8118
20200220,4,산본,18162,19325,20200223,37487
20200220,4,대야미,5229,4572,20200223,9801
20200220,4,반월,4638,4315,20200223,8953
20200220,4,상록수,18887,18626,20200223,37513
20200220,4,한대앞,7841,7780,20200223,15621
20200220,4,중앙,16287,17227,20200223,33514
20200220,4,고잔,8424,8063,20200223,16487
20200220,4,초지,4289,4350,20200223,8639
20200220,4,안산,12074,10570,20200223,22644
20200220,4,신길온천,1493,1331,20200223,2824
20200220,4,정왕,6683,7239,20200223,13922
20200220,4,오이도,9137,8761,20200223,17898
20200220,4,수리산,4348,3407,20200223,7755
20200221,4,산본,17536,19131,20200224,36667
20200221,4,대야미,5106,4328,20200224,9434
20200221,4,반월,4471,4130,20200224,8601
20200221,4,상록수,18637,18159,20200224,36796
20200221,4,한대앞,7760,7573,20200224,15333
20200221,4,중앙,16109,17631,20200224,33740
20200221,4,고잔,8288,8066,20200224,16354
20200221,4,초지,4136,3993,20200224,8129
20200221,4,안산,12126,10525,20200224,22651
20200221,4,신길온천,1522,1306,20200224,2828
20200221,4,정왕,7081,7338,20200224,14419
20200221,4,오이도,9248,8685,20200224,17933
20200221,4,수리산,4332,3242,20200224,7574
20200222,4,산본,10753,11765,20200225,22518
20200222,4,대야미,3185,2671,20200225,5856
20200222,4,반월,3012,2752,20200225,5764
20200222,4,상록수,12412,11823,20200225,24235
20200222,4,한대앞,5066,4872,20200225,9938
20200222,4,중앙,11186,12010,20200225,23196
20200222,4,고잔,5296,5397,20200225,10693
20200222,4,초지,2349,2339,20200225,4688
20200222,4,안산,8119,8024,20200225,16143
20200222,4,신길온천,993,972,20200225,1965
20200222,4,정왕,4602,4649,20200225,9251
20200222,4,오이도,6050,6087,20200225,12137
20200222,4,수리산,2394,2017,20200225,4411
20200223,4,산본,6683,7167,20200226,13850
20200223,4,대야미,2237,1983,20200226,4220
20200223,4,반월,1901,1979,20200226,3880
20200223,4,상록수,8181,8066,20200226,16247
20200223,4,한대앞,3308,3182,20200226,6490
20200223,4,중앙,7690,7458,20200226,15148
20200223,4,고잔,3065,3264,20200226,6329
20200223,4,초지,1440,1422,20200226,2862
20200223,4,안산,6887,6102,20200226,12989
20200223,4,신길온천,697,672,20200226,1369
20200223,4,정왕,2972,3307,20200226,6279
20200223,4,오이도,4051,4062,20200226,8113
20200223,4,수리산,1540,1534,20200226,3074
20200224,4,산본,14519,15550,20200227,30069
20200224,4,대야미,4269,3871,20200227,8140
20200224,4,반월,3815,3578,20200227,7393
20200224,4,상록수,16104,16035,20200227,32139
20200224,4,한대앞,6520,6594,20200227,13114
20200224,4,중앙,13004,13375,20200227,26379
20200224,4,고잔,7143,6900,20200227,14043
20200224,4,초지,3626,3639,20200227,7265
20200224,4,안산,10729,9618,20200227,20347
20200224,4,신길온천,1393,1188,20200227,2581
20200224,4,정왕,5770,6401,20200227,12171
20200224,4,오이도,7632,7106,20200227,14738
20200224,4,수리산,3699,2934,20200227,6633
20200225,4,산본,13262,14284,20200228,27546
20200225,4,대야미,3791,3461,20200228,7252
20200225,4,반월,3375,3241,20200228,6616
20200225,4,상록수,14587,13453,20200228,28040
20200225,4,한대앞,5837,5945,20200228,11782
20200225,4,중앙,11396,11753,20200228,23149
20200225,4,고잔,6365,6305,20200228,12670
20200225,4,초지,3373,3386,20200228,6759
20200225,4,안산,9627,8344,20200228,17971
20200225,4,신길온천,1166,1055,20200228,2221
20200225,4,정왕,5054,5541,20200228,10595
20200225,4,오이도,6654,6302,20200228,12956
20200225,4,수리산,3446,2665,20200228,6111
20200226,4,대야미,4098,3655,20200229,7753
20200226,4,산본,13502,14555,20200229,28057
20200226,4,반월,3513,3400,20200229,6913
20200226,4,상록수,14968,14942,20200229,29910
20200226,4,한대앞,6063,6038,20200229,12101
20200226,4,중앙,11856,12487,20200229,24343
20200226,4,고잔,6668,6458,20200229,13126
20200226,4,초지,3252,3333,20200229,6585
20200226,4,안산,10052,8754,20200229,18806
20200226,4,신길온천,1191,1103,20200229,2294
20200226,4,정왕,5391,5832,20200229,11223
20200226,4,오이도,6942,6597,20200229,13539
20200226,4,수리산,3552,2811,20200229,6363
20200227,4,산본,13248,14092,20200301,27340
20200227,4,대야미,3953,3597,20200301,7550
20200227,4,반월,3490,3368,20200301,6858
20200227,4,상록수,14678,14661,20200301,29339
20200227,4,한대앞,6025,6034,20200301,12059
20200227,4,중앙,11593,12271,20200301,23864
20200227,4,고잔,6470,6314,20200301,12784
20200227,4,초지,3255,3131,20200301,6386
20200227,4,안산,9833,8524,20200301,18357
20200227,4,신길온천,1211,1089,20200301,2300
20200227,4,정왕,5196,5720,20200301,10916
20200227,4,오이도,6857,6507,20200301,13364
20200227,4,수리산,3451,2752,20200301,6203
20200228,4,산본,12813,13949,20200302,26762
20200228,4,대야미,3763,3252,20200302,7015
20200228,4,반월,3349,3038,20200302,6387
20200228,4,상록수,14283,13998,20200302,28281
20200228,4,한대앞,5804,5735,20200302,11539
20200228,4,중앙,11168,12275,20200302,23443
20200228,4,고잔,6229,6076,20200302,12305
20200228,4,초지,3025,2964,20200302,5989
20200228,4,안산,9525,8265,20200302,17790
20200228,4,신길온천,1191,1026,20200302,2217
20200228,4,정왕,5262,5608,20200302,10870
20200228,4,오이도,6556,6301,20200302,12857
20200228,4,수리산,3292,2552,20200302,5844
20200229,4,산본,7963,8585,20200303,16548
20200229,4,대야미,2456,2165,20200303,4621
20200229,4,반월,2156,2033,20200303,4189
20200229,4,상록수,9234,8422,20200303,17656
20200229,4,한대앞,3675,3713,20200303,7388
20200229,4,중앙,8116,8919,20200303,17035
20200229,4,고잔,3478,3562,20200303,7040
20200229,4,초지,1699,1697,20200303,3396
20200229,4,안산,5886,5560,20200303,11446
20200229,4,신길온천,788,749,20200303,1537
20200229,4,정왕,3226,3351,20200303,6577
20200229,4,오이도,4193,4011,20200303,8204
20200229,4,수리산,1825,1502,20200303,3327
20200301,4,산본,5160,5448,20200304,10608
20200301,4,대야미,1768,1594,20200304,3362
20200301,4,반월,1431,1415,20200304,2846
20200301,4,상록수,6039,5868,20200304,11907
20200301,4,한대앞,2454,2423,20200304,4877
20200301,4,중앙,5480,5460,20200304,10940
20200301,4,고잔,2130,2144,20200304,4274
20200301,4,초지,1085,1085,20200304,2170
20200301,4,안산,4410,4035,20200304,8445
20200301,4,신길온천,513,502,20200304,1015
20200301,4,정왕,2283,2472,20200304,4755
20200301,4,오이도,2714,2727,20200304,5441
20200301,4,수리산,1171,1141,20200304,2312
20200302,4,산본,13063,13871,20200305,26934
20200302,4,대야미,3953,3502,20200305,7455
20200302,4,반월,3383,3263,20200305,6646
20200302,4,상록수,14531,14371,20200305,28902
20200302,4,한대앞,5793,5933,20200305,11726
20200302,4,중앙,11409,11803,20200305,23212
20200302,4,고잔,6470,6269,20200305,12739
20200302,4,초지,3142,3089,20200305,6231
20200302,4,안산,9831,8637,20200305,18468
20200302,4,신길온천,1168,1057,20200305,2225
20200302,4,정왕,5297,5786,20200305,11083
20200302,4,오이도,6523,6205,20200305,12728
20200302,4,수리산,3390,2736,20200305,6126
20200303,4,산본,12962,13974,20200306,26936
20200303,4,대야미,3969,3581,20200306,7550
20200303,4,반월,3411,3264,20200306,6675
20200303,4,상록수,14338,14264,20200306,28602
20200303,4,한대앞,5882,5885,20200306,11767
20200303,4,중앙,11562,12053,20200306,23615
20200303,4,고잔,6411,6307,20200306,12718
20200303,4,초지,3119,3050,20200306,6169
20200303,4,안산,9643,8337,20200306,17980
20200303,4,신길온천,1185,1078,20200306,2263
20200303,4,정왕,5155,5640,20200306,10795
20200303,4,오이도,6519,6201,20200306,12720
20200303,4,수리산,3454,2764,20200306,6218
20200304,4,산본,12753,13767,20200307,26520
20200304,4,대야미,3892,3399,20200307,7291
20200304,4,반월,3378,3126,20200307,6504
20200304,4,상록수,14052,14134,20200307,28186
20200304,4,한대앞,5645,5771,20200307,11416
20200304,4,중앙,11428,11981,20200307,23409
20200304,4,고잔,6238,6133,20200307,12371
20200304,4,초지,3011,2998,20200307,6009
20200304,4,안산,9560,8365,20200307,17925
20200304,4,신길온천,1175,1119,20200307,2294
20200304,4,정왕,5084,5525,20200307,10609
20200304,4,오이도,6355,6054,20200307,12409
20200304,4,수리산,3292,2605,20200307,5897
20200305,4,산본,12789,13809,20200308,26598
20200305,4,대야미,3905,3519,20200308,7424
20200305,4,반월,3300,3213,20200308,6513
20200305,4,상록수,14435,14224,20200308,28659
20200305,4,한대앞,5750,5792,20200308,11542
20200305,4,중앙,11489,12070,20200308,23559
20200305,4,고잔,6259,6185,20200308,12444
20200305,4,초지,3255,3221,20200308,6476
20200305,4,안산,9499,8103,20200308,17602
20200305,4,신길온천,1174,1081,20200308,2255
20200305,4,정왕,5034,5506,20200308,10540
20200305,4,오이도,6493,6208,20200308,12701
20200305,4,수리산,3366,2645,20200308,6011
20200306,4,산본,13392,14440,20200309,27832
20200306,4,대야미,4151,3589,20200309,7740
20200306,4,반월,3669,3326,20200309,6995
20200306,4,상록수,14971,14833,20200309,29804
20200306,4,한대앞,6025,5996,20200309,12021
20200306,4,중앙,12150,13519,20200309,25669
20200306,4,고잔,6430,6365,20200309,12795
20200306,4,초지,3228,3226,20200309,6454
20200306,4,안산,9874,8543,20200309,18417
20200306,4,신길온천,1237,1142,20200309,2379
20200306,4,정왕,5334,5739,20200309,11073
20200306,4,오이도,6986,6619,20200309,13605
20200306,4,수리산,3469,2633,20200309,6102
20200307,4,안산,6284,5973,20200310,12257
20200307,4,산본,8255,8976,20200310,17231
20200307,4,대야미,2696,2283,20200310,4979
20200307,4,반월,2262,2140,20200310,4402
20200307,4,상록수,9627,9243,20200310,18870
20200307,4,한대앞,3850,3830,20200310,7680
20200307,4,중앙,8641,9762,20200310,18403
20200307,4,고잔,3609,3549,20200310,7158
20200307,4,초지,1916,1820,20200310,3736
20200307,4,신길온천,801,774,20200310,1575
20200307,4,정왕,3417,3398,20200310,6815
20200307,4,오이도,4512,4571,20200310,9083
20200307,4,수리산,1878,1678,20200310,3556
20200308,4,산본,5607,5792,20200311,11399
20200308,4,대야미,1948,1728,20200311,3676
20200308,4,반월,1582,1596,20200311,3178
20200308,4,상록수,6465,6108,20200311,12573
20200308,4,한대앞,2492,2388,20200311,4880
20200308,4,중앙,6177,5985,20200311,12162
20200308,4,고잔,2327,2321,20200311,4648
20200308,4,초지,1243,1145,20200311,2388
20200308,4,안산,5009,4707,20200311,9716
20200308,4,신길온천,569,523,20200311,1092
20200308,4,정왕,2469,2779,20200311,5248
20200308,4,오이도,3530,3343,20200311,6873
20200308,4,수리산,1362,1491,20200311,2853
20200309,4,산본,13506,14476,20200312,27982
20200309,4,대야미,4084,3738,20200312,7822
20200309,4,반월,3479,3282,20200312,6761
20200309,4,상록수,14754,14816,20200312,29570
20200309,4,한대앞,5641,5714,20200312,11355
20200309,4,중앙,11793,12045,20200312,23838
20200309,4,고잔,6496,6304,20200312,12800
20200309,4,초지,3251,3214,20200312,6465
20200309,4,안산,9770,8680,20200312,18450
20200309,4,신길온천,1259,1136,20200312,2395
20200309,4,정왕,5331,5807,20200312,11138
20200309,4,오이도,6935,6616,20200312,13551
20200309,4,수리산,3565,2750,20200312,6315
20200310,4,산본,12697,13490,20200313,26187
20200310,4,대야미,3738,3328,20200313,7066
20200310,4,반월,3147,2952,20200313,6099
20200310,4,상록수,13893,13792,20200313,27685
20200310,4,한대앞,5401,5331,20200313,10732
20200310,4,중앙,11038,11525,20200313,22563
20200310,4,고잔,6117,5930,20200313,12047
20200310,4,초지,3086,3028,20200313,6114
20200310,4,안산,9255,7945,20200313,17200
20200310,4,신길온천,1117,973,20200313,2090
20200310,4,정왕,4816,5275,20200313,10091
20200310,4,오이도,6391,6104,20200313,12495
20200310,4,수리산,3262,2591,20200313,5853
20200311,4,산본,13422,14374,20200314,27796
20200311,4,대야미,4031,3642,20200314,7673
20200311,4,반월,3445,3248,20200314,6693
20200311,4,상록수,14652,14485,20200314,29137
20200311,4,한대앞,5775,5783,20200314,11558
20200311,4,중앙,11938,12575,20200314,24513
20200311,4,고잔,6362,6295,20200314,12657
20200311,4,초지,3192,3133,20200314,6325
20200311,4,안산,9692,8438,20200314,18130
20200311,4,신길온천,1220,1121,20200314,2341
20200311,4,정왕,5131,5674,20200314,10805
20200311,4,오이도,6790,6525,20200314,13315
20200311,4,수리산,3431,2756,20200314,6187
20200312,4,산본,13257,14126,20200315,27383
20200312,4,대야미,4001,3545,20200315,7546
20200312,4,반월,3336,3185,20200315,6521
20200312,4,상록수,14419,14282,20200315,28701
20200312,4,한대앞,5699,5724,20200315,11423
20200312,4,중앙,11719,12271,20200315,23990
20200312,4,고잔,6446,6261,20200315,12707
20200312,4,초지,3221,3196,20200315,6417
20200312,4,안산,9586,8237,20200315,17823
20200312,4,신길온천,1246,1117,20200315,2363
20200312,4,정왕,5089,5651,20200315,10740
20200312,4,오이도,6725,6399,20200315,13124
20200312,4,수리산,3440,2773,20200315,6213
20200313,4,산본,13573,14688,20200316,28261
20200313,4,대야미,4068,3500,20200316,7568
20200313,4,반월,3511,3216,20200316,6727
20200313,4,상록수,14860,14558,20200316,29418
20200313,4,한대앞,5731,5819,20200316,11550
20200313,4,중앙,12056,13269,20200316,25325
20200313,4,고잔,6355,6197,20200316,12552
20200313,4,초지,3236,3137,20200316,6373
20200313,4,안산,9776,8445,20200316,18221
20200313,4,신길온천,1224,1124,20200316,2348
20200313,4,정왕,5466,5677,20200316,11143
20200313,4,오이도,6968,6766,20200316,13734
20200313,4,수리산,3381,2642,20200316,6023
20200314,4,산본,8743,9313,20200317,18056
20200314,4,대야미,2876,2460,20200317,5336
20200314,4,반월,2436,2243,20200317,4679
20200314,4,상록수,9855,9451,20200317,19306
20200314,4,한대앞,3790,3714,20200317,7504
20200314,4,중앙,8898,9957,20200317,18855
20200314,4,고잔,3555,3565,20200317,7120
20200314,4,초지,1948,1921,20200317,3869
20200314,4,안산,6287,6080,20200317,12367
20200314,4,신길온천,858,774,20200317,1632
20200314,4,정왕,3540,3596,20200317,7136
20200314,4,오이도,5011,5045,20200317,10056
20200314,4,수리산,2057,1859,20200317,3916
20200315,4,산본,5751,5797,20200318,11548
20200315,4,대야미,1918,1754,20200318,3672
20200315,4,반월,1617,1727,20200318,3344
20200315,4,상록수,6594,6372,20200318,12966
20200315,4,한대앞,2578,2481,20200318,5059
20200315,4,중앙,6297,6193,20200318,12490
20200315,4,고잔,2258,2152,20200318,4410
20200315,4,초지,1313,1228,20200318,2541
20200315,4,안산,5300,4711,20200318,10011
20200315,4,신길온천,590,557,20200318,1147
20200315,4,정왕,2560,2838,20200318,5398
20200315,4,오이도,3319,3314,20200318,6633
20200315,4,수리산,1291,1346,20200318,2637
20200316,4,산본,13227,14117,20200319,27344
20200316,4,대야미,3944,3619,20200319,7563
20200316,4,반월,3453,3278,20200319,6731
20200316,4,상록수,14669,14599,20200319,29268
20200316,4,한대앞,5799,5878,20200319,11677
20200316,4,중앙,11794,12230,20200319,24024
20200316,4,고잔,6514,6265,20200319,12779
20200316,4,초지,3311,3204,20200319,6515
20200316,4,안산,9648,8505,20200319,18153
20200316,4,신길온천,1289,1127,20200319,2416
20200316,4,정왕,5399,5955,20200319,11354
20200316,4,오이도,6806,6298,20200319,13104
20200316,4,수리산,3492,2783,20200319,6275
20200317,4,산본,13302,14189,20200320,27491
20200317,4,대야미,4064,3612,20200320,7676
20200317,4,반월,3447,3259,20200320,6706
20200317,4,상록수,14529,14586,20200320,29115
20200317,4,한대앞,5751,5691,20200320,11442
20200317,4,중앙,11497,12149,20200320,23646
20200317,4,고잔,6425,6286,20200320,12711
20200317,4,초지,3208,3171,20200320,6379
20200317,4,안산,9655,8360,20200320,18015
20200317,4,신길온천,1224,1133,20200320,2357
20200317,4,정왕,5259,5788,20200320,11047
20200317,4,오이도,6756,6503,20200320,13259
20200317,4,수리산,3430,2694,20200320,6124
20200318,4,산본,13820,14746,20200321,28566
20200318,4,대야미,4253,3833,20200321,8086
20200318,4,반월,3669,3445,20200321,7114
20200318,4,상록수,15077,15084,20200321,30161
20200318,4,한대앞,5987,6074,20200321,12061
20200318,4,중앙,12198,12858,20200321,25056
20200318,4,고잔,6658,6425,20200321,13083
20200318,4,초지,3367,3285,20200321,6652
20200318,4,안산,9754,8422,20200321,18176
20200318,4,신길온천,1314,1208,20200321,2522
20200318,4,정왕,5419,5919,20200321,11338
20200318,4,오이도,7264,6945,20200321,14209
20200318,4,수리산,3519,2865,20200321,6384
20200319,4,산본,12857,13557,20200322,26414
20200319,4,대야미,3793,3391,20200322,7184
20200319,4,반월,3143,3029,20200322,6172
20200319,4,상록수,14184,14221,20200322,28405
20200319,4,한대앞,5658,5612,20200322,11270
20200319,4,중앙,11132,11725,20200322,22857
20200319,4,고잔,6253,6073,20200322,12326
20200319,4,초지,3118,3117,20200322,6235
20200319,4,안산,9334,8101,20200322,17435
20200319,4,신길온천,1167,1073,20200322,2240
20200319,4,정왕,5172,5739,20200322,10911
20200319,4,오이도,6472,6118,20200322,12590
20200319,4,수리산,3319,2562,20200322,5881
20200320,4,산본,14117,15400,20200323,29517
20200320,4,대야미,4343,3727,20200323,8070
20200320,4,반월,3832,3476,20200323,7308
20200320,4,상록수,15870,15566,20200323,31436
20200320,4,한대앞,6331,6197,20200323,12528
20200320,4,중앙,12745,14260,20200323,27005
20200320,4,고잔,6799,6407,20200323,13206
20200320,4,초지,3513,3517,20200323,7030
20200320,4,안산,10242,8898,20200323,19140
20200320,4,신길온천,1326,1220,20200323,2546
20200320,4,정왕,5848,6116,20200323,11964
20200320,4,오이도,7525,7202,20200323,14727
20200320,4,수리산,3586,2811,20200323,6397
20200321,4,산본,9073,9770,20200324,18843
20200321,4,대야미,3042,2622,20200324,5664
20200321,4,반월,2537,2366,20200324,4903
20200321,4,상록수,10612,9960,20200324,20572
20200321,4,한대앞,4126,4145,20200324,8271
20200321,4,중앙,9432,10582,20200324,20014
20200321,4,고잔,3877,3831,20200324,7708
20200321,4,초지,1955,1972,20200324,3927
20200321,4,안산,6668,6387,20200324,13055
20200321,4,신길온천,883,838,20200324,1721
20200321,4,정왕,3850,3892,20200324,7742
20200321,4,오이도,5397,5400,20200324,10797
20200321,4,수리산,2180,1958,20200324,4138
20200322,4,산본,5951,6378,20200325,12329
20200322,4,대야미,2229,2013,20200325,4242
20200322,4,반월,1817,1870,20200325,3687
20200322,4,상록수,7235,6940,20200325,14175
20200322,4,한대앞,2965,2853,20200325,5818
20200322,4,중앙,6888,6712,20200325,13600
20200322,4,고잔,2561,2499,20200325,5060
20200322,4,초지,1308,1274,20200325,2582
20200322,4,안산,5905,5286,20200325,11191
20200322,4,신길온천,660,628,20200325,1288
20200322,4,정왕,2826,3143,20200325,5969
20200322,4,오이도,3885,3845,20200325,7730
20200322,4,수리산,1456,1534,20200325,2990
20200323,4,산본,13681,14593,20200326,28274
20200323,4,대야미,4219,3779,20200326,7998
20200323,4,반월,3629,3493,20200326,7122
20200323,4,상록수,15117,14885,20200326,30002
20200323,4,한대앞,6080,6097,20200326,12177
20200323,4,중앙,12204,12683,20200326,24887
20200323,4,고잔,6665,6597,20200326,13262
20200323,4,초지,3389,3401,20200326,6790
20200323,4,안산,9996,8765,20200326,18761
20200323,4,신길온천,1322,1171,20200326,2493
20200323,4,정왕,5573,5987,20200326,11560
20200323,4,오이도,7066,6628,20200326,13694
20200323,4,수리산,3576,2845,20200326,6421
20200324,4,산본,13733,14600,20200327,28333
20200324,4,대야미,4252,3802,20200327,8054
20200324,4,반월,3596,3403,20200327,6999
20200324,4,상록수,14974,15054,20200327,30028
20200324,4,한대앞,5970,5987,20200327,11957
20200324,4,중앙,11890,12522,20200327,24412
20200324,4,고잔,6720,6472,20200327,13192
20200324,4,초지,3319,3330,20200327,6649
20200324,4,안산,9667,8537,20200327,18204
20200324,4,신길온천,1329,1209,20200327,2538
20200324,4,정왕,5364,5877,20200327,11241
20200324,4,오이도,7157,6746,20200327,13903
20200324,4,수리산,3525,2930,20200327,6455
20200325,4,산본,14172,15102,20200328,29274
20200325,4,대야미,4357,3896,20200328,8253
20200325,4,반월,3720,3517,20200328,7237
20200325,4,상록수,15317,15093,20200328,30410
20200325,4,한대앞,6177,6181,20200328,12358
20200325,4,중앙,12357,13091,20200328,25448
20200325,4,고잔,6770,6628,20200328,13398
20200325,4,초지,3421,3458,20200328,6879
20200325,4,안산,9864,8506,20200328,18370
20200325,4,신길온천,1263,1128,20200328,2391
20200325,4,정왕,5500,5961,20200328,11461
20200325,4,오이도,7194,6953,20200328,14147
20200325,4,수리산,3686,2995,20200328,6681
20200326,4,산본,13400,14294,20200329,27694
20200326,4,대야미,4138,3739,20200329,7877
20200326,4,반월,3521,3364,20200329,6885
20200326,4,상록수,14789,14666,20200329,29455
20200326,4,한대앞,5975,5976,20200329,11951
20200326,4,중앙,11684,12262,20200329,23946
20200326,4,고잔,6518,6265,20200329,12783
20200326,4,초지,3239,3253,20200329,6492
20200326,4,안산,9505,8334,20200329,17839
20200326,4,신길온천,1276,1168,20200329,2444
20200326,4,정왕,5248,5687,20200329,10935
20200326,4,오이도,6826,6485,20200329,13311
20200326,4,수리산,3556,2843,20200329,6399
20200327,4,산본,14170,15147,20200330,29317
20200327,4,대야미,4323,3796,20200330,8119
20200327,4,반월,3710,3355,20200330,7065
20200327,4,상록수,15393,15118,20200330,30511
20200327,4,한대앞,6357,6197,20200330,12554
20200327,4,중앙,12510,13740,20200330,26250
20200327,4,고잔,6749,6555,20200330,13304
20200327,4,초지,3502,3315,20200330,6817
20200327,4,안산,10108,8671,20200330,18779
20200327,4,신길온천,1317,1265,20200330,2582
20200327,4,정왕,5751,6010,20200330,11761
20200327,4,오이도,7412,6979,20200330,14391
20200327,4,수리산,3646,2744,20200330,6390
20200328,4,산본,9140,9594,20200331,18734
20200328,4,대야미,3131,2751,20200331,5882
20200328,4,반월,2646,2416,20200331,5062
20200328,4,상록수,10339,10114,20200331,20453
20200328,4,한대앞,4156,4058,20200331,8214
20200328,4,중앙,9141,9926,20200331,19067
20200328,4,고잔,3890,3767,20200331,7657
20200328,4,초지,2022,1976,20200331,3998
20200328,4,안산,6645,6434,20200331,13079
20200328,4,신길온천,923,855,20200331,1778
20200328,4,정왕,3872,3823,20200331,7695
20200328,4,오이도,5405,5417,20200331,10822
20200328,4,수리산,2246,2096,20200331,4342
20200329,4,산본,6140,6493,20200401,12633
20200329,4,대야미,2396,2029,20200401,4425
20200329,4,반월,1760,1833,20200401,3593
20200329,4,상록수,7159,6872,20200401,14031
20200329,4,한대앞,2802,2664,20200401,5466
20200329,4,중앙,6621,6592,20200401,13213
20200329,4,고잔,2579,2478,20200401,5057
20200329,4,초지,1375,1304,20200401,2679
20200329,4,안산,5807,5159,20200401,10966
20200329,4,신길온천,684,638,20200401,1322
20200329,4,정왕,2771,3136,20200401,5907
20200329,4,오이도,4063,4051,20200401,8114
20200329,4,수리산,1468,1640,20200401,3108
20200330,4,산본,13754,14747,20200402,28501
20200330,4,대야미,4312,3843,20200402,8155
20200330,4,반월,3628,3352,20200402,6980
20200330,4,상록수,15111,14883,20200402,29994
20200330,4,한대앞,6061,6002,20200402,12063
20200330,4,중앙,11989,12479,20200402,24468
20200330,4,고잔,6717,6385,20200402,13102
20200330,4,초지,3410,3454,20200402,6864
20200330,4,안산,9950,8749,20200402,18699
20200330,4,신길온천,1336,1180,20200402,2516
20200330,4,정왕,5488,6107,20200402,11595
20200330,4,오이도,7131,6709,20200402,13840
20200330,4,수리산,3642,2993,20200402,6635
20200331,4,산본,13863,14637,20200403,28500
20200331,4,대야미,4284,3894,20200403,8178
20200331,4,반월,3681,3502,20200403,7183
20200331,4,상록수,15042,14899,20200403,29941
20200331,4,한대앞,6160,6108,20200403,12268
20200331,4,중앙,11949,12471,20200403,24420
20200331,4,고잔,6738,6428,20200403,13166
20200331,4,초지,3350,3311,20200403,6661
20200331,4,안산,9751,8570,20200403,18321
20200331,4,신길온천,1262,1205,20200403,2467
20200331,4,정왕,5384,5921,20200403,11305
20200331,4,오이도,7092,6814,20200403,13906
20200331,4,수리산,3736,2980,20200403,6716
20200401,4,산본,13823,14942,20200404,28765
20200401,4,대야미,4424,3913,20200404,8337
20200401,4,반월,3711,3547,20200404,7258
20200401,4,상록수,15211,14911,20200404,30122
20200401,4,한대앞,6011,6013,20200404,12024
20200401,4,중앙,12037,12650,20200404,24687
20200401,4,고잔,6703,6535,20200404,13238
20200401,4,초지,3368,3373,20200404,6741
20200401,4,안산,10030,8699,20200404,18729
20200401,4,신길온천,1327,1194,20200404,2521
20200401,4,정왕,5419,6009,20200404,11428
20200401,4,오이도,7131,6957,20200404,14088
20200401,4,수리산,3659,2974,20200404,6633
20200402,4,산본,13891,14786,20200405,28677
20200402,4,대야미,4412,3881,20200405,8293
20200402,4,반월,3643,3449,20200405,7092
20200402,4,상록수,15003,14860,20200405,29863
20200402,4,한대앞,6000,5977,20200405,11977
20200402,4,중앙,12083,12676,20200405,24759
20200402,4,고잔,6731,6424,20200405,13155
20200402,4,초지,3398,3354,20200405,6752
20200402,4,안산,9728,8613,20200405,18341
20200402,4,신길온천,1282,1182,20200405,2464
20200402,4,정왕,5418,5893,20200405,11311
20200402,4,오이도,7113,6805,20200405,13918
20200402,4,수리산,3610,2931,20200405,6541
20200403,4,산본,14579,15660,20200406,30239
20200403,4,대야미,4560,3836,20200406,8396
20200403,4,반월,3913,3534,20200406,7447
20200403,4,상록수,16098,15495,20200406,31593
20200403,4,한대앞,6323,6417,20200406,12740
20200403,4,중앙,12924,14306,20200406,27230
20200403,4,고잔,6922,6592,20200406,13514
20200403,4,초지,3517,3446,20200406,6963
20200403,4,안산,10277,9080,20200406,19357
20200403,4,신길온천,1375,1213,20200406,2588
20200403,4,정왕,5935,6290,20200406,12225
20200403,4,오이도,7743,7466,20200406,15209
20200403,4,수리산,3742,2925,20200406,6667
20200404,4,산본,9536,10024,20200407,19560
20200404,4,대야미,3336,2806,20200407,6142
20200404,4,반월,2702,2523,20200407,5225
20200404,4,상록수,10376,10101,20200407,20477
20200404,4,한대앞,4200,4142,20200407,8342
20200404,4,중앙,9399,10153,20200407,19552
20200404,4,고잔,4028,4019,20200407,8047
20200404,4,초지,2094,2135,20200407,4229
20200404,4,안산,7069,6927,20200407,13996
20200404,4,신길온천,889,881,20200407,1770
20200404,4,정왕,3906,3968,20200407,7874
20200404,4,오이도,5523,5555,20200407,11078
20200404,4,수리산,2210,2122,20200407,4332
20200405,4,산본,6166,6572,20200408,12738
20200405,4,대야미,2391,2143,20200408,4534
20200405,4,반월,1821,1850,20200408,3671
20200405,4,상록수,7455,7082,20200408,14537
20200405,4,한대앞,2880,2900,20200408,5780
20200405,4,중앙,6798,6730,20200408,13528
20200405,4,고잔,2622,2621,20200408,5243
20200405,4,초지,1530,1449,20200408,2979
20200405,4,안산,6077,5461,20200408,11538
20200405,4,신길온천,687,651,20200408,1338
20200405,4,정왕,3041,3212,20200408,6253
20200405,4,오이도,3958,3949,20200408,7907
20200405,4,수리산,1507,1564,20200408,3071
20200406,4,산본,14196,15160,20200409,29356
20200406,4,대야미,4502,4056,20200409,8558
20200406,4,반월,3799,3689,20200409,7488
20200406,4,상록수,15589,15379,20200409,30968
20200406,4,한대앞,6396,6280,20200409,12676
20200406,4,중앙,12445,12997,20200409,25442
20200406,4,고잔,7051,6848,20200409,13899
20200406,4,초지,3459,3385,20200409,6844
20200406,4,안산,10197,8908,20200409,19105
20200406,4,신길온천,1335,1188,20200409,2523
20200406,4,정왕,5620,6270,20200409,11890
20200406,4,오이도,7505,7069,20200409,14574
20200406,4,수리산,3675,2947,20200409,6622
20200407,4,산본,14356,15252,20200410,29608
20200407,4,대야미,4487,4034,20200410,8521
20200407,4,반월,3800,3607,20200410,7407
20200407,4,상록수,15579,15420,20200410,30999
20200407,4,한대앞,6271,6282,20200410,12553
20200407,4,중앙,12300,12768,20200410,25068
20200407,4,고잔,6942,6890,20200410,13832
20200407,4,초지,3449,3453,20200410,6902
20200407,4,안산,9895,8654,20200410,18549
20200407,4,신길온천,1370,1260,20200410,2630
20200407,4,정왕,5431,5887,20200410,11318
20200407,4,오이도,7429,7200,20200410,14629
20200407,4,수리산,3845,3104,20200410,6949
20200408,4,산본,14221,15159,20200411,29380
20200408,4,대야미,4525,4004,20200411,8529
20200408,4,반월,3821,3636,20200411,7457
20200408,4,상록수,15446,15539,20200411,30985
20200408,4,한대앞,6267,6298,20200411,12565
20200408,4,중앙,12588,13149,20200411,25737
20200408,4,고잔,7065,6698,20200411,13763
20200408,4,초지,3473,3398,20200411,6871
20200408,4,안산,9975,8790,20200411,18765
20200408,4,신길온천,1359,1220,20200411,2579
20200408,4,정왕,5504,6083,20200411,11587
20200408,4,오이도,7377,7035,20200411,14412
20200408,4,수리산,3771,2964,20200411,6735
20200409,4,산본,14113,14973,20200412,29086
20200409,4,대야미,4549,4001,20200412,8550
20200409,4,반월,3715,3521,20200412,7236
20200409,4,상록수,15547,15397,20200412,30944
20200409,4,한대앞,6190,6220,20200412,12410
20200409,4,중앙,12500,13095,20200412,25595
20200409,4,고잔,6896,6747,20200412,13643
20200409,4,초지,3450,3452,20200412,6902
20200409,4,안산,9929,8666,20200412,18595
20200409,4,신길온천,1345,1234,20200412,2579
20200409,4,정왕,5452,5924,20200412,11376
20200409,4,오이도,7362,7099,20200412,14461
20200409,4,수리산,3725,2956,20200412,6681
20200410,4,산본,14956,16064,20200413,31020
20200410,4,대야미,4783,4138,20200413,8921
20200410,4,반월,3934,3637,20200413,7571
20200410,4,상록수,16238,15759,20200413,31997
20200410,4,한대앞,6550,6405,20200413,12955
20200410,4,중앙,13428,14824,20200413,28252
20200410,4,고잔,7208,6888,20200413,14096
20200410,4,초지,3638,3548,20200413,7186
20200410,4,안산,10353,9170,20200413,19523
20200410,4,신길온천,1422,1300,20200413,2722
20200410,4,정왕,6030,6254,20200413,12284
20200410,4,오이도,7846,7614,20200413,15460
20200410,4,수리산,3781,2860,20200413,6641
20200411,4,산본,9731,10327,20200414,20058
20200411,4,대야미,3530,2898,20200414,6428
20200411,4,반월,2810,2543,20200414,5353
20200411,4,상록수,11120,10635,20200414,21755
20200411,4,한대앞,4529,4348,20200414,8877
20200411,4,중앙,10121,11048,20200414,21169
20200411,4,고잔,4323,4407,20200414,8730
20200411,4,초지,2199,2245,20200414,4444
20200411,4,안산,7483,7660,20200414,15143
20200411,4,신길온천,1006,930,20200414,1936
20200411,4,정왕,4194,4241,20200414,8435
20200411,4,오이도,5885,6054,20200414,11939
20200411,4,수리산,2232,2135,20200414,4367
20200412,4,산본,6427,6539,20200415,12966
20200412,4,대야미,2514,2101,20200415,4615
20200412,4,반월,1933,2023,20200415,3956
20200412,4,상록수,7741,7417,20200415,15158
20200412,4,한대앞,3118,3104,20200415,6222
20200412,4,중앙,7333,7120,20200415,14453
20200412,4,고잔,2880,2947,20200415,5827
20200412,4,초지,1485,1453,20200415,2938
20200412,4,안산,7147,6281,20200415,13428
20200412,4,신길온천,717,685,20200415,1402
20200412,4,정왕,3110,3423,20200415,6533
20200412,4,오이도,4327,4239,20200415,8566
20200412,4,수리산,1517,1630,20200415,3147
20200413,4,산본,14576,15391,20200416,29967
20200413,4,대야미,4600,4106,20200416,8706
20200413,4,반월,3900,3679,20200416,7579
20200413,4,상록수,15876,15672,20200416,31548
20200413,4,한대앞,6392,6428,20200416,12820
20200413,4,중앙,12972,13420,20200416,26392
20200413,4,고잔,7117,6804,20200416,13921
20200413,4,초지,3590,3543,20200416,7133
20200413,4,안산,10445,9224,20200416,19669
20200413,4,신길온천,1392,1297,20200416,2689
20200413,4,정왕,5786,6346,20200416,12132
20200413,4,오이도,7578,7211,20200416,14789
20200413,4,수리산,3878,3170,20200416,7048
20200414,4,산본,15087,16018,20200417,31105
20200414,4,대야미,4847,4118,20200417,8965
20200414,4,반월,4003,3676,20200417,7679
20200414,4,상록수,16574,15902,20200417,32476
20200414,4,한대앞,6636,6494,20200417,13130
20200414,4,중앙,13241,14537,20200417,27778
20200414,4,고잔,7339,6978,20200417,14317
20200414,4,초지,3667,3559,20200417,7226
20200414,4,안산,10576,9207,20200417,19783
20200414,4,신길온천,1429,1281,20200417,2710
20200414,4,정왕,5973,6466,20200417,12439
20200414,4,오이도,8061,7712,20200417,15773
20200414,4,수리산,4030,3165,20200417,7195
20200415,4,산본,8616,9061,20200418,17677
20200415,4,대야미,3019,2622,20200418,5641
20200415,4,반월,2552,2435,20200418,4987
20200415,4,상록수,10165,9895,20200418,20060
20200415,4,한대앞,3959,4052,20200418,8011
20200415,4,중앙,8851,9208,20200418,18059
20200415,4,고잔,3623,3572,20200418,7195
20200415,4,초지,2054,2104,20200418,4158
20200415,4,안산,6829,6168,20200418,12997
20200415,4,신길온천,918,843,20200418,1761
20200415,4,정왕,3771,4085,20200418,7856
20200415,4,오이도,5500,5522,20200418,11022
20200415,4,수리산,2177,2216,20200418,4393
20200416,4,산본,14842,15663,20200419,30505
20200416,4,대야미,4729,4182,20200419,8911
20200416,4,반월,3889,3655,20200419,7544
20200416,4,상록수,16221,15839,20200419,32060
20200416,4,한대앞,6524,6493,20200419,13017
20200416,4,중앙,13090,13694,20200419,26784
20200416,4,고잔,7167,6996,20200419,14163
20200416,4,초지,3703,3640,20200419,7343
20200416,4,안산,10247,9118,20200419,19365
20200416,4,신길온천,1405,1289,20200419,2694
20200416,4,정왕,5837,6422,20200419,12259
20200416,4,오이도,7735,7447,20200419,15182
20200416,4,수리산,3951,3195,20200419,7146
20200417,4,산본,14423,15591,20200420,30014
20200417,4,대야미,4430,3788,20200420,8218
20200417,4,반월,3825,3428,20200420,7253
20200417,4,상록수,15649,15157,20200420,30806
20200417,4,한대앞,6258,6253,20200420,12511
20200417,4,중앙,13043,14384,20200420,27427
20200417,4,고잔,6958,6696,20200420,13654
20200417,4,초지,3553,3398,20200420,6951
20200417,4,안산,10081,8975,20200420,19056
20200417,4,신길온천,1343,1189,20200420,2532
20200417,4,정왕,5899,6262,20200420,12161
20200417,4,오이도,7513,7234,20200420,14747
20200417,4,수리산,3780,2766,20200420,6546
20200418,4,산본,10698,11245,20200421,21943
20200418,4,대야미,3864,3230,20200421,7094
20200418,4,반월,3194,2941,20200421,6135
20200418,4,상록수,11964,11269,20200421,23233
20200418,4,한대앞,5047,4969,20200421,10016
20200418,4,중앙,11484,12336,20200421,23820
20200418,4,고잔,4662,4775,20200421,9437
20200418,4,초지,2378,2371,20200421,4749
20200418,4,안산,8159,8185,20200421,16344
20200418,4,신길온천,1052,1057,20200421,2109
20200418,4,정왕,4556,4649,20200421,9205
20200418,4,오이도,6509,6644,20200421,13153
20200418,4,수리산,2738,2655,20200421,5393
20200419,4,산본,6537,6737,20200422,13274
20200419,4,대야미,2358,2157,20200422,4515
20200419,4,반월,1968,2022,20200422,3990
20200419,4,상록수,7892,7383,20200422,15275
20200419,4,한대앞,3049,3045,20200422,6094
20200419,4,중앙,7187,7207,20200422,14394
20200419,4,고잔,2958,3014,20200422,5972
20200419,4,초지,1542,1382,20200422,2924
20200419,4,안산,7082,6237,20200422,13319
20200419,4,신길온천,721,719,20200422,1440
20200419,4,정왕,3162,3332,20200422,6494
20200419,4,오이도,4352,4371,20200422,8723
20200419,4,수리산,1676,1905,20200422,3581
20200420,4,산본,14882,15563,20200423,30445
20200420,4,대야미,4514,4091,20200423,8605
20200420,4,반월,3834,3681,20200423,7515
20200420,4,상록수,16355,15880,20200423,32235
20200420,4,한대앞,6586,6474,20200423,13060
20200420,4,중앙,12983,13803,20200423,26786
20200420,4,고잔,7309,6972,20200423,14281
20200420,4,초지,3733,3645,20200423,7378
20200420,4,안산,10662,9415,20200423,20077
20200420,4,신길온천,1393,1227,20200423,2620
20200420,4,정왕,5888,6426,20200423,12314
20200420,4,오이도,7723,7253,20200423,14976
20200420,4,수리산,3867,3116,20200423,6983
20200421,4,산본,15021,15927,20200424,30948
20200421,4,대야미,4609,4074,20200424,8683
20200421,4,반월,3838,3565,20200424,7403
20200421,4,상록수,16207,16078,20200424,32285
20200421,4,한대앞,6511,6638,20200424,13149
20200421,4,중앙,13040,13765,20200424,26805
20200421,4,고잔,7298,7020,20200424,14318
20200421,4,초지,3657,3551,20200424,7208
20200421,4,안산,10401,9243,20200424,19644
20200421,4,신길온천,1417,1277,20200424,2694
20200421,4,정왕,5687,6221,20200424,11908
20200421,4,오이도,7738,7456,20200424,15194
20200421,4,수리산,3892,3221,20200424,7113
20200422,4,산본,15048,16041,20200425,31089
20200422,4,대야미,4522,4004,20200425,8526
20200422,4,반월,3812,3599,20200425,7411
20200422,4,상록수,15809,15807,20200425,31616
20200422,4,한대앞,6449,6454,20200425,12903
20200422,4,중앙,13030,13777,20200425,26807
20200422,4,고잔,7272,6883,20200425,14155
20200422,4,초지,3600,3488,20200425,7088
20200422,4,안산,10121,9009,20200425,19130
20200422,4,신길온천,1386,1253,20200425,2639
20200422,4,정왕,5695,6165,20200425,11860
20200422,4,오이도,7603,7309,20200425,14912
20200422,4,수리산,3931,3085,20200425,7016
20200423,4,산본,15171,16195,20200426,31366
20200423,4,대야미,4661,4154,20200426,8815
20200423,4,반월,3922,3726,20200426,7648
20200423,4,상록수,16273,16053,20200426,32326
20200423,4,한대앞,6702,6742,20200426,13444
20200423,4,중앙,13228,14050,20200426,27278
20200423,4,고잔,7425,7077,20200426,14502
20200423,4,초지,3636,3577,20200426,7213
20200423,4,안산,10427,9185,20200426,19612
20200423,4,신길온천,1395,1294,20200426,2689
20200423,4,정왕,5807,6275,20200426,12082
20200423,4,오이도,7628,7432,20200426,15060
20200423,4,수리산,4113,3291,20200426,7404
20200424,4,산본,16226,17508,20200427,33734
20200424,4,대야미,4960,4285,20200427,9245
20200424,4,반월,4170,3858,20200427,8028
20200424,4,상록수,17204,16696,20200427,33900
20200424,4,한대앞,7026,6756,20200427,13782
20200424,4,중앙,14223,15853,20200427,30076
20200424,4,고잔,7576,7362,20200427,14938
20200424,4,초지,3910,3693,20200427,7603
20200424,4,안산,10767,9592,20200427,20359
20200424,4,신길온천,1471,1325,20200427,2796
20200424,4,정왕,6378,6649,20200427,13027
20200424,4,오이도,8314,8040,20200427,16354
20200424,4,수리산,4205,3317,20200427,7522
20200425,4,산본,11526,12101,20200428,23627
20200425,4,대야미,4110,3297,20200428,7407
20200425,4,반월,3236,2899,20200428,6135
20200425,4,상록수,12507,11741,20200428,24248
20200425,4,한대앞,5189,5195,20200428,10384
20200425,4,중앙,11777,12620,20200428,24397
20200425,4,고잔,4760,4635,20200428,9395
20200425,4,초지,2637,2603,20200428,5240
20200425,4,안산,7990,8037,20200428,16027
20200425,4,신길온천,1074,1015,20200428,2089
20200425,4,정왕,4459,4512,20200428,8971
20200425,4,오이도,6868,6980,20200428,13848
20200425,4,수리산,2895,3067,20200428,5962
20200426,4,산본,8072,8153,20200429,16225
20200426,4,대야미,3061,2619,20200429,5680
20200426,4,반월,2240,2274,20200429,4514
20200426,4,상록수,9085,8835,20200429,17920
20200426,4,한대앞,3650,3560,20200429,7210
20200426,4,중앙,8546,8538,20200429,17084
20200426,4,고잔,3581,3500,20200429,7081
20200426,4,초지,1791,1720,20200429,3511
20200426,4,안산,7681,6954,20200429,14635
20200426,4,신길온천,864,827,20200429,1691
20200426,4,정왕,3663,3923,20200429,7586
20200426,4,오이도,5277,5335,20200429,10612
20200426,4,수리산,2401,2931,20200429,5332
20200427,4,산본,15844,16643,20200430,32487
20200427,4,대야미,4910,4417,20200430,9327
20200427,4,반월,4206,3989,20200430,8195
20200427,4,상록수,16968,16643,20200430,33611
20200427,4,한대앞,6964,6988,20200430,13952
20200427,4,중앙,13865,14455,20200430,28320
20200427,4,고잔,7651,7319,20200430,14970
20200427,4,초지,3855,3704,20200430,7559
20200427,4,안산,10770,9733,20200430,20503
20200427,4,신길온천,1543,1298,20200430,2841
20200427,4,정왕,6242,6747,20200430,12989
20200427,4,오이도,8256,7710,20200430,15966
20200427,4,수리산,4198,3521,20200430,7719
20200428,4,산본,15836,16667,20200501,32503
20200428,4,대야미,5030,4332,20200501,9362
20200428,4,반월,4126,3895,20200501,8021
20200428,4,상록수,17064,16711,20200501,33775
20200428,4,한대앞,6951,6862,20200501,13813
20200428,4,중앙,13976,14651,20200501,28627
20200428,4,고잔,7739,7423,20200501,15162
20200428,4,초지,3881,3845,20200501,7726
20200428,4,안산,10724,9586,20200501,20310
20200428,4,신길온천,1435,1355,20200501,2790
20200428,4,정왕,6064,6520,20200501,12584
20200428,4,오이도,8242,8091,20200501,16333
20200428,4,수리산,4346,3628,20200501,7974
20200429,4,산본,16931,17928,20200502,34859
20200429,4,대야미,5193,4440,20200502,9633
20200429,4,반월,4448,4023,20200502,8471
20200429,4,상록수,17833,17135,20200502,34968
20200429,4,한대앞,7221,7040,20200502,14261
20200429,4,중앙,14719,16315,20200502,31034
20200429,4,고잔,7992,7632,20200502,15624
20200429,4,초지,3963,3826,20200502,7789
20200429,4,안산,11213,10050,20200502,21263
20200429,4,신길온천,1560,1439,20200502,2999
20200429,4,정왕,6647,7010,20200502,13657
20200429,4,오이도,8766,8442,20200502,17208
20200429,4,수리산,4481,3567,20200502,8048
20200430,4,산본,10074,10453,20200503,20527
20200430,4,대야미,3676,3019,20200503,6695
20200430,4,반월,2960,2673,20200503,5633
20200430,4,상록수,11673,11210,20200503,22883
20200430,4,한대앞,4515,4394,20200503,8909
20200430,4,중앙,10261,11264,20200503,21525
20200430,4,고잔,4146,3975,20200503,8121
20200430,4,초지,2529,2484,20200503,5013
20200430,4,안산,7959,7967,20200503,15926
20200430,4,신길온천,1136,1044,20200503,2180
20200430,4,정왕,4652,4516,20200503,9168
20200430,4,오이도,7276,7475,20200503,14751
20200430,4,수리산,2719,2805,20200503,5524
20200501,4,수리산,2960,2707,20200504,5667
20200501,4,오이도,7370,7579,20200504,14949
20200501,4,정왕,4888,4811,20200504,9699
20200501,4,신길온천,1127,1082,20200504,2209
20200501,4,안산,9200,9222,20200504,18422
20200501,4,초지,2502,2484,20200504,4986
20200501,4,고잔,4773,4481,20200504,9254
20200501,4,중앙,11563,12461,20200504,24024
20200501,4,한대앞,5108,4798,20200504,9906
20200501,4,상록수,12027,11628,20200504,23655
20200501,4,반월,3178,2944,20200504,6122
20200501,4,대야미,3722,3100,20200504,6822
20200501,4,산본,11187,11709,20200504,22896
20200502,4,초지,2324,2247,20200505,4571
20200502,4,안산,9600,9514,20200505,19114
20200502,4,신길온천,1051,957,20200505,2008
20200502,4,정왕,4635,4810,20200505,9445
20200502,4,오이도,7235,7281,20200505,14516
20200502,4,수리산,2684,2756,20200505,5440
20200502,4,고잔,4641,4530,20200505,9171
20200502,4,중앙,11374,12214,20200505,23588
20200502,4,산본,10699,11255,20200505,21954
20200502,4,대야미,3620,3092,20200505,6712
20200502,4,반월,3027,2781,20200505,5808
20200502,4,상록수,11754,11286,20200505,23040
20200502,4,한대앞,4878,4649,20200505,9527
20200503,4,수리산,2124,2367,20200506,4491
20200503,4,오이도,5799,5524,20200506,11323
20200503,4,정왕,4002,4081,20200506,8083
20200503,4,신길온천,940,858,20200506,1798
20200503,4,안산,9051,8073,20200506,17124
20200503,4,초지,1831,1717,20200506,3548
20200503,4,고잔,3272,3333,20200506,6605
20200503,4,중앙,9219,9265,20200506,18484
20200503,4,한대앞,3831,3587,20200506,7418
20200503,4,상록수,9356,8902,20200506,18258
20200503,4,반월,2516,2360,20200506,4876
20200503,4,대야미,2726,2496,20200506,5222
20200503,4,산본,7948,8387,20200506,16335
20200504,4,수리산,3631,2916,20200507,6547
20200504,4,오이도,7802,7661,20200507,15463
20200504,4,정왕,5821,6272,20200507,12093
20200504,4,신길온천,1366,1235,20200507,2601
20200504,4,안산,10730,9647,20200507,20377
20200504,4,초지,3215,3064,20200507,6279
20200504,4,고잔,7227,6923,20200507,14150
20200504,4,중앙,13579,14557,20200507,28136
20200504,4,상록수,15698,15121,20200507,30819
20200504,4,반월,3959,3787,20200507,7746
20200504,4,대야미,4479,3954,20200507,8433
20200504,4,산본,14767,15698,20200507,30465
20200504,4,한대앞,6401,6237,20200507,12638
20200505,4,수리산,2197,2274,20200508,4471
20200505,4,오이도,5994,5873,20200508,11867
20200505,4,정왕,3538,4023,20200508,7561
20200505,4,신길온천,889,864,20200508,1753
20200505,4,안산,6782,6216,20200508,12998
20200505,4,초지,2055,2142,20200508,4197
20200505,4,고잔,3464,3527,20200508,6991
20200505,4,중앙,9410,9450,20200508,18860
20200505,4,한대앞,3931,3875,20200508,7806
20200505,4,상록수,10104,9747,20200508,19851
20200505,4,반월,2531,2463,20200508,4994
20200505,4,대야미,3113,2746,20200508,5859
20200505,4,산본,8922,9363,20200508,18285
20200506,4,산본,16828,18051,20200509,34879
20200506,4,대야미,5125,4606,20200509,9731
20200506,4,반월,4399,4179,20200509,8578
20200506,4,상록수,17703,17473,20200509,35176
20200506,4,한대앞,7349,7296,20200509,14645
20200506,4,중앙,15492,16017,20200509,31509
20200506,4,고잔,8131,7761,20200509,15892
20200506,4,초지,4157,4178,20200509,8335
20200506,4,안산,11188,10242,20200509,21430
20200506,4,신길온천,1600,1434,20200509,3034
20200506,4,정왕,6588,7127,20200509,13715
20200506,4,오이도,8655,8370,20200509,17025
20200506,4,수리산,4373,3490,20200509,7863
20200507,4,산본,17004,18124,20200510,35128
20200507,4,대야미,5191,4682,20200510,9873
20200507,4,반월,4445,4151,20200510,8596
20200507,4,상록수,18001,17648,20200510,35649
20200507,4,한대앞,7307,7337,20200510,14644
20200507,4,중앙,15624,16300,20200510,31924
20200507,4,고잔,8126,7922,20200510,16048
20200507,4,초지,4296,4162,20200510,8458
20200507,4,안산,11271,10112,20200510,21383
20200507,4,신길온천,1628,1439,20200510,3067
20200507,4,정왕,6401,7012,20200510,13413
20200507,4,오이도,8932,8432,20200510,17364
20200507,4,수리산,4389,3487,20200510,7876
20200508,4,반월,4511,4226,20200511,8737
20200508,4,신길온천,1594,1512,20200511,3106
20200508,4,정왕,6905,7130,20200511,14035
20200508,4,오이도,8757,8825,20200511,17582
20200508,4,수리산,4377,3290,20200511,7667
20200508,4,안산,11675,10693,20200511,22368
20200508,4,초지,4159,4179,20200511,8338
20200508,4,고잔,8212,8023,20200511,16235
20200508,4,중앙,15732,17144,20200511,32876
20200508,4,한대앞,7612,7592,20200511,15204
20200508,4,상록수,18289,18105,20200511,36394
20200508,4,대야미,5377,4563,20200511,9940
20200508,4,산본,16993,18762,20200511,35755
20200509,4,산본,10384,11065,20200512,21449
20200509,4,대야미,3237,2738,20200512,5975
20200509,4,반월,2900,2606,20200512,5506
20200509,4,상록수,11493,11168,20200512,22661
20200509,4,한대앞,4688,4636,20200512,9324
20200509,4,중앙,10844,11806,20200512,22650
20200509,4,고잔,4524,4558,20200512,9082
20200509,4,초지,2398,2247,20200512,4645
20200509,4,안산,7511,7571,20200512,15082
20200509,4,신길온천,1020,934,20200512,1954
20200509,4,정왕,4101,4222,20200512,8323
20200509,4,오이도,5913,5773,20200512,11686
20200509,4,수리산,2282,1855,20200512,4137
20200510,4,산본,8281,8625,20200513,16906
20200510,4,대야미,2922,2654,20200513,5576
20200510,4,반월,2374,2385,20200513,4759
20200510,4,상록수,9729,9222,20200513,18951
20200510,4,한대앞,3929,3820,20200513,7749
20200510,4,중앙,9496,9502,20200513,18998
20200510,4,고잔,3667,3621,20200513,7288
20200510,4,초지,2118,2055,20200513,4173
20200510,4,안산,8608,7694,20200513,16302
20200510,4,신길온천,937,895,20200513,1832
20200510,4,정왕,3850,4285,20200513,8135
20200510,4,오이도,5428,5320,20200513,10748
20200510,4,수리산,1976,2005,20200513,3981
20200511,4,수리산,4166,3357,20200514,7523
20200511,4,오이도,8809,8251,20200514,17060
20200511,4,정왕,7336,7900,20200514,15236
20200511,4,신길온천,1563,1360,20200514,2923
20200511,4,안산,11410,10285,20200514,21695
20200511,4,초지,4199,4163,20200514,8362
20200511,4,고잔,7821,7595,20200514,15416
20200511,4,중앙,15417,15785,20200514,31202
20200511,4,한대앞,7158,7269,20200514,14427
20200511,4,상록수,17612,17290,20200514,34902
20200511,4,반월,4425,4148,20200514,8573
20200511,4,대야미,5026,4608,20200514,9634
20200511,4,산본,16206,17347,20200514,33553
20200512,4,산본,16113,17290,20200515,33403
20200512,4,대야미,4977,4348,20200515,9325
20200512,4,반월,4294,4061,20200515,8355
20200512,4,상록수,17423,17318,20200515,34741
20200512,4,한대앞,7108,6981,20200515,14089
20200512,4,중앙,15122,15893,20200515,31015
20200512,4,고잔,7889,7733,20200515,15622
20200512,4,초지,4053,4019,20200515,8072
20200512,4,안산,11086,9707,20200515,20793
20200512,4,신길온천,1533,1393,20200515,2926
20200512,4,정왕,7110,7579,20200515,14689
20200512,4,오이도,8386,8176,20200515,16562
20200512,4,수리산,4222,3318,20200515,7540
20200513,4,수리산,4219,3338,20200516,7557
20200513,4,오이도,8539,8356,20200516,16895
20200513,4,정왕,6972,7450,20200516,14422
20200513,4,신길온천,1523,1390,20200516,2913
20200513,4,안산,11213,9722,20200516,20935
20200513,4,초지,3936,3985,20200516,7921
20200513,4,고잔,7913,7708,20200516,15621
20200513,4,중앙,15077,15863,20200516,30940
20200513,4,한대앞,7221,7206,20200516,14427
20200513,4,상록수,17387,17184,20200516,34571
20200513,4,반월,4317,4136,20200516,8453
20200513,4,대야미,5284,4624,20200516,9908
20200513,4,산본,16552,17704,20200516,34256
20200514,4,대야미,5146,4525,20200517,9671
20200514,4,반월,4244,4028,20200517,8272
20200514,4,상록수,17325,17351,20200517,34676
20200514,4,한대앞,7176,7037,20200517,14213
20200514,4,중앙,15006,15460,20200517,30466
20200514,4,고잔,7871,7653,20200517,15524
20200514,4,초지,4039,3985,20200517,8024
20200514,4,안산,11090,9874,20200517,20964
20200514,4,신길온천,1520,1397,20200517,2917
20200514,4,정왕,6866,7435,20200517,14301
20200514,4,오이도,8409,8108,20200517,16517
20200514,4,수리산,4149,3267,20200517,7416
20200514,4,산본,16419,17377,20200517,33796
20200515,4,반월,4122,3711,20200518,7833
20200515,4,상록수,16961,16425,20200518,33386
20200515,4,한대앞,6669,6679,20200518,13348
20200515,4,중앙,14696,15947,20200518,30643
20200515,4,고잔,7330,7230,20200518,14560
20200515,4,초지,3846,3682,20200518,7528
20200515,4,안산,10546,9623,20200518,20169
20200515,4,신길온천,1439,1311,20200518,2750
20200515,4,정왕,6852,6888,20200518,13740
20200515,4,오이도,7989,7844,20200518,15833
20200515,4,수리산,3958,2955,20200518,6913
20200515,4,대야미,4619,3927,20200518,8546
20200515,4,산본,15602,17058,20200518,32660
20200516,4,수리산,2602,2206,20200519,4808
20200516,4,오이도,6745,6764,20200519,13509
20200516,4,정왕,5036,4978,20200519,10014
20200516,4,신길온천,1133,1073,20200519,2206
20200516,4,안산,8947,9242,20200519,18189
20200516,4,초지,2519,2511,20200519,5030
20200516,4,고잔,5339,5464,20200519,10803
20200516,4,중앙,12419,13450,20200519,25869
20200516,4,한대앞,5239,5007,20200519,10246
20200516,4,상록수,12624,12252,20200519,24876
20200516,4,반월,3163,2869,20200519,6032
20200516,4,대야미,3802,3214,20200519,7016
20200516,4,산본,11554,12198,20200519,23752
20200517,4,수리산,1991,2190,20200520,4181
20200517,4,오이도,5275,5289,20200520,10564
20200517,4,정왕,3832,4227,20200520,8059
20200517,4,신길온천,935,876,20200520,1811
20200517,4,안산,9059,7931,20200520,16990
20200517,4,초지,1811,1692,20200520,3503
20200517,4,고잔,3819,3618,20200520,7437
20200517,4,중앙,9452,9426,20200520,18878
20200517,4,한대앞,3847,3752,20200520,7599
20200517,4,상록수,9781,9397,20200520,19178
20200517,4,반월,2505,2476,20200520,4981
20200517,4,대야미,3039,2764,20200520,5803
20200517,4,산본,8262,8737,20200520,16999
20200518,4,산본,15302,16241,20200521,31543
20200518,4,대야미,4707,4199,20200521,8906
20200518,4,반월,4023,3834,20200521,7857
20200518,4,상록수,16650,16420,20200521,33070
20200518,4,한대앞,6776,6831,20200521,13607
20200518,4,중앙,13759,14116,20200521,27875
20200518,4,고잔,7606,7292,20200521,14898
20200518,4,초지,3939,3843,20200521,7782
20200518,4,안산,10948,9895,20200521,20843
20200518,4,신길온천,1444,1269,20200521,2713
20200518,4,정왕,6962,7683,20200521,14645
20200518,4,오이도,7830,7390,20200521,15220
20200518,4,수리산,3949,3125,20200521,7074
20200519,4,산본,15590,16675,20200522,32265
20200519,4,대야미,4661,4072,20200522,8733
20200519,4,반월,4007,3770,20200522,7777
20200519,4,상록수,16663,16609,20200522,33272
20200519,4,한대앞,6795,6820,20200522,13615
20200519,4,중앙,14156,14818,20200522,28974
20200519,4,고잔,7611,7331,20200522,14942
20200519,4,초지,3901,3778,20200522,7679
20200519,4,안산,10767,9515,20200522,20282
20200519,4,신길온천,1403,1260,20200522,2663
20200519,4,정왕,6769,7353,20200522,14122
20200519,4,오이도,7853,7527,20200522,15380
20200519,4,수리산,4015,3037,20200522,7052
20200520,4,수리산,4276,3411,20200523,7687
20200520,4,오이도,8671,8390,20200523,17061
20200520,4,정왕,7270,7656,20200523,14926
20200520,4,신길온천,1579,1422,20200523,3001
20200520,4,안산,11325,10101,20200523,21426
20200520,4,초지,4442,4550,20200523,8992
20200520,4,고잔,7848,7651,20200523,15499
20200520,4,중앙,15224,16111,20200523,31335
20200520,4,한대앞,7565,7533,20200523,15098
20200520,4,상록수,17874,17686,20200523,35560
20200520,4,반월,4429,4184,20200523,8613
20200520,4,대야미,5132,4587,20200523,9719
20200520,4,산본,16636,17737,20200523,34373
20200521,4,수리산,4235,3358,20200524,7593
20200521,4,오이도,8625,8367,20200524,16992
20200521,4,정왕,7281,7674,20200524,14955
20200521,4,신길온천,1534,1426,20200524,2960
20200521,4,안산,11245,9846,20200524,21091
20200521,4,초지,4082,4044,20200524,8126
20200521,4,고잔,7856,7593,20200524,15449
20200521,4,중앙,15364,16096,20200524,31460
20200521,4,한대앞,7289,7303,20200524,14592
20200521,4,상록수,17642,17446,20200524,35088
20200521,4,반월,4356,4159,20200524,8515
20200521,4,대야미,5157,4573,20200524,9730
20200521,4,산본,16252,17266,20200524,33518
20200522,4,산본,16754,17869,20200525,34623
20200522,4,대야미,5328,4471,20200525,9799
20200522,4,반월,4542,4230,20200525,8772
20200522,4,상록수,18189,17615,20200525,35804
20200522,4,한대앞,7446,7508,20200525,14954
20200522,4,중앙,15837,17390,20200525,33227
20200522,4,고잔,8022,7796,20200525,15818
20200522,4,초지,4104,4152,20200525,8256
20200522,4,안산,11424,10489,20200525,21913
20200522,4,신길온천,1588,1467,20200525,3055
20200522,4,정왕,7649,7459,20200525,15108
20200522,4,오이도,8765,8532,20200525,17297
20200522,4,수리산,4295,3256,20200525,7551
20200523,4,산본,11297,11701,20200526,22998
20200523,4,대야미,3971,3492,20200526,7463
20200523,4,반월,3559,3139,20200526,6698
20200523,4,상록수,13539,12959,20200526,26498
20200523,4,한대앞,5760,5602,20200526,11362
20200523,4,중앙,13530,14388,20200526,27918
20200523,4,고잔,5450,5532,20200526,10982
20200523,4,초지,2792,2792,20200526,5584
20200523,4,안산,9254,10175,20200526,19429
20200523,4,신길온천,1263,1198,20200526,2461
20200523,4,정왕,5136,5081,20200526,10217
20200523,4,오이도,7264,7548,20200526,14812
20200523,4,수리산,2797,2657,20200526,5454
20200524,4,안산,9391,7709,20200527,17100
20200524,4,신길온천,882,847,20200527,1729
20200524,4,정왕,3705,4100,20200527,7805
20200524,4,오이도,4851,4845,20200527,9696
20200524,4,수리산,1738,1559,20200527,3297
20200524,4,초지,1765,1671,20200527,3436
20200524,4,고잔,3429,3349,20200527,6778
20200524,4,중앙,9147,9177,20200527,18324
20200524,4,한대앞,3681,3545,20200527,7226
20200524,4,상록수,8934,8563,20200527,17497
20200524,4,반월,2158,2205,20200527,4363
20200524,4,대야미,2568,2367,20200527,4935
20200524,4,산본,6801,7232,20200527,14033
20200525,4,수리산,4258,3377,20200528,7635
20200525,4,오이도,8704,8179,20200528,16883
20200525,4,정왕,7324,8139,20200528,15463
20200525,4,신길온천,1575,1402,20200528,2977
20200525,4,안산,11451,10189,20200528,21640
20200525,4,초지,4334,4299,20200528,8633
20200525,4,고잔,8000,7868,20200528,15868
20200525,4,중앙,15356,15944,20200528,31300
20200525,4,한대앞,7317,7362,20200528,14679
20200525,4,상록수,17861,17428,20200528,35289
20200525,4,반월,4399,4205,20200528,8604
20200525,4,대야미,4907,4530,20200528,9437
20200525,4,산본,15953,16609,20200528,32562
20200526,4,오이도,8404,8101,20200529,16505
20200526,4,수리산,4118,3313,20200529,7431
20200526,4,정왕,7203,7904,20200529,15107
20200526,4,신길온천,1534,1409,20200529,2943
20200526,4,안산,10989,9874,20200529,20863
20200526,4,초지,4053,4007,20200529,8060
20200526,4,고잔,7944,7753,20200529,15697
20200526,4,중앙,15162,15765,20200529,30927
20200526,4,한대앞,7385,7279,20200529,14664
20200526,4,상록수,17476,17363,20200529,34839
20200526,4,반월,4372,4147,20200529,8519
20200526,4,대야미,4907,4396,20200529,9303
20200526,4,산본,15817,16481,20200529,32298
20200527,4,수리산,4289,3419,20200530,7708
20200527,4,오이도,8681,8410,20200530,17091
20200527,4,정왕,7296,7841,20200530,15137
20200527,4,신길온천,1595,1425,20200530,3020
20200527,4,안산,11320,10164,20200530,21484
20200527,4,초지,4244,4242,20200530,8486
20200527,4,고잔,8200,7941,20200530,16141
20200527,4,중앙,15424,16245,20200530,31669
20200527,4,한대앞,7431,7445,20200530,14876
20200527,4,상록수,17895,17603,20200530,35498
20200527,4,반월,4482,4273,20200530,8755
20200527,4,대야미,5126,4572,20200530,9698
20200527,4,산본,16314,16547,20200530,32861
20200528,4,수리산,4214,3364,20200531,7578
20200528,4,오이도,8513,8242,20200531,16755
20200528,4,정왕,7109,7585,20200531,14694
20200528,4,신길온천,1577,1486,20200531,3063
20200528,4,안산,11041,9902,20200531,20943
20200528,4,초지,4174,4128,20200531,8302
20200528,4,고잔,7887,7686,20200531,15573
20200528,4,중앙,15396,15757,20200531,31153
20200528,4,한대앞,7175,7201,20200531,14376
20200528,4,상록수,17559,17311,20200531,34870
20200528,4,반월,4413,4207,20200531,8620
20200528,4,대야미,5017,4526,20200531,9543
20200528,4,산본,16028,16572,20200531,32600
20200529,4,산본,16694,17745,20200601,34439
20200529,4,대야미,5252,4487,20200601,9739
20200529,4,반월,4680,4257,20200601,8937
20200529,4,상록수,18139,17633,20200601,35772
20200529,4,한대앞,7661,7699,20200601,15360
20200529,4,중앙,16060,17476,20200601,33536
20200529,4,고잔,8066,7970,20200601,16036
20200529,4,초지,4114,4034,20200601,8148
20200529,4,안산,11757,10505,20200601,22262
20200529,4,신길온천,1625,1477,20200601,3102
20200529,4,정왕,7583,7605,20200601,15188
20200529,4,오이도,8993,8625,20200601,17618
20200529,4,수리산,4322,3313,20200601,7635
20200530,4,오이도,7000,7137,20200602,14137
20200530,4,수리산,2842,2517,20200602,5359
20200530,4,정왕,5011,5021,20200602,10032
20200530,4,신길온천,1167,1135,20200602,2302
20200530,4,안산,8994,9225,20200602,18219
20200530,4,초지,2834,2909,20200602,5743
20200530,4,고잔,5299,5362,20200602,10661
20200530,4,중앙,12864,13993,20200602,26857
20200530,4,한대앞,5615,5556,20200602,11171
20200530,4,상록수,12967,12596,20200602,25563
20200530,4,반월,3446,3163,20200602,6609
20200530,4,대야미,3884,3450,20200602,7334
20200530,4,산본,11472,11959,20200602,23431
20200531,4,수리산,2025,2121,20200603,4146
20200531,4,오이도,5120,4972,20200603,10092
20200531,4,정왕,3779,4140,20200603,7919
20200531,4,신길온천,877,759,20200603,1636
20200531,4,안산,8562,7739,20200603,16301
20200531,4,초지,1766,1683,20200603,3449
20200531,4,고잔,3600,3540,20200603,7140
20200531,4,중앙,9196,9208,20200603,18404
20200531,4,한대앞,3845,3693,20200603,7538
20200531,4,상록수,9269,8733,20200603,18002
20200531,4,반월,2365,2335,20200603,4700
20200531,4,대야미,2766,2473,20200603,5239
20200531,4,산본,7554,7984,20200603,15538
20200101,UI,신설동,892,828,20200104,1720
20200101,UI,보문,917,855,20200104,1772
20200101,UI,성신여대입구,2010,2363,20200104,4373
20200101,UI,정릉,2096,1989,20200104,4085
20200101,UI,북한산보국문,2945,2849,20200104,5794
20200101,UI,솔샘,2477,2272,20200104,4749
20200101,UI,삼양사거리,1288,1316,20200104,2604
20200101,UI,삼양,1113,1188,20200104,2301
20200101,UI,화계,1789,1690,20200104,3479
20200101,UI,가오리,2041,1974,20200104,4015
20200101,UI,4.19민주묘지,1504,1352,20200104,2856
20200101,UI,솔밭공원,1201,1209,20200104,2410
20200101,UI,북한산우이,3048,2766,20200104,5814
20200102,UI,북한산우이,2558,2282,20200105,4840
20200102,UI,솔밭공원,2436,2375,20200105,4811
20200102,UI,4.19민주묘지,2734,2560,20200105,5294
20200102,UI,가오리,4228,4157,20200105,8385
20200102,UI,화계,3420,3275,20200105,6695
20200102,UI,삼양,2151,2234,20200105,4385
20200102,UI,삼양사거리,2526,2638,20200105,5164
20200102,UI,솔샘,6085,5705,20200105,11790
20200102,UI,북한산보국문,5997,5731,20200105,11728
20200102,UI,정릉,4494,4137,20200105,8631
20200102,UI,성신여대입구,3632,4176,20200105,7808
20200102,UI,보문,1597,1564,20200105,3161
20200102,UI,신설동,2144,2148,20200105,4292
20200103,UI,삼양,2188,2308,20200106,4496
20200103,UI,삼양사거리,2643,2710,20200106,5353
20200103,UI,솔샘,6338,5658,20200106,11996
20200103,UI,북한산보국문,6470,5956,20200106,12426
20200103,UI,신설동,2227,2259,20200106,4486
20200103,UI,보문,1570,1587,20200106,3157
20200103,UI,성신여대입구,3740,4298,20200106,8038
20200103,UI,정릉,4819,4382,20200106,9201
20200103,UI,북한산우이,2477,2140,20200106,4617
20200103,UI,솔밭공원,2550,2489,20200106,5039
20200103,UI,4.19민주묘지,2924,2752,20200106,5676
20200103,UI,가오리,4409,4168,20200106,8577
20200103,UI,화계,3557,3288,20200106,6845
20200104,UI,북한산보국문,5117,4407,20200107,9524
20200104,UI,북한산우이,3116,3178,20200107,6294
20200104,UI,솔밭공원,1957,1789,20200107,3746
20200104,UI,4.19민주묘지,2230,2064,20200107,4294
20200104,UI,가오리,3227,2925,20200107,6152
20200104,UI,화계,2663,2459,20200107,5122
20200104,UI,삼양,1633,1636,20200107,3269
20200104,UI,삼양사거리,1999,2026,20200107,4025
20200104,UI,솔샘,4259,3730,20200107,7989
20200104,UI,정릉,3913,3286,20200107,7199
20200104,UI,성신여대입구,3181,3763,20200107,6944
20200104,UI,보문,1339,1331,20200107,2670
20200104,UI,신설동,1474,1488,20200107,2962
20200105,UI,북한산우이,3140,3093,20200108,6233
20200105,UI,솔밭공원,1551,1480,20200108,3031
20200105,UI,4.19민주묘지,1974,1680,20200108,3654
20200105,UI,가오리,2503,2370,20200108,4873
20200105,UI,화계,2188,2071,20200108,4259
20200105,UI,삼양,1361,1376,20200108,2737
20200105,UI,삼양사거리,1648,1641,20200108,3289
20200105,UI,솔샘,3178,2939,20200108,6117
20200105,UI,북한산보국문,4257,3727,20200108,7984
20200105,UI,정릉,2963,2506,20200108,5469
20200105,UI,성신여대입구,2402,2790,20200108,5192
20200105,UI,보문,1146,1136,20200108,2282
20200105,UI,신설동,1305,1323,20200108,2628
20200106,UI,북한산우이,2291,2044,20200109,4335
20200106,UI,솔밭공원,2496,2438,20200109,4934
20200106,UI,4.19민주묘지,2844,2726,20200109,5570
20200106,UI,가오리,4416,4384,20200109,8800
20200106,UI,화계,3657,3470,20200109,7127
20200106,UI,삼양,2117,2334,20200109,4451
20200106,UI,삼양사거리,2656,2802,20200109,5458
20200106,UI,솔샘,6298,5940,20200109,12238
20200106,UI,북한산보국문,6179,5963,20200109,12142
20200106,UI,정릉,4738,4533,20200109,9271
20200106,UI,성신여대입구,3775,4159,20200109,7934
20200106,UI,보문,1669,1710,20200109,3379
20200106,UI,신설동,2265,2269,20200109,4534
20200107,UI,북한산우이,2104,1782,20200110,3886
20200107,UI,솔밭공원,2438,2419,20200110,4857
20200107,UI,4.19민주묘지,2662,2577,20200110,5239
20200107,UI,가오리,4310,4340,20200110,8650
20200107,UI,화계,3476,3339,20200110,6815
20200107,UI,삼양,1965,2198,20200110,4163
20200107,UI,삼양사거리,2465,2610,20200110,5075
20200107,UI,솔샘,6235,5865,20200110,12100
20200107,UI,북한산보국문,5968,5827,20200110,11795
20200107,UI,정릉,4456,4409,20200110,8865
20200107,UI,성신여대입구,3702,4069,20200110,7771
20200107,UI,보문,1595,1683,20200110,3278
20200107,UI,신설동,2069,2060,20200110,4129
20200108,UI,정릉,4857,4541,20200111,9398
20200108,UI,신설동,2244,2232,20200111,4476
20200108,UI,보문,1680,1734,20200111,3414
20200108,UI,북한산우이,2382,2041,20200111,4423
20200108,UI,솔밭공원,2618,2485,20200111,5103
20200108,UI,4.19민주묘지,2933,2810,20200111,5743
20200108,UI,가오리,4414,4368,20200111,8782
20200108,UI,화계,3715,3529,20200111,7244
20200108,UI,삼양,2184,2399,20200111,4583
20200108,UI,삼양사거리,2689,2792,20200111,5481
20200108,UI,솔샘,6306,5872,20200111,12178
20200108,UI,북한산보국문,6415,6091,20200111,12506
20200108,UI,성신여대입구,3824,4257,20200111,8081
20200109,UI,북한산우이,2756,2357,20200112,5113
20200109,UI,솔밭공원,2606,2638,20200112,5244
20200109,UI,4.19민주묘지,2923,2766,20200112,5689
20200109,UI,가오리,4655,4526,20200112,9181
20200109,UI,화계,3637,3444,20200112,7081
20200109,UI,삼양,2118,2221,20200112,4339
20200109,UI,삼양사거리,2726,2807,20200112,5533
20200109,UI,솔샘,6450,5850,20200112,12300
20200109,UI,북한산보국문,6410,6125,20200112,12535
20200109,UI,정릉,4864,4517,20200112,9381
20200109,UI,성신여대입구,3906,4326,20200112,8232
20200109,UI,보문,1730,1754,20200112,3484
20200109,UI,신설동,2262,2333,20200112,4595
20200110,UI,북한산우이,2560,2232,20200113,4792
20200110,UI,솔밭공원,2716,2549,20200113,5265
20200110,UI,4.19민주묘지,3021,2838,20200113,5859
20200110,UI,가오리,4558,4308,20200113,8866
20200110,UI,화계,3697,3421,20200113,7118
20200110,UI,삼양,2224,2371,20200113,4595
20200110,UI,삼양사거리,2738,2781,20200113,5519
20200110,UI,솔샘,6593,6020,20200113,12613
20200110,UI,북한산보국문,6730,6115,20200113,12845
20200110,UI,정릉,5137,4638,20200113,9775
20200110,UI,성신여대입구,4102,4589,20200113,8691
20200110,UI,보문,1778,1749,20200113,3527
20200110,UI,신설동,2362,2318,20200113,4680
20200111,UI,북한산우이,3112,3158,20200114,6270
20200111,UI,솔밭공원,2133,1980,20200114,4113
20200111,UI,4.19민주묘지,3581,3179,20200114,6760
20200111,UI,가오리,3340,3083,20200114,6423
20200111,UI,화계,2745,2489,20200114,5234
20200111,UI,삼양,1731,1725,20200114,3456
20200111,UI,삼양사거리,2083,2109,20200114,4192
20200111,UI,솔샘,4551,3834,20200114,8385
20200111,UI,북한산보국문,5200,4635,20200114,9835
20200111,UI,정릉,4124,3429,20200114,7553
20200111,UI,성신여대입구,3220,3866,20200114,7086
20200111,UI,보문,1355,1358,20200114,2713
20200111,UI,신설동,1649,1592,20200114,3241
20200112,UI,북한산우이,2891,2818,20200115,5709
20200112,UI,솔밭공원,1678,1528,20200115,3206
20200112,UI,4.19민주묘지,2424,2102,20200115,4526
20200112,UI,가오리,2645,2473,20200115,5118
20200112,UI,화계,2305,2233,20200115,4538
20200112,UI,삼양,1265,1336,20200115,2601
20200112,UI,삼양사거리,1620,1620,20200115,3240
20200112,UI,솔샘,3205,2989,20200115,6194
20200112,UI,북한산보국문,4277,3725,20200115,8002
20200112,UI,정릉,3098,2696,20200115,5794
20200112,UI,성신여대입구,2635,3021,20200115,5656
20200112,UI,보문,1137,1177,20200115,2314
20200112,UI,신설동,1226,1272,20200115,2498
20200113,UI,북한산우이,2309,2013,20200116,4322
20200113,UI,솔밭공원,2617,2565,20200116,5182
20200113,UI,4.19민주묘지,2877,2782,20200116,5659
20200113,UI,가오리,4350,4332,20200116,8682
20200113,UI,화계,3690,3592,20200116,7282
20200113,UI,삼양,2234,2398,20200116,4632
20200113,UI,삼양사거리,2676,2822,20200116,5498
20200113,UI,솔샘,6378,5933,20200116,12311
20200113,UI,북한산보국문,6243,6136,20200116,12379
20200113,UI,정릉,4755,4443,20200116,9198
20200113,UI,성신여대입구,3776,4264,20200116,8040
20200113,UI,보문,1651,1618,20200116,3269
20200113,UI,신설동,2239,2232,20200116,4471
20200114,UI,성신여대입구,3828,4193,20200117,8021
20200114,UI,정릉,4708,4467,20200117,9175
20200114,UI,북한산보국문,6434,6067,20200117,12501
20200114,UI,솔샘,6374,5963,20200117,12337
20200114,UI,삼양사거리,2694,2762,20200117,5456
20200114,UI,삼양,2133,2329,20200117,4462
20200114,UI,화계,3899,3617,20200117,7516
20200114,UI,가오리,4553,4541,20200117,9094
20200114,UI,4.19민주묘지,2862,2852,20200117,5714
20200114,UI,솔밭공원,2720,2625,20200117,5345
20200114,UI,북한산우이,2497,2188,20200117,4685
20200114,UI,보문,1680,1692,20200117,3372
20200114,UI,신설동,2199,2247,20200117,4446
20200115,UI,북한산우이,2479,2124,20200118,4603
20200115,UI,솔밭공원,2613,2562,20200118,5175
20200115,UI,4.19민주묘지,3054,2897,20200118,5951
20200115,UI,가오리,4424,4362,20200118,8786
20200115,UI,화계,3694,3604,20200118,7298
20200115,UI,삼양,2239,2439,20200118,4678
20200115,UI,삼양사거리,2753,2817,20200118,5570
20200115,UI,솔샘,6427,6011,20200118,12438
20200115,UI,북한산보국문,6521,6095,20200118,12616
20200115,UI,정릉,4847,4586,20200118,9433
20200115,UI,성신여대입구,3966,4365,20200118,8331
20200115,UI,보문,1669,1720,20200118,3389
20200115,UI,신설동,2304,2307,20200118,4611
20200116,UI,신설동,2259,2274,20200119,4533
20200116,UI,보문,1647,1717,20200119,3364
20200116,UI,성신여대입구,3964,4179,20200119,8143
20200116,UI,정릉,4805,4395,20200119,9200
20200116,UI,북한산보국문,6408,6071,20200119,12479
20200116,UI,솔샘,6386,5955,20200119,12341
20200116,UI,삼양사거리,2745,2829,20200119,5574
20200116,UI,삼양,2225,2389,20200119,4614
20200116,UI,화계,3719,3539,20200119,7258
20200116,UI,가오리,4637,4533,20200119,9170
20200116,UI,4.19민주묘지,2934,2747,20200119,5681
20200116,UI,솔밭공원,2746,2591,20200119,5337
20200116,UI,북한산우이,2604,2268,20200119,4872
20200117,UI,북한산우이,2517,2277,20200120,4794
20200117,UI,솔밭공원,2789,2526,20200120,5315
20200117,UI,4.19민주묘지,2987,2830,20200120,5817
20200117,UI,가오리,4530,4432,20200120,8962
20200117,UI,화계,3831,3491,20200120,7322
20200117,UI,삼양,2382,2505,20200120,4887
20200117,UI,삼양사거리,2765,2776,20200120,5541
20200117,UI,솔샘,6420,5880,20200120,12300
20200117,UI,북한산보국문,6730,6140,20200120,12870
20200117,UI,정릉,4953,4449,20200120,9402
20200117,UI,성신여대입구,4047,4520,20200120,8567
20200117,UI,보문,1723,1761,20200120,3484
20200117,UI,신설동,2264,2372,20200120,4636
20200118,UI,신설동,1528,1574,20200121,3102
20200118,UI,북한산우이,3024,3003,20200121,6027
20200118,UI,솔밭공원,2155,1889,20200121,4044
20200118,UI,4.19민주묘지,2453,2184,20200121,4637
20200118,UI,가오리,3411,3222,20200121,6633
20200118,UI,화계,2887,2657,20200121,5544
20200118,UI,삼양,1792,1817,20200121,3609
20200118,UI,삼양사거리,2157,2125,20200121,4282
20200118,UI,솔샘,4429,3875,20200121,8304
20200118,UI,북한산보국문,5452,4658,20200121,10110
20200118,UI,정릉,4031,3226,20200121,7257
20200118,UI,성신여대입구,3297,3803,20200121,7100
20200118,UI,보문,1324,1331,20200121,2655
20200119,UI,성신여대입구,2452,2829,20200122,5281
20200119,UI,보문,1201,1195,20200122,2396
20200119,UI,신설동,1119,1199,20200122,2318
20200119,UI,북한산우이,2642,2641,20200122,5283
20200119,UI,솔밭공원,1528,1468,20200122,2996
20200119,UI,4.19민주묘지,1795,1584,20200122,3379
20200119,UI,가오리,2599,2391,20200122,4990
20200119,UI,화계,2195,2056,20200122,4251
20200119,UI,삼양,1350,1335,20200122,2685
20200119,UI,삼양사거리,1602,1542,20200122,3144
20200119,UI,솔샘,3140,2842,20200122,5982
20200119,UI,북한산보국문,4029,3580,20200122,7609
20200119,UI,정릉,3043,2430,20200122,5473
20200120,UI,보문,1710,1727,20200123,3437
20200120,UI,성신여대입구,3793,4268,20200123,8061
20200120,UI,정릉,4845,4458,20200123,9303
20200120,UI,북한산보국문,6308,6068,20200123,12376
20200120,UI,솔샘,6529,6029,20200123,12558
20200120,UI,삼양사거리,2775,2785,20200123,5560
20200120,UI,삼양,2294,2496,20200123,4790
20200120,UI,화계,3757,3562,20200123,7319
20200120,UI,가오리,4503,4531,20200123,9034
20200120,UI,4.19민주묘지,2917,2785,20200123,5702
20200120,UI,솔밭공원,2906,2847,20200123,5753
20200120,UI,북한산우이,2396,2157,20200123,4553
20200120,UI,신설동,2336,2341,20200123,4677
20200121,UI,북한산우이,2438,2175,20200124,4613
20200121,UI,솔밭공원,2777,2640,20200124,5417
20200121,UI,4.19민주묘지,2931,2833,20200124,5764
20200121,UI,가오리,4511,4499,20200124,9010
20200121,UI,화계,3824,3643,20200124,7467
20200121,UI,삼양,2253,2465,20200124,4718
20200121,UI,삼양사거리,2745,2905,20200124,5650
20200121,UI,솔샘,6490,6089,20200124,12579
20200121,UI,북한산보국문,6299,5882,20200124,12181
20200121,UI,정릉,4886,4459,20200124,9345
20200121,UI,성신여대입구,3828,4240,20200124,8068
20200121,UI,보문,1660,1709,20200124,3369
20200121,UI,신설동,2315,2354,20200124,4669
20200122,UI,북한산우이,2410,2093,20200125,4503
20200122,UI,솔밭공원,2641,2522,20200125,5163
20200122,UI,4.19민주묘지,2880,2767,20200125,5647
20200122,UI,가오리,4548,4474,20200125,9022
20200122,UI,화계,3822,3546,20200125,7368
20200122,UI,삼양,2188,2365,20200125,4553
20200122,UI,삼양사거리,2698,2802,20200125,5500
20200122,UI,솔샘,6557,5929,20200125,12486
20200122,UI,북한산보국문,6406,5905,20200125,12311
20200122,UI,정릉,4828,4491,20200125,9319
20200122,UI,성신여대입구,3783,4273,20200125,8056
20200122,UI,보문,1714,1715,20200125,3429
20200122,UI,신설동,2393,2350,20200125,4743
20200123,UI,북한산우이,2279,1946,20200126,4225
20200123,UI,솔밭공원,2571,2302,20200126,4873
20200123,UI,4.19민주묘지,2751,2429,20200126,5180
20200123,UI,가오리,4276,4178,20200126,8454
20200123,UI,화계,3527,3148,20200126,6675
20200123,UI,삼양,2092,2244,20200126,4336
20200123,UI,삼양사거리,2525,2577,20200126,5102
20200123,UI,솔샘,6152,5355,20200126,11507
20200123,UI,북한산보국문,6129,5236,20200126,11365
20200123,UI,정릉,4584,3976,20200126,8560
20200123,UI,성신여대입구,3650,4179,20200126,7829
20200123,UI,보문,1576,1578,20200126,3154
20200123,UI,신설동,2107,2149,20200126,4256
20200124,UI,신설동,739,840,20200127,1579
20200124,UI,보문,813,769,20200127,1582
20200124,UI,성신여대입구,1676,1978,20200127,3654
20200124,UI,정릉,2175,1744,20200127,3919
20200124,UI,북한산보국문,3103,2355,20200127,5458
20200124,UI,솔샘,2420,1986,20200127,4406
20200124,UI,삼양사거리,1195,1182,20200127,2377
20200124,UI,삼양,1062,1093,20200127,2155
20200124,UI,화계,1650,1459,20200127,3109
20200124,UI,가오리,2102,1999,20200127,4101
20200124,UI,4.19민주묘지,1334,1146,20200127,2480
20200124,UI,솔밭공원,1275,1188,20200127,2463
20200124,UI,북한산우이,1571,1625,20200127,3196
20200125,UI,신설동,699,715,20200128,1414
20200125,UI,북한산우이,2675,2598,20200128,5273
20200125,UI,솔밭공원,1362,1360,20200128,2722
20200125,UI,4.19민주묘지,1492,1358,20200128,2850
20200125,UI,가오리,2292,2111,20200128,4403
20200125,UI,화계,1963,1698,20200128,3661
20200125,UI,삼양,1160,1242,20200128,2402
20200125,UI,삼양사거리,1360,1351,20200128,2711
20200125,UI,솔샘,2501,2292,20200128,4793
20200125,UI,북한산보국문,3122,2801,20200128,5923
20200125,UI,정릉,2273,1935,20200128,4208
20200125,UI,성신여대입구,1311,1743,20200128,3054
20200125,UI,보문,840,792,20200128,1632
20200126,UI,북한산우이,2978,2904,20200129,5882
20200126,UI,솔밭공원,1421,1325,20200129,2746
20200126,UI,4.19민주묘지,1504,1324,20200129,2828
20200126,UI,가오리,2354,2074,20200129,4428
20200126,UI,화계,1833,1725,20200129,3558
20200126,UI,삼양,1127,1133,20200129,2260
20200126,UI,삼양사거리,1461,1443,20200129,2904
20200126,UI,솔샘,2623,2392,20200129,5015
20200126,UI,북한산보국문,3446,3082,20200129,6528
20200126,UI,정릉,2500,2169,20200129,4669
20200126,UI,성신여대입구,1897,2433,20200129,4330
20200126,UI,보문,835,890,20200129,1725
20200126,UI,신설동,1039,987,20200129,2026
20200127,UI,북한산우이,3099,3006,20200130,6105
20200127,UI,솔밭공원,1287,1271,20200130,2558
20200127,UI,4.19민주묘지,1668,1515,20200130,3183
20200127,UI,가오리,2412,2179,20200130,4591
20200127,UI,화계,1842,1826,20200130,3668
20200127,UI,삼양,1131,1194,20200130,2325
20200127,UI,삼양사거리,1439,1381,20200130,2820
20200127,UI,솔샘,2615,2401,20200130,5016
20200127,UI,북한산보국문,3396,3075,20200130,6471
20200127,UI,정릉,2401,2151,20200130,4552
20200127,UI,성신여대입구,2381,2810,20200130,5191
20200127,UI,보문,898,958,20200130,1856
20200127,UI,신설동,1001,1024,20200130,2025
20200128,UI,북한산우이,2380,2141,20200131,4521
20200128,UI,솔밭공원,2338,2344,20200131,4682
20200128,UI,4.19민주묘지,2676,2562,20200131,5238
20200128,UI,가오리,4178,4091,20200131,8269
20200128,UI,화계,3460,3271,20200131,6731
20200128,UI,삼양,1967,2199,20200131,4166
20200128,UI,삼양사거리,2528,2610,20200131,5138
20200128,UI,솔샘,5743,5499,20200131,11242
20200128,UI,북한산보국문,5775,5508,20200131,11283
20200128,UI,정릉,4303,4186,20200131,8489
20200128,UI,성신여대입구,3694,3968,20200131,7662
20200128,UI,보문,1491,1472,20200131,2963
20200128,UI,신설동,2157,2164,20200131,4321
20200129,UI,북한산우이,2598,2380,20200201,4978
20200129,UI,솔밭공원,2491,2436,20200201,4927
20200129,UI,4.19민주묘지,2802,2729,20200201,5531
20200129,UI,가오리,4350,4366,20200201,8716
20200129,UI,화계,3482,3448,20200201,6930
20200129,UI,삼양,2200,2395,20200201,4595
20200129,UI,삼양사거리,2694,2707,20200201,5401
20200129,UI,솔샘,6186,5834,20200201,12020
20200129,UI,북한산보국문,6076,5801,20200201,11877
20200129,UI,정릉,4601,4343,20200201,8944
20200129,UI,성신여대입구,3566,4079,20200201,7645
20200129,UI,보문,1623,1670,20200201,3293
20200129,UI,신설동,2308,2309,20200201,4617
20200130,UI,성신여대입구,3640,4055,20200202,7695
20200130,UI,신설동,2312,2290,20200202,4602
20200130,UI,삼양사거리,2622,2665,20200202,5287
20200130,UI,삼양,2199,2350,20200202,4549
20200130,UI,화계,3581,3430,20200202,7011
20200130,UI,가오리,4427,4333,20200202,8760
20200130,UI,4.19민주묘지,2865,2758,20200202,5623
20200130,UI,솔밭공원,2554,2472,20200202,5026
20200130,UI,북한산우이,2634,2342,20200202,4976
20200130,UI,보문,1623,1648,20200202,3271
20200130,UI,정릉,4564,4324,20200202,8888
20200130,UI,북한산보국문,6070,5805,20200202,11875
20200130,UI,솔샘,6169,5681,20200202,11850
20200131,UI,북한산우이,2611,2267,20200203,4878
20200131,UI,솔밭공원,2484,2326,20200203,4810
20200131,UI,4.19민주묘지,2733,2656,20200203,5389
20200131,UI,가오리,4232,4152,20200203,8384
20200131,UI,화계,3576,3315,20200203,6891
20200131,UI,삼양,2088,2278,20200203,4366
20200131,UI,삼양사거리,2612,2645,20200203,5257
20200131,UI,솔샘,6051,5477,20200203,11528
20200131,UI,북한산보국문,6044,5677,20200203,11721
20200131,UI,정릉,4447,4187,20200203,8634
20200131,UI,성신여대입구,3129,3314,20200203,6443
20200131,UI,보문,1564,1649,20200203,3213
20200131,UI,신설동,2279,2293,20200203,4572
20200201,UI,북한산우이,2578,2684,20200204,5262
20200201,UI,솔밭공원,1652,1577,20200204,3229
20200201,UI,4.19민주묘지,2026,1715,20200204,3741
20200201,UI,가오리,2721,2580,20200204,5301
20200201,UI,화계,2451,2276,20200204,4727
20200201,UI,삼양,1393,1475,20200204,2868
20200201,UI,삼양사거리,1733,1737,20200204,3470
20200201,UI,솔샘,3385,3020,20200204,6405
20200201,UI,북한산보국문,4241,3723,20200204,7964
20200201,UI,정릉,3221,2672,20200204,5893
20200201,UI,성신여대입구,2129,2350,20200204,4479
20200201,UI,보문,1089,1120,20200204,2209
20200201,UI,신설동,1405,1340,20200204,2745
20200202,UI,북한산우이,2689,2457,20200205,5146
20200202,UI,솔밭공원,1256,1225,20200205,2481
20200202,UI,4.19민주묘지,1674,1397,20200205,3071
20200202,UI,가오리,2091,2031,20200205,4122
20200202,UI,화계,1905,1797,20200205,3702
20200202,UI,삼양,1176,1189,20200205,2365
20200202,UI,삼양사거리,1402,1369,20200205,2771
20200202,UI,솔샘,2502,2247,20200205,4749
20200202,UI,북한산보국문,3409,3034,20200205,6443
20200202,UI,정릉,2359,2050,20200205,4409
20200202,UI,성신여대입구,1687,1817,20200205,3504
20200202,UI,보문,950,1023,20200205,1973
20200202,UI,신설동,1064,1079,20200205,2143
20200203,UI,북한산우이,2337,2039,20200206,4376
20200203,UI,솔밭공원,2292,2303,20200206,4595
20200203,UI,4.19민주묘지,2672,2592,20200206,5264
20200203,UI,가오리,3982,4071,20200206,8053
20200203,UI,화계,3363,3242,20200206,6605
20200203,UI,삼양,1966,2178,20200206,4144
20200203,UI,삼양사거리,2543,2537,20200206,5080
20200203,UI,솔샘,5765,5572,20200206,11337
20200203,UI,북한산보국문,5586,5483,20200206,11069
20200203,UI,정릉,4180,4050,20200206,8230
20200203,UI,성신여대입구,2970,3295,20200206,6265
20200203,UI,보문,1442,1549,20200206,2991
20200203,UI,신설동,2163,2151,20200206,4314
20200204,UI,북한산우이,2832,2532,20200207,5364
20200204,UI,솔밭공원,2357,2347,20200207,4704
20200204,UI,4.19민주묘지,2636,2598,20200207,5234
20200204,UI,가오리,4145,4231,20200207,8376
20200204,UI,화계,3436,3378,20200207,6814
20200204,UI,삼양,2002,2232,20200207,4234
20200204,UI,삼양사거리,2484,2543,20200207,5027
20200204,UI,솔샘,5764,5586,20200207,11350
20200204,UI,북한산보국문,5798,5713,20200207,11511
20200204,UI,정릉,4258,4091,20200207,8349
20200204,UI,성신여대입구,3171,3291,20200207,6462
20200204,UI,보문,1563,1637,20200207,3200
20200204,UI,신설동,2184,2233,20200207,4417
20200205,UI,북한산우이,2089,1796,20200208,3885
20200205,UI,솔밭공원,2240,2172,20200208,4412
20200205,UI,4.19민주묘지,2448,2407,20200208,4855
20200205,UI,가오리,3959,4001,20200208,7960
20200205,UI,화계,3168,3054,20200208,6222
20200205,UI,삼양,1879,2116,20200208,3995
20200205,UI,삼양사거리,2253,2400,20200208,4653
20200205,UI,솔샘,5646,5336,20200208,10982
20200205,UI,북한산보국문,5557,5458,20200208,11015
20200205,UI,정릉,4123,3934,20200208,8057
20200205,UI,성신여대입구,3026,3208,20200208,6234
20200205,UI,보문,1444,1553,20200208,2997
20200205,UI,신설동,2123,2144,20200208,4267
20200206,UI,북한산우이,2094,1811,20200209,3905
20200206,UI,솔밭공원,2294,2278,20200209,4572
20200206,UI,4.19민주묘지,2350,2312,20200209,4662
20200206,UI,가오리,3840,3827,20200209,7667
20200206,UI,화계,3109,2962,20200209,6071
20200206,UI,삼양,1873,2068,20200209,3941
20200206,UI,삼양사거리,2198,2337,20200209,4535
20200206,UI,솔샘,5643,5325,20200209,10968
20200206,UI,북한산보국문,5536,5312,20200209,10848
20200206,UI,정릉,3985,3850,20200209,7835
20200206,UI,성신여대입구,2861,3122,20200209,5983
20200206,UI,보문,1359,1463,20200209,2822
20200206,UI,신설동,2159,2153,20200209,4312
20200207,UI,성신여대입구,3046,3371,20200210,6417
20200207,UI,북한산우이,2241,1945,20200210,4186
20200207,UI,솔밭공원,2312,2337,20200210,4649
20200207,UI,4.19민주묘지,2619,2531,20200210,5150
20200207,UI,가오리,4078,4007,20200210,8085
20200207,UI,화계,3249,2952,20200210,6201
20200207,UI,삼양,1952,2132,20200210,4084
20200207,UI,삼양사거리,2355,2373,20200210,4728
20200207,UI,솔샘,5853,5377,20200210,11230
20200207,UI,북한산보국문,6020,5538,20200210,11558
20200207,UI,정릉,4174,3948,20200210,8122
20200207,UI,보문,1510,1553,20200210,3063
20200207,UI,신설동,2137,2256,20200210,4393
20200208,UI,북한산우이,2714,2625,20200211,5339
20200208,UI,솔밭공원,1608,1531,20200211,3139
20200208,UI,4.19민주묘지,1958,1807,20200211,3765
20200208,UI,가오리,2673,2499,20200211,5172
20200208,UI,화계,2385,2198,20200211,4583
20200208,UI,삼양,1477,1508,20200211,2985
20200208,UI,삼양사거리,1739,1719,20200211,3458
20200208,UI,솔샘,3423,2971,20200211,6394
20200208,UI,북한산보국문,4143,3686,20200211,7829
20200208,UI,정릉,3137,2613,20200211,5750
20200208,UI,성신여대입구,2146,2595,20200211,4741
20200208,UI,보문,1116,1146,20200211,2262
20200208,UI,신설동,1288,1304,20200211,2592
20200209,UI,북한산우이,2273,2199,20200212,4472
20200209,UI,솔밭공원,1268,1139,20200212,2407
20200209,UI,4.19민주묘지,1644,1517,20200212,3161
20200209,UI,가오리,2142,2010,20200212,4152
20200209,UI,화계,1829,1707,20200212,3536
20200209,UI,삼양,1079,1052,20200212,2131
20200209,UI,삼양사거리,1324,1329,20200212,2653
20200209,UI,솔샘,2434,2297,20200212,4731
20200209,UI,북한산보국문,3451,3137,20200212,6588
20200209,UI,정릉,2436,2100,20200212,4536
20200209,UI,성신여대입구,1786,1995,20200212,3781
20200209,UI,보문,994,1017,20200212,2011
20200209,UI,신설동,1036,1048,20200212,2084
20200210,UI,북한산우이,2364,2124,20200213,4488
20200210,UI,신설동,2223,2234,20200213,4457
20200210,UI,보문,1514,1520,20200213,3034
20200210,UI,성신여대입구,3059,3437,20200213,6496
20200210,UI,정릉,4110,3938,20200213,8048
20200210,UI,북한산보국문,5645,5488,20200213,11133
20200210,UI,솔샘,5837,5494,20200213,11331
20200210,UI,삼양사거리,2421,2464,20200213,4885
20200210,UI,삼양,1983,2181,20200213,4164
20200210,UI,화계,3253,3101,20200213,6354
20200210,UI,가오리,3962,3909,20200213,7871
20200210,UI,4.19민주묘지,2654,2630,20200213,5284
20200210,UI,솔밭공원,2337,2293,20200213,4630
20200211,UI,북한산우이,2552,2356,20200214,4908
20200211,UI,솔밭공원,2392,2381,20200214,4773
20200211,UI,4.19민주묘지,2755,2661,20200214,5416
20200211,UI,가오리,4043,4009,20200214,8052
20200211,UI,화계,3330,3145,20200214,6475
20200211,UI,삼양,1980,2227,20200214,4207
20200211,UI,삼양사거리,2433,2529,20200214,4962
20200211,UI,솔샘,5910,5520,20200214,11430
20200211,UI,북한산보국문,5846,5519,20200214,11365
20200211,UI,정릉,4295,4129,20200214,8424
20200211,UI,성신여대입구,3254,3475,20200214,6729
20200211,UI,보문,1478,1511,20200214,2989
20200211,UI,신설동,2272,2257,20200214,4529
20200212,UI,신설동,2195,2265,20200215,4460
20200212,UI,보문,1457,1469,20200215,2926
20200212,UI,성신여대입구,2938,3407,20200215,6345
20200212,UI,정릉,4222,3882,20200215,8104
20200212,UI,북한산보국문,5659,5410,20200215,11069
20200212,UI,솔샘,5814,5320,20200215,11134
20200212,UI,삼양사거리,2348,2423,20200215,4771
20200212,UI,삼양,1948,2131,20200215,4079
20200212,UI,화계,3231,3028,20200215,6259
20200212,UI,가오리,3942,4005,20200215,7947
20200212,UI,4.19민주묘지,2468,2381,20200215,4849
20200212,UI,솔밭공원,2279,2156,20200215,4435
20200212,UI,북한산우이,2083,1781,20200215,3864
20200213,UI,북한산우이,2451,2113,20200216,4564
20200213,UI,솔밭공원,2422,2380,20200216,4802
20200213,UI,4.19민주묘지,2757,2621,20200216,5378
20200213,UI,가오리,4072,4009,20200216,8081
20200213,UI,화계,3333,3054,20200216,6387
20200213,UI,삼양,1988,2204,20200216,4192
20200213,UI,삼양사거리,2448,2459,20200216,4907
20200213,UI,솔샘,5846,5498,20200216,11344
20200213,UI,북한산보국문,5863,5555,20200216,11418
20200213,UI,정릉,4429,4227,20200216,8656
20200213,UI,성신여대입구,3324,3782,20200216,7106
20200213,UI,보문,1484,1568,20200216,3052
20200213,UI,신설동,2181,2288,20200216,4469
20200214,UI,북한산우이,2400,2137,20200217,4537
20200214,UI,솔밭공원,2565,2339,20200217,4904
20200214,UI,4.19민주묘지,2863,2697,20200217,5560
20200214,UI,가오리,4156,3889,20200217,8045
20200214,UI,화계,3488,3170,20200217,6658
20200214,UI,삼양,2171,2356,20200217,4527
20200214,UI,삼양사거리,2511,2554,20200217,5065
20200214,UI,솔샘,6147,5545,20200217,11692
20200214,UI,북한산보국문,6218,5707,20200217,11925
20200214,UI,정릉,4625,4210,20200217,8835
20200214,UI,성신여대입구,3457,3873,20200217,7330
20200214,UI,보문,1609,1601,20200217,3210
20200214,UI,신설동,2188,2300,20200217,4488
20200215,UI,북한산우이,2804,2648,20200218,5452
20200215,UI,솔밭공원,1805,1728,20200218,3533
20200215,UI,4.19민주묘지,2166,1902,20200218,4068
20200215,UI,가오리,2952,2766,20200218,5718
20200215,UI,화계,2486,2321,20200218,4807
20200215,UI,삼양,1480,1529,20200218,3009
20200215,UI,삼양사거리,1858,1920,20200218,3778
20200215,UI,솔샘,3748,3307,20200218,7055
20200215,UI,북한산보국문,4441,3861,20200218,8302
20200215,UI,정릉,3471,2878,20200218,6349
20200215,UI,성신여대입구,2591,2960,20200218,5551
20200215,UI,보문,1224,1295,20200218,2519
20200215,UI,신설동,1534,1422,20200218,2956
20200216,UI,북한산우이,2011,2045,20200219,4056
20200216,UI,솔밭공원,1271,1238,20200219,2509
20200216,UI,4.19민주묘지,1472,1301,20200219,2773
20200216,UI,가오리,2153,2008,20200219,4161
20200216,UI,화계,1897,1716,20200219,3613
20200216,UI,삼양,1167,1193,20200219,2360
20200216,UI,삼양사거리,1359,1363,20200219,2722
20200216,UI,솔샘,2695,2502,20200219,5197
20200216,UI,북한산보국문,3443,3007,20200219,6450
20200216,UI,정릉,2474,2180,20200219,4654
20200216,UI,성신여대입구,1939,2299,20200219,4238
20200216,UI,보문,968,1011,20200219,1979
20200216,UI,신설동,889,906,20200219,1795
20200217,UI,북한산우이,2292,1928,20200220,4220
20200217,UI,솔밭공원,2297,2295,20200220,4592
20200217,UI,4.19민주묘지,2482,2443,20200220,4925
20200217,UI,가오리,3963,3955,20200220,7918
20200217,UI,화계,3242,3141,20200220,6383
20200217,UI,삼양,1941,2154,20200220,4095
20200217,UI,삼양사거리,2384,2453,20200220,4837
20200217,UI,솔샘,5912,5481,20200220,11393
20200217,UI,북한산보국문,5861,5537,20200220,11398
20200217,UI,정릉,4229,4033,20200220,8262
20200217,UI,성신여대입구,3211,3641,20200220,6852
20200217,UI,보문,1457,1542,20200220,2999
20200217,UI,신설동,2034,2018,20200220,4052
20200218,UI,북한산우이,2370,2181,20200221,4551
20200218,UI,솔밭공원,2552,2482,20200221,5034
20200218,UI,4.19민주묘지,2580,2480,20200221,5060
20200218,UI,가오리,3935,3979,20200221,7914
20200218,UI,화계,3309,3070,20200221,6379
20200218,UI,삼양,1943,2142,20200221,4085
20200218,UI,삼양사거리,2372,2434,20200221,4806
20200218,UI,솔샘,5742,5463,20200221,11205
20200218,UI,북한산보국문,5835,5590,20200221,11425
20200218,UI,정릉,4242,3956,20200221,8198
20200218,UI,성신여대입구,3284,3747,20200221,7031
20200218,UI,보문,1474,1516,20200221,2990
20200218,UI,신설동,2049,2004,20200221,4053
20200219,UI,북한산우이,2500,2151,20200222,4651
20200219,UI,솔밭공원,2423,2331,20200222,4754
20200219,UI,4.19민주묘지,2724,2684,20200222,5408
20200219,UI,가오리,4037,4019,20200222,8056
20200219,UI,화계,3234,3143,20200222,6377
20200219,UI,삼양,1984,2282,20200222,4266
20200219,UI,삼양사거리,2517,2610,20200222,5127
20200219,UI,솔샘,5818,5562,20200222,11380
20200219,UI,북한산보국문,5969,5801,20200222,11770
20200219,UI,정릉,4320,4174,20200222,8494
20200219,UI,성신여대입구,3336,3687,20200222,7023
20200219,UI,보문,1448,1494,20200222,2942
20200219,UI,신설동,2198,2130,20200222,4328
20200220,UI,북한산우이,2368,2110,20200223,4478
20200220,UI,솔밭공원,2291,2273,20200223,4564
20200220,UI,4.19민주묘지,2736,2639,20200223,5375
20200220,UI,가오리,3925,3860,20200223,7785
20200220,UI,화계,3141,3038,20200223,6179
20200220,UI,삼양,1908,2126,20200223,4034
20200220,UI,삼양사거리,2410,2532,20200223,4942
20200220,UI,솔샘,5764,5293,20200223,11057
20200220,UI,북한산보국문,5652,5431,20200223,11083
20200220,UI,정릉,4148,3848,20200223,7996
20200220,UI,성신여대입구,3179,3560,20200223,6739
20200220,UI,보문,1466,1574,20200223,3040
20200220,UI,신설동,2114,2108,20200223,4222
20200221,UI,북한산우이,2160,1911,20200224,4071
20200221,UI,솔밭공원,2266,2149,20200224,4415
20200221,UI,4.19민주묘지,2625,2507,20200224,5132
20200221,UI,가오리,3803,3745,20200224,7548
20200221,UI,화계,3115,2909,20200224,6024
20200221,UI,삼양,1873,2094,20200224,3967
20200221,UI,삼양사거리,2286,2370,20200224,4656
20200221,UI,솔샘,5548,5044,20200224,10592
20200221,UI,북한산보국문,5648,5316,20200224,10964
20200221,UI,정릉,4120,3851,20200224,7971
20200221,UI,성신여대입구,3211,3479,20200224,6690
20200221,UI,보문,1485,1458,20200224,2943
20200221,UI,신설동,1940,2032,20200224,3972
20200222,UI,성신여대입구,2165,2446,20200225,4611
20200222,UI,북한산우이,1891,1805,20200225,3696
20200222,UI,솔밭공원,1445,1348,20200225,2793
20200222,UI,4.19민주묘지,1644,1556,20200225,3200
20200222,UI,가오리,2399,2275,20200225,4674
20200222,UI,화계,2100,1896,20200225,3996
20200222,UI,삼양,1232,1333,20200225,2565
20200222,UI,삼양사거리,1529,1574,20200225,3103
20200222,UI,솔샘,3030,2667,20200225,5697
20200222,UI,북한산보국문,3751,3356,20200225,7107
20200222,UI,정릉,2799,2328,20200225,5127
20200222,UI,보문,1045,1103,20200225,2148
20200222,UI,신설동,1166,1127,20200225,2293
20200223,UI,북한산우이,2017,2030,20200226,4047
20200223,UI,솔밭공원,1066,1036,20200226,2102
20200223,UI,4.19민주묘지,1453,1301,20200226,2754
20200223,UI,가오리,1770,1663,20200226,3433
20200223,UI,화계,1471,1367,20200226,2838
20200223,UI,삼양,930,943,20200226,1873
20200223,UI,삼양사거리,1173,1122,20200226,2295
20200223,UI,솔샘,2038,2007,20200226,4045
20200223,UI,북한산보국문,2762,2541,20200226,5303
20200223,UI,정릉,2033,1697,20200226,3730
20200223,UI,성신여대입구,1630,1911,20200226,3541
20200223,UI,보문,717,745,20200226,1462
20200223,UI,신설동,823,825,20200226,1648
20200224,UI,북한산우이,2267,1997,20200227,4264
20200224,UI,솔밭공원,2013,1984,20200227,3997
20200224,UI,4.19민주묘지,2270,2257,20200227,4527
20200224,UI,가오리,3528,3541,20200227,7069
20200224,UI,화계,2908,2728,20200227,5636
20200224,UI,삼양,1690,1966,20200227,3656
20200224,UI,삼양사거리,2108,2159,20200227,4267
20200224,UI,솔샘,4958,4705,20200227,9663
20200224,UI,북한산보국문,4893,4826,20200227,9719
20200224,UI,정릉,3527,3380,20200227,6907
20200224,UI,성신여대입구,2572,2952,20200227,5524
20200224,UI,보문,1283,1313,20200227,2596
20200224,UI,신설동,1811,1865,20200227,3676
20200225,UI,북한산우이,1694,1400,20200228,3094
20200225,UI,솔밭공원,1810,1747,20200228,3557
20200225,UI,4.19민주묘지,1991,2033,20200228,4024
20200225,UI,가오리,3100,3243,20200228,6343
20200225,UI,화계,2591,2465,20200228,5056
20200225,UI,삼양,1565,1753,20200228,3318
20200225,UI,삼양사거리,1900,1999,20200228,3899
20200225,UI,솔샘,4583,4332,20200228,8915
20200225,UI,북한산보국문,4504,4425,20200228,8929
20200225,UI,정릉,3237,3139,20200228,6376
20200225,UI,성신여대입구,2372,2663,20200228,5035
20200225,UI,보문,1187,1203,20200228,2390
20200225,UI,신설동,1731,1723,20200228,3454
20200226,UI,북한산우이,1976,1773,20200229,3749
20200226,UI,솔밭공원,1887,1913,20200229,3800
20200226,UI,4.19민주묘지,2110,2109,20200229,4219
20200226,UI,가오리,3328,3362,20200229,6690
20200226,UI,화계,2695,2528,20200229,5223
20200226,UI,삼양,1586,1831,20200229,3417
20200226,UI,삼양사거리,1972,1980,20200229,3952
20200226,UI,솔샘,4604,4333,20200229,8937
20200226,UI,북한산보국문,4557,4475,20200229,9032
20200226,UI,정릉,3341,3138,20200229,6479
20200226,UI,성신여대입구,2435,2729,20200229,5164
20200226,UI,보문,1224,1230,20200229,2454
20200226,UI,신설동,1713,1766,20200229,3479
20200227,UI,신설동,1782,1777,20200301,3559
20200227,UI,보문,1213,1228,20200301,2441
20200227,UI,성신여대입구,2282,2604,20200301,4886
20200227,UI,정릉,3313,3143,20200301,6456
20200227,UI,북한산보국문,4426,4357,20200301,8783
20200227,UI,솔샘,4484,4335,20200301,8819
20200227,UI,삼양사거리,1921,2033,20200301,3954
20200227,UI,삼양,1576,1747,20200301,3323
20200227,UI,화계,2637,2528,20200301,5165
20200227,UI,가오리,3216,3272,20200301,6488
20200227,UI,4.19민주묘지,2073,1989,20200301,4062
20200227,UI,솔밭공원,1889,1897,20200301,3786
20200227,UI,북한산우이,1987,1838,20200301,3825
20200228,UI,북한산우이,1665,1419,20200302,3084
20200228,UI,솔밭공원,1750,1668,20200302,3418
20200228,UI,4.19민주묘지,1902,1876,20200302,3778
20200228,UI,가오리,3047,3014,20200302,6061
20200228,UI,화계,2496,2313,20200302,4809
20200228,UI,삼양,1503,1661,20200302,3164
20200228,UI,삼양사거리,1805,1808,20200302,3613
20200228,UI,솔샘,4359,4161,20200302,8520
20200228,UI,북한산보국문,4321,4152,20200302,8473
20200228,UI,정릉,3094,2998,20200302,6092
20200228,UI,성신여대입구,2345,2691,20200302,5036
20200228,UI,보문,1118,1240,20200302,2358
20200228,UI,신설동,1630,1702,20200302,3332
20200229,UI,신설동,994,996,20200303,1990
20200229,UI,보문,825,840,20200303,1665
20200229,UI,성신여대입구,1780,2031,20200303,3811
20200229,UI,정릉,2191,1806,20200303,3997
20200229,UI,북한산보국문,3006,2680,20200303,5686
20200229,UI,솔샘,2288,2117,20200303,4405
20200229,UI,삼양사거리,1249,1333,20200303,2582
20200229,UI,삼양,1071,1107,20200303,2178
20200229,UI,화계,1752,1542,20200303,3294
20200229,UI,가오리,1970,1823,20200303,3793
20200229,UI,4.19민주묘지,1606,1385,20200303,2991
20200229,UI,솔밭공원,1226,1218,20200303,2444
20200229,UI,북한산우이,1789,1805,20200303,3594
20200301,UI,신설동,636,646,20200304,1282
20200301,UI,보문,564,542,20200304,1106
20200301,UI,성신여대입구,1170,1388,20200304,2558
20200301,UI,정릉,1454,1253,20200304,2707
20200301,UI,북한산보국문,2177,1932,20200304,4109
20200301,UI,솔샘,1516,1342,20200304,2858
20200301,UI,삼양사거리,903,896,20200304,1799
20200301,UI,삼양,751,815,20200304,1566
20200301,UI,화계,1180,1075,20200304,2255
20200301,UI,가오리,1444,1300,20200304,2744
20200301,UI,4.19민주묘지,1096,961,20200304,2057
20200301,UI,솔밭공원,911,794,20200304,1705
20200301,UI,북한산우이,1713,1750,20200304,3463
20200302,UI,북한산우이,1850,1627,20200305,3477
20200302,UI,솔밭공원,1750,1815,20200305,3565
20200302,UI,4.19민주묘지,1944,1911,20200305,3855
20200302,UI,가오리,3061,3143,20200305,6204
20200302,UI,화계,2558,2447,20200305,5005
20200302,UI,삼양,1616,1759,20200305,3375
20200302,UI,삼양사거리,1830,1921,20200305,3751
20200302,UI,솔샘,4472,4295,20200305,8767
20200302,UI,북한산보국문,4268,4188,20200305,8456
20200302,UI,정릉,3177,3074,20200305,6251
20200302,UI,성신여대입구,2302,2538,20200305,4840
20200302,UI,보문,1182,1213,20200305,2395
20200302,UI,신설동,1796,1743,20200305,3539
20200303,UI,북한산우이,1838,1704,20200306,3542
20200303,UI,솔밭공원,1799,1796,20200306,3595
20200303,UI,4.19민주묘지,1966,1950,20200306,3916
20200303,UI,가오리,2992,3091,20200306,6083
20200303,UI,화계,2518,2414,20200306,4932
20200303,UI,삼양,1538,1668,20200306,3206
20200303,UI,삼양사거리,1860,1847,20200306,3707
20200303,UI,솔샘,4404,4268,20200306,8672
20200303,UI,북한산보국문,4305,4238,20200306,8543
20200303,UI,정릉,3172,3095,20200306,6267
20200303,UI,성신여대입구,2232,2568,20200306,4800
20200303,UI,보문,1188,1201,20200306,2389
20200303,UI,신설동,1781,1790,20200306,3571
20200304,UI,북한산우이,1661,1458,20200307,3119
20200304,UI,솔밭공원,1736,1728,20200307,3464
20200304,UI,4.19민주묘지,1966,1930,20200307,3896
20200304,UI,가오리,3113,3144,20200307,6257
20200304,UI,화계,2481,2366,20200307,4847
20200304,UI,삼양,1588,1774,20200307,3362
20200304,UI,삼양사거리,1855,1908,20200307,3763
20200304,UI,솔샘,4365,4193,20200307,8558
20200304,UI,북한산보국문,4208,4184,20200307,8392
20200304,UI,정릉,3149,3045,20200307,6194
20200304,UI,성신여대입구,2322,2625,20200307,4947
20200304,UI,보문,1114,1189,20200307,2303
20200304,UI,신설동,1682,1706,20200307,3388
20200305,UI,북한산우이,1775,1563,20200308,3338
20200305,UI,솔밭공원,1739,1775,20200308,3514
20200305,UI,4.19민주묘지,1981,1896,20200308,3877
20200305,UI,가오리,3061,3054,20200308,6115
20200305,UI,화계,2453,2368,20200308,4821
20200305,UI,삼양,1521,1700,20200308,3221
20200305,UI,삼양사거리,1799,1804,20200308,3603
20200305,UI,솔샘,4220,3977,20200308,8197
20200305,UI,북한산보국문,4281,4184,20200308,8465
20200305,UI,정릉,3143,3075,20200308,6218
20200305,UI,성신여대입구,2251,2590,20200308,4841
20200305,UI,보문,1077,1179,20200308,2256
20200305,UI,신설동,1767,1706,20200308,3473
20200306,UI,북한산우이,1783,1649,20200309,3432
20200306,UI,솔밭공원,1811,1750,20200309,3561
20200306,UI,4.19민주묘지,2050,1904,20200309,3954
20200306,UI,가오리,3042,3035,20200309,6077
20200306,UI,화계,2615,2422,20200309,5037
20200306,UI,삼양,1546,1718,20200309,3264
20200306,UI,삼양사거리,1791,1833,20200309,3624
20200306,UI,솔샘,4240,3828,20200309,8068
20200306,UI,북한산보국문,4481,4111,20200309,8592
20200306,UI,정릉,3247,3082,20200309,6329
20200306,UI,성신여대입구,2350,2766,20200309,5116
20200306,UI,보문,1144,1165,20200309,2309
20200306,UI,신설동,1694,1713,20200309,3407
20200307,UI,북한산우이,1978,2053,20200310,4031
20200307,UI,솔밭공원,1150,1135,20200310,2285
20200307,UI,4.19민주묘지,1517,1295,20200310,2812
20200307,UI,가오리,1868,1753,20200310,3621
20200307,UI,화계,1660,1495,20200310,3155
20200307,UI,삼양,1032,1146,20200310,2178
20200307,UI,삼양사거리,1274,1370,20200310,2644
20200307,UI,솔샘,2278,2014,20200310,4292
20200307,UI,북한산보국문,3122,2744,20200310,5866
20200307,UI,정릉,2253,1910,20200310,4163
20200307,UI,성신여대입구,1731,2120,20200310,3851
20200307,UI,보문,808,811,20200310,1619
20200307,UI,신설동,1030,962,20200310,1992
20200308,UI,북한산우이,2168,2281,20200311,4449
20200308,UI,솔밭공원,892,848,20200311,1740
20200308,UI,4.19민주묘지,1322,1054,20200311,2376
20200308,UI,가오리,1451,1278,20200311,2729
20200308,UI,화계,1274,1203,20200311,2477
20200308,UI,삼양,781,801,20200311,1582
20200308,UI,삼양사거리,972,970,20200311,1942
20200308,UI,솔샘,1607,1408,20200311,3015
20200308,UI,북한산보국문,2424,2117,20200311,4541
20200308,UI,정릉,1715,1372,20200311,3087
20200308,UI,성신여대입구,1295,1574,20200311,2869
20200308,UI,보문,610,610,20200311,1220
20200308,UI,신설동,741,762,20200311,1503
20200309,UI,북한산우이,1884,1755,20200312,3639
20200309,UI,솔밭공원,1874,1895,20200312,3769
20200309,UI,4.19민주묘지,2085,2077,20200312,4162
20200309,UI,가오리,3141,3162,20200312,6303
20200309,UI,화계,2608,2457,20200312,5065
20200309,UI,삼양,1676,1822,20200312,3498
20200309,UI,삼양사거리,1914,1914,20200312,3828
20200309,UI,솔샘,4429,4115,20200312,8544
20200309,UI,북한산보국문,4373,4430,20200312,8803
20200309,UI,정릉,3319,3212,20200312,6531
20200309,UI,성신여대입구,2349,2632,20200312,4981
20200309,UI,보문,1173,1236,20200312,2409
20200309,UI,신설동,1821,1783,20200312,3604
20200310,UI,북한산우이,1585,1319,20200313,2904
20200310,UI,솔밭공원,1712,1693,20200313,3405
20200310,UI,4.19민주묘지,1827,1815,20200313,3642
20200310,UI,가오리,2977,3070,20200313,6047
20200310,UI,화계,2437,2248,20200313,4685
20200310,UI,삼양,1476,1602,20200313,3078
20200310,UI,삼양사거리,1728,1783,20200313,3511
20200310,UI,솔샘,4272,3949,20200313,8221
20200310,UI,북한산보국문,4216,4139,20200313,8355
20200310,UI,정릉,3195,3089,20200313,6284
20200310,UI,성신여대입구,2293,2616,20200313,4909
20200310,UI,보문,1146,1146,20200313,2292
20200310,UI,신설동,1687,1685,20200313,3372
20200311,UI,신설동,1813,1775,20200314,3588
20200311,UI,보문,1164,1168,20200314,2332
20200311,UI,성신여대입구,2349,2675,20200314,5024
20200311,UI,정릉,3254,3143,20200314,6397
20200311,UI,북한산보국문,4502,4308,20200314,8810
20200311,UI,솔샘,4426,4142,20200314,8568
20200311,UI,삼양사거리,1883,1847,20200314,3730
20200311,UI,삼양,1619,1752,20200314,3371
20200311,UI,북한산우이,1939,1836,20200314,3775
20200311,UI,솔밭공원,1772,1778,20200314,3550
20200311,UI,4.19민주묘지,2061,2008,20200314,4069
20200311,UI,가오리,3069,3119,20200314,6188
20200311,UI,화계,2547,2465,20200314,5012
20200312,UI,북한산우이,1843,1667,20200315,3510
20200312,UI,솔밭공원,1778,1782,20200315,3560
20200312,UI,4.19민주묘지,1984,1908,20200315,3892
20200312,UI,가오리,2948,2916,20200315,5864
20200312,UI,화계,2524,2402,20200315,4926
20200312,UI,삼양,1562,1712,20200315,3274
20200312,UI,삼양사거리,1778,1869,20200315,3647
20200312,UI,솔샘,4352,4072,20200315,8424
20200312,UI,북한산보국문,4321,4225,20200315,8546
20200312,UI,정릉,3284,3098,20200315,6382
20200312,UI,성신여대입구,2164,2552,20200315,4716
20200312,UI,보문,1105,1185,20200315,2290
20200312,UI,신설동,1724,1702,20200315,3426
20200313,UI,북한산우이,1835,1643,20200316,3478
20200313,UI,솔밭공원,1774,1713,20200316,3487
20200313,UI,4.19민주묘지,2096,2016,20200316,4112
20200313,UI,가오리,2988,3031,20200316,6019
20200313,UI,화계,2527,2328,20200316,4855
20200313,UI,삼양,1602,1730,20200316,3332
20200313,UI,삼양사거리,1824,1885,20200316,3709
20200313,UI,솔샘,4455,3989,20200316,8444
20200313,UI,북한산보국문,4533,4241,20200316,8774
20200313,UI,정릉,3341,3147,20200316,6488
20200313,UI,성신여대입구,2382,2737,20200316,5119
20200313,UI,보문,1123,1196,20200316,2319
20200313,UI,신설동,1736,1715,20200316,3451
20200314,UI,북한산우이,2112,2095,20200317,4207
20200314,UI,솔밭공원,1279,1206,20200317,2485
20200314,UI,4.19민주묘지,1544,1379,20200317,2923
20200314,UI,가오리,2023,1879,20200317,3902
20200314,UI,화계,1784,1646,20200317,3430
20200314,UI,삼양,1085,1171,20200317,2256
20200314,UI,삼양사거리,1306,1317,20200317,2623
20200314,UI,솔샘,2444,2185,20200317,4629
20200314,UI,북한산보국문,3151,2820,20200317,5971
20200314,UI,정릉,2352,1970,20200317,4322
20200314,UI,성신여대입구,1822,2222,20200317,4044
20200314,UI,보문,789,840,20200317,1629
20200314,UI,신설동,1067,1020,20200317,2087
20200315,UI,북한산우이,2012,2082,20200318,4094
20200315,UI,솔밭공원,855,823,20200318,1678
20200315,UI,4.19민주묘지,1254,1027,20200318,2281
20200315,UI,가오리,1374,1282,20200318,2656
20200315,UI,화계,1231,1145,20200318,2376
20200315,UI,삼양,805,793,20200318,1598
20200315,UI,삼양사거리,948,976,20200318,1924
20200315,UI,솔샘,1680,1472,20200318,3152
20200315,UI,북한산보국문,2316,2076,20200318,4392
20200315,UI,정릉,1612,1344,20200318,2956
20200315,UI,성신여대입구,1269,1555,20200318,2824
20200315,UI,보문,596,684,20200318,1280
20200315,UI,신설동,747,717,20200318,1464
20200316,UI,북한산우이,1964,1763,20200319,3727
20200316,UI,솔밭공원,1801,1742,20200319,3543
20200316,UI,4.19민주묘지,2026,1944,20200319,3970
20200316,UI,가오리,3098,3200,20200319,6298
20200316,UI,화계,2588,2503,20200319,5091
20200316,UI,삼양,1620,1741,20200319,3361
20200316,UI,삼양사거리,1902,1889,20200319,3791
20200316,UI,솔샘,4414,4135,20200319,8549
20200316,UI,북한산보국문,4422,4216,20200319,8638
20200316,UI,정릉,3230,3111,20200319,6341
20200316,UI,성신여대입구,2299,2594,20200319,4893
20200316,UI,보문,1131,1281,20200319,2412
20200316,UI,신설동,1759,1928,20200319,3687
20200317,UI,북한산우이,1792,1523,20200320,3315
20200317,UI,솔밭공원,1839,1754,20200320,3593
20200317,UI,4.19민주묘지,1975,1925,20200320,3900
20200317,UI,가오리,3050,3086,20200320,6136
20200317,UI,화계,2526,2368,20200320,4894
20200317,UI,삼양,1545,1688,20200320,3233
20200317,UI,삼양사거리,1806,1834,20200320,3640
20200317,UI,솔샘,4437,4209,20200320,8646
20200317,UI,북한산보국문,4361,4207,20200320,8568
20200317,UI,정릉,3233,3110,20200320,6343
20200317,UI,성신여대입구,2334,2642,20200320,4976
20200317,UI,보문,1122,1170,20200320,2292
20200317,UI,신설동,1712,1705,20200320,3417
20200318,UI,북한산우이,2145,1928,20200321,4073
20200318,UI,솔밭공원,1881,1872,20200321,3753
20200318,UI,4.19민주묘지,2135,2073,20200321,4208
20200318,UI,가오리,3132,3186,20200321,6318
20200318,UI,화계,2559,2477,20200321,5036
20200318,UI,삼양,1595,1736,20200321,3331
20200318,UI,삼양사거리,1948,2026,20200321,3974
20200318,UI,솔샘,4558,4254,20200321,8812
20200318,UI,북한산보국문,4538,4273,20200321,8811
20200318,UI,정릉,3439,3257,20200321,6696
20200318,UI,성신여대입구,2366,2696,20200321,5062
20200318,UI,보문,1239,1220,20200321,2459
20200318,UI,신설동,1751,1781,20200321,3532
20200319,UI,신설동,1672,1689,20200322,3361
20200319,UI,보문,1118,1174,20200322,2292
20200319,UI,성신여대입구,2183,2477,20200322,4660
20200319,UI,정릉,3160,2980,20200322,6140
20200319,UI,북한산보국문,4168,4068,20200322,8236
20200319,UI,솔샘,4412,4189,20200322,8601
20200319,UI,삼양사거리,1726,1815,20200322,3541
20200319,UI,삼양,1496,1620,20200322,3116
20200319,UI,화계,2485,2364,20200322,4849
20200319,UI,가오리,2927,3002,20200322,5929
20200319,UI,4.19민주묘지,1913,1898,20200322,3811
20200319,UI,솔밭공원,1711,1722,20200322,3433
20200319,UI,북한산우이,1641,1437,20200322,3078
20200320,UI,북한산우이,2100,1868,20200323,3968
20200320,UI,솔밭공원,1904,1801,20200323,3705
20200320,UI,4.19민주묘지,2219,2108,20200323,4327
20200320,UI,가오리,3256,3178,20200323,6434
20200320,UI,화계,2751,2521,20200323,5272
20200320,UI,삼양,1702,1830,20200323,3532
20200320,UI,삼양사거리,1982,2036,20200323,4018
20200320,UI,솔샘,4611,4231,20200323,8842
20200320,UI,북한산보국문,4839,4477,20200323,9316
20200320,UI,정릉,3540,3330,20200323,6870
20200320,UI,성신여대입구,2548,2886,20200323,5434
20200320,UI,보문,1271,1294,20200323,2565
20200320,UI,신설동,1829,1748,20200323,3577
20200321,UI,북한산우이,2297,2367,20200324,4664
20200321,UI,솔밭공원,1294,1226,20200324,2520
20200321,UI,4.19민주묘지,1725,1514,20200324,3239
20200321,UI,가오리,2108,1940,20200324,4048
20200321,UI,화계,1903,1674,20200324,3577
20200321,UI,삼양,1184,1239,20200324,2423
20200321,UI,삼양사거리,1419,1412,20200324,2831
20200321,UI,솔샘,2522,2260,20200324,4782
20200321,UI,북한산보국문,3427,2912,20200324,6339
20200321,UI,정릉,2491,2129,20200324,4620
20200321,UI,성신여대입구,1823,2292,20200324,4115
20200321,UI,보문,870,857,20200324,1727
20200321,UI,신설동,1026,1047,20200324,2073
20200322,UI,북한산우이,2381,2467,20200325,4848
20200322,UI,솔밭공원,963,973,20200325,1936
20200322,UI,4.19민주묘지,1470,1190,20200325,2660
20200322,UI,가오리,1514,1415,20200325,2929
20200322,UI,화계,1406,1258,20200325,2664
20200322,UI,삼양,778,833,20200325,1611
20200322,UI,삼양사거리,1021,1033,20200325,2054
20200322,UI,솔샘,1770,1632,20200325,3402
20200322,UI,북한산보국문,2533,2319,20200325,4852
20200322,UI,정릉,1792,1535,20200325,3327
20200322,UI,성신여대입구,1427,1688,20200325,3115
20200322,UI,보문,699,685,20200325,1384
20200322,UI,신설동,757,825,20200325,1582
20200323,UI,신설동,1744,1750,20200326,3494
20200323,UI,보문,1203,1213,20200326,2416
20200323,UI,성신여대입구,2360,2624,20200326,4984
20200323,UI,정릉,3283,3208,20200326,6491
20200323,UI,북한산보국문,4509,4436,20200326,8945
20200323,UI,솔샘,4599,4373,20200326,8972
20200323,UI,삼양사거리,1956,2028,20200326,3984
20200323,UI,삼양,1662,1798,20200326,3460
20200323,UI,화계,2649,2488,20200326,5137
20200323,UI,가오리,3183,3170,20200326,6353
20200323,UI,4.19민주묘지,2078,2090,20200326,4168
20200323,UI,솔밭공원,1879,1885,20200326,3764
20200323,UI,북한산우이,2039,1887,20200326,3926
20200324,UI,북한산우이,2327,2199,20200327,4526
20200324,UI,솔밭공원,1881,1890,20200327,3771
20200324,UI,4.19민주묘지,2177,2055,20200327,4232
20200324,UI,가오리,3106,3190,20200327,6296
20200324,UI,화계,2658,2569,20200327,5227
20200324,UI,삼양,1607,1739,20200327,3346
20200324,UI,삼양사거리,1917,1953,20200327,3870
20200324,UI,솔샘,4583,4358,20200327,8941
20200324,UI,북한산보국문,4422,4294,20200327,8716
20200324,UI,정릉,3365,3311,20200327,6676
20200324,UI,성신여대입구,2327,2613,20200327,4940
20200324,UI,보문,1208,1237,20200327,2445
20200324,UI,신설동,1802,1752,20200327,3554
20200325,UI,북한산우이,2178,2047,20200328,4225
20200325,UI,솔밭공원,1900,1869,20200328,3769
20200325,UI,4.19민주묘지,2272,2223,20200328,4495
20200325,UI,가오리,3292,3233,20200328,6525
20200325,UI,화계,2721,2593,20200328,5314
20200325,UI,삼양,1637,1778,20200328,3415
20200325,UI,삼양사거리,1957,1996,20200328,3953
20200325,UI,솔샘,4687,4371,20200328,9058
20200325,UI,북한산보국문,4623,4449,20200328,9072
20200325,UI,정릉,3524,3342,20200328,6866
20200325,UI,성신여대입구,2442,2793,20200328,5235
20200325,UI,보문,1206,1222,20200328,2428
20200325,UI,신설동,1876,1862,20200328,3738
20200326,UI,정릉,3396,3183,20200329,6579
20200326,UI,성신여대입구,2354,2720,20200329,5074
20200326,UI,보문,1237,1299,20200329,2536
20200326,UI,신설동,1819,1761,20200329,3580
20200326,UI,북한산우이,2013,1867,20200329,3880
20200326,UI,솔밭공원,1901,1870,20200329,3771
20200326,UI,4.19민주묘지,2114,2117,20200329,4231
20200326,UI,가오리,3079,3191,20200329,6270
20200326,UI,화계,2641,2575,20200329,5216
20200326,UI,삼양,1631,1752,20200329,3383
20200326,UI,삼양사거리,1847,1950,20200329,3797
20200326,UI,솔샘,4602,4257,20200329,8859
20200326,UI,북한산보국문,4449,4426,20200329,8875
20200327,UI,북한산우이,1909,1709,20200330,3618
20200327,UI,솔밭공원,1944,1826,20200330,3770
20200327,UI,4.19민주묘지,2098,2096,20200330,4194
20200327,UI,가오리,3243,3204,20200330,6447
20200327,UI,화계,2699,2515,20200330,5214
20200327,UI,삼양,1595,1788,20200330,3383
20200327,UI,삼양사거리,1971,2016,20200330,3987
20200327,UI,솔샘,4690,4304,20200330,8994
20200327,UI,북한산보국문,4583,4295,20200330,8878
20200327,UI,정릉,3552,3227,20200330,6779
20200327,UI,성신여대입구,2524,2905,20200330,5429
20200327,UI,보문,1246,1273,20200330,2519
20200327,UI,신설동,1756,1744,20200330,3500
20200328,UI,북한산우이,2565,2665,20200331,5230
20200328,UI,솔밭공원,1359,1243,20200331,2602
20200328,UI,4.19민주묘지,1810,1509,20200331,3319
20200328,UI,가오리,2109,2055,20200331,4164
20200328,UI,화계,1904,1679,20200331,3583
20200328,UI,삼양,1202,1238,20200331,2440
20200328,UI,삼양사거리,1475,1472,20200331,2947
20200328,UI,솔샘,2677,2398,20200331,5075
20200328,UI,북한산보국문,3438,3187,20200331,6625
20200328,UI,정릉,2548,2155,20200331,4703
20200328,UI,성신여대입구,1941,2305,20200331,4246
20200328,UI,보문,914,920,20200331,1834
20200328,UI,신설동,1120,1056,20200331,2176
20200329,UI,북한산우이,2446,2555,20200401,5001
20200329,UI,솔밭공원,1005,921,20200401,1926
20200329,UI,4.19민주묘지,1526,1253,20200401,2779
20200329,UI,가오리,1648,1419,20200401,3067
20200329,UI,화계,1395,1267,20200401,2662
20200329,UI,삼양,808,864,20200401,1672
20200329,UI,삼양사거리,1046,1016,20200401,2062
20200329,UI,솔샘,1825,1703,20200401,3528
20200329,UI,북한산보국문,2615,2368,20200401,4983
20200329,UI,정릉,1800,1520,20200401,3320
20200329,UI,성신여대입구,1393,1694,20200401,3087
20200329,UI,보문,627,667,20200401,1294
20200329,UI,신설동,835,845,20200401,1680
20200330,UI,북한산우이,2090,1943,20200402,4033
20200330,UI,솔밭공원,1951,1895,20200402,3846
20200330,UI,4.19민주묘지,2233,2148,20200402,4381
20200330,UI,가오리,3174,3230,20200402,6404
20200330,UI,화계,2655,2566,20200402,5221
20200330,UI,삼양,1680,1809,20200402,3489
20200330,UI,삼양사거리,1938,2021,20200402,3959
20200330,UI,솔샘,4585,4426,20200402,9011
20200330,UI,북한산보국문,4557,4422,20200402,8979
20200330,UI,정릉,3448,3354,20200402,6802
20200330,UI,성신여대입구,2350,2642,20200402,4992
20200330,UI,보문,1196,1190,20200402,2386
20200330,UI,신설동,1818,1750,20200402,3568
20200331,UI,신설동,1816,1795,20200403,3611
20200331,UI,보문,1184,1218,20200403,2402
20200331,UI,성신여대입구,2485,2648,20200403,5133
20200331,UI,정릉,3514,3286,20200403,6800
20200331,UI,북한산보국문,4479,4363,20200403,8842
20200331,UI,솔샘,4628,4390,20200403,9018
20200331,UI,삼양사거리,1889,1985,20200403,3874
20200331,UI,삼양,1633,1699,20200403,3332
20200331,UI,화계,2676,2547,20200403,5223
20200331,UI,가오리,3296,3205,20200403,6501
20200331,UI,4.19민주묘지,2244,2186,20200403,4430
20200331,UI,솔밭공원,1848,1865,20200403,3713
20200331,UI,북한산우이,2192,2047,20200403,4239
20200401,UI,북한산우이,2137,1965,20200404,4102
20200401,UI,솔밭공원,1840,1811,20200404,3651
20200401,UI,4.19민주묘지,2279,2216,20200404,4495
20200401,UI,가오리,3312,3301,20200404,6613
20200401,UI,화계,2672,2539,20200404,5211
20200401,UI,삼양,1602,1738,20200404,3340
20200401,UI,삼양사거리,1916,1998,20200404,3914
20200401,UI,솔샘,4687,4391,20200404,9078
20200401,UI,북한산보국문,4630,4358,20200404,8988
20200401,UI,정릉,3540,3296,20200404,6836
20200401,UI,성신여대입구,2412,2718,20200404,5130
20200401,UI,보문,1234,1229,20200404,2463
20200401,UI,신설동,1808,1755,20200404,3563
20200402,UI,신설동,1776,1821,20200405,3597
20200402,UI,보문,1200,1252,20200405,2452
20200402,UI,성신여대입구,2374,2700,20200405,5074
20200402,UI,정릉,3487,3236,20200405,6723
20200402,UI,북한산보국문,4525,4360,20200405,8885
20200402,UI,솔샘,4677,4414,20200405,9091
20200402,UI,삼양사거리,1929,1985,20200405,3914
20200402,UI,삼양,1646,1779,20200405,3425
20200402,UI,화계,2623,2532,20200405,5155
20200402,UI,가오리,3249,3169,20200405,6418
20200402,UI,4.19민주묘지,2279,2186,20200405,4465
20200402,UI,솔밭공원,1922,1888,20200405,3810
20200402,UI,북한산우이,2134,2053,20200405,4187
20200403,UI,북한산우이,2163,1903,20200406,4066
20200403,UI,솔밭공원,1947,1854,20200406,3801
20200403,UI,4.19민주묘지,2266,2180,20200406,4446
20200403,UI,가오리,3297,3262,20200406,6559
20200403,UI,화계,2749,2514,20200406,5263
20200403,UI,삼양,1744,1811,20200406,3555
20200403,UI,삼양사거리,2035,2007,20200406,4042
20200403,UI,솔샘,4777,4322,20200406,9099
20200403,UI,북한산보국문,4786,4360,20200406,9146
20200403,UI,정릉,3626,3238,20200406,6864
20200403,UI,성신여대입구,2484,2896,20200406,5380
20200403,UI,보문,1268,1241,20200406,2509
20200403,UI,신설동,1834,1848,20200406,3682
20200404,UI,신설동,1057,1049,20200407,2106
20200404,UI,보문,923,971,20200407,1894
20200404,UI,성신여대입구,2048,2430,20200407,4478
20200404,UI,정릉,2555,2257,20200407,4812
20200404,UI,북한산보국문,3542,3184,20200407,6726
20200404,UI,솔샘,2711,2467,20200407,5178
20200404,UI,삼양사거리,1404,1408,20200407,2812
20200404,UI,삼양,1207,1288,20200407,2495
20200404,UI,화계,1863,1692,20200407,3555
20200404,UI,가오리,2262,2023,20200407,4285
20200404,UI,4.19민주묘지,1782,1587,20200407,3369
20200404,UI,솔밭공원,1365,1267,20200407,2632
20200404,UI,북한산우이,2788,3016,20200407,5804
20200405,UI,북한산우이,2405,2681,20200408,5086
20200405,UI,솔밭공원,985,978,20200408,1963
20200405,UI,4.19민주묘지,1486,1198,20200408,2684
20200405,UI,가오리,1680,1510,20200408,3190
20200405,UI,화계,1350,1228,20200408,2578
20200405,UI,삼양,872,906,20200408,1778
20200405,UI,삼양사거리,1143,1096,20200408,2239
20200405,UI,솔샘,1894,1735,20200408,3629
20200405,UI,북한산보국문,2588,2380,20200408,4968
20200405,UI,정릉,1800,1560,20200408,3360
20200405,UI,성신여대입구,1450,1667,20200408,3117
20200405,UI,보문,634,681,20200408,1315
20200405,UI,신설동,852,845,20200408,1697
20200406,UI,북한산우이,2048,1955,20200409,4003
20200406,UI,솔밭공원,1923,1939,20200409,3862
20200406,UI,4.19민주묘지,2269,2244,20200409,4513
20200406,UI,가오리,3372,3379,20200409,6751
20200406,UI,화계,2608,2552,20200409,5160
20200406,UI,삼양,1722,1873,20200409,3595
20200406,UI,삼양사거리,2028,2065,20200409,4093
20200406,UI,솔샘,4724,4496,20200409,9220
20200406,UI,북한산보국문,4604,4450,20200409,9054
20200406,UI,정릉,3546,3451,20200409,6997
20200406,UI,성신여대입구,2486,2779,20200409,5265
20200406,UI,보문,1270,1300,20200409,2570
20200406,UI,신설동,1786,1790,20200409,3576
20200407,UI,북한산우이,2256,2072,20200410,4328
20200407,UI,솔밭공원,1956,1870,20200410,3826
20200407,UI,4.19민주묘지,2343,2251,20200410,4594
20200407,UI,가오리,3362,3348,20200410,6710
20200407,UI,화계,2736,2640,20200410,5376
20200407,UI,삼양,1644,1847,20200410,3491
20200407,UI,삼양사거리,2000,2068,20200410,4068
20200407,UI,솔샘,4875,4568,20200410,9443
20200407,UI,북한산보국문,4639,4507,20200410,9146
20200407,UI,정릉,3638,3425,20200410,7063
20200407,UI,성신여대입구,2472,2844,20200410,5316
20200407,UI,보문,1233,1305,20200410,2538
20200407,UI,신설동,1863,1860,20200410,3723
20200408,UI,신설동,1825,1835,20200411,3660
20200408,UI,보문,1237,1261,20200411,2498
20200408,UI,성신여대입구,2499,2906,20200411,5405
20200408,UI,정릉,3639,3471,20200411,7110
20200408,UI,북한산보국문,4818,4586,20200411,9404
20200408,UI,솔샘,4805,4499,20200411,9304
20200408,UI,삼양사거리,2027,2033,20200411,4060
20200408,UI,삼양,1715,1936,20200411,3651
20200408,UI,화계,2791,2652,20200411,5443
20200408,UI,가오리,3378,3431,20200411,6809
20200408,UI,4.19민주묘지,2195,2185,20200411,4380
20200408,UI,솔밭공원,1938,1900,20200411,3838
20200408,UI,북한산우이,2283,2074,20200411,4357
20200409,UI,북한산우이,2224,2071,20200412,4295
20200409,UI,솔밭공원,1976,1886,20200412,3862
20200409,UI,4.19민주묘지,2258,2182,20200412,4440
20200409,UI,가오리,3276,3283,20200412,6559
20200409,UI,화계,2694,2563,20200412,5257
20200409,UI,삼양,1746,1907,20200412,3653
20200409,UI,삼양사거리,2059,2097,20200412,4156
20200409,UI,솔샘,4743,4444,20200412,9187
20200409,UI,북한산보국문,4649,4595,20200412,9244
20200409,UI,정릉,3558,3431,20200412,6989
20200409,UI,성신여대입구,2536,2754,20200412,5290
20200409,UI,보문,1230,1304,20200412,2534
20200409,UI,신설동,1804,1826,20200412,3630
20200410,UI,북한산우이,2225,1961,20200413,4186
20200410,UI,솔밭공원,1966,1901,20200413,3867
20200410,UI,4.19민주묘지,2442,2351,20200413,4793
20200410,UI,가오리,3422,3345,20200413,6767
20200410,UI,화계,2844,2660,20200413,5504
20200410,UI,삼양,1856,1966,20200413,3822
20200410,UI,삼양사거리,2031,2083,20200413,4114
20200410,UI,솔샘,4798,4342,20200413,9140
20200410,UI,북한산보국문,4916,4521,20200413,9437
20200410,UI,정릉,3834,3439,20200413,7273
20200410,UI,성신여대입구,2669,3040,20200413,5709
20200410,UI,보문,1309,1308,20200413,2617
20200410,UI,신설동,1757,1803,20200413,3560
20200411,UI,북한산우이,2747,3013,20200414,5760
20200411,UI,솔밭공원,1392,1278,20200414,2670
20200411,UI,4.19민주묘지,2026,1713,20200414,3739
20200411,UI,가오리,2349,2186,20200414,4535
20200411,UI,화계,1845,1806,20200414,3651
20200411,UI,삼양,1369,1408,20200414,2777
20200411,UI,삼양사거리,1464,1491,20200414,2955
20200411,UI,솔샘,2821,2532,20200414,5353
20200411,UI,북한산보국문,3669,3349,20200414,7018
20200411,UI,정릉,2777,2256,20200414,5033
20200411,UI,성신여대입구,2092,2467,20200414,4559
20200411,UI,보문,969,941,20200414,1910
20200411,UI,신설동,1125,1083,20200414,2208
20200412,UI,북한산우이,2384,2692,20200415,5076
20200412,UI,솔밭공원,1029,968,20200415,1997
20200412,UI,4.19민주묘지,1449,1219,20200415,2668
20200412,UI,가오리,1699,1486,20200415,3185
20200412,UI,화계,1443,1318,20200415,2761
20200412,UI,삼양,841,950,20200415,1791
20200412,UI,삼양사거리,1098,1077,20200415,2175
20200412,UI,솔샘,1986,1845,20200415,3831
20200412,UI,북한산보국문,2795,2477,20200415,5272
20200412,UI,정릉,1916,1603,20200415,3519
20200412,UI,성신여대입구,1512,1794,20200415,3306
20200412,UI,보문,665,716,20200415,1381
20200412,UI,신설동,843,801,20200415,1644
20200413,UI,북한산우이,2106,1995,20200416,4101
20200413,UI,솔밭공원,1957,1861,20200416,3818
20200413,UI,4.19민주묘지,2275,2145,20200416,4420
20200413,UI,가오리,3410,3455,20200416,6865
20200413,UI,화계,2775,2693,20200416,5468
20200413,UI,삼양,1773,1932,20200416,3705
20200413,UI,삼양사거리,2154,2167,20200416,4321
20200413,UI,솔샘,4829,4540,20200416,9369
20200413,UI,북한산보국문,4772,4628,20200416,9400
20200413,UI,정릉,3635,3395,20200416,7030
20200413,UI,성신여대입구,2501,2875,20200416,5376
20200413,UI,보문,1225,1223,20200416,2448
20200413,UI,신설동,1861,1842,20200416,3703
20200414,UI,신설동,1956,2175,20200417,4131
20200414,UI,보문,1306,1316,20200417,2622
20200414,UI,성신여대입구,2548,3030,20200417,5578
20200414,UI,정릉,3795,3407,20200417,7202
20200414,UI,북한산보국문,4984,4484,20200417,9468
20200414,UI,솔샘,4954,4420,20200417,9374
20200414,UI,삼양사거리,2036,2031,20200417,4067
20200414,UI,삼양,1713,1786,20200417,3499
20200414,UI,화계,2883,2639,20200417,5522
20200414,UI,가오리,3488,3356,20200417,6844
20200414,UI,4.19민주묘지,2349,2205,20200417,4554
20200414,UI,솔밭공원,1984,1907,20200417,3891
20200414,UI,북한산우이,2237,2026,20200417,4263
20200415,UI,보문,913,835,20200418,1748
20200415,UI,북한산우이,2489,2542,20200418,5031
20200415,UI,솔밭공원,1265,1235,20200418,2500
20200415,UI,4.19민주묘지,1787,1578,20200418,3365
20200415,UI,가오리,2202,2020,20200418,4222
20200415,UI,화계,1895,1796,20200418,3691
20200415,UI,삼양,1217,1274,20200418,2491
20200415,UI,삼양사거리,1539,1503,20200418,3042
20200415,UI,솔샘,2600,2392,20200418,4992
20200415,UI,북한산보국문,3287,3031,20200418,6318
20200415,UI,정릉,2556,2193,20200418,4749
20200415,UI,성신여대입구,1876,2338,20200418,4214
20200415,UI,신설동,1076,1076,20200418,2152
20200416,UI,북한산우이,2264,2151,20200419,4415
20200416,UI,솔밭공원,2051,1978,20200419,4029
20200416,UI,4.19민주묘지,2504,2419,20200419,4923
20200416,UI,가오리,3473,3358,20200419,6831
20200416,UI,화계,2851,2609,20200419,5460
20200416,UI,삼양,1758,1952,20200419,3710
20200416,UI,삼양사거리,2177,2195,20200419,4372
20200416,UI,솔샘,4936,4588,20200419,9524
20200416,UI,북한산보국문,4766,4726,20200419,9492
20200416,UI,정릉,3803,3497,20200419,7300
20200416,UI,성신여대입구,2536,2920,20200419,5456
20200416,UI,보문,1291,1276,20200419,2567
20200416,UI,신설동,1914,1908,20200419,3822
20200417,UI,북한산우이,1775,1491,20200420,3266
20200417,UI,솔밭공원,1842,1720,20200420,3562
20200417,UI,4.19민주묘지,2099,2067,20200420,4166
20200417,UI,가오리,3243,3164,20200420,6407
20200417,UI,화계,2726,2401,20200420,5127
20200417,UI,삼양,1683,1804,20200420,3487
20200417,UI,삼양사거리,1941,2029,20200420,3970
20200417,UI,솔샘,4802,4314,20200420,9116
20200417,UI,북한산보국문,4695,4334,20200420,9029
20200417,UI,정릉,3642,3315,20200420,6957
20200417,UI,성신여대입구,2416,2892,20200420,5308
20200417,UI,보문,1293,1283,20200420,2576
20200417,UI,신설동,1735,1778,20200420,3513
20200418,UI,북한산우이,3181,3209,20200421,6390
20200418,UI,솔밭공원,1431,1417,20200421,2848
20200418,UI,4.19민주묘지,2100,1896,20200421,3996
20200418,UI,가오리,2484,2216,20200421,4700
20200418,UI,화계,2096,1912,20200421,4008
20200418,UI,삼양,1305,1441,20200421,2746
20200418,UI,삼양사거리,1669,1644,20200421,3313
20200418,UI,솔샘,3038,2723,20200421,5761
20200418,UI,북한산보국문,3891,3458,20200421,7349
20200418,UI,정릉,3059,2483,20200421,5542
20200418,UI,성신여대입구,2184,2632,20200421,4816
20200418,UI,보문,1021,1022,20200421,2043
20200418,UI,신설동,1245,1204,20200421,2449
20200419,UI,북한산우이,2522,2679,20200422,5201
20200419,UI,솔밭공원,1069,976,20200422,2045
20200419,UI,4.19민주묘지,1613,1503,20200422,3116
20200419,UI,가오리,1723,1558,20200422,3281
20200419,UI,화계,1508,1316,20200422,2824
20200419,UI,삼양,905,954,20200422,1859
20200419,UI,삼양사거리,1179,1120,20200422,2299
20200419,UI,솔샘,1945,1787,20200422,3732
20200419,UI,북한산보국문,2582,2416,20200422,4998
20200419,UI,정릉,1798,1627,20200422,3425
20200419,UI,성신여대입구,1554,1723,20200422,3277
20200419,UI,보문,721,734,20200422,1455
20200419,UI,신설동,766,824,20200422,1590
20200420,UI,북한산우이,2018,1829,20200423,3847
20200420,UI,솔밭공원,1963,1952,20200423,3915
20200420,UI,4.19민주묘지,2337,2314,20200423,4651
20200420,UI,가오리,3414,3337,20200423,6751
20200420,UI,화계,2798,2674,20200423,5472
20200420,UI,삼양,1796,1980,20200423,3776
20200420,UI,삼양사거리,2143,2221,20200423,4364
20200420,UI,솔샘,4959,4667,20200423,9626
20200420,UI,북한산보국문,4798,4672,20200423,9470
20200420,UI,정릉,3628,3587,20200423,7215
20200420,UI,성신여대입구,2552,2832,20200423,5384
20200420,UI,보문,1291,1332,20200423,2623
20200420,UI,신설동,1879,1892,20200423,3771
20200421,UI,북한산우이,2346,2078,20200424,4424
20200421,UI,솔밭공원,2045,1986,20200424,4031
20200421,UI,4.19민주묘지,2402,2373,20200424,4775
20200421,UI,가오리,3569,3491,20200424,7060
20200421,UI,화계,2848,2742,20200424,5590
20200421,UI,삼양,1798,2063,20200424,3861
20200421,UI,삼양사거리,2139,2191,20200424,4330
20200421,UI,솔샘,5098,4799,20200424,9897
20200421,UI,북한산보국문,4941,4780,20200424,9721
20200421,UI,정릉,3780,3693,20200424,7473
20200421,UI,성신여대입구,2562,3036,20200424,5598
20200421,UI,보문,1276,1312,20200424,2588
20200421,UI,신설동,1973,1951,20200424,3924
20200422,UI,북한산우이,2084,1937,20200425,4021
20200422,UI,솔밭공원,1875,1831,20200425,3706
20200422,UI,4.19민주묘지,2253,2212,20200425,4465
20200422,UI,가오리,3450,3488,20200425,6938
20200422,UI,화계,2777,2606,20200425,5383
20200422,UI,삼양,1765,1951,20200425,3716
20200422,UI,삼양사거리,2057,2148,20200425,4205
20200422,UI,솔샘,4993,4613,20200425,9606
20200422,UI,북한산보국문,4818,4704,20200425,9522
20200422,UI,정릉,3751,3597,20200425,7348
20200422,UI,성신여대입구,2534,2883,20200425,5417
20200422,UI,보문,1316,1346,20200425,2662
20200422,UI,신설동,1824,1859,20200425,3683
20200423,UI,북한산우이,2768,2493,20200426,5261
20200423,UI,솔밭공원,2020,2012,20200426,4032
20200423,UI,4.19민주묘지,2441,2295,20200426,4736
20200423,UI,가오리,3516,3540,20200426,7056
20200423,UI,화계,2789,2655,20200426,5444
20200423,UI,삼양,1832,1974,20200426,3806
20200423,UI,삼양사거리,2057,2114,20200426,4171
20200423,UI,솔샘,5188,4703,20200426,9891
20200423,UI,북한산보국문,5062,4778,20200426,9840
20200423,UI,정릉,3826,3638,20200426,7464
20200423,UI,성신여대입구,2716,3111,20200426,5827
20200423,UI,보문,1374,1391,20200426,2765
20200423,UI,신설동,1941,1993,20200426,3934
20200424,UI,북한산우이,2464,2193,20200427,4657
20200424,UI,솔밭공원,2179,2037,20200427,4216
20200424,UI,4.19민주묘지,2494,2444,20200427,4938
20200424,UI,가오리,3617,3488,20200427,7105
20200424,UI,화계,3008,2751,20200427,5759
20200424,UI,삼양,1867,1927,20200427,3794
20200424,UI,삼양사거리,2241,2195,20200427,4436
20200424,UI,솔샘,5222,4672,20200427,9894
20200424,UI,북한산보국문,5303,4906,20200427,10209
20200424,UI,정릉,4069,3637,20200427,7706
20200424,UI,성신여대입구,2819,3330,20200427,6149
20200424,UI,보문,1305,1398,20200427,2703
20200424,UI,신설동,1968,1971,20200427,3939
20200425,UI,북한산우이,3400,3613,20200428,7013
20200425,UI,솔밭공원,1554,1385,20200428,2939
20200425,UI,4.19민주묘지,2010,1827,20200428,3837
20200425,UI,가오리,2463,2284,20200428,4747
20200425,UI,화계,2115,1962,20200428,4077
20200425,UI,삼양,1367,1426,20200428,2793
20200425,UI,삼양사거리,1688,1726,20200428,3414
20200425,UI,솔샘,3215,2800,20200428,6015
20200425,UI,북한산보국문,4050,3667,20200428,7717
20200425,UI,정릉,3082,2581,20200428,5663
20200425,UI,성신여대입구,2325,2852,20200428,5177
20200425,UI,보문,1021,1003,20200428,2024
20200425,UI,신설동,1291,1302,20200428,2593
20200426,UI,북한산우이,3318,3581,20200429,6899
20200426,UI,솔밭공원,1237,1232,20200429,2469
20200426,UI,4.19민주묘지,1799,1438,20200429,3237
20200426,UI,가오리,2010,1754,20200429,3764
20200426,UI,화계,1744,1566,20200429,3310
20200426,UI,삼양,1012,1083,20200429,2095
20200426,UI,삼양사거리,1404,1380,20200429,2784
20200426,UI,솔샘,2209,2069,20200429,4278
20200426,UI,북한산보국문,3091,2945,20200429,6036
20200426,UI,정릉,2196,1918,20200429,4114
20200426,UI,성신여대입구,1807,2086,20200429,3893
20200426,UI,보문,807,819,20200429,1626
20200426,UI,신설동,977,971,20200429,1948
20200427,UI,북한산우이,2461,2216,20200430,4677
20200427,UI,솔밭공원,2058,2024,20200430,4082
20200427,UI,4.19민주묘지,2491,2390,20200430,4881
20200427,UI,가오리,3672,3571,20200430,7243
20200427,UI,화계,2921,2720,20200430,5641
20200427,UI,삼양,1839,2032,20200430,3871
20200427,UI,삼양사거리,2243,2243,20200430,4486
20200427,UI,솔샘,5072,4772,20200430,9844
20200427,UI,북한산보국문,5056,4809,20200430,9865
20200427,UI,정릉,3900,3701,20200430,7601
20200427,UI,성신여대입구,2656,3081,20200430,5737
20200427,UI,보문,1389,1350,20200430,2739
20200427,UI,신설동,2000,1953,20200430,3953
20200428,UI,북한산우이,2583,2391,20200501,4974
20200428,UI,솔밭공원,2148,2070,20200501,4218
20200428,UI,4.19민주묘지,2457,2395,20200501,4852
20200428,UI,가오리,3609,3499,20200501,7108
20200428,UI,화계,2944,2743,20200501,5687
20200428,UI,삼양,1815,2049,20200501,3864
20200428,UI,삼양사거리,2235,2210,20200501,4445
20200428,UI,솔샘,5174,4837,20200501,10011
20200428,UI,북한산보국문,5093,4904,20200501,9997
20200428,UI,정릉,4036,3807,20200501,7843
20200428,UI,성신여대입구,2665,3121,20200501,5786
20200428,UI,보문,1316,1401,20200501,2717
20200428,UI,신설동,2027,1958,20200501,3985
20200429,UI,북한산우이,2778,2584,20200502,5362
20200429,UI,솔밭공원,2177,2079,20200502,4256
20200429,UI,4.19민주묘지,2639,2553,20200502,5192
20200429,UI,가오리,3747,3642,20200502,7389
20200429,UI,화계,3036,2821,20200502,5857
20200429,UI,삼양,2018,2143,20200502,4161
20200429,UI,삼양사거리,2338,2345,20200502,4683
20200429,UI,솔샘,5331,4903,20200502,10234
20200429,UI,북한산보국문,5326,4982,20200502,10308
20200429,UI,정릉,4181,3915,20200502,8096
20200429,UI,성신여대입구,2838,3337,20200502,6175
20200429,UI,보문,1430,1420,20200502,2850
20200429,UI,신설동,1994,2040,20200502,4034
20200430,UI,북한산우이,5032,5183,20200503,10215
20200430,UI,솔밭공원,1513,1425,20200503,2938
20200430,UI,4.19민주묘지,2310,1844,20200503,4154
20200430,UI,가오리,2532,2348,20200503,4880
20200430,UI,화계,2575,2199,20200503,4774
20200430,UI,삼양,1344,1360,20200503,2704
20200430,UI,삼양사거리,1660,1619,20200503,3279
20200430,UI,솔샘,2980,2590,20200503,5570
20200430,UI,북한산보국문,3798,3353,20200503,7151
20200430,UI,정릉,2855,2427,20200503,5282
20200430,UI,성신여대입구,2058,2391,20200503,4449
20200430,UI,보문,1019,981,20200503,2000
20200430,UI,신설동,1238,1212,20200503,2450
20200501,UI,신설동,1277,1297,20200504,2574
20200501,UI,보문,1069,1020,20200504,2089
20200501,UI,성신여대입구,2228,2700,20200504,4928
20200501,UI,정릉,3057,2537,20200504,5594
20200501,UI,북한산보국문,3981,3486,20200504,7467
20200501,UI,솔샘,3243,2885,20200504,6128
20200501,UI,삼양사거리,1743,1703,20200504,3446
20200501,UI,삼양,1459,1530,20200504,2989
20200501,UI,화계,2171,1922,20200504,4093
20200501,UI,가오리,2676,2441,20200504,5117
20200501,UI,4.19민주묘지,2067,1884,20200504,3951
20200501,UI,솔밭공원,1641,1459,20200504,3100
20200501,UI,북한산우이,2685,2606,20200504,5291
20200502,UI,북한산우이,2656,2828,20200505,5484
20200502,UI,솔밭공원,1456,1364,20200505,2820
20200502,UI,4.19민주묘지,1963,1744,20200505,3707
20200502,UI,가오리,2321,2122,20200505,4443
20200502,UI,화계,2074,1823,20200505,3897
20200502,UI,삼양,1233,1335,20200505,2568
20200502,UI,삼양사거리,1580,1531,20200505,3111
20200502,UI,솔샘,2988,2657,20200505,5645
20200502,UI,북한산보국문,3572,3211,20200505,6783
20200502,UI,정릉,2949,2407,20200505,5356
20200502,UI,성신여대입구,2194,2606,20200505,4800
20200502,UI,보문,949,944,20200505,1893
20200502,UI,신설동,1200,1169,20200505,2369
20200503,UI,신설동,987,961,20200506,1948
20200503,UI,보문,801,795,20200506,1596
20200503,UI,성신여대입구,1682,2057,20200506,3739
20200503,UI,정릉,2221,1951,20200506,4172
20200503,UI,북한산보국문,3134,2822,20200506,5956
20200503,UI,솔샘,2344,2095,20200506,4439
20200503,UI,삼양사거리,1315,1295,20200506,2610
20200503,UI,삼양,1086,1124,20200506,2210
20200503,UI,화계,1659,1536,20200506,3195
20200503,UI,가오리,2002,1885,20200506,3887
20200503,UI,4.19민주묘지,1702,1451,20200506,3153
20200503,UI,솔밭공원,1202,1169,20200506,2371
20200503,UI,북한산우이,2419,2437,20200506,4856
20200504,UI,신설동,1917,1840,20200507,3757
20200504,UI,보문,1328,1309,20200507,2637
20200504,UI,성신여대입구,2653,3135,20200507,5788
20200504,UI,정릉,3686,3423,20200507,7109
20200504,UI,북한산보국문,4796,4565,20200507,9361
20200504,UI,솔샘,4572,4141,20200507,8713
20200504,UI,삼양사거리,2161,2140,20200507,4301
20200504,UI,삼양,1764,1906,20200507,3670
20200504,UI,화계,2801,2582,20200507,5383
20200504,UI,가오리,3432,3322,20200507,6754
20200504,UI,4.19민주묘지,2493,2331,20200507,4824
20200504,UI,솔밭공원,2006,1885,20200507,3891
20200504,UI,북한산우이,2409,2281,20200507,4690
20200505,UI,신설동,1109,1035,20200508,2144
20200505,UI,보문,844,820,20200508,1664
20200505,UI,성신여대입구,1929,2300,20200508,4229
20200505,UI,정릉,2532,2121,20200508,4653
20200505,UI,북한산보국문,3285,2986,20200508,6271
20200505,UI,솔샘,2583,2356,20200508,4939
20200505,UI,삼양사거리,1466,1443,20200508,2909
20200505,UI,삼양,1195,1257,20200508,2452
20200505,UI,화계,1844,1761,20200508,3605
20200505,UI,가오리,2211,2053,20200508,4264
20200505,UI,4.19민주묘지,1734,1611,20200508,3345
20200505,UI,솔밭공원,1353,1277,20200508,2630
20200505,UI,북한산우이,2552,2583,20200508,5135
20200506,UI,북한산우이,2467,2287,20200509,4754
20200506,UI,솔밭공원,2204,2117,20200509,4321
20200506,UI,4.19민주묘지,2696,2600,20200509,5296
20200506,UI,가오리,3755,3731,20200509,7486
20200506,UI,화계,3104,2913,20200509,6017
20200506,UI,삼양,1975,2092,20200509,4067
20200506,UI,삼양사거리,2273,2363,20200509,4636
20200506,UI,솔샘,5415,5063,20200509,10478
20200506,UI,북한산보국문,5304,5161,20200509,10465
20200506,UI,정릉,4159,3844,20200509,8003
20200506,UI,성신여대입구,2837,3272,20200509,6109
20200506,UI,보문,1385,1443,20200509,2828
20200506,UI,신설동,2071,2045,20200509,4116
20200507,UI,북한산우이,2645,2406,20200510,5051
20200507,UI,솔밭공원,2285,2155,20200510,4440
20200507,UI,4.19민주묘지,2660,2626,20200510,5286
20200507,UI,가오리,3845,3803,20200510,7648
20200507,UI,화계,3041,2833,20200510,5874
20200507,UI,삼양,2120,2179,20200510,4299
20200507,UI,삼양사거리,2317,2326,20200510,4643
20200507,UI,솔샘,5510,5069,20200510,10579
20200507,UI,북한산보국문,5483,5115,20200510,10598
20200507,UI,정릉,4230,3986,20200510,8216
20200507,UI,성신여대입구,2846,3368,20200510,6214
20200507,UI,보문,1381,1460,20200510,2841
20200507,UI,신설동,2070,2077,20200510,4147
20200508,UI,북한산우이,2516,2258,20200511,4774
20200508,UI,솔밭공원,2302,2272,20200511,4574
20200508,UI,4.19민주묘지,2720,2693,20200511,5413
20200508,UI,가오리,3886,4008,20200511,7894
20200508,UI,화계,3184,2934,20200511,6118
20200508,UI,삼양,2141,2370,20200511,4511
20200508,UI,삼양사거리,2422,2480,20200511,4902
20200508,UI,솔샘,5506,5099,20200511,10605
20200508,UI,북한산보국문,5657,5489,20200511,11146
20200508,UI,정릉,4379,4113,20200511,8492
20200508,UI,성신여대입구,3057,3517,20200511,6574
20200508,UI,보문,1494,1429,20200511,2923
20200508,UI,신설동,2093,2069,20200511,4162
20200509,UI,북한산우이,1552,1583,20200512,3135
20200509,UI,솔밭공원,1308,1219,20200512,2527
20200509,UI,4.19민주묘지,1547,1514,20200512,3061
20200509,UI,가오리,2289,2132,20200512,4421
20200509,UI,화계,1884,1669,20200512,3553
20200509,UI,삼양,1365,1418,20200512,2783
20200509,UI,삼양사거리,1507,1447,20200512,2954
20200509,UI,솔샘,2940,2517,20200512,5457
20200509,UI,북한산보국문,3455,3111,20200512,6566
20200509,UI,정릉,2649,2225,20200512,4874
20200509,UI,성신여대입구,2007,2515,20200512,4522
20200509,UI,보문,952,895,20200512,1847
20200509,UI,신설동,991,932,20200512,1923
20200510,UI,북한산우이,2808,2869,20200513,5677
20200510,UI,솔밭공원,1307,1216,20200513,2523
20200510,UI,4.19민주묘지,1839,1629,20200513,3468
20200510,UI,가오리,2053,1974,20200513,4027
20200510,UI,화계,1806,1624,20200513,3430
20200510,UI,삼양,1095,1124,20200513,2219
20200510,UI,삼양사거리,1381,1381,20200513,2762
20200510,UI,솔샘,2360,2175,20200513,4535
20200510,UI,북한산보국문,3154,2864,20200513,6018
20200510,UI,정릉,2295,1975,20200513,4270
20200510,UI,성신여대입구,1796,2148,20200513,3944
20200510,UI,보문,816,862,20200513,1678
20200510,UI,신설동,959,1002,20200513,1961
20200511,UI,신설동,2064,2074,20200514,4138
20200511,UI,보문,1390,1399,20200514,2789
20200511,UI,성신여대입구,2702,3149,20200514,5851
20200511,UI,정릉,4134,3963,20200514,8097
20200511,UI,북한산보국문,5233,5025,20200514,10258
20200511,UI,솔샘,5433,5107,20200514,10540
20200511,UI,삼양사거리,2336,2395,20200514,4731
20200511,UI,삼양,2114,2212,20200514,4326
20200511,UI,화계,3020,2935,20200514,5955
20200511,UI,가오리,3793,3710,20200514,7503
20200511,UI,4.19민주묘지,2695,2657,20200514,5352
20200511,UI,솔밭공원,2182,2111,20200514,4293
20200511,UI,북한산우이,2339,2235,20200514,4574
20200512,UI,북한산우이,2345,2185,20200515,4530
20200512,UI,솔밭공원,2096,2069,20200515,4165
20200512,UI,4.19민주묘지,2711,2754,20200515,5465
20200512,UI,가오리,3714,3631,20200515,7345
20200512,UI,화계,2989,2830,20200515,5819
20200512,UI,삼양,2060,2196,20200515,4256
20200512,UI,삼양사거리,2207,2248,20200515,4455
20200512,UI,솔샘,5293,5065,20200515,10358
20200512,UI,북한산보국문,5215,5122,20200515,10337
20200512,UI,정릉,4065,3860,20200515,7925
20200512,UI,성신여대입구,2752,3210,20200515,5962
20200512,UI,보문,1358,1447,20200515,2805
20200512,UI,신설동,2015,2087,20200515,4102
20200513,UI,북한산우이,2550,2322,20200516,4872
20200513,UI,솔밭공원,2197,2084,20200516,4281
20200513,UI,4.19민주묘지,2640,2587,20200516,5227
20200513,UI,가오리,3780,3710,20200516,7490
20200513,UI,화계,3061,2820,20200516,5881
20200513,UI,삼양,2125,2275,20200516,4400
20200513,UI,삼양사거리,2250,2358,20200516,4608
20200513,UI,북한산보국문,5386,5162,20200516,10548
20200513,UI,정릉,4089,3920,20200516,8009
20200513,UI,성신여대입구,2761,3225,20200516,5986
20200513,UI,보문,1371,1407,20200516,2778
20200513,UI,신설동,2092,2064,20200516,4156
20200513,UI,솔샘,5356,4993,20200516,10349
20200514,UI,북한산우이,2479,2367,20200517,4846
20200514,UI,솔밭공원,2169,2089,20200517,4258
20200514,UI,4.19민주묘지,2601,2563,20200517,5164
20200514,UI,가오리,3745,3644,20200517,7389
20200514,UI,화계,2984,2810,20200517,5794
20200514,UI,삼양,2042,2154,20200517,4196
20200514,UI,삼양사거리,2269,2287,20200517,4556
20200514,UI,신설동,2066,2040,20200517,4106
20200514,UI,보문,1401,1378,20200517,2779
20200514,UI,성신여대입구,2819,3157,20200517,5976
20200514,UI,정릉,4087,3780,20200517,7867
20200514,UI,북한산보국문,5294,5196,20200517,10490
20200514,UI,솔샘,5415,5019,20200517,10434
20200515,UI,북한산우이,1884,1669,20200518,3553
20200515,UI,솔밭공원,2003,1921,20200518,3924
20200515,UI,4.19민주묘지,2368,2362,20200518,4730
20200515,UI,가오리,3529,3410,20200518,6939
20200515,UI,화계,2851,2698,20200518,5549
20200515,UI,삼양,1973,2109,20200518,4082
20200515,UI,삼양사거리,2049,2121,20200518,4170
20200515,UI,솔샘,5268,4761,20200518,10029
20200515,UI,북한산보국문,5236,4877,20200518,10113
20200515,UI,정릉,3997,3720,20200518,7717
20200515,UI,성신여대입구,2799,3267,20200518,6066
20200515,UI,보문,1371,1417,20200518,2788
20200515,UI,신설동,1912,1963,20200518,3875
20200516,UI,신설동,1027,1384,20200519,2411
20200516,UI,보문,957,1218,20200519,2175
20200516,UI,성신여대입구,1968,2517,20200519,4485
20200516,UI,정릉,2729,2482,20200519,5211
20200516,UI,북한산보국문,3847,3488,20200519,7335
20200516,UI,솔샘,2940,2428,20200519,5368
20200516,UI,삼양사거리,1584,1456,20200519,3040
20200516,UI,삼양,1481,1558,20200519,3039
20200516,UI,화계,1939,1653,20200519,3592
20200516,UI,가오리,2489,1990,20200519,4479
20200516,UI,4.19민주묘지,1903,1612,20200519,3515
20200516,UI,솔밭공원,1536,1295,20200519,2831
20200516,UI,북한산우이,2408,2637,20200519,5045
20200517,UI,신설동,1033,1031,20200520,2064
20200517,UI,보문,868,897,20200520,1765
20200517,UI,성신여대입구,1897,2182,20200520,4079
20200517,UI,정릉,2401,2038,20200520,4439
20200517,UI,북한산보국문,3164,2933,20200520,6097
20200517,UI,솔샘,2353,2240,20200520,4593
20200517,UI,삼양사거리,1347,1381,20200520,2728
20200517,UI,삼양,1113,1147,20200520,2260
20200517,UI,화계,1830,1623,20200520,3453
20200517,UI,가오리,2087,1844,20200520,3931
20200517,UI,4.19민주묘지,1700,1488,20200520,3188
20200517,UI,솔밭공원,1295,1243,20200520,2538
20200517,UI,북한산우이,3107,3342,20200520,6449
20200518,UI,북한산우이,2101,1949,20200521,4050
20200518,UI,솔밭공원,2112,2071,20200521,4183
20200518,UI,4.19민주묘지,2457,2466,20200521,4923
20200518,UI,가오리,3563,3658,20200521,7221
20200518,UI,화계,2858,2753,20200521,5611
20200518,UI,삼양,2086,2225,20200521,4311
20200518,UI,삼양사거리,2189,2296,20200521,4485
20200518,UI,솔샘,5146,4974,20200521,10120
20200518,UI,북한산보국문,4994,4980,20200521,9974
20200518,UI,정릉,3973,3826,20200521,7799
20200518,UI,성신여대입구,2734,3125,20200521,5859
20200518,UI,보문,1390,1417,20200521,2807
20200518,UI,신설동,1957,1996,20200521,3953
20200519,UI,북한산우이,2154,1914,20200522,4068
20200519,UI,솔밭공원,2117,2035,20200522,4152
20200519,UI,4.19민주묘지,2534,2558,20200522,5092
20200519,UI,가오리,3639,3559,20200522,7198
20200519,UI,화계,2898,2701,20200522,5599
20200519,UI,삼양,1970,2103,20200522,4073
20200519,UI,삼양사거리,2158,2226,20200522,4384
20200519,UI,솔샘,5173,4868,20200522,10041
20200519,UI,북한산보국문,4999,4896,20200522,9895
20200519,UI,정릉,3949,3715,20200522,7664
20200519,UI,성신여대입구,2728,3180,20200522,5908
20200519,UI,보문,1356,1380,20200522,2736
20200519,UI,신설동,1980,1947,20200522,3927
20200520,UI,신설동,2135,2109,20200523,4244
20200520,UI,보문,1437,1470,20200523,2907
20200520,UI,성신여대입구,2911,3399,20200523,6310
20200520,UI,정릉,4328,4004,20200523,8332
20200520,UI,북한산보국문,5610,5359,20200523,10969
20200520,UI,솔샘,5524,5116,20200523,10640
20200520,UI,삼양사거리,2423,2504,20200523,4927
20200520,UI,삼양,2076,2187,20200523,4263
20200520,UI,화계,3213,2965,20200523,6178
20200520,UI,가오리,3911,3920,20200523,7831
20200520,UI,4.19민주묘지,2821,2760,20200523,5581
20200520,UI,솔밭공원,2238,2141,20200523,4379
20200520,UI,북한산우이,2539,2360,20200523,4899
20200521,UI,신설동,2147,2087,20200524,4234
20200521,UI,보문,1430,1435,20200524,2865
20200521,UI,성신여대입구,2962,3483,20200524,6445
20200521,UI,정릉,4246,4025,20200524,8271
20200521,UI,북한산보국문,5526,5273,20200524,10799
20200521,UI,솔샘,5599,5052,20200524,10651
20200521,UI,삼양사거리,2351,2398,20200524,4749
20200521,UI,삼양,2068,2210,20200524,4278
20200521,UI,화계,3057,2894,20200524,5951
20200521,UI,가오리,3779,3763,20200524,7542
20200521,UI,4.19민주묘지,2862,2727,20200524,5589
20200521,UI,솔밭공원,2368,2226,20200524,4594
20200521,UI,북한산우이,2654,2473,20200524,5127
20200522,UI,북한산우이,2551,2368,20200525,4919
20200522,UI,솔밭공원,2241,2138,20200525,4379
20200522,UI,4.19민주묘지,2798,2705,20200525,5503
20200522,UI,가오리,3929,3674,20200525,7603
20200522,UI,화계,3128,2794,20200525,5922
20200522,UI,삼양,2056,2219,20200525,4275
20200522,UI,삼양사거리,2349,2305,20200525,4654
20200522,UI,솔샘,5565,5013,20200525,10578
20200522,UI,북한산보국문,5736,5316,20200525,11052
20200522,UI,정릉,4311,3985,20200525,8296
20200522,UI,성신여대입구,3056,3530,20200525,6586
20200522,UI,보문,1431,1442,20200525,2873
20200522,UI,신설동,2094,2121,20200525,4215
20200523,UI,북한산우이,3896,4012,20200526,7908
20200523,UI,솔밭공원,1699,1606,20200526,3305
20200523,UI,4.19민주묘지,2265,2140,20200526,4405
20200523,UI,가오리,2775,2560,20200526,5335
20200523,UI,화계,2312,2043,20200526,4355
20200523,UI,삼양,1623,1654,20200526,3277
20200523,UI,삼양사거리,1861,1815,20200526,3676
20200523,UI,솔샘,3579,3252,20200526,6831
20200523,UI,북한산보국문,4468,3976,20200526,8444
20200523,UI,정릉,3456,2868,20200526,6324
20200523,UI,성신여대입구,2540,2964,20200526,5504
20200523,UI,보문,1148,1093,20200526,2241
20200523,UI,신설동,1391,1429,20200526,2820
20200524,UI,신설동,933,890,20200527,1823
20200524,UI,보문,853,841,20200527,1694
20200524,UI,성신여대입구,1708,2086,20200527,3794
20200524,UI,정릉,2317,1851,20200527,4168
20200524,UI,북한산보국문,3199,2798,20200527,5997
20200524,UI,북한산우이,2290,2443,20200527,4733
20200524,UI,솔밭공원,1222,1153,20200527,2375
20200524,UI,4.19민주묘지,1582,1435,20200527,3017
20200524,UI,가오리,1894,1758,20200527,3652
20200524,UI,화계,1737,1554,20200527,3291
20200524,UI,삼양,1017,1050,20200527,2067
20200524,UI,삼양사거리,1297,1321,20200527,2618
20200524,UI,솔샘,2387,2262,20200527,4649
20200525,UI,신설동,2225,2211,20200528,4436
20200525,UI,보문,1441,1464,20200528,2905
20200525,UI,성신여대입구,2967,3311,20200528,6278
20200525,UI,정릉,4216,4020,20200528,8236
20200525,UI,북한산보국문,5438,5310,20200528,10748
20200525,UI,솔샘,5491,5143,20200528,10634
20200525,UI,삼양사거리,2375,2397,20200528,4772
20200525,UI,삼양,2079,2215,20200528,4294
20200525,UI,화계,3134,2972,20200528,6106
20200525,UI,가오리,3879,3795,20200528,7674
20200525,UI,4.19민주묘지,2781,2706,20200528,5487
20200525,UI,솔밭공원,2262,2190,20200528,4452
20200525,UI,북한산우이,2576,2380,20200528,4956
20200526,UI,신설동,2093,2051,20200529,4144
20200526,UI,보문,1405,1479,20200529,2884
20200526,UI,성신여대입구,2955,3270,20200529,6225
20200526,UI,정릉,4200,3977,20200529,8177
20200526,UI,북한산보국문,5410,5305,20200529,10715
20200526,UI,솔샘,5517,5156,20200529,10673
20200526,UI,삼양사거리,2342,2411,20200529,4753
20200526,UI,삼양,2048,2223,20200529,4271
20200526,UI,화계,3097,2911,20200529,6008
20200526,UI,가오리,3815,3939,20200529,7754
20200526,UI,4.19민주묘지,2787,2755,20200529,5542
20200526,UI,솔밭공원,2252,2256,20200529,4508
20200526,UI,북한산우이,2424,2184,20200529,4608
20200527,UI,삼양사거리,2400,2401,20200530,4801
20200527,UI,삼양,2136,2276,20200530,4412
20200527,UI,화계,3315,3031,20200530,6346
20200527,UI,가오리,3900,3895,20200530,7795
20200527,UI,4.19민주묘지,2889,2682,20200530,5571
20200527,UI,솔밭공원,2398,2371,20200530,4769
20200527,UI,북한산우이,2680,2531,20200530,5211
20200527,UI,신설동,2232,2270,20200530,4502
20200527,UI,보문,1442,1467,20200530,2909
20200527,UI,성신여대입구,2986,3389,20200530,6375
20200527,UI,정릉,4336,4049,20200530,8385
20200527,UI,북한산보국문,5636,5375,20200530,11011
20200527,UI,솔샘,5612,5227,20200530,10839
20200528,UI,신설동,2190,2173,20200531,4363
20200528,UI,보문,1482,1443,20200531,2925
20200528,UI,성신여대입구,2901,3379,20200531,6280
20200528,UI,정릉,4244,3968,20200531,8212
20200528,UI,북한산보국문,5611,5236,20200531,10847
20200528,UI,솔샘,5556,5238,20200531,10794
20200528,UI,삼양사거리,2299,2360,20200531,4659
20200528,UI,삼양,2165,2277,20200531,4442
20200528,UI,화계,3180,2934,20200531,6114
20200528,UI,가오리,3860,3791,20200531,7651
20200528,UI,4.19민주묘지,2817,2713,20200531,5530
20200528,UI,솔밭공원,2297,2201,20200531,4498
20200528,UI,북한산우이,2508,2252,20200531,4760
20200529,UI,북한산우이,2690,2462,20200601,5152
20200529,UI,솔밭공원,2345,2185,20200601,4530
20200529,UI,4.19민주묘지,2811,2673,20200601,5484
20200529,UI,가오리,3903,3741,20200601,7644
20200529,UI,화계,3227,2925,20200601,6152
20200529,UI,삼양,2123,2211,20200601,4334
20200529,UI,삼양사거리,2345,2384,20200601,4729
20200529,UI,솔샘,5555,4967,20200601,10522
20200529,UI,북한산보국문,5723,5430,20200601,11153
20200529,UI,정릉,4406,4031,20200601,8437
20200529,UI,성신여대입구,3066,3570,20200601,6636
20200529,UI,보문,1480,1485,20200601,2965
20200529,UI,신설동,2130,2199,20200601,4329
20200530,UI,북한산우이,4174,4280,20200602,8454
20200530,UI,솔밭공원,1639,1564,20200602,3203
20200530,UI,4.19민주묘지,2212,2045,20200602,4257
20200530,UI,가오리,2710,2370,20200602,5080
20200530,UI,화계,2465,2273,20200602,4738
20200530,UI,삼양,1536,1596,20200602,3132
20200530,UI,삼양사거리,1793,1763,20200602,3556
20200530,UI,솔샘,3392,3028,20200602,6420
20200530,UI,북한산보국문,4340,3902,20200602,8242
20200530,UI,정릉,3277,2775,20200602,6052
20200530,UI,성신여대입구,2396,2837,20200602,5233
20200530,UI,보문,1111,1155,20200602,2266
20200530,UI,신설동,1399,1298,20200602,2697
20200531,UI,신설동,1031,1037,20200603,2068
20200531,UI,보문,857,932,20200603,1789
20200531,UI,성신여대입구,1776,2231,20200603,4007
20200531,UI,정릉,2399,2043,20200603,4442
20200531,UI,북한산보국문,3323,2914,20200603,6237
20200531,UI,솔샘,2334,2209,20200603,4543
20200531,UI,삼양사거리,1321,1345,20200603,2666
20200531,UI,삼양,1115,1106,20200603,2221
20200531,UI,화계,1798,1655,20200603,3453
20200531,UI,가오리,1991,1847,20200603,3838
20200531,UI,4.19민주묘지,1861,1564,20200603,3425
20200531,UI,솔밭공원,1271,1170,20200603,2441
20200531,UI,북한산우이,3067,3234,20200603,6301
20200101,3,대화,6456,5901,20200104,12357
20200101,3,주엽,4213,4264,20200104,8477
20200101,3,정발산,4468,4495,20200104,8963
20200101,3,마두,3643,3685,20200104,7328
20200101,3,백석,5630,5479,20200104,11109
20200101,3,대곡,732,569,20200104,1301
20200101,3,화정,9733,9958,20200104,19691
20200101,3,원당,5402,5402,20200104,10804
20200101,3,삼송,9788,9860,20200104,19648
20200101,3,원흥,3944,3886,20200104,7830
20200102,3,원흥,10126,9646,20200105,19772
20200102,3,삼송,19681,18748,20200105,38429
20200102,3,원당,12336,11764,20200105,24100
20200102,3,화정,20439,21091,20200105,41530
20200102,3,대곡,1725,1247,20200105,2972
20200102,3,백석,11836,11787,20200105,23623
20200102,3,마두,9311,9568,20200105,18879
20200102,3,정발산,8566,8970,20200105,17536
20200102,3,주엽,10735,11018,20200105,21753
20200102,3,대화,16529,12550,20200105,29079
20200103,3,원흥,10678,9606,20200106,20284
20200103,3,삼송,20853,19462,20200106,40315
20200103,3,원당,12940,12289,20200106,25229
20200103,3,화정,21456,22314,20200106,43770
20200103,3,대곡,1880,1347,20200106,3227
20200103,3,백석,12510,12663,20200106,25173
20200103,3,마두,9545,9901,20200106,19446
20200103,3,정발산,9481,10424,20200106,19905
20200103,3,주엽,11100,11382,20200106,22482
20200103,3,대화,16778,12870,20200106,29648
20200104,3,원당,9947,9177,20200107,19124
20200104,3,원흥,7241,6579,20200107,13820
20200104,3,삼송,15413,14156,20200107,29569
20200104,3,화정,16054,16395,20200107,32449
20200104,3,대곡,1249,1130,20200107,2379
20200104,3,백석,9805,9797,20200107,19602
20200104,3,마두,6434,6478,20200107,12912
20200104,3,정발산,8294,9391,20200107,17685
20200104,3,주엽,7939,7933,20200107,15872
20200104,3,대화,11371,9656,20200107,21027
20200105,3,원흥,5440,5323,20200108,10763
20200105,3,삼송,11369,11220,20200108,22589
20200105,3,원당,7132,6922,20200108,14054
20200105,3,화정,13195,13567,20200108,26762
20200105,3,대곡,1050,850,20200108,1900
20200105,3,백석,7453,7176,20200108,14629
20200105,3,마두,4458,4401,20200108,8859
20200105,3,정발산,7192,7037,20200108,14229
20200105,3,주엽,5244,5690,20200108,10934
20200105,3,대화,8437,7600,20200108,16037
20200106,3,원흥,10239,9599,20200109,19838
20200106,3,삼송,20043,19100,20200109,39143
20200106,3,원당,12447,11668,20200109,24115
20200106,3,화정,20864,21720,20200109,42584
20200106,3,대곡,1805,1242,20200109,3047
20200106,3,백석,11992,12200,20200109,24192
20200106,3,마두,9232,9668,20200109,18900
20200106,3,정발산,8566,8759,20200109,17325
20200106,3,주엽,11119,11281,20200109,22400
20200106,3,대화,16544,12766,20200109,29310
20200107,3,원흥,9750,9214,20200110,18964
20200107,3,삼송,19182,18190,20200110,37372
20200107,3,원당,11920,11301,20200110,23221
20200107,3,화정,19643,20606,20200110,40249
20200107,3,대곡,1710,1170,20200110,2880
20200107,3,백석,11610,11553,20200110,23163
20200107,3,마두,8905,9264,20200110,18169
20200107,3,정발산,8074,8373,20200110,16447
20200107,3,주엽,10531,10873,20200110,21404
20200107,3,대화,16153,12666,20200110,28819
20200108,3,원흥,10351,9632,20200111,19983
20200108,3,삼송,19850,18978,20200111,38828
20200108,3,원당,12575,12088,20200111,24663
20200108,3,화정,21290,22015,20200111,43305
20200108,3,대곡,1794,1315,20200111,3109
20200108,3,백석,11888,11808,20200111,23696
20200108,3,마두,9804,10157,20200111,19961
20200108,3,정발산,8799,9185,20200111,17984
20200108,3,주엽,10953,11301,20200111,22254
20200108,3,대화,16941,12962,20200111,29903
20200109,3,원흥,10472,9854,20200112,20326
20200109,3,삼송,20250,19374,20200112,39624
20200109,3,원당,13130,12392,20200112,25522
20200109,3,화정,21394,21904,20200112,43298
20200109,3,대곡,1810,1264,20200112,3074
20200109,3,백석,12632,12788,20200112,25420
20200109,3,마두,9701,10026,20200112,19727
20200109,3,정발산,8945,9314,20200112,18259
20200109,3,주엽,11019,11411,20200112,22430
20200109,3,대화,17484,13567,20200112,31051
20200110,3,원흥,10806,9757,20200113,20563
20200110,3,삼송,20824,19383,20200113,40207
20200110,3,원당,13341,12582,20200113,25923
20200110,3,화정,22163,22934,20200113,45097
20200110,3,대곡,1877,1352,20200113,3229
20200110,3,백석,12847,13107,20200113,25954
20200110,3,마두,9999,10301,20200113,20300
20200110,3,정발산,9541,10420,20200113,19961
20200110,3,주엽,11542,11730,20200113,23272
20200110,3,대화,17488,13543,20200113,31031
20200111,3,원흥,7407,6741,20200114,14148
20200111,3,삼송,16211,15048,20200114,31259
20200111,3,원당,10269,9538,20200114,19807
20200111,3,화정,16942,17380,20200114,34322
20200111,3,대곡,1442,1192,20200114,2634
20200111,3,백석,10422,10445,20200114,20867
20200111,3,마두,6846,6972,20200114,13818
20200111,3,정발산,8673,9726,20200114,18399
20200111,3,주엽,8830,8676,20200114,17506
20200111,3,대화,12374,10534,20200114,22908
20200112,3,원흥,5251,5158,20200115,10409
20200112,3,삼송,11963,11741,20200115,23704
20200112,3,원당,7430,7414,20200115,14844
20200112,3,화정,13402,13734,20200115,27136
20200112,3,대곡,1015,831,20200115,1846
20200112,3,백석,7591,7392,20200115,14983
20200112,3,마두,4430,4482,20200115,8912
20200112,3,정발산,7139,6940,20200115,14079
20200112,3,주엽,5758,5912,20200115,11670
20200112,3,대화,8906,8017,20200115,16923
20200113,3,원흥,10346,9781,20200116,20127
20200113,3,삼송,20035,19090,20200116,39125
20200113,3,원당,12795,12213,20200116,25008
20200113,3,화정,21255,21839,20200116,43094
20200113,3,대곡,1860,1302,20200116,3162
20200113,3,백석,12378,12368,20200116,24746
20200113,3,마두,9392,9848,20200116,19240
20200113,3,정발산,8619,8900,20200116,17519
20200113,3,주엽,11197,11509,20200116,22706
20200113,3,대화,17222,13259,20200116,30481
20200114,3,대화,17007,13254,20200117,30261
20200114,3,주엽,11153,11409,20200117,22562
20200114,3,정발산,8631,9220,20200117,17851
20200114,3,마두,9399,9831,20200117,19230
20200114,3,백석,12450,12375,20200117,24825
20200114,3,대곡,1896,1319,20200117,3215
20200114,3,화정,21549,22243,20200117,43792
20200114,3,원당,13049,12349,20200117,25398
20200114,3,삼송,20018,19272,20200117,39290
20200114,3,원흥,10407,9745,20200117,20152
20200115,3,원흥,10454,9747,20200118,20201
20200115,3,삼송,20377,19370,20200118,39747
20200115,3,원당,12832,12224,20200118,25056
20200115,3,화정,22030,22749,20200118,44779
20200115,3,대곡,1854,1333,20200118,3187
20200115,3,백석,12435,12472,20200118,24907
20200115,3,마두,9769,10110,20200118,19879
20200115,3,정발산,8862,9253,20200118,18115
20200115,3,주엽,11145,11519,20200118,22664
20200115,3,대화,17122,13268,20200118,30390
20200116,3,대화,17270,13372,20200119,30642
20200116,3,주엽,11200,11449,20200119,22649
20200116,3,정발산,8869,9244,20200119,18113
20200116,3,마두,9838,10229,20200119,20067
20200116,3,백석,12708,12508,20200119,25216
20200116,3,대곡,1841,1366,20200119,3207
20200116,3,화정,21144,22066,20200119,43210
20200116,3,원당,12978,12337,20200119,25315
20200116,3,삼송,20428,19476,20200119,39904
20200116,3,원흥,10770,9972,20200119,20742
20200117,3,원흥,10856,9903,20200120,20759
20200117,3,삼송,21038,19612,20200120,40650
20200117,3,원당,13363,12574,20200120,25937
20200117,3,화정,22046,22842,20200120,44888
20200117,3,대곡,1838,1377,20200120,3215
20200117,3,백석,13006,13089,20200120,26095
20200117,3,마두,10009,10336,20200120,20345
20200117,3,정발산,9611,10537,20200120,20148
20200117,3,주엽,11475,11843,20200120,23318
20200117,3,대화,17667,13585,20200120,31252
20200118,3,원흥,7479,6915,20200121,14394
20200118,3,삼송,16508,15296,20200121,31804
20200118,3,원당,10401,9693,20200121,20094
20200118,3,화정,16736,17440,20200121,34176
20200118,3,대곡,1486,1267,20200121,2753
20200118,3,백석,9918,10012,20200121,19930
20200118,3,마두,6844,6738,20200121,13582
20200118,3,정발산,8421,9358,20200121,17779
20200118,3,주엽,8510,8424,20200121,16934
20200118,3,대화,12280,10436,20200121,22716
20200119,3,원흥,5390,5125,20200122,10515
20200119,3,삼송,11901,11801,20200122,23702
20200119,3,원당,7302,7263,20200122,14565
20200119,3,화정,13501,13804,20200122,27305
20200119,3,대곡,1053,793,20200122,1846
20200119,3,백석,7503,7380,20200122,14883
20200119,3,마두,4508,4524,20200122,9032
20200119,3,정발산,6900,6802,20200122,13702
20200119,3,주엽,5673,5739,20200122,11412
20200119,3,대화,9259,8288,20200122,17547
20200120,3,대화,17303,13233,20200123,30536
20200120,3,주엽,11403,11700,20200123,23103
20200120,3,정발산,8839,9094,20200123,17933
20200120,3,마두,9618,9929,20200123,19547
20200120,3,백석,12452,12603,20200123,25055
20200120,3,대곡,1879,1363,20200123,3242
20200120,3,화정,21408,22000,20200123,43408
20200120,3,원당,12908,12265,20200123,25173
20200120,3,삼송,20574,19610,20200123,40184
20200120,3,원흥,10694,9977,20200123,20671
20200121,3,원흥,10377,9631,20200124,20008
20200121,3,삼송,20198,19602,20200124,39800
20200121,3,원당,12961,12248,20200124,25209
20200121,3,화정,21329,22097,20200124,43426
20200121,3,대곡,1911,1333,20200124,3244
20200121,3,백석,12574,12627,20200124,25201
20200121,3,마두,9222,9576,20200124,18798
20200121,3,정발산,8924,9270,20200124,18194
20200121,3,주엽,11217,11540,20200124,22757
20200121,3,대화,16665,12892,20200124,29557
20200122,3,원흥,10452,9428,20200125,19880
20200122,3,삼송,20425,19369,20200125,39794
20200122,3,원당,12839,12227,20200125,25066
20200122,3,화정,21633,22529,20200125,44162
20200122,3,대곡,1821,1330,20200125,3151
20200122,3,백석,12328,12658,20200125,24986
20200122,3,마두,9578,9860,20200125,19438
20200122,3,정발산,8829,9201,20200125,18030
20200122,3,주엽,11061,11284,20200125,22345
20200122,3,대화,16833,12973,20200125,29806
20200123,3,원흥,9850,8668,20200126,18518
20200123,3,삼송,19854,18384,20200126,38238
20200123,3,원당,12229,11515,20200126,23744
20200123,3,화정,20184,21096,20200126,41280
20200123,3,대곡,1666,1235,20200126,2901
20200123,3,백석,12243,12635,20200126,24878
20200123,3,마두,9221,9462,20200126,18683
20200123,3,정발산,8836,9688,20200126,18524
20200123,3,주엽,10258,10373,20200126,20631
20200123,3,대화,15517,12067,20200126,27584
20200124,3,대화,6462,5730,20200127,12192
20200124,3,주엽,4078,4135,20200127,8213
20200124,3,정발산,4250,4330,20200127,8580
20200124,3,마두,3607,3549,20200127,7156
20200124,3,백석,5811,5935,20200127,11746
20200124,3,대곡,798,615,20200127,1413
20200124,3,화정,8665,9013,20200127,17678
20200124,3,원당,5712,5646,20200127,11358
20200124,3,삼송,10432,9989,20200127,20421
20200124,3,원흥,3942,3350,20200127,7292
20200125,3,원흥,3103,2934,20200128,6037
20200125,3,삼송,9845,9280,20200128,19125
20200125,3,원당,5543,5259,20200128,10802
20200125,3,화정,6992,7569,20200128,14561
20200125,3,대곡,772,582,20200128,1354
20200125,3,백석,4697,4418,20200128,9115
20200125,3,마두,2630,2619,20200128,5249
20200125,3,정발산,3593,4027,20200128,7620
20200125,3,주엽,3462,3407,20200128,6869
20200125,3,대화,5720,5035,20200128,10755
20200126,3,원흥,4333,4104,20200129,8437
20200126,3,삼송,11518,11036,20200129,22554
20200126,3,원당,6422,6180,20200129,12602
20200126,3,화정,11300,11841,20200129,23141
20200126,3,대곡,868,719,20200129,1587
20200126,3,백석,6567,6359,20200129,12926
20200126,3,마두,3877,3924,20200129,7801
20200126,3,정발산,5502,6123,20200129,11625
20200126,3,주엽,4453,4768,20200129,9221
20200126,3,대화,7118,6360,20200129,13478
20200127,3,원흥,4182,4102,20200130,8284
20200127,3,삼송,10536,10431,20200130,20967
20200127,3,원당,6185,5956,20200130,12141
20200127,3,화정,10061,10438,20200130,20499
20200127,3,대곡,957,733,20200130,1690
20200127,3,백석,6819,6530,20200130,13349
20200127,3,마두,4031,4062,20200130,8093
20200127,3,정발산,5022,5276,20200130,10298
20200127,3,주엽,4720,4629,20200130,9349
20200127,3,대화,7203,6333,20200130,13536
20200128,3,원흥,9020,8691,20200131,17711
20200128,3,삼송,18079,17510,20200131,35589
20200128,3,원당,11417,10796,20200131,22213
20200128,3,화정,18779,19411,20200131,38190
20200128,3,대곡,1677,1191,20200131,2868
20200128,3,백석,10932,10885,20200131,21817
20200128,3,마두,8082,8477,20200131,16559
20200128,3,정발산,7803,8105,20200131,15908
20200128,3,주엽,9380,9606,20200131,18986
20200128,3,대화,14778,11371,20200131,26149
20200129,3,원흥,9914,9224,20200201,19138
20200129,3,삼송,19001,18246,20200201,37247
20200129,3,원당,11843,11258,20200201,23101
20200129,3,화정,20006,20684,20200201,40690
20200129,3,대곡,1684,1221,20200201,2905
20200129,3,백석,10971,10975,20200201,21946
20200129,3,마두,8698,8985,20200201,17683
20200129,3,정발산,7989,8272,20200201,16261
20200129,3,주엽,9737,10062,20200201,19799
20200129,3,대화,15377,11884,20200201,27261
20200130,3,대화,15156,11657,20200202,26813
20200130,3,주엽,9761,9951,20200202,19712
20200130,3,정발산,7936,8109,20200202,16045
20200130,3,마두,8814,9013,20200202,17827
20200130,3,백석,11185,11089,20200202,22274
20200130,3,대곡,1717,1248,20200202,2965
20200130,3,화정,19211,19949,20200202,39160
20200130,3,원당,12070,11428,20200202,23498
20200130,3,삼송,18829,18105,20200202,36934
20200130,3,원흥,9883,9240,20200202,19123
20200131,3,원흥,9936,9127,20200203,19063
20200131,3,삼송,19287,18034,20200203,37321
20200131,3,원당,11984,11359,20200203,23343
20200131,3,화정,19495,20290,20200203,39785
20200131,3,대곡,1717,1273,20200203,2990
20200131,3,백석,11207,11380,20200203,22587
20200131,3,마두,8526,8812,20200203,17338
20200131,3,정발산,8251,9008,20200203,17259
20200131,3,주엽,9775,9952,20200203,19727
20200131,3,대화,15322,11800,20200203,27122
20200201,3,원흥,6031,5513,20200204,11544
20200201,3,삼송,12539,11597,20200204,24136
20200201,3,원당,8109,7498,20200204,15607
20200201,3,화정,13309,13872,20200204,27181
20200201,3,대곡,1140,930,20200204,2070
20200201,3,백석,7603,7684,20200204,15287
20200201,3,마두,4958,5033,20200204,9991
20200201,3,정발산,6116,6743,20200204,12859
20200201,3,주엽,6259,6033,20200204,12292
20200201,3,대화,9006,7708,20200204,16714
20200202,3,원흥,4434,4183,20200205,8617
20200202,3,삼송,9050,8867,20200205,17917
20200202,3,원당,5840,5775,20200205,11615
20200202,3,화정,10502,10926,20200205,21428
20200202,3,대곡,836,715,20200205,1551
20200202,3,백석,5541,5347,20200205,10888
20200202,3,마두,3373,3522,20200205,6895
20200202,3,정발산,5229,5291,20200205,10520
20200202,3,주엽,4060,4153,20200205,8213
20200202,3,대화,6349,5886,20200205,12235
20200203,3,원흥,9389,8881,20200206,18270
20200203,3,삼송,17808,17201,20200206,35009
20200203,3,원당,11233,10756,20200206,21989
20200203,3,화정,18153,18786,20200206,36939
20200203,3,대곡,1623,1175,20200206,2798
20200203,3,백석,10306,10372,20200206,20678
20200203,3,마두,7778,7958,20200206,15736
20200203,3,정발산,6997,7188,20200206,14185
20200203,3,주엽,8896,9072,20200206,17968
20200203,3,대화,14589,11316,20200206,25905
20200204,3,원흥,9259,8738,20200207,17997
20200204,3,삼송,17839,17202,20200207,35041
20200204,3,원당,11277,10889,20200207,22166
20200204,3,화정,18217,19087,20200207,37304
20200204,3,대곡,1672,1179,20200207,2851
20200204,3,백석,10415,10310,20200207,20725
20200204,3,마두,7836,8248,20200207,16084
20200204,3,정발산,7169,7439,20200207,14608
20200204,3,주엽,8938,9128,20200207,18066
20200204,3,대화,14701,11590,20200207,26291
20200205,3,원흥,9103,8422,20200208,17525
20200205,3,삼송,17506,16661,20200208,34167
20200205,3,원당,10725,10294,20200208,21019
20200205,3,화정,18192,18969,20200208,37161
20200205,3,대곡,1579,1132,20200208,2711
20200205,3,백석,9939,9937,20200208,19876
20200205,3,마두,7683,8080,20200208,15763
20200205,3,정발산,6870,7119,20200208,13989
20200205,3,주엽,8255,8556,20200208,16811
20200205,3,대화,14476,11303,20200208,25779
20200206,3,삼송,17240,16518,20200209,33758
20200206,3,원흥,9054,8529,20200209,17583
20200206,3,원당,10607,10138,20200209,20745
20200206,3,화정,17431,17973,20200209,35404
20200206,3,대곡,1580,1127,20200209,2707
20200206,3,백석,9950,9834,20200209,19784
20200206,3,마두,7706,7994,20200209,15700
20200206,3,정발산,6913,7257,20200209,14170
20200206,3,주엽,8375,8662,20200209,17037
20200206,3,대화,13929,10821,20200209,24750
20200207,3,원흥,9595,8788,20200210,18383
20200207,3,삼송,17936,16877,20200210,34813
20200207,3,원당,11226,10673,20200210,21899
20200207,3,화정,18343,19348,20200210,37691
20200207,3,대곡,1620,1207,20200210,2827
20200207,3,백석,10609,10548,20200210,21157
20200207,3,마두,8125,8447,20200210,16572
20200207,3,정발산,7779,8400,20200210,16179
20200207,3,주엽,8834,9175,20200210,18009
20200207,3,대화,14405,10999,20200210,25404
20200208,3,원흥,6252,5630,20200211,11882
20200208,3,삼송,12067,11320,20200211,23387
20200208,3,원당,7774,7297,20200211,15071
20200208,3,화정,13041,13453,20200211,26494
20200208,3,대곡,1114,931,20200211,2045
20200208,3,백석,7562,7556,20200211,15118
20200208,3,마두,4896,5018,20200211,9914
20200208,3,정발산,6254,6828,20200211,13082
20200208,3,주엽,5933,5962,20200211,11895
20200208,3,대화,8790,7569,20200211,16359
20200209,3,원흥,4405,4266,20200212,8671
20200209,3,삼송,9206,9047,20200212,18253
20200209,3,원당,5849,5519,20200212,11368
20200209,3,화정,10776,11132,20200212,21908
20200209,3,대곡,804,630,20200212,1434
20200209,3,백석,5680,5559,20200212,11239
20200209,3,마두,3488,3535,20200212,7023
20200209,3,정발산,5366,5466,20200212,10832
20200209,3,주엽,4045,4148,20200212,8193
20200209,3,대화,6391,5806,20200212,12197
20200210,3,원흥,9420,8848,20200213,18268
20200210,3,삼송,18008,17305,20200213,35313
20200210,3,원당,11366,10821,20200213,22187
20200210,3,화정,18306,18990,20200213,37296
20200210,3,대곡,1679,1146,20200213,2825
20200210,3,백석,10528,10426,20200213,20954
20200210,3,마두,7927,8198,20200213,16125
20200210,3,정발산,6919,7203,20200213,14122
20200210,3,주엽,8806,9263,20200213,18069
20200210,3,대화,14452,11043,20200213,25495
20200211,3,원흥,9622,9004,20200214,18626
20200211,3,삼송,18647,17673,20200214,36320
20200211,3,원당,11708,11313,20200214,23021
20200211,3,화정,19000,19639,20200214,38639
20200211,3,대곡,1766,1243,20200214,3009
20200211,3,백석,10893,11068,20200214,21961
20200211,3,마두,8133,8354,20200214,16487
20200211,3,정발산,7720,8154,20200214,15874
20200211,3,주엽,9206,9459,20200214,18665
20200211,3,대화,14932,11255,20200214,26187
20200212,3,원흥,9184,8701,20200215,17885
20200212,3,삼송,17859,16884,20200215,34743
20200212,3,원당,10969,10464,20200215,21433
20200212,3,화정,18386,19261,20200215,37647
20200212,3,대곡,1612,1169,20200215,2781
20200212,3,백석,10255,10275,20200215,20530
20200212,3,마두,8111,8494,20200215,16605
20200212,3,정발산,7115,7471,20200215,14586
20200212,3,주엽,8865,9046,20200215,17911
20200212,3,대화,14530,11200,20200215,25730
20200213,3,원흥,9766,8996,20200216,18762
20200213,3,삼송,18695,17917,20200216,36612
20200213,3,원당,11903,11253,20200216,23156
20200213,3,화정,19223,19750,20200216,38973
20200213,3,대곡,1774,1254,20200216,3028
20200213,3,백석,10875,11018,20200216,21893
20200213,3,마두,8538,8772,20200216,17310
20200213,3,정발산,7859,8272,20200216,16131
20200213,3,주엽,9333,9498,20200216,18831
20200213,3,대화,15116,11422,20200216,26538
20200214,3,원흥,10170,9253,20200217,19423
20200214,3,삼송,19605,18266,20200217,37871
20200214,3,원당,12311,11671,20200217,23982
20200214,3,화정,20492,21293,20200217,41785
20200214,3,대곡,1809,1316,20200217,3125
20200214,3,백석,11804,11893,20200217,23697
20200214,3,마두,8817,9214,20200217,18031
20200214,3,정발산,8955,9893,20200217,18848
20200214,3,주엽,9797,10073,20200217,19870
20200214,3,대화,15381,11909,20200217,27290
20200215,3,원흥,6663,5969,20200218,12632
20200215,3,삼송,13602,12915,20200218,26517
20200215,3,원당,8705,8066,20200218,16771
20200215,3,화정,14498,15123,20200218,29621
20200215,3,대곡,1222,1062,20200218,2284
20200215,3,백석,8563,8671,20200218,17234
20200215,3,마두,5725,5736,20200218,11461
20200215,3,정발산,7119,7814,20200218,14933
20200215,3,주엽,6731,6691,20200218,13422
20200215,3,대화,9801,8278,20200218,18079
20200216,3,원흥,4608,4393,20200219,9001
20200216,3,삼송,9798,9554,20200219,19352
20200216,3,원당,6130,5960,20200219,12090
20200216,3,화정,11410,11765,20200219,23175
20200216,3,대곡,839,690,20200219,1529
20200216,3,백석,6268,6206,20200219,12474
20200216,3,마두,3909,3870,20200219,7779
20200216,3,정발산,5816,5736,20200219,11552
20200216,3,주엽,4397,4425,20200219,8822
20200216,3,대화,6911,6285,20200219,13196
20200217,3,원흥,9361,8853,20200220,18214
20200217,3,삼송,18248,17932,20200220,36180
20200217,3,원당,11545,11132,20200220,22677
20200217,3,화정,18970,19712,20200220,38682
20200217,3,대곡,1834,1231,20200220,3065
20200217,3,백석,11079,11271,20200220,22350
20200217,3,마두,8410,8808,20200220,17218
20200217,3,정발산,7674,8213,20200220,15887
20200217,3,주엽,9236,9487,20200220,18723
20200217,3,대화,15462,11840,20200220,27302
20200218,3,원흥,9091,8677,20200221,17768
20200218,3,삼송,18246,17312,20200221,35558
20200218,3,원당,11566,11032,20200221,22598
20200218,3,화정,19095,19859,20200221,38954
20200218,3,대곡,1729,1257,20200221,2986
20200218,3,백석,10743,10632,20200221,21375
20200218,3,마두,8006,8411,20200221,16417
20200218,3,정발산,7585,7998,20200221,15583
20200218,3,주엽,9227,9407,20200221,18634
20200218,3,대화,14726,11424,20200221,26150
20200219,3,원흥,9431,8909,20200222,18340
20200219,3,삼송,18856,18176,20200222,37032
20200219,3,원당,11898,11301,20200222,23199
20200219,3,화정,19086,19742,20200222,38828
20200219,3,대곡,1790,1305,20200222,3095
20200219,3,백석,11059,10934,20200222,21993
20200219,3,마두,8529,8992,20200222,17521
20200219,3,정발산,7876,8254,20200222,16130
20200219,3,주엽,9457,9753,20200222,19210
20200219,3,대화,15246,11587,20200222,26833
20200220,3,원흥,9422,8747,20200223,18169
20200220,3,삼송,18562,17705,20200223,36267
20200220,3,원당,11801,11210,20200223,23011
20200220,3,화정,18618,19197,20200223,37815
20200220,3,대곡,1810,1277,20200223,3087
20200220,3,백석,10974,10990,20200223,21964
20200220,3,마두,8398,8649,20200223,17047
20200220,3,정발산,7847,8205,20200223,16052
20200220,3,주엽,9299,9454,20200223,18753
20200220,3,대화,15116,11663,20200223,26779
20200221,3,원흥,9071,8403,20200224,17474
20200221,3,삼송,17490,16608,20200224,34098
20200221,3,원당,11141,10687,20200224,21828
20200221,3,화정,17306,18017,20200224,35323
20200221,3,대곡,1711,1237,20200224,2948
20200221,3,백석,10528,10621,20200224,21149
20200221,3,마두,7950,8251,20200224,16201
20200221,3,정발산,7498,8041,20200224,15539
20200221,3,주엽,8689,9023,20200224,17712
20200221,3,대화,14085,10864,20200224,24949
20200222,3,원흥,5010,4728,20200225,9738
20200222,3,삼송,10143,9694,20200225,19837
20200222,3,원당,6772,6420,20200225,13192
20200222,3,화정,10782,11136,20200225,21918
20200222,3,대곡,922,782,20200225,1704
20200222,3,백석,6637,6681,20200225,13318
20200222,3,마두,4220,4307,20200225,8527
20200222,3,정발산,5375,5789,20200225,11164
20200222,3,주엽,4810,4870,20200225,9680
20200222,3,대화,7182,6345,20200225,13527
20200223,3,원흥,3318,3255,20200226,6573
20200223,3,삼송,6984,6881,20200226,13865
20200223,3,원당,4639,4421,20200226,9060
20200223,3,화정,7257,7540,20200226,14797
20200223,3,대곡,693,588,20200226,1281
20200223,3,백석,4631,4515,20200226,9146
20200223,3,마두,2549,2499,20200226,5048
20200223,3,정발산,3692,3781,20200226,7473
20200223,3,주엽,3160,3086,20200226,6246
20200223,3,대화,4959,4420,20200226,9379
20200224,3,원흥,7976,7559,20200227,15535
20200224,3,삼송,15159,14566,20200227,29725
20200224,3,원당,9737,9397,20200227,19134
20200224,3,화정,14638,14880,20200227,29518
20200224,3,대곡,1451,1014,20200227,2465
20200224,3,백석,8522,8554,20200227,17076
20200224,3,마두,6199,6516,20200227,12715
20200224,3,정발산,5898,6113,20200227,12011
20200224,3,주엽,7173,7480,20200227,14653
20200224,3,대화,12201,9057,20200227,21258
20200225,3,원흥,7332,6896,20200228,14228
20200225,3,삼송,13957,13551,20200228,27508
20200225,3,원당,8754,8523,20200228,17277
20200225,3,화정,13287,13875,20200228,27162
20200225,3,대곡,1277,905,20200228,2182
20200225,3,백석,8024,8065,20200228,16089
20200225,3,마두,5557,5764,20200228,11321
20200225,3,정발산,5374,5499,20200228,10873
20200225,3,주엽,6348,6620,20200228,12968
20200225,3,대화,11174,8383,20200228,19557
20200226,3,원흥,7429,7031,20200229,14460
20200226,3,삼송,13887,13523,20200229,27410
20200226,3,원당,8955,8724,20200229,17679
20200226,3,화정,13274,13557,20200229,26831
20200226,3,대곡,1325,954,20200229,2279
20200226,3,백석,7891,7971,20200229,15862
20200226,3,마두,5552,5900,20200229,11452
20200226,3,정발산,5489,5451,20200229,10940
20200226,3,주엽,6484,6630,20200229,13114
20200226,3,대화,11085,8510,20200229,19595
20200227,3,원흥,7257,6977,20200301,14234
20200227,3,삼송,13563,13407,20200301,26970
20200227,3,원당,8803,8440,20200301,17243
20200227,3,화정,13173,13452,20200301,26625
20200227,3,대곡,1360,960,20200301,2320
20200227,3,백석,8017,8024,20200301,16041
20200227,3,마두,5427,5783,20200301,11210
20200227,3,정발산,5233,5307,20200301,10540
20200227,3,주엽,6327,6472,20200301,12799
20200227,3,대화,10667,8176,20200301,18843
20200228,3,원흥,6875,6304,20200302,13179
20200228,3,삼송,12841,12381,20200302,25222
20200228,3,원당,8257,7973,20200302,16230
20200228,3,화정,12135,12752,20200302,24887
20200228,3,대곡,1270,884,20200302,2154
20200228,3,백석,7516,7785,20200302,15301
20200228,3,마두,5244,5634,20200302,10878
20200228,3,정발산,4859,5187,20200302,10046
20200228,3,주엽,5867,5897,20200302,11764
20200228,3,대화,10150,8000,20200302,18150
20200229,3,원흥,3964,3839,20200303,7803
20200229,3,삼송,7650,7374,20200303,15024
20200229,3,원당,5109,4881,20200303,9990
20200229,3,화정,7655,7905,20200303,15560
20200229,3,대곡,711,565,20200303,1276
20200229,3,백석,4663,4730,20200303,9393
20200229,3,마두,2822,2839,20200303,5661
20200229,3,정발산,3414,3665,20200303,7079
20200229,3,주엽,3305,3313,20200303,6618
20200229,3,대화,5191,4558,20200303,9749
20200301,3,원흥,2584,2414,20200304,4998
20200301,3,삼송,5161,5066,20200304,10227
20200301,3,원당,3408,3343,20200304,6751
20200301,3,화정,5155,5235,20200304,10390
20200301,3,대곡,537,439,20200304,976
20200301,3,백석,3304,3253,20200304,6557
20200301,3,마두,1734,1745,20200304,3479
20200301,3,정발산,2429,2396,20200304,4825
20200301,3,주엽,2072,2050,20200304,4122
20200301,3,대화,3565,3228,20200304,6793
20200302,3,원흥,7042,6788,20200305,13830
20200302,3,삼송,13465,12982,20200305,26447
20200302,3,원당,8532,8140,20200305,16672
20200302,3,화정,12573,13005,20200305,25578
20200302,3,대곡,1338,926,20200305,2264
20200302,3,백석,7648,7727,20200305,15375
20200302,3,마두,5298,5482,20200305,10780
20200302,3,정발산,4940,5200,20200305,10140
20200302,3,주엽,6043,6201,20200305,12244
20200302,3,대화,10382,7907,20200305,18289
20200303,3,원흥,7094,6729,20200306,13823
20200303,3,삼송,13500,13057,20200306,26557
20200303,3,원당,8497,8164,20200306,16661
20200303,3,화정,12784,13091,20200306,25875
20200303,3,대곡,1321,970,20200306,2291
20200303,3,백석,7774,7758,20200306,15532
20200303,3,마두,5402,5688,20200306,11090
20200303,3,정발산,5096,5210,20200306,10306
20200303,3,주엽,5933,6101,20200306,12034
20200303,3,대화,10293,7968,20200306,18261
20200304,3,원흥,6999,6676,20200307,13675
20200304,3,삼송,13324,12938,20200307,26262
20200304,3,원당,8346,8059,20200307,16405
20200304,3,화정,12528,12987,20200307,25515
20200304,3,대곡,1263,909,20200307,2172
20200304,3,백석,7604,7800,20200307,15404
20200304,3,마두,5296,5577,20200307,10873
20200304,3,정발산,5218,5272,20200307,10490
20200304,3,주엽,5872,6047,20200307,11919
20200304,3,대화,10237,8036,20200307,18273
20200305,3,원흥,7128,6638,20200308,13766
20200305,3,삼송,13615,13109,20200308,26724
20200305,3,원당,8419,8151,20200308,16570
20200305,3,화정,12538,13094,20200308,25632
20200305,3,대곡,1300,903,20200308,2203
20200305,3,백석,7880,7919,20200308,15799
20200305,3,마두,5423,5654,20200308,11077
20200305,3,정발산,5145,5381,20200308,10526
20200305,3,주엽,6005,6115,20200308,12120
20200305,3,대화,10421,8059,20200308,18480
20200306,3,원흥,7227,6714,20200309,13941
20200306,3,삼송,13803,12994,20200309,26797
20200306,3,원당,8758,8420,20200309,17178
20200306,3,화정,13045,13744,20200309,26789
20200306,3,대곡,1355,947,20200309,2302
20200306,3,백석,8111,8190,20200309,16301
20200306,3,마두,5514,5875,20200309,11389
20200306,3,정발산,5464,6077,20200309,11541
20200306,3,주엽,6263,6331,20200309,12594
20200306,3,대화,10625,8320,20200309,18945
20200307,3,원흥,4276,3910,20200310,8186
20200307,3,삼송,8215,7786,20200310,16001
20200307,3,원당,5398,5014,20200310,10412
20200307,3,화정,8339,8683,20200310,17022
20200307,3,대곡,823,734,20200310,1557
20200307,3,백석,5186,5293,20200310,10479
20200307,3,마두,3131,3225,20200310,6356
20200307,3,정발산,3980,4471,20200310,8451
20200307,3,주엽,3669,3747,20200310,7416
20200307,3,대화,5659,4965,20200310,10624
20200308,3,원흥,2926,2747,20200311,5673
20200308,3,삼송,5947,5695,20200311,11642
20200308,3,원당,3888,3678,20200311,7566
20200308,3,화정,5966,6168,20200311,12134
20200308,3,대곡,656,595,20200311,1251
20200308,3,백석,3822,3598,20200311,7420
20200308,3,마두,2017,1924,20200311,3941
20200308,3,정발산,3080,3193,20200311,6273
20200308,3,주엽,2490,2384,20200311,4874
20200308,3,대화,3969,3574,20200311,7543
20200309,3,원흥,7343,7012,20200312,14355
20200309,3,삼송,13829,13391,20200312,27220
20200309,3,원당,9098,8641,20200312,17739
20200309,3,화정,13534,13910,20200312,27444
20200309,3,대곡,1425,1007,20200312,2432
20200309,3,백석,8181,8245,20200312,16426
20200309,3,마두,5605,5883,20200312,11488
20200309,3,정발산,5419,5681,20200312,11100
20200309,3,주엽,6505,6666,20200312,13171
20200309,3,대화,10916,8403,20200312,19319
20200310,3,원흥,7002,6579,20200313,13581
20200310,3,삼송,13139,12677,20200313,25816
20200310,3,원당,8388,8142,20200313,16530
20200310,3,화정,12782,13245,20200313,26027
20200310,3,대곡,1256,951,20200313,2207
20200310,3,백석,7834,7961,20200313,15795
20200310,3,마두,5340,5632,20200313,10972
20200310,3,정발산,4972,5183,20200313,10155
20200310,3,주엽,6056,6275,20200313,12331
20200310,3,대화,10527,8016,20200313,18543
20200311,3,원흥,7324,7008,20200314,14332
20200311,3,삼송,13768,13196,20200314,26964
20200311,3,원당,8863,8434,20200314,17297
20200311,3,화정,13365,13743,20200314,27108
20200311,3,대곡,1395,1016,20200314,2411
20200311,3,백석,7905,7973,20200314,15878
20200311,3,마두,5776,5973,20200314,11749
20200311,3,정발산,5530,5919,20200314,11449
20200311,3,주엽,6473,6562,20200314,13035
20200311,3,대화,10606,8205,20200314,18811
20200312,3,원흥,7209,6821,20200315,14030
20200312,3,삼송,13797,13279,20200315,27076
20200312,3,원당,8733,8323,20200315,17056
20200312,3,화정,13166,13516,20200315,26682
20200312,3,대곡,1401,1003,20200315,2404
20200312,3,백석,7896,8021,20200315,15917
20200312,3,마두,5530,5710,20200315,11240
20200312,3,정발산,5538,5940,20200315,11478
20200312,3,주엽,6277,6392,20200315,12669
20200312,3,대화,10471,8125,20200315,18596
20200313,3,원흥,7454,6830,20200316,14284
20200313,3,삼송,13879,13255,20200316,27134
20200313,3,원당,8953,8349,20200316,17302
20200313,3,화정,13499,14173,20200316,27672
20200313,3,대곡,1360,975,20200316,2335
20200313,3,백석,8215,8355,20200316,16570
20200313,3,마두,5645,6035,20200316,11680
20200313,3,정발산,5697,6274,20200316,11971
20200313,3,주엽,6380,6519,20200316,12899
20200313,3,대화,10543,8279,20200316,18822
20200314,3,원흥,4599,4309,20200317,8908
20200314,3,삼송,8773,8289,20200317,17062
20200314,3,원당,5726,5487,20200317,11213
20200314,3,화정,8871,9055,20200317,17926
20200314,3,대곡,861,755,20200317,1616
20200314,3,백석,5422,5472,20200317,10894
20200314,3,마두,3264,3314,20200317,6578
20200314,3,정발산,4384,4769,20200317,9153
20200314,3,주엽,3974,4070,20200317,8044
20200314,3,대화,6055,5234,20200317,11289
20200315,3,원흥,2971,2817,20200318,5788
20200315,3,삼송,6190,5907,20200318,12097
20200315,3,원당,3904,3766,20200318,7670
20200315,3,화정,6138,6260,20200318,12398
20200315,3,대곡,633,528,20200318,1161
20200315,3,백석,3803,3722,20200318,7525
20200315,3,마두,2056,2003,20200318,4059
20200315,3,정발산,3039,3132,20200318,6171
20200315,3,주엽,2555,2470,20200318,5025
20200315,3,대화,4076,3720,20200318,7796
20200316,3,원흥,7328,7009,20200319,14337
20200316,3,삼송,14038,13525,20200319,27563
20200316,3,원당,8936,8542,20200319,17478
20200316,3,화정,13451,13729,20200319,27180
20200316,3,대곡,1393,1056,20200319,2449
20200316,3,백석,8141,8218,20200319,16359
20200316,3,마두,5791,5953,20200319,11744
20200316,3,정발산,5438,5668,20200319,11106
20200316,3,주엽,6509,6712,20200319,13221
20200316,3,대화,10761,8303,20200319,19064
20200317,3,주엽,6454,6693,20200320,13147
20200317,3,원흥,7452,7052,20200320,14504
20200317,3,삼송,13964,13396,20200320,27360
20200317,3,원당,8778,8468,20200320,17246
20200317,3,화정,13345,13898,20200320,27243
20200317,3,대곡,1443,1024,20200320,2467
20200317,3,백석,8139,8184,20200320,16323
20200317,3,마두,5587,5910,20200320,11497
20200317,3,정발산,5435,5679,20200320,11114
20200317,3,대화,10731,8312,20200320,19043
20200318,3,원흥,7663,7248,20200321,14911
20200318,3,삼송,14217,13672,20200321,27889
20200318,3,원당,9086,8664,20200321,17750
20200318,3,화정,13689,14225,20200321,27914
20200318,3,대곡,1487,1158,20200321,2645
20200318,3,백석,8204,8272,20200321,16476
20200318,3,마두,5721,6148,20200321,11869
20200318,3,정발산,5858,6039,20200321,11897
20200318,3,주엽,6702,6767,20200321,13469
20200318,3,대화,10942,8449,20200321,19391
20200319,3,원흥,7028,6607,20200322,13635
20200319,3,삼송,13409,12972,20200322,26381
20200319,3,원당,8462,8058,20200322,16520
20200319,3,화정,12730,13206,20200322,25936
20200319,3,대곡,1341,931,20200322,2272
20200319,3,백석,7759,7835,20200322,15594
20200319,3,마두,5390,5661,20200322,11051
20200319,3,정발산,5259,5369,20200322,10628
20200319,3,주엽,6180,6365,20200322,12545
20200319,3,대화,10225,7837,20200322,18062
20200320,3,원흥,7797,7252,20200323,15049
20200320,3,삼송,14806,13871,20200323,28677
20200320,3,원당,9360,8848,20200323,18208
20200320,3,화정,14146,14775,20200323,28921
20200320,3,대곡,1540,1103,20200323,2643
20200320,3,백석,8649,8809,20200323,17458
20200320,3,마두,5982,6334,20200323,12316
20200320,3,정발산,6157,6678,20200323,12835
20200320,3,주엽,6860,7081,20200323,13941
20200320,3,대화,10977,8760,20200323,19737
20200321,3,원흥,4830,4427,20200324,9257
20200321,3,삼송,9086,8628,20200324,17714
20200321,3,원당,6109,5791,20200324,11900
20200321,3,화정,9221,9653,20200324,18874
20200321,3,대곡,978,839,20200324,1817
20200321,3,백석,5564,5626,20200324,11190
20200321,3,마두,3528,3406,20200324,6934
20200321,3,정발산,4493,4978,20200324,9471
20200321,3,주엽,4163,4232,20200324,8395
20200321,3,대화,6156,5458,20200324,11614
20200322,3,원흥,3117,3140,20200325,6257
20200322,3,삼송,6540,6426,20200325,12966
20200322,3,원당,4218,4038,20200325,8256
20200322,3,화정,6619,6817,20200325,13436
20200322,3,대곡,752,632,20200325,1384
20200322,3,백석,4089,3974,20200325,8063
20200322,3,마두,2260,2152,20200325,4412
20200322,3,정발산,3555,3519,20200325,7074
20200322,3,주엽,2728,2618,20200325,5346
20200322,3,대화,4340,3928,20200325,8268
20200323,3,원흥,7376,7062,20200326,14438
20200323,3,삼송,14149,13577,20200326,27726
20200323,3,원당,9267,8915,20200326,18182
20200323,3,화정,13692,14008,20200326,27700
20200323,3,대곡,1536,1110,20200326,2646
20200323,3,백석,8199,8265,20200326,16464
20200323,3,마두,5900,6169,20200326,12069
20200323,3,정발산,5730,5882,20200326,11612
20200323,3,주엽,6730,6963,20200326,13693
20200323,3,대화,11025,8390,20200326,19415
20200324,3,원흥,7508,7130,20200327,14638
20200324,3,삼송,14583,13995,20200327,28578
20200324,3,원당,9268,8926,20200327,18194
20200324,3,화정,14028,14418,20200327,28446
20200324,3,대곡,1468,1095,20200327,2563
20200324,3,백석,8336,8444,20200327,16780
20200324,3,마두,5884,6162,20200327,12046
20200324,3,정발산,5767,5922,20200327,11689
20200324,3,주엽,6652,6942,20200327,13594
20200324,3,대화,10933,8365,20200327,19298
20200325,3,원흥,7588,7221,20200328,14809
20200325,3,삼송,14577,13938,20200328,28515
20200325,3,원당,9372,8975,20200328,18347
20200325,3,화정,13995,14365,20200328,28360
20200325,3,대곡,1520,1186,20200328,2706
20200325,3,백석,8267,8283,20200328,16550
20200325,3,마두,6034,6312,20200328,12346
20200325,3,정발산,5853,6159,20200328,12012
20200325,3,주엽,6783,6931,20200328,13714
20200325,3,대화,10924,8580,20200328,19504
20200326,3,원흥,7458,6997,20200329,14455
20200326,3,삼송,14270,13625,20200329,27895
20200326,3,원당,9115,8750,20200329,17865
20200326,3,화정,13537,14006,20200329,27543
20200326,3,대곡,1450,1036,20200329,2486
20200326,3,백석,8224,8380,20200329,16604
20200326,3,마두,5725,5979,20200329,11704
20200326,3,정발산,5520,5699,20200329,11219
20200326,3,주엽,6565,6695,20200329,13260
20200326,3,대화,10801,8310,20200329,19111
20200327,3,원흥,7672,7042,20200330,14714
20200327,3,삼송,14616,13774,20200330,28390
20200327,3,원당,9495,8993,20200330,18488
20200327,3,화정,13995,14731,20200330,28726
20200327,3,대곡,1498,1132,20200330,2630
20200327,3,백석,8555,8694,20200330,17249
20200327,3,마두,6121,6385,20200330,12506
20200327,3,정발산,6089,6700,20200330,12789
20200327,3,주엽,6772,7062,20200330,13834
20200327,3,대화,10978,8599,20200330,19577
20200328,3,원흥,4825,4478,20200331,9303
20200328,3,삼송,9386,9000,20200331,18386
20200328,3,원당,6127,5915,20200331,12042
20200328,3,화정,9387,9804,20200331,19191
20200328,3,대곡,964,851,20200331,1815
20200328,3,백석,5739,5666,20200331,11405
20200328,3,마두,3573,3574,20200331,7147
20200328,3,정발산,4553,4941,20200331,9494
20200328,3,주엽,4257,4279,20200331,8536
20200328,3,대화,6404,5605,20200331,12009
20200329,3,원흥,3173,3076,20200401,6249
20200329,3,삼송,6643,6391,20200401,13034
20200329,3,원당,4409,4177,20200401,8586
20200329,3,화정,6624,6760,20200401,13384
20200329,3,대곡,758,629,20200401,1387
20200329,3,백석,3954,3875,20200401,7829
20200329,3,마두,2174,2146,20200401,4320
20200329,3,정발산,3555,3662,20200401,7217
20200329,3,주엽,2745,2683,20200401,5428
20200329,3,대화,4402,4018,20200401,8420
20200330,3,원흥,7680,7213,20200402,14893
20200330,3,삼송,14647,13998,20200402,28645
20200330,3,원당,9548,9155,20200402,18703
20200330,3,화정,14123,14535,20200402,28658
20200330,3,대곡,1508,1141,20200402,2649
20200330,3,백석,8438,8437,20200402,16875
20200330,3,마두,5968,6299,20200402,12267
20200330,3,정발산,5727,5914,20200402,11641
20200330,3,주엽,6975,6983,20200402,13958
20200330,3,대화,11219,8626,20200402,19845
20200331,3,원흥,7676,7262,20200403,14938
20200331,3,삼송,14751,14007,20200403,28758
20200331,3,원당,9456,8972,20200403,18428
20200331,3,화정,14285,14713,20200403,28998
20200331,3,대곡,1463,1125,20200403,2588
20200331,3,백석,8340,8464,20200403,16804
20200331,3,마두,6013,6345,20200403,12358
20200331,3,정발산,5888,6142,20200403,12030
20200331,3,주엽,6718,6826,20200403,13544
20200331,3,대화,11039,8590,20200403,19629
20200401,3,원흥,7759,7170,20200404,14929
20200401,3,지축,1,0,20200404,1
20200401,3,삼송,14650,14069,20200404,28719
20200401,3,원당,9473,9024,20200404,18497
20200401,3,화정,13941,14531,20200404,28472
20200401,3,대곡,1515,1164,20200404,2679
20200401,3,백석,8359,8374,20200404,16733
20200401,3,마두,6048,6306,20200404,12354
20200401,3,정발산,6063,6182,20200404,12245
20200401,3,주엽,6708,6808,20200404,13516
20200401,3,대화,10917,8492,20200404,19409
20200402,3,원흥,7723,7119,20200405,14842
20200402,3,삼송,14663,14104,20200405,28767
20200402,3,원당,9333,8910,20200405,18243
20200402,3,화정,14039,14462,20200405,28501
20200402,3,대곡,1545,1166,20200405,2711
20200402,3,백석,8350,8303,20200405,16653
20200402,3,마두,5862,6084,20200405,11946
20200402,3,정발산,5896,5979,20200405,11875
20200402,3,주엽,6740,6810,20200405,13550
20200402,3,대화,10922,8568,20200405,19490
20200403,3,화정,14638,15098,20200406,29736
20200403,3,원흥,7860,7229,20200406,15089
20200403,3,삼송,15349,14492,20200406,29841
20200403,3,원당,9780,9072,20200406,18852
20200403,3,대곡,1627,1268,20200406,2895
20200403,3,백석,8800,8903,20200406,17703
20200403,3,마두,6202,6514,20200406,12716
20200403,3,정발산,6324,6740,20200406,13064
20200403,3,주엽,7013,7385,20200406,14398
20200403,3,대화,10929,8855,20200406,19784
20200404,3,원흥,4916,4522,20200407,9438
20200404,3,삼송,9500,9056,20200407,18556
20200404,3,원당,6242,5951,20200407,12193
20200404,3,화정,9462,9884,20200407,19346
20200404,3,대곡,944,828,20200407,1772
20200404,3,백석,5754,5807,20200407,11561
20200404,3,마두,3567,3614,20200407,7181
20200404,3,정발산,4954,5438,20200407,10392
20200404,3,주엽,4289,4345,20200407,8634
20200404,3,대화,6490,5743,20200407,12233
20200405,3,원흥,3347,3132,20200408,6479
20200405,3,삼송,6857,6618,20200408,13475
20200405,3,원당,4442,4139,20200408,8581
20200405,3,화정,6703,6960,20200408,13663
20200405,3,대곡,744,611,20200408,1355
20200405,3,백석,4037,3941,20200408,7978
20200405,3,마두,2323,2263,20200408,4586
20200405,3,정발산,3694,3753,20200408,7447
20200405,3,주엽,2843,2732,20200408,5575
20200405,3,대화,4511,3969,20200408,8480
20200406,3,원흥,7798,7254,20200409,15052
20200406,3,삼송,14861,14559,20200409,29420
20200406,3,원당,9692,9123,20200409,18815
20200406,3,화정,14416,14969,20200409,29385
20200406,3,대곡,1623,1196,20200409,2819
20200406,3,백석,8455,8463,20200409,16918
20200406,3,마두,6217,6493,20200409,12710
20200406,3,정발산,5937,6123,20200409,12060
20200406,3,주엽,7226,7304,20200409,14530
20200406,3,대화,11400,8743,20200409,20143
20200407,3,원흥,7840,7307,20200410,15147
20200407,3,삼송,15003,14487,20200410,29490
20200407,3,원당,9594,9120,20200410,18714
20200407,3,화정,14430,14959,20200410,29389
20200407,3,대곡,1571,1225,20200410,2796
20200407,3,백석,8384,8411,20200410,16795
20200407,3,마두,6028,6280,20200410,12308
20200407,3,정발산,6043,6165,20200410,12208
20200407,3,주엽,6989,7074,20200410,14063
20200407,3,대화,11352,8815,20200410,20167
20200408,3,원흥,7834,7350,20200411,15184
20200408,3,삼송,15298,14404,20200411,29702
20200408,3,원당,9568,9233,20200411,18801
20200408,3,화정,14690,14942,20200411,29632
20200408,3,대곡,1563,1177,20200411,2740
20200408,3,백석,8315,8257,20200411,16572
20200408,3,마두,6068,6368,20200411,12436
20200408,3,정발산,6223,6513,20200411,12736
20200408,3,주엽,7106,7342,20200411,14448
20200408,3,대화,11246,8750,20200411,19996
20200409,3,화정,14267,14735,20200412,29002
20200409,3,원흥,7842,7294,20200412,15136
20200409,3,삼송,15165,14516,20200412,29681
20200409,3,원당,9592,9039,20200412,18631
20200409,3,대곡,1499,1188,20200412,2687
20200409,3,백석,8656,8561,20200412,17217
20200409,3,마두,6113,6386,20200412,12499
20200409,3,정발산,6121,6318,20200412,12439
20200409,3,주엽,6935,7051,20200412,13986
20200409,3,대화,11213,8819,20200412,20032
20200410,3,원흥,7903,7326,20200413,15229
20200410,3,삼송,15566,14631,20200413,30197
20200410,3,원당,10073,9375,20200413,19448
20200410,3,화정,14794,15462,20200413,30256
20200410,3,대곡,1576,1257,20200413,2833
20200410,3,백석,8978,9107,20200413,18085
20200410,3,마두,6469,6806,20200413,13275
20200410,3,정발산,6371,6944,20200413,13315
20200410,3,주엽,7417,7564,20200413,14981
20200410,3,대화,11610,9102,20200413,20712
20200411,3,원흥,5013,4679,20200414,9692
20200411,3,삼송,10168,9704,20200414,19872
20200411,3,원당,6763,6313,20200414,13076
20200411,3,화정,10269,10717,20200414,20986
20200411,3,대곡,1086,880,20200414,1966
20200411,3,백석,6137,6097,20200414,12234
20200411,3,마두,3705,3847,20200414,7552
20200411,3,정발산,5088,5642,20200414,10730
20200411,3,주엽,4720,4733,20200414,9453
20200411,3,대화,6726,5897,20200414,12623
20200412,3,원흥,3228,3190,20200415,6418
20200412,3,삼송,6942,6835,20200415,13777
20200412,3,원당,4593,4371,20200415,8964
20200412,3,화정,6917,7209,20200415,14126
20200412,3,대곡,802,664,20200415,1466
20200412,3,백석,4387,4241,20200415,8628
20200412,3,마두,2489,2376,20200415,4865
20200412,3,정발산,3734,3805,20200415,7539
20200412,3,주엽,3024,2984,20200415,6008
20200412,3,대화,4678,4201,20200415,8879
20200413,3,원흥,7818,7437,20200416,15255
20200413,3,삼송,15449,14642,20200416,30091
20200413,3,원당,9874,9302,20200416,19176
20200413,3,화정,14716,15242,20200416,29958
20200413,3,대곡,1593,1200,20200416,2793
20200413,3,백석,8799,8719,20200416,17518
20200413,3,마두,6322,6529,20200416,12851
20200413,3,정발산,6040,6110,20200416,12150
20200413,3,주엽,7355,7529,20200416,14884
20200413,3,대화,11671,8950,20200416,20621
20200414,3,원흥,8219,7535,20200417,15754
20200414,3,삼송,15914,14921,20200417,30835
20200414,3,원당,10110,9434,20200417,19544
20200414,3,화정,15103,15554,20200417,30657
20200414,3,대곡,1659,1278,20200417,2937
20200414,3,백석,9101,9089,20200417,18190
20200414,3,마두,6528,6644,20200417,13172
20200414,3,정발산,6269,6721,20200417,12990
20200414,3,주엽,7419,7461,20200417,14880
20200414,3,대화,11764,9278,20200417,21042
20200415,3,원흥,4573,4367,20200418,8940
20200415,3,지축,1,0,20200418,1
20200415,3,삼송,9176,8974,20200418,18150
20200415,3,원당,5884,5612,20200418,11496
20200415,3,화정,8915,9286,20200418,18201
20200415,3,대곡,974,850,20200418,1824
20200415,3,백석,5284,5183,20200418,10467
20200415,3,마두,3237,3216,20200418,6453
20200415,3,정발산,4435,4622,20200418,9057
20200415,3,주엽,3938,3965,20200418,7903
20200415,3,대화,5823,5029,20200418,10852
20200416,3,원흥,8116,7625,20200419,15741
20200416,3,삼송,15716,15019,20200419,30735
20200416,3,원당,10003,9458,20200419,19461
20200416,3,화정,14840,15251,20200419,30091
20200416,3,대곡,1597,1226,20200419,2823
20200416,3,백석,8908,8886,20200419,17794
20200416,3,마두,6467,6675,20200419,13142
20200416,3,정발산,6352,6478,20200419,12830
20200416,3,주엽,7318,7391,20200419,14709
20200416,3,대화,11592,9027,20200419,20619
20200417,3,원흥,7638,6992,20200420,14630
20200417,3,삼송,15045,14102,20200420,29147
20200417,3,원당,9514,8871,20200420,18385
20200417,3,화정,14219,14884,20200420,29103
20200417,3,대곡,1455,1127,20200420,2582
20200417,3,백석,8480,8564,20200420,17044
20200417,3,마두,6117,6433,20200420,12550
20200417,3,정발산,5846,6319,20200420,12165
20200417,3,주엽,7042,7172,20200420,14214
20200417,3,대화,11402,8697,20200420,20099
20200418,3,원흥,5559,5143,20200421,10702
20200418,3,삼송,10764,10243,20200421,21007
20200418,3,원당,7051,6651,20200421,13702
20200418,3,화정,10837,11272,20200421,22109
20200418,3,대곡,1123,978,20200421,2101
20200418,3,백석,6371,6538,20200421,12909
20200418,3,마두,3953,4019,20200421,7972
20200418,3,정발산,5561,5526,20200421,11087
20200418,3,주엽,5163,5228,20200421,10391
20200418,3,대화,7224,6192,20200421,13416
20200419,3,원흥,3345,3179,20200422,6524
20200419,3,삼송,7013,6740,20200422,13753
20200419,3,원당,4585,4428,20200422,9013
20200419,3,화정,6912,7175,20200422,14087
20200419,3,대곡,741,609,20200422,1350
20200419,3,백석,4316,4218,20200422,8534
20200419,3,마두,2469,2419,20200422,4888
20200419,3,정발산,3525,2889,20200422,6414
20200419,3,주엽,3125,3016,20200422,6141
20200419,3,대화,4700,4324,20200422,9024
20200420,3,원흥,7963,7499,20200423,15462
20200420,3,삼송,15543,14946,20200423,30489
20200420,3,원당,9922,9518,20200423,19440
20200420,3,화정,14732,15350,20200423,30082
20200420,3,대곡,1622,1212,20200423,2834
20200420,3,백석,8960,8904,20200423,17864
20200420,3,마두,6486,6692,20200423,13178
20200420,3,정발산,5875,4949,20200423,10824
20200420,3,주엽,7551,7655,20200423,15206
20200420,3,대화,11833,9085,20200423,20918
20200421,3,원흥,8259,7802,20200424,16061
20200421,3,지축,1,0,20200424,1
20200421,3,삼송,15965,15408,20200424,31373
20200421,3,원당,10134,9587,20200424,19721
20200421,3,화정,15208,15661,20200424,30869
20200421,3,대곡,1603,1235,20200424,2838
20200421,3,백석,9105,9171,20200424,18276
20200421,3,마두,6631,6874,20200424,13505
20200421,3,정발산,6179,6235,20200424,12414
20200421,3,주엽,7546,7753,20200424,15299
20200421,3,대화,11920,9398,20200424,21318
20200422,3,원흥,8132,7656,20200425,15788
20200422,3,삼송,15767,15105,20200425,30872
20200422,3,원당,10076,9666,20200425,19742
20200422,3,화정,14936,15318,20200425,30254
20200422,3,대곡,1604,1191,20200425,2795
20200422,3,백석,8789,8847,20200425,17636
20200422,3,마두,6548,6830,20200425,13378
20200422,3,정발산,6191,6320,20200425,12511
20200422,3,주엽,7298,7528,20200425,14826
20200422,3,대화,11554,8974,20200425,20528
20200423,3,원흥,8406,7758,20200426,16164
20200423,3,삼송,16261,15659,20200426,31920
20200423,3,원당,10239,9820,20200426,20059
20200423,3,화정,15251,15674,20200426,30925
20200423,3,대곡,1707,1243,20200426,2950
20200423,3,백석,9320,9329,20200426,18649
20200423,3,마두,6568,6874,20200426,13442
20200423,3,정발산,6270,6398,20200426,12668
20200423,3,주엽,7692,7754,20200426,15446
20200423,3,대화,11863,9318,20200426,21181
20200424,3,원흥,8578,7676,20200427,16254
20200424,3,지축,1,0,20200427,1
20200424,3,삼송,16705,15749,20200427,32454
20200424,3,원당,10487,9804,20200427,20291
20200424,3,화정,15861,16486,20200427,32347
20200424,3,대곡,1759,1370,20200427,3129
20200424,3,백석,9633,9862,20200427,19495
20200424,3,마두,6930,7194,20200427,14124
20200424,3,정발산,6537,7238,20200427,13775
20200424,3,주엽,7955,8043,20200427,15998
20200424,3,대화,12327,9416,20200427,21743
20200425,3,원흥,5563,5133,20200428,10696
20200425,3,삼송,11621,10999,20200428,22620
20200425,3,원당,7502,7019,20200428,14521
20200425,3,화정,11408,11762,20200428,23170
20200425,3,대곡,1070,967,20200428,2037
20200425,3,백석,6792,6842,20200428,13634
20200425,3,마두,4203,4320,20200428,8523
20200425,3,정발산,5423,5817,20200428,11240
20200425,3,주엽,5176,5203,20200428,10379
20200425,3,대화,7632,6458,20200428,14090
20200426,3,원흥,3945,3792,20200429,7737
20200426,3,삼송,8485,8315,20200429,16800
20200426,3,원당,5526,5265,20200429,10791
20200426,3,화정,8145,8534,20200429,16679
20200426,3,대곡,938,792,20200429,1730
20200426,3,백석,5053,5040,20200429,10093
20200426,3,마두,2819,2798,20200429,5617
20200426,3,정발산,4482,4547,20200429,9029
20200426,3,주엽,3606,3536,20200429,7142
20200426,3,대화,5456,4928,20200429,10384
20200427,3,원흥,8479,7910,20200430,16389
20200427,3,삼송,16495,15884,20200430,32379
20200427,3,원당,10616,10120,20200430,20736
20200427,3,화정,15663,16097,20200430,31760
20200427,3,대곡,1733,1326,20200430,3059
20200427,3,백석,9453,9439,20200430,18892
20200427,3,마두,6957,7207,20200430,14164
20200427,3,정발산,6381,6530,20200430,12911
20200427,3,주엽,8093,8140,20200430,16233
20200427,3,대화,12408,9464,20200430,21872
20200428,3,원흥,8688,8024,20200501,16712
20200428,3,삼송,16741,16092,20200501,32833
20200428,3,원당,10833,10264,20200501,21097
20200428,3,화정,16016,16605,20200501,32621
20200428,3,대곡,1792,1362,20200501,3154
20200428,3,백석,9763,9781,20200501,19544
20200428,3,마두,7156,7330,20200501,14486
20200428,3,정발산,6699,6812,20200501,13511
20200428,3,주엽,8041,8108,20200501,16149
20200428,3,대화,12558,9793,20200501,22351
20200429,3,원흥,8864,8122,20200502,16986
20200429,3,삼송,17288,16190,20200502,33478
20200429,3,원당,11051,10250,20200502,21301
20200429,3,화정,16675,16990,20200502,33665
20200429,3,대곡,1768,1340,20200502,3108
20200429,3,백석,9964,10030,20200502,19994
20200429,3,마두,7542,7812,20200502,15354
20200429,3,정발산,7060,7653,20200502,14713
20200429,3,주엽,8127,8108,20200502,16235
20200429,3,대화,12845,9943,20200502,22788
20200430,3,원흥,5207,4826,20200503,10033
20200430,3,삼송,10849,10200,20200503,21049
20200430,3,원당,7050,6740,20200503,13790
20200430,3,화정,10413,10567,20200503,20980
20200430,3,대곡,1139,972,20200503,2111
20200430,3,백석,6132,6080,20200503,12212
20200430,3,마두,3909,3921,20200503,7830
20200430,3,정발산,5468,5723,20200503,11191
20200430,3,주엽,4812,4838,20200503,9650
20200430,3,대화,6989,6001,20200503,12990
20200501,3,대화,7824,6713,20200504,14537
20200501,3,주엽,5647,5615,20200504,11262
20200501,3,정발산,5673,6092,20200504,11765
20200501,3,마두,4718,4896,20200504,9614
20200501,3,백석,6670,6583,20200504,13253
20200501,3,대곡,1089,946,20200504,2035
20200501,3,화정,11848,12371,20200504,24219
20200501,3,원당,7752,7310,20200504,15062
20200501,3,삼송,11479,10791,20200504,22270
20200501,3,원흥,5718,5243,20200504,10961
20200502,3,원흥,5198,4901,20200505,10099
20200502,3,삼송,10655,10219,20200505,20874
20200502,3,원당,7025,6626,20200505,13651
20200502,3,화정,10866,11284,20200505,22150
20200502,3,대곡,1069,884,20200505,1953
20200502,3,대화,7148,6202,20200505,13350
20200502,3,주엽,5071,5024,20200505,10095
20200502,3,정발산,5388,5921,20200505,11309
20200502,3,마두,4155,4151,20200505,8306
20200502,3,백석,6314,6418,20200505,12732
20200503,3,대화,5461,5010,20200506,10471
20200503,3,주엽,3765,3723,20200506,7488
20200503,3,정발산,4558,4698,20200506,9256
20200503,3,마두,2977,2981,20200506,5958
20200503,3,백석,4906,4861,20200506,9767
20200503,3,대곡,928,816,20200506,1744
20200503,3,화정,8350,8646,20200506,16996
20200503,3,원당,5562,5223,20200506,10785
20200503,3,삼송,8718,8445,20200506,17163
20200503,3,원흥,4010,3907,20200506,7917
20200504,3,대곡,1566,1182,20200507,2748
20200504,3,화정,15328,15629,20200507,30957
20200504,3,원당,9982,9318,20200507,19300
20200504,3,삼송,15193,14559,20200507,29752
20200504,3,원흥,7818,7120,20200507,14938
20200504,3,대화,11290,9102,20200507,20392
20200504,3,주엽,7593,7614,20200507,15207
20200504,3,정발산,6857,7171,20200507,14028
20200504,3,마두,6754,6891,20200507,13645
20200504,3,백석,9168,9128,20200507,18296
20200505,3,대화,6187,5396,20200508,11583
20200505,3,주엽,4378,4299,20200508,8677
20200505,3,정발산,4993,5191,20200508,10184
20200505,3,마두,3399,3473,20200508,6872
20200505,3,백석,5430,5453,20200508,10883
20200505,3,대곡,994,843,20200508,1837
20200505,3,화정,9181,9539,20200508,18720
20200505,3,원당,6425,6037,20200508,12462
20200505,3,삼송,9991,9570,20200508,19561
20200505,3,원흥,4676,4421,20200508,9097
20200506,3,삼송,17386,16755,20200509,34141
20200506,3,원당,11255,10580,20200509,21835
20200506,3,화정,16982,17345,20200509,34327
20200506,3,대곡,1763,1365,20200509,3128
20200506,3,백석,10068,9908,20200509,19976
20200506,3,마두,7618,7815,20200509,15433
20200506,3,정발산,7166,7502,20200509,14668
20200506,3,주엽,8727,8827,20200509,17554
20200506,3,대화,13181,10264,20200509,23445
20200506,3,원흥,8984,8357,20200509,17341
20200507,3,원흥,9226,8606,20200510,17832
20200507,3,삼송,17727,16902,20200510,34629
20200507,3,원당,11382,10869,20200510,22251
20200507,3,화정,17249,17586,20200510,34835
20200507,3,대곡,1825,1367,20200510,3192
20200507,3,백석,10217,10096,20200510,20313
20200507,3,마두,7567,7825,20200510,15392
20200507,3,정발산,7395,7484,20200510,14879
20200507,3,주엽,8751,8771,20200510,17522
20200507,3,대화,13410,10335,20200510,23745
20200508,3,원흥,9084,8455,20200511,17539
20200508,3,삼송,18090,17523,20200511,35613
20200508,3,원당,11519,11110,20200511,22629
20200508,3,화정,17085,17982,20200511,35067
20200508,3,대곡,1887,1435,20200511,3322
20200508,3,백석,10362,10797,20200511,21159
20200508,3,마두,7682,8221,20200511,15903
20200508,3,정발산,7309,7894,20200511,15203
20200508,3,주엽,8685,9228,20200511,17913
20200508,3,대화,14405,11945,20200511,26350
20200509,3,원흥,5253,4985,20200512,10238
20200509,3,삼송,10835,10191,20200512,21026
20200509,3,원당,6803,6476,20200512,13279
20200509,3,화정,10646,10110,20200512,20756
20200509,3,대곡,969,786,20200512,1755
20200509,3,백석,6557,6523,20200512,13080
20200509,3,마두,4130,4185,20200512,8315
20200509,3,정발산,4868,5504,20200512,10372
20200509,3,주엽,5114,4973,20200512,10087
20200509,3,대화,8429,7400,20200512,15829
20200510,3,원흥,4252,4153,20200513,8405
20200510,3,삼송,9129,8687,20200513,17816
20200510,3,원당,6066,5737,20200513,11803
20200510,3,화정,8910,8341,20200513,17251
20200510,3,대곡,969,783,20200513,1752
20200510,3,백석,5294,5219,20200513,10513
20200510,3,마두,3036,3065,20200513,6101
20200510,3,정발산,4919,4890,20200513,9809
20200510,3,주엽,3944,3933,20200513,7877
20200510,3,대화,7190,6566,20200513,13756
20200511,3,대화,14200,11297,20200514,25497
20200511,3,정발산,6814,7332,20200514,14146
20200511,3,마두,7596,7892,20200514,15488
20200511,3,백석,10097,10011,20200514,20108
20200511,3,대곡,1977,1429,20200514,3406
20200511,3,화정,16764,17196,20200514,33960
20200511,3,원당,11262,10700,20200514,21962
20200511,3,삼송,17367,16794,20200514,34161
20200511,3,원흥,8946,8486,20200514,17432
20200511,3,주엽,8798,8812,20200514,17610
20200512,3,원흥,8822,8313,20200515,17135
20200512,3,삼송,17187,16505,20200515,33692
20200512,3,원당,10947,10407,20200515,21354
20200512,3,화정,16697,17104,20200515,33801
20200512,3,대곡,1912,1433,20200515,3345
20200512,3,백석,9898,9774,20200515,19672
20200512,3,마두,7246,7593,20200515,14839
20200512,3,정발산,6771,7062,20200515,13833
20200512,3,주엽,8364,8562,20200515,16926
20200512,3,대화,13206,10174,20200515,23380
20200513,3,원흥,9026,8523,20200516,17549
20200513,3,삼송,17292,16702,20200516,33994
20200513,3,원당,11099,10567,20200516,21666
20200513,3,화정,16764,17226,20200516,33990
20200513,3,대곡,1893,1420,20200516,3313
20200513,3,백석,9860,9909,20200516,19769
20200513,3,마두,7419,7718,20200516,15137
20200513,3,정발산,7300,7635,20200516,14935
20200513,3,주엽,8515,8774,20200516,17289
20200513,3,대화,12973,10074,20200516,23047
20200514,3,대화,12925,10018,20200517,22943
20200514,3,주엽,8491,8592,20200517,17083
20200514,3,정발산,7038,7353,20200517,14391
20200514,3,마두,7259,7517,20200517,14776
20200514,3,백석,10031,10044,20200517,20075
20200514,3,대곡,1891,1457,20200517,3348
20200514,3,화정,16639,16992,20200517,33631
20200514,3,원당,11004,10435,20200517,21439
20200514,3,삼송,17317,16555,20200517,33872
20200514,3,원흥,9053,8487,20200517,17540
20200515,3,원흥,8551,7842,20200518,16393
20200515,3,삼송,16707,15915,20200518,32622
20200515,3,원당,10510,9884,20200518,20394
20200515,3,화정,15821,16561,20200518,32382
20200515,3,대곡,1646,1281,20200518,2927
20200515,3,백석,9666,9741,20200518,19407
20200515,3,마두,7153,7361,20200518,14514
20200515,3,정발산,6595,7375,20200518,13970
20200515,3,주엽,8022,8325,20200518,16347
20200515,3,대화,12732,10005,20200518,22737
20200516,3,대화,7915,6818,20200519,14733
20200516,3,주엽,5663,5657,20200519,11320
20200516,3,정발산,5583,6103,20200519,11686
20200516,3,마두,4548,4600,20200519,9148
20200516,3,백석,6956,7003,20200519,13959
20200516,3,대곡,1129,919,20200519,2048
20200516,3,화정,11605,12018,20200519,23623
20200516,3,원당,7558,7149,20200519,14707
20200516,3,삼송,11546,11072,20200519,22618
20200516,3,원흥,5606,5399,20200519,11005
20200517,3,대화,5761,5031,20200520,10792
20200517,3,주엽,3892,3833,20200520,7725
20200517,3,정발산,4808,4981,20200520,9789
20200517,3,마두,3013,3044,20200520,6057
20200517,3,백석,5107,5111,20200520,10218
20200517,3,대곡,952,862,20200520,1814
20200517,3,화정,8564,8806,20200520,17370
20200517,3,원당,5976,5720,20200520,11696
20200517,3,삼송,8810,8411,20200520,17221
20200517,3,원흥,4194,4038,20200520,8232
20200518,3,원흥,8414,7943,20200521,16357
20200518,3,삼송,16225,15937,20200521,32162
20200518,3,원당,10431,9848,20200521,20279
20200518,3,화정,15496,16081,20200521,31577
20200518,3,대곡,1717,1223,20200521,2940
20200518,3,백석,9243,9473,20200521,18716
20200518,3,마두,6951,7346,20200521,14297
20200518,3,정발산,6396,6439,20200521,12835
20200518,3,주엽,8050,8145,20200521,16195
20200518,3,대화,12585,9820,20200521,22405
20200519,3,원흥,8389,7931,20200522,16320
20200519,3,삼송,16499,15900,20200522,32399
20200519,3,원당,10502,9952,20200522,20454
20200519,3,화정,15914,16535,20200522,32449
20200519,3,대곡,1618,1209,20200522,2827
20200519,3,백석,9632,9538,20200522,19170
20200519,3,마두,6908,7250,20200522,14158
20200519,3,정발산,6605,6890,20200522,13495
20200519,3,주엽,8112,8310,20200522,16422
20200519,3,대화,12694,9618,20200522,22312
20200520,3,대화,13343,10412,20200523,23755
20200520,3,주엽,8861,8915,20200523,17776
20200520,3,정발산,7479,7729,20200523,15208
20200520,3,마두,7597,7866,20200523,15463
20200520,3,백석,10183,10240,20200523,20423
20200520,3,대곡,1925,1419,20200523,3344
20200520,3,화정,17361,17899,20200523,35260
20200520,3,원당,11473,10938,20200523,22411
20200520,3,삼송,17577,17105,20200523,34682
20200520,3,원흥,9301,8654,20200523,17955
20200521,3,대화,13526,10397,20200524,23923
20200521,3,주엽,8658,8808,20200524,17466
20200521,3,정발산,7369,7532,20200524,14901
20200521,3,마두,7420,7762,20200524,15182
20200521,3,백석,10215,10068,20200524,20283
20200521,3,대곡,1896,1423,20200524,3319
20200521,3,화정,17222,17833,20200524,35055
20200521,3,원당,11365,10790,20200524,22155
20200521,3,삼송,17724,17048,20200524,34772
20200521,3,원흥,9225,8595,20200524,17820
20200522,3,원흥,9243,8316,20200525,17559
20200522,3,삼송,17673,16883,20200525,34556
20200522,3,원당,11517,10774,20200525,22291
20200522,3,화정,17013,17987,20200525,35000
20200522,3,대곡,1881,1448,20200525,3329
20200522,3,백석,10298,10456,20200525,20754
20200522,3,마두,7623,7918,20200525,15541
20200522,3,정발산,7306,8103,20200525,15409
20200522,3,주엽,8886,8902,20200525,17788
20200522,3,대화,13528,10719,20200525,24247
20200523,3,원흥,6116,5800,20200526,11916
20200523,3,삼송,12534,11981,20200526,24515
20200523,3,원당,8308,7865,20200526,16173
20200523,3,화정,12696,13170,20200526,25866
20200523,3,대곡,1352,1124,20200526,2476
20200523,3,백석,7481,7550,20200526,15031
20200523,3,마두,4901,5041,20200526,9942
20200523,3,정발산,6542,6999,20200526,13541
20200523,3,주엽,5972,5956,20200526,11928
20200523,3,대화,8734,7534,20200526,16268
20200524,3,화정,8408,7835,20200527,16243
20200524,3,원당,5497,5238,20200527,10735
20200524,3,삼송,8577,8379,20200527,16956
20200524,3,원흥,4016,3903,20200527,7919
20200524,3,대화,5477,4965,20200527,10442
20200524,3,주엽,3675,3625,20200527,7300
20200524,3,정발산,4533,4476,20200527,9009
20200524,3,마두,2908,2875,20200527,5783
20200524,3,백석,5071,4958,20200527,10029
20200524,3,대곡,893,752,20200527,1645
20200525,3,대화,13626,10431,20200528,24057
20200525,3,주엽,8920,8923,20200528,17843
20200525,3,정발산,7091,7260,20200528,14351
20200525,3,마두,7669,7940,20200528,15609
20200525,3,백석,10040,10035,20200528,20075
20200525,3,대곡,1938,1436,20200528,3374
20200525,3,화정,17175,17697,20200528,34872
20200525,3,원당,11328,10821,20200528,22149
20200525,3,삼송,17487,16939,20200528,34426
20200525,3,원흥,9107,8472,20200528,17579
20200526,3,대화,13202,10186,20200529,23388
20200526,3,주엽,8551,8768,20200529,17319
20200526,3,정발산,6906,7082,20200529,13988
20200526,3,마두,7453,7685,20200529,15138
20200526,3,백석,10012,10065,20200529,20077
20200526,3,대곡,1906,1439,20200529,3345
20200526,3,화정,16815,17390,20200529,34205
20200526,3,원당,11258,10596,20200529,21854
20200526,3,삼송,17281,16923,20200529,34204
20200526,3,원흥,8885,8391,20200529,17276
20200527,3,마두,7704,8096,20200530,15800
20200527,3,정발산,7715,7942,20200530,15657
20200527,3,주엽,8906,8890,20200530,17796
20200527,3,대화,13565,10576,20200530,24141
20200527,3,백석,10130,9934,20200530,20064
20200527,3,대곡,1895,1422,20200530,3317
20200527,3,화정,17755,18082,20200530,35837
20200527,3,원당,11432,10887,20200530,22319
20200527,3,삼송,17873,17094,20200530,34967
20200527,3,원흥,9194,8620,20200530,17814
20200528,3,대화,13331,10323,20200531,23654
20200528,3,주엽,8716,8850,20200531,17566
20200528,3,정발산,7048,7333,20200531,14381
20200528,3,마두,7405,7753,20200531,15158
20200528,3,백석,9960,9952,20200531,19912
20200528,3,대곡,1831,1436,20200531,3267
20200528,3,화정,17143,17609,20200531,34752
20200528,3,원당,11202,10623,20200531,21825
20200528,3,삼송,17474,17083,20200531,34557
20200528,3,원흥,9101,8407,20200531,17508
20200529,3,원흥,9102,8321,20200601,17423
20200529,3,삼송,17677,16767,20200601,34444
20200529,3,원당,11366,10791,20200601,22157
20200529,3,화정,17411,18061,20200601,35472
20200529,3,대곡,1862,1435,20200601,3297
20200529,3,백석,10121,10203,20200601,20324
20200529,3,마두,7624,7786,20200601,15410
20200529,3,정발산,7422,8055,20200601,15477
20200529,3,주엽,8710,8860,20200601,17570
20200529,3,대화,13514,10538,20200601,24052
20200530,3,원흥,5850,5498,20200602,11348
20200530,3,삼송,11860,11361,20200602,23221
20200530,3,원당,7965,7566,20200602,15531
20200530,3,화정,12216,12693,20200602,24909
20200530,3,대곡,1230,1106,20200602,2336
20200530,3,백석,7212,7184,20200602,14396
20200530,3,마두,4615,4558,20200602,9173
20200530,3,정발산,6042,6652,20200602,12694
20200530,3,주엽,5916,5962,20200602,11878
20200530,3,대화,8305,7184,20200602,15489
20200531,3,대화,5651,5135,20200603,10786
20200531,3,주엽,3838,3765,20200603,7603
20200531,3,정발산,4742,4716,20200603,9458
20200531,3,마두,3022,3001,20200603,6023
20200531,3,백석,5017,4957,20200603,9974
20200531,3,대곡,936,810,20200603,1746
20200531,3,화정,8659,8817,20200603,17476
20200531,3,원당,5742,5507,20200603,11249
20200531,3,삼송,8597,8166,20200603,16763
20200531,3,원흥,4064,3941,20200603,8005
20200101,1,신창,792,938,20200104,1730
20200101,1,온양온천,4010,3941,20200104,7951
20200101,1,배방,613,789,20200104,1402
20200101,1,아산,2511,1612,20200104,4123
20200101,1,쌍용,1124,1123,20200104,2247
20200101,1,봉명,612,628,20200104,1240
20200102,1,봉명,1246,1249,20200105,2495
20200102,1,쌍용,1913,1769,20200105,3682
20200102,1,아산,2688,2255,20200105,4943
20200102,1,배방,950,878,20200105,1828
20200102,1,온양온천,4370,4495,20200105,8865
20200102,1,신창,1137,1311,20200105,2448
20200103,1,봉명,1383,1317,20200106,2700
20200103,1,쌍용,2181,1973,20200106,4154
20200103,1,아산,3160,2952,20200106,6112
20200103,1,배방,1133,996,20200106,2129
20200103,1,온양온천,5042,4938,20200106,9980
20200103,1,신창,1413,1147,20200106,2560
20200104,1,봉명,998,967,20200107,1965
20200104,1,쌍용,1936,1703,20200107,3639
20200104,1,아산,2790,2639,20200107,5429
20200104,1,배방,1126,982,20200107,2108
20200104,1,온양온천,6678,6862,20200107,13540
20200104,1,신창,1078,999,20200107,2077
20200105,1,봉명,724,661,20200108,1385
20200105,1,쌍용,1269,1372,20200108,2641
20200105,1,아산,2880,2064,20200108,4944
20200105,1,배방,754,898,20200108,1652
20200105,1,온양온천,4790,4661,20200108,9451
20200105,1,신창,894,1020,20200108,1914
20200106,1,봉명,1446,1384,20200109,2830
20200106,1,쌍용,1901,1792,20200109,3693
20200106,1,아산,2716,2317,20200109,5033
20200106,1,배방,950,913,20200109,1863
20200106,1,온양온천,4196,4317,20200109,8513
20200106,1,신창,1142,1261,20200109,2403
20200107,1,쌍용,1813,1647,20200110,3460
20200107,1,봉명,1240,1265,20200110,2505
20200107,1,아산,2342,2096,20200110,4438
20200107,1,배방,844,832,20200110,1676
20200107,1,온양온천,3764,3750,20200110,7514
20200107,1,신창,1020,971,20200110,1991
20200108,1,봉명,1356,1328,20200111,2684
20200108,1,쌍용,1867,1734,20200111,3601
20200108,1,아산,2595,2272,20200111,4867
20200108,1,배방,942,956,20200111,1898
20200108,1,온양온천,3893,3937,20200111,7830
20200108,1,신창,1070,1048,20200111,2118
20200109,1,봉명,1389,1394,20200112,2783
20200109,1,쌍용,2166,2007,20200112,4173
20200109,1,아산,2699,2276,20200112,4975
20200109,1,배방,1060,1058,20200112,2118
20200109,1,온양온천,5424,5454,20200112,10878
20200109,1,신창,1097,1130,20200112,2227
20200110,1,봉명,1332,1307,20200113,2639
20200110,1,쌍용,2238,1958,20200113,4196
20200110,1,아산,3294,3015,20200113,6309
20200110,1,배방,1173,1016,20200113,2189
20200110,1,온양온천,5089,4846,20200113,9935
20200110,1,신창,1487,1054,20200113,2541
20200111,1,봉명,964,926,20200114,1890
20200111,1,쌍용,1946,1802,20200114,3748
20200111,1,아산,3110,2915,20200114,6025
20200111,1,배방,1186,1031,20200114,2217
20200111,1,온양온천,5694,5726,20200114,11420
20200111,1,신창,1124,973,20200114,2097
20200112,1,봉명,799,772,20200115,1571
20200112,1,쌍용,1347,1311,20200115,2658
20200112,1,아산,2812,2155,20200115,4967
20200112,1,배방,792,866,20200115,1658
20200112,1,온양온천,4918,4859,20200115,9777
20200112,1,신창,877,1076,20200115,1953
20200113,1,봉명,1358,1358,20200116,2716
20200113,1,쌍용,1990,1825,20200116,3815
20200113,1,아산,2776,2404,20200116,5180
20200113,1,배방,981,959,20200116,1940
20200113,1,온양온천,4355,4489,20200116,8844
20200113,1,신창,1165,1284,20200116,2449
20200114,1,신창,1137,1326,20200117,2463
20200114,1,온양온천,5492,5559,20200117,11051
20200114,1,배방,1008,930,20200117,1938
20200114,1,아산,2578,2303,20200117,4881
20200114,1,쌍용,2061,1936,20200117,3997
20200114,1,봉명,1486,1421,20200117,2907
20200115,1,봉명,1407,1431,20200118,2838
20200115,1,쌍용,2058,1807,20200118,3865
20200115,1,아산,2648,2414,20200118,5062
20200115,1,배방,1025,942,20200118,1967
20200115,1,온양온천,4272,4246,20200118,8518
20200115,1,신창,1363,1042,20200118,2405
20200116,1,신창,1231,1121,20200119,2352
20200116,1,온양온천,4416,4410,20200119,8826
20200116,1,배방,968,936,20200119,1904
20200116,1,아산,2615,2370,20200119,4985
20200116,1,쌍용,2074,1890,20200119,3964
20200116,1,봉명,1332,1342,20200119,2674
20200117,1,봉명,1409,1349,20200120,2758
20200117,1,쌍용,2061,1950,20200120,4011
20200117,1,아산,3234,2860,20200120,6094
20200117,1,배방,1186,1042,20200120,2228
20200117,1,온양온천,4707,4709,20200120,9416
20200117,1,신창,1486,1094,20200120,2580
20200118,1,봉명,1028,935,20200121,1963
20200118,1,쌍용,1908,1657,20200121,3565
20200118,1,아산,2838,2627,20200121,5465
20200118,1,배방,1085,984,20200121,2069
20200118,1,온양온천,5648,5622,20200121,11270
20200118,1,신창,1177,1006,20200121,2183
20200119,1,봉명,876,860,20200122,1736
20200119,1,쌍용,1470,1481,20200122,2951
20200119,1,아산,2726,2105,20200122,4831
20200119,1,배방,817,911,20200122,1728
20200119,1,온양온천,6011,6155,20200122,12166
20200119,1,신창,875,1057,20200122,1932
20200120,1,신창,1210,1208,20200123,2418
20200120,1,온양온천,4545,4652,20200123,9197
20200120,1,배방,986,961,20200123,1947
20200120,1,아산,2765,2506,20200123,5271
20200120,1,쌍용,2003,1919,20200123,3922
20200120,1,봉명,1432,1406,20200123,2838
20200121,1,봉명,1366,1324,20200124,2690
20200121,1,쌍용,2074,1877,20200124,3951
20200121,1,아산,2597,2444,20200124,5041
20200121,1,배방,1014,939,20200124,1953
20200121,1,온양온천,4459,4438,20200124,8897
20200121,1,신창,1217,1122,20200124,2339
20200122,1,봉명,1353,1255,20200125,2608
20200122,1,쌍용,1945,1760,20200125,3705
20200122,1,아산,2662,2644,20200125,5306
20200122,1,배방,990,921,20200125,1911
20200122,1,온양온천,4133,4296,20200125,8429
20200122,1,신창,1215,961,20200125,2176
20200123,1,봉명,894,869,20200126,1763
20200123,1,쌍용,2036,1927,20200126,3963
20200123,1,아산,3086,3372,20200126,6458
20200123,1,배방,1057,1124,20200126,2181
20200123,1,온양온천,4580,5164,20200126,9744
20200123,1,신창,1333,1309,20200126,2642
20200124,1,신창,1029,1852,20200127,2881
20200124,1,온양온천,4689,5762,20200127,10451
20200124,1,배방,723,878,20200127,1601
20200124,1,아산,2125,2381,20200127,4506
20200124,1,쌍용,1363,1275,20200127,2638
20200124,1,봉명,617,610,20200127,1227
20200125,1,봉명,637,558,20200128,1195
20200125,1,쌍용,1142,1104,20200128,2246
20200125,1,아산,2196,1756,20200128,3952
20200125,1,배방,831,695,20200128,1526
20200125,1,온양온천,4031,3857,20200128,7888
20200125,1,신창,1603,1011,20200128,2614
20200126,1,봉명,587,632,20200129,1219
20200126,1,쌍용,1149,1012,20200129,2161
20200126,1,아산,2400,1716,20200129,4116
20200126,1,배방,843,691,20200129,1534
20200126,1,온양온천,4814,4454,20200129,9268
20200126,1,신창,1363,917,20200129,2280
20200127,1,봉명,936,953,20200130,1889
20200127,1,쌍용,1246,1190,20200130,2436
20200127,1,아산,2835,1807,20200130,4642
20200127,1,배방,727,829,20200130,1556
20200127,1,온양온천,4955,4509,20200130,9464
20200127,1,신창,992,997,20200130,1989
20200128,1,봉명,1250,1199,20200131,2449
20200128,1,쌍용,1705,1599,20200131,3304
20200128,1,아산,2848,2211,20200131,5059
20200128,1,배방,849,845,20200131,1694
20200128,1,온양온천,3988,3994,20200131,7982
20200128,1,신창,888,1036,20200131,1924
20200129,1,봉명,1212,1183,20200201,2395
20200129,1,쌍용,1965,1811,20200201,3776
20200129,1,아산,2400,2121,20200201,4521
20200129,1,배방,868,867,20200201,1735
20200129,1,온양온천,3878,3897,20200201,7775
20200129,1,신창,940,948,20200201,1888
20200130,1,신창,926,855,20200202,1781
20200130,1,온양온천,3537,3554,20200202,7091
20200130,1,배방,893,798,20200202,1691
20200130,1,아산,2386,2134,20200202,4520
20200130,1,쌍용,1791,1687,20200202,3478
20200130,1,봉명,1261,1215,20200202,2476
20200131,1,봉명,1159,1139,20200203,2298
20200131,1,쌍용,1815,1651,20200203,3466
20200131,1,아산,2569,2414,20200203,4983
20200131,1,배방,977,873,20200203,1850
20200131,1,온양온천,3555,3559,20200203,7114
20200131,1,신창,1120,902,20200203,2022
20200201,1,봉명,707,677,20200204,1384
20200201,1,쌍용,1302,1184,20200204,2486
20200201,1,아산,1996,1931,20200204,3927
20200201,1,배방,728,629,20200204,1357
20200201,1,온양온천,3225,3160,20200204,6385
20200201,1,신창,744,733,20200204,1477
20200202,1,봉명,518,479,20200205,997
20200202,1,쌍용,960,943,20200205,1903
20200202,1,아산,1846,1452,20200205,3298
20200202,1,배방,536,640,20200205,1176
20200202,1,온양온천,2673,2777,20200205,5450
20200202,1,신창,604,737,20200205,1341
20200203,1,봉명,1197,1135,20200206,2332
20200203,1,쌍용,1582,1521,20200206,3103
20200203,1,아산,2214,1957,20200206,4171
20200203,1,배방,772,766,20200206,1538
20200203,1,온양온천,2885,3016,20200206,5901
20200203,1,신창,899,934,20200206,1833
20200204,1,봉명,1238,1208,20200207,2446
20200204,1,쌍용,1661,1517,20200207,3178
20200204,1,아산,2005,1883,20200207,3888
20200204,1,배방,774,715,20200207,1489
20200204,1,온양온천,3298,3277,20200207,6575
20200204,1,신창,833,760,20200207,1593
20200205,1,봉명,1074,1071,20200208,2145
20200205,1,쌍용,1491,1363,20200208,2854
20200205,1,아산,1997,1796,20200208,3793
20200205,1,배방,714,694,20200208,1408
20200205,1,온양온천,2586,2591,20200208,5177
20200205,1,신창,732,737,20200208,1469
20200206,1,봉명,1056,1017,20200209,2073
20200206,1,쌍용,1514,1433,20200209,2947
20200206,1,아산,2076,1852,20200209,3928
20200206,1,배방,739,722,20200209,1461
20200206,1,온양온천,2761,2740,20200209,5501
20200206,1,신창,821,757,20200209,1578
20200207,1,봉명,1070,1033,20200210,2103
20200207,1,쌍용,1763,1638,20200210,3401
20200207,1,아산,2374,2361,20200210,4735
20200207,1,배방,919,730,20200210,1649
20200207,1,온양온천,3081,3123,20200210,6204
20200207,1,신창,1055,784,20200210,1839
20200208,1,봉명,660,606,20200211,1266
20200208,1,쌍용,1345,1163,20200211,2508
20200208,1,아산,2024,1929,20200211,3953
20200208,1,배방,767,716,20200211,1483
20200208,1,온양온천,3089,3139,20200211,6228
20200208,1,신창,702,699,20200211,1401
20200209,1,봉명,534,516,20200212,1050
20200209,1,쌍용,959,916,20200212,1875
20200209,1,아산,1919,1537,20200212,3456
20200209,1,배방,586,677,20200212,1263
20200209,1,온양온천,3182,3196,20200212,6378
20200209,1,신창,631,807,20200212,1438
20200210,1,봉명,1175,1135,20200213,2310
20200210,1,쌍용,1686,1537,20200213,3223
20200210,1,아산,2213,1986,20200213,4199
20200210,1,배방,810,817,20200213,1627
20200210,1,온양온천,3284,3390,20200213,6674
20200210,1,신창,924,963,20200213,1887
20200211,1,봉명,1164,1182,20200214,2346
20200211,1,쌍용,1678,1521,20200214,3199
20200211,1,아산,2148,1997,20200214,4145
20200211,1,배방,800,794,20200214,1594
20200211,1,온양온천,3193,3267,20200214,6460
20200211,1,신창,875,874,20200214,1749
20200212,1,봉명,1045,1045,20200215,2090
20200212,1,쌍용,1602,1512,20200215,3114
20200212,1,아산,2064,1919,20200215,3983
20200212,1,배방,785,770,20200215,1555
20200212,1,온양온천,2867,2878,20200215,5745
20200212,1,신창,872,797,20200215,1669
20200213,1,봉명,1130,1131,20200216,2261
20200213,1,쌍용,1918,1706,20200216,3624
20200213,1,아산,2245,2071,20200216,4316
20200213,1,배방,800,771,20200216,1571
20200213,1,온양온천,3272,3291,20200216,6563
20200213,1,신창,899,837,20200216,1736
20200214,1,봉명,1161,1145,20200217,2306
20200214,1,쌍용,2009,1808,20200217,3817
20200214,1,아산,2841,2724,20200217,5565
20200214,1,배방,1005,932,20200217,1937
20200214,1,온양온천,4312,4289,20200217,8601
20200214,1,신창,1206,944,20200217,2150
20200215,1,봉명,754,714,20200218,1468
20200215,1,쌍용,1554,1367,20200218,2921
20200215,1,아산,2586,2451,20200218,5037
20200215,1,배방,921,838,20200218,1759
20200215,1,온양온천,3839,3940,20200218,7779
20200215,1,신창,908,815,20200218,1723
20200216,1,봉명,534,520,20200219,1054
20200216,1,쌍용,1000,1065,20200219,2065
20200216,1,아산,2309,1702,20200219,4011
20200216,1,배방,589,714,20200219,1303
20200216,1,온양온천,3147,3250,20200219,6397
20200216,1,신창,690,808,20200219,1498
20200217,1,봉명,1503,1350,20200220,2853
20200217,1,쌍용,2180,2075,20200220,4255
20200217,1,아산,3137,2686,20200220,5823
20200217,1,배방,953,988,20200220,1941
20200217,1,온양온천,3326,3619,20200220,6945
20200217,1,신창,937,952,20200220,1889
20200218,1,봉명,1340,1321,20200221,2661
20200218,1,쌍용,2014,1822,20200221,3836
20200218,1,아산,2537,2330,20200221,4867
20200218,1,배방,930,830,20200221,1760
20200218,1,온양온천,3374,3376,20200221,6750
20200218,1,신창,934,979,20200221,1913
20200219,1,봉명,1249,1218,20200222,2467
20200219,1,쌍용,1851,1738,20200222,3589
20200219,1,아산,2479,2161,20200222,4640
20200219,1,배방,831,824,20200222,1655
20200219,1,온양온천,3880,4003,20200222,7883
20200219,1,신창,1024,989,20200222,2013
20200220,1,봉명,1166,1123,20200223,2289
20200220,1,쌍용,1759,1648,20200223,3407
20200220,1,아산,2414,2075,20200223,4489
20200220,1,배방,865,843,20200223,1708
20200220,1,온양온천,3257,3259,20200223,6516
20200220,1,신창,1162,1076,20200223,2238
20200221,1,봉명,1083,1012,20200224,2095
20200221,1,쌍용,1783,1573,20200224,3356
20200221,1,아산,2506,2324,20200224,4830
20200221,1,배방,913,769,20200224,1682
20200221,1,온양온천,3249,3205,20200224,6454
20200221,1,신창,1158,936,20200224,2094
20200222,1,봉명,576,534,20200225,1110
20200222,1,쌍용,1117,1027,20200225,2144
20200222,1,아산,1887,1745,20200225,3632
20200222,1,배방,771,620,20200225,1391
20200222,1,온양온천,2679,2755,20200225,5434
20200222,1,신창,662,590,20200225,1252
20200223,1,봉명,382,371,20200226,753
20200223,1,쌍용,791,781,20200226,1572
20200223,1,아산,1472,1169,20200226,2641
20200223,1,배방,476,567,20200226,1043
20200223,1,온양온천,2014,2056,20200226,4070
20200223,1,신창,502,559,20200226,1061
20200224,1,봉명,941,921,20200227,1862
20200224,1,쌍용,1347,1279,20200227,2626
20200224,1,아산,1866,1701,20200227,3567
20200224,1,배방,683,659,20200227,1342
20200224,1,온양온천,2576,2637,20200227,5213
20200224,1,신창,715,775,20200227,1490
20200225,1,봉명,776,739,20200228,1515
20200225,1,쌍용,1171,1053,20200228,2224
20200225,1,아산,1363,1226,20200228,2589
20200225,1,배방,465,488,20200228,953
20200225,1,온양온천,1752,1852,20200228,3604
20200225,1,신창,550,537,20200228,1087
20200226,1,봉명,761,759,20200229,1520
20200226,1,쌍용,1076,988,20200229,2064
20200226,1,아산,1415,1237,20200229,2652
20200226,1,배방,526,494,20200229,1020
20200226,1,온양온천,1831,1885,20200229,3716
20200226,1,신창,591,569,20200229,1160
20200227,1,봉명,715,702,20200301,1417
20200227,1,쌍용,1044,971,20200301,2015
20200227,1,아산,1298,1219,20200301,2517
20200227,1,배방,519,460,20200301,979
20200227,1,온양온천,1746,1795,20200301,3541
20200227,1,신창,594,552,20200301,1146
20200228,1,봉명,650,632,20200302,1282
20200228,1,쌍용,1021,927,20200302,1948
20200228,1,아산,1313,1238,20200302,2551
20200228,1,배방,530,465,20200302,995
20200228,1,온양온천,1739,1731,20200302,3470
20200228,1,신창,563,473,20200302,1036
20200229,1,봉명,368,375,20200303,743
20200229,1,쌍용,587,553,20200303,1140
20200229,1,아산,949,812,20200303,1761
20200229,1,배방,408,342,20200303,750
20200229,1,온양온천,1504,1599,20200303,3103
20200229,1,신창,360,345,20200303,705
20200301,1,봉명,260,233,20200304,493
20200301,1,쌍용,447,414,20200304,861
20200301,1,아산,727,624,20200304,1351
20200301,1,배방,255,309,20200304,564
20200301,1,온양온천,1143,1144,20200304,2287
20200301,1,신창,272,346,20200304,618
20200302,1,봉명,660,614,20200305,1274
20200302,1,쌍용,907,847,20200305,1754
20200302,1,아산,1218,1092,20200305,2310
20200302,1,배방,464,438,20200305,902
20200302,1,온양온천,1616,1645,20200305,3261
20200302,1,신창,512,547,20200305,1059
20200303,1,봉명,640,607,20200306,1247
20200303,1,쌍용,930,828,20200306,1758
20200303,1,아산,1103,1013,20200306,2116
20200303,1,배방,455,439,20200306,894
20200303,1,온양온천,1518,1532,20200306,3050
20200303,1,신창,492,501,20200306,993
20200304,1,봉명,649,631,20200307,1280
20200304,1,쌍용,926,846,20200307,1772
20200304,1,아산,1047,985,20200307,2032
20200304,1,배방,472,441,20200307,913
20200304,1,온양온천,1651,1700,20200307,3351
20200304,1,신창,480,453,20200307,933
20200305,1,봉명,619,591,20200308,1210
20200305,1,쌍용,912,871,20200308,1783
20200305,1,아산,1180,1047,20200308,2227
20200305,1,배방,457,445,20200308,902
20200305,1,온양온천,1504,1568,20200308,3072
20200305,1,신창,495,466,20200308,961
20200306,1,봉명,678,628,20200309,1306
20200306,1,쌍용,1055,966,20200309,2021
20200306,1,아산,1439,1403,20200309,2842
20200306,1,배방,595,490,20200309,1085
20200306,1,온양온천,1798,1871,20200309,3669
20200306,1,신창,619,515,20200309,1134
20200307,1,봉명,410,393,20200310,803
20200307,1,쌍용,653,562,20200310,1215
20200307,1,아산,935,816,20200310,1751
20200307,1,배방,431,383,20200310,814
20200307,1,온양온천,1519,1610,20200310,3129
20200307,1,신창,427,375,20200310,802
20200308,1,아산,893,763,20200311,1656
20200308,1,봉명,315,339,20200311,654
20200308,1,쌍용,551,537,20200311,1088
20200308,1,배방,332,377,20200311,709
20200308,1,온양온천,1506,1456,20200311,2962
20200308,1,신창,356,412,20200311,768
20200309,1,봉명,739,723,20200312,1462
20200309,1,쌍용,1082,971,20200312,2053
20200309,1,아산,1401,1293,20200312,2694
20200309,1,배방,525,548,20200312,1073
20200309,1,온양온천,2178,2113,20200312,4291
20200309,1,신창,558,638,20200312,1196
20200310,1,봉명,719,681,20200313,1400
20200310,1,쌍용,961,908,20200313,1869
20200310,1,아산,1173,1091,20200313,2264
20200310,1,배방,487,439,20200313,926
20200310,1,온양온천,1660,1756,20200313,3416
20200310,1,신창,498,511,20200313,1009
20200311,1,봉명,748,741,20200314,1489
20200311,1,쌍용,1061,967,20200314,2028
20200311,1,아산,1241,1174,20200314,2415
20200311,1,배방,521,507,20200314,1028
20200311,1,온양온천,1812,1793,20200314,3605
20200311,1,신창,580,562,20200314,1142
20200312,1,봉명,754,723,20200315,1477
20200312,1,쌍용,1088,1015,20200315,2103
20200312,1,아산,1307,1241,20200315,2548
20200312,1,배방,515,485,20200315,1000
20200312,1,온양온천,1823,1895,20200315,3718
20200312,1,신창,607,577,20200315,1184
20200313,1,봉명,726,696,20200316,1422
20200313,1,쌍용,1144,1038,20200316,2182
20200313,1,아산,1534,1462,20200316,2996
20200313,1,배방,639,586,20200316,1225
20200313,1,온양온천,2017,2034,20200316,4051
20200313,1,신창,741,592,20200316,1333
20200314,1,봉명,454,417,20200317,871
20200314,1,쌍용,812,754,20200317,1566
20200314,1,아산,1143,1124,20200317,2267
20200314,1,배방,510,443,20200317,953
20200314,1,온양온천,2112,2122,20200317,4234
20200314,1,신창,499,472,20200317,971
20200315,1,봉명,294,298,20200318,592
20200315,1,쌍용,628,573,20200318,1201
20200315,1,아산,1041,904,20200318,1945
20200315,1,배방,356,447,20200318,803
20200315,1,온양온천,1566,1644,20200318,3210
20200315,1,신창,435,497,20200318,932
20200316,1,쌍용,1142,1081,20200319,2223
20200316,1,봉명,779,746,20200319,1525
20200316,1,아산,1461,1314,20200319,2775
20200316,1,배방,589,578,20200319,1167
20200316,1,온양온천,2042,2042,20200319,4084
20200316,1,신창,627,670,20200319,1297
20200317,1,봉명,848,800,20200320,1648
20200317,1,쌍용,1071,1003,20200320,2074
20200317,1,아산,1370,1321,20200320,2691
20200317,1,배방,562,539,20200320,1101
20200317,1,온양온천,1919,1991,20200320,3910
20200317,1,신창,579,583,20200320,1162
20200318,1,봉명,785,758,20200321,1543
20200318,1,쌍용,1136,1049,20200321,2185
20200318,1,아산,1398,1323,20200321,2721
20200318,1,배방,580,550,20200321,1130
20200318,1,온양온천,1977,2039,20200321,4016
20200318,1,신창,655,638,20200321,1293
20200319,1,봉명,781,737,20200322,1518
20200319,1,쌍용,1093,1024,20200322,2117
20200319,1,아산,1327,1247,20200322,2574
20200319,1,배방,543,495,20200322,1038
20200319,1,온양온천,2050,2014,20200322,4064
20200319,1,신창,693,629,20200322,1322
20200320,1,봉명,790,772,20200323,1562
20200320,1,쌍용,1285,1173,20200323,2458
20200320,1,아산,1743,1729,20200323,3472
20200320,1,배방,759,615,20200323,1374
20200320,1,온양온천,2297,2334,20200323,4631
20200320,1,신창,900,704,20200323,1604
20200321,1,봉명,540,501,20200324,1041
20200321,1,쌍용,891,835,20200324,1726
20200321,1,아산,1302,1223,20200324,2525
20200321,1,배방,586,515,20200324,1101
20200321,1,온양온천,2142,2160,20200324,4302
20200321,1,신창,609,571,20200324,1180
20200322,1,봉명,378,366,20200325,744
20200322,1,쌍용,694,650,20200325,1344
20200322,1,아산,1255,1067,20200325,2322
20200322,1,배방,401,503,20200325,904
20200322,1,온양온천,1799,1821,20200325,3620
20200322,1,신창,499,691,20200325,1190
20200323,1,봉명,856,796,20200326,1652
20200323,1,쌍용,1185,1136,20200326,2321
20200323,1,아산,1624,1453,20200326,3077
20200323,1,배방,599,618,20200326,1217
20200323,1,온양온천,2152,2211,20200326,4363
20200323,1,신창,712,763,20200326,1475
20200324,1,봉명,926,835,20200327,1761
20200324,1,쌍용,1222,1159,20200327,2381
20200324,1,아산,1478,1386,20200327,2864
20200324,1,배방,628,603,20200327,1231
20200324,1,온양온천,2411,2432,20200327,4843
20200324,1,신창,720,715,20200327,1435
20200325,1,봉명,864,844,20200328,1708
20200325,1,쌍용,1236,1153,20200328,2389
20200325,1,아산,1530,1335,20200328,2865
20200325,1,배방,631,563,20200328,1194
20200325,1,온양온천,2201,2215,20200328,4416
20200325,1,신창,701,674,20200328,1375
20200326,1,봉명,799,749,20200329,1548
20200326,1,쌍용,1179,1117,20200329,2296
20200326,1,아산,1444,1336,20200329,2780
20200326,1,배방,569,559,20200329,1128
20200326,1,온양온천,2025,2054,20200329,4079
20200326,1,신창,687,661,20200329,1348
20200327,1,봉명,825,777,20200330,1602
20200327,1,쌍용,1279,1157,20200330,2436
20200327,1,아산,1897,1800,20200330,3697
20200327,1,배방,759,637,20200330,1396
20200327,1,온양온천,2276,2376,20200330,4652
20200327,1,신창,1014,697,20200330,1711
20200328,1,쌍용,930,887,20200331,1817
20200328,1,봉명,502,464,20200331,966
20200328,1,아산,1493,1305,20200331,2798
20200328,1,배방,605,558,20200331,1163
20200328,1,온양온천,2113,2182,20200331,4295
20200328,1,신창,685,581,20200331,1266
20200329,1,봉명,420,401,20200401,821
20200329,1,쌍용,778,726,20200401,1504
20200329,1,아산,1327,1120,20200401,2447
20200329,1,배방,454,574,20200401,1028
20200329,1,온양온천,2283,2348,20200401,4631
20200329,1,신창,538,732,20200401,1270
20200330,1,봉명,899,895,20200402,1794
20200330,1,쌍용,1313,1225,20200402,2538
20200330,1,아산,1591,1415,20200402,3006
20200330,1,배방,631,615,20200402,1246
20200330,1,온양온천,2306,2331,20200402,4637
20200330,1,신창,681,814,20200402,1495
20200331,1,봉명,871,856,20200403,1727
20200331,1,쌍용,1252,1169,20200403,2421
20200331,1,아산,1539,1383,20200403,2922
20200331,1,배방,645,628,20200403,1273
20200331,1,온양온천,2178,2236,20200403,4414
20200331,1,신창,708,718,20200403,1426
20200401,1,아산,1557,1426,20200404,2983
20200401,1,봉명,842,790,20200404,1632
20200401,1,쌍용,1258,1167,20200404,2425
20200401,1,배방,672,651,20200404,1323
20200401,1,온양온천,2171,2260,20200404,4431
20200401,1,신창,723,722,20200404,1445
20200402,1,봉명,897,841,20200405,1738
20200402,1,쌍용,1333,1215,20200405,2548
20200402,1,아산,1568,1489,20200405,3057
20200402,1,배방,678,651,20200405,1329
20200402,1,온양온천,2263,2241,20200405,4504
20200402,1,신창,812,711,20200405,1523
20200403,1,봉명,904,824,20200406,1728
20200403,1,쌍용,1481,1318,20200406,2799
20200403,1,아산,1963,1932,20200406,3895
20200403,1,배방,876,696,20200406,1572
20200403,1,온양온천,2431,2563,20200406,4994
20200403,1,신창,1020,697,20200406,1717
20200404,1,봉명,543,532,20200407,1075
20200404,1,쌍용,1020,864,20200407,1884
20200404,1,아산,1527,1381,20200407,2908
20200404,1,배방,607,541,20200407,1148
20200404,1,온양온천,2517,2600,20200407,5117
20200404,1,신창,713,694,20200407,1407
20200405,1,봉명,382,390,20200408,772
20200405,1,쌍용,752,717,20200408,1469
20200405,1,아산,1399,1130,20200408,2529
20200405,1,배방,427,558,20200408,985
20200405,1,온양온천,1931,1980,20200408,3911
20200405,1,신창,507,745,20200408,1252
20200406,1,봉명,922,891,20200409,1813
20200406,1,쌍용,1348,1262,20200409,2610
20200406,1,아산,1696,1539,20200409,3235
20200406,1,배방,697,711,20200409,1408
20200406,1,온양온천,2389,2353,20200409,4742
20200406,1,신창,783,798,20200409,1581
20200407,1,봉명,947,930,20200410,1877
20200407,1,쌍용,1306,1214,20200410,2520
20200407,1,아산,1598,1486,20200410,3084
20200407,1,배방,723,653,20200410,1376
20200407,1,온양온천,2298,2331,20200410,4629
20200407,1,신창,734,775,20200410,1509
20200408,1,봉명,964,922,20200411,1886
20200408,1,쌍용,1359,1248,20200411,2607
20200408,1,아산,1673,1510,20200411,3183
20200408,1,배방,618,580,20200411,1198
20200408,1,온양온천,2263,2296,20200411,4559
20200408,1,신창,774,801,20200411,1575
20200409,1,봉명,1001,950,20200412,1951
20200409,1,쌍용,1387,1341,20200412,2728
20200409,1,아산,1688,1543,20200412,3231
20200409,1,배방,692,641,20200412,1333
20200409,1,온양온천,2778,2741,20200412,5519
20200409,1,신창,874,764,20200412,1638
20200410,1,봉명,935,853,20200413,1788
20200410,1,쌍용,1507,1387,20200413,2894
20200410,1,아산,2118,2053,20200413,4171
20200410,1,배방,867,739,20200413,1606
20200410,1,온양온천,2702,2732,20200413,5434
20200410,1,신창,1180,861,20200413,2041
20200411,1,봉명,563,507,20200414,1070
20200411,1,쌍용,1029,947,20200414,1976
20200411,1,아산,1620,1511,20200414,3131
20200411,1,배방,720,583,20200414,1303
20200411,1,온양온천,2506,2552,20200414,5058
20200411,1,신창,790,748,20200414,1538
20200412,1,봉명,381,403,20200415,784
20200412,1,쌍용,834,782,20200415,1616
20200412,1,아산,1450,1205,20200415,2655
20200412,1,배방,480,627,20200415,1107
20200412,1,온양온천,2033,2115,20200415,4148
20200412,1,신창,655,814,20200415,1469
20200413,1,봉명,986,958,20200416,1944
20200413,1,쌍용,1421,1325,20200416,2746
20200413,1,아산,1748,1581,20200416,3329
20200413,1,배방,661,672,20200416,1333
20200413,1,온양온천,2517,2600,20200416,5117
20200413,1,신창,782,806,20200416,1588
20200414,1,봉명,912,871,20200417,1783
20200414,1,쌍용,1403,1169,20200417,2572
20200414,1,아산,1765,1513,20200417,3278
20200414,1,배방,728,626,20200417,1354
20200414,1,온양온천,2627,2614,20200417,5241
20200414,1,신창,891,777,20200417,1668
20200415,1,봉명,461,458,20200418,919
20200415,1,쌍용,881,851,20200418,1732
20200415,1,아산,1363,1196,20200418,2559
20200415,1,배방,563,550,20200418,1113
20200415,1,온양온천,1989,2046,20200418,4035
20200415,1,신창,648,643,20200418,1291
20200416,1,봉명,913,872,20200419,1785
20200416,1,쌍용,1491,1343,20200419,2834
20200416,1,아산,1810,1603,20200419,3413
20200416,1,배방,749,742,20200419,1491
20200416,1,온양온천,2584,2661,20200419,5245
20200416,1,신창,835,782,20200419,1617
20200417,1,봉명,934,861,20200420,1795
20200417,1,쌍용,1476,1347,20200420,2823
20200417,1,아산,2115,2042,20200420,4157
20200417,1,배방,817,743,20200420,1560
20200417,1,온양온천,2627,2631,20200420,5258
20200417,1,신창,1031,772,20200420,1803
20200418,1,봉명,554,506,20200421,1060
20200418,1,쌍용,1152,1016,20200421,2168
20200418,1,아산,1724,1640,20200421,3364
20200418,1,배방,768,611,20200421,1379
20200418,1,온양온천,2673,2782,20200421,5455
20200418,1,신창,810,738,20200421,1548
20200419,1,봉명,469,471,20200422,940
20200419,1,쌍용,837,853,20200422,1690
20200419,1,아산,1512,1178,20200422,2690
20200419,1,배방,500,629,20200422,1129
20200419,1,온양온천,2711,2733,20200422,5444
20200419,1,신창,603,782,20200422,1385
20200420,1,봉명,1039,937,20200423,1976
20200420,1,쌍용,1456,1367,20200423,2823
20200420,1,아산,1870,1695,20200423,3565
20200420,1,배방,752,747,20200423,1499
20200420,1,온양온천,2520,2533,20200423,5053
20200420,1,신창,743,814,20200423,1557
20200421,1,봉명,993,959,20200424,1952
20200421,1,쌍용,1430,1311,20200424,2741
20200421,1,아산,1763,1668,20200424,3431
20200421,1,배방,731,660,20200424,1391
20200421,1,온양온천,2567,2688,20200424,5255
20200421,1,신창,779,812,20200424,1591
20200422,1,봉명,979,958,20200425,1937
20200422,1,쌍용,1478,1328,20200425,2806
20200422,1,아산,1701,1690,20200425,3391
20200422,1,배방,730,667,20200425,1397
20200422,1,온양온천,2488,2496,20200425,4984
20200422,1,신창,771,756,20200425,1527
20200423,1,배방,695,631,20200426,1326
20200423,1,봉명,981,948,20200426,1929
20200423,1,쌍용,1479,1315,20200426,2794
20200423,1,아산,1774,1615,20200426,3389
20200423,1,온양온천,2623,2666,20200426,5289
20200423,1,신창,864,719,20200426,1583
20200424,1,봉명,1030,1029,20200427,2059
20200424,1,쌍용,1806,1606,20200427,3412
20200424,1,아산,2231,2176,20200427,4407
20200424,1,배방,897,757,20200427,1654
20200424,1,온양온천,3697,3764,20200427,7461
20200424,1,신창,1219,882,20200427,2101
20200425,1,봉명,623,559,20200428,1182
20200425,1,쌍용,1148,1105,20200428,2253
20200425,1,아산,1954,1739,20200428,3693
20200425,1,배방,767,593,20200428,1360
20200425,1,온양온천,2779,3001,20200428,5780
20200425,1,신창,799,675,20200428,1474
20200426,1,봉명,448,487,20200429,935
20200426,1,쌍용,931,902,20200429,1833
20200426,1,아산,1652,1464,20200429,3116
20200426,1,배방,523,694,20200429,1217
20200426,1,온양온천,2682,2606,20200429,5288
20200426,1,신창,741,936,20200429,1677
20200427,1,쌍용,1604,1428,20200430,3032
20200427,1,봉명,1010,994,20200430,2004
20200427,1,아산,1965,1777,20200430,3742
20200427,1,배방,732,757,20200430,1489
20200427,1,온양온천,2771,2828,20200430,5599
20200427,1,신창,782,875,20200430,1657
20200428,1,봉명,1077,1009,20200501,2086
20200428,1,쌍용,1598,1463,20200501,3061
20200428,1,아산,1901,1815,20200501,3716
20200428,1,배방,786,732,20200501,1518
20200428,1,온양온천,2779,2906,20200501,5685
20200428,1,신창,798,794,20200501,1592
20200429,1,봉명,1140,1036,20200502,2176
20200429,1,쌍용,1805,1656,20200502,3461
20200429,1,아산,2292,2500,20200502,4792
20200429,1,배방,973,875,20200502,1848
20200429,1,온양온천,4054,4147,20200502,8201
20200429,1,신창,1089,921,20200502,2010
20200430,1,봉명,518,481,20200503,999
20200430,1,쌍용,1117,1058,20200503,2175
20200430,1,아산,1778,2083,20200503,3861
20200430,1,배방,819,637,20200503,1456
20200430,1,온양온천,2987,3023,20200503,6010
20200430,1,신창,1002,869,20200503,1871
20200501,1,신창,1190,857,20200504,2047
20200501,1,온양온천,3204,3209,20200504,6413
20200501,1,배방,869,709,20200504,1578
20200501,1,아산,1906,1882,20200504,3788
20200501,1,쌍용,1308,1153,20200504,2461
20200501,1,봉명,569,583,20200504,1152
20200502,1,신창,920,929,20200505,1849
20200502,1,온양온천,3136,3158,20200505,6294
20200502,1,배방,732,733,20200505,1465
20200502,1,아산,1947,1790,20200505,3737
20200502,1,쌍용,1173,1065,20200505,2238
20200502,1,봉명,578,526,20200505,1104
20200503,1,신창,855,905,20200506,1760
20200503,1,온양온천,2796,2736,20200506,5532
20200503,1,배방,580,663,20200506,1243
20200503,1,아산,2094,1472,20200506,3566
20200503,1,쌍용,945,930,20200506,1875
20200503,1,봉명,418,448,20200506,866
20200504,1,신창,982,1017,20200507,1999
20200504,1,온양온천,3954,4039,20200507,7993
20200504,1,배방,873,878,20200507,1751
20200504,1,아산,2226,1946,20200507,4172
20200504,1,쌍용,1640,1538,20200507,3178
20200504,1,봉명,1153,1088,20200507,2241
20200505,1,신창,676,797,20200508,1473
20200505,1,온양온천,2433,2501,20200508,4934
20200505,1,배방,560,643,20200508,1203
20200505,1,아산,1782,1289,20200508,3071
20200505,1,쌍용,1050,962,20200508,2012
20200505,1,봉명,476,473,20200508,949
20200506,1,봉명,1115,1113,20200509,2228
20200506,1,쌍용,1731,1589,20200509,3320
20200506,1,아산,2097,1862,20200509,3959
20200506,1,배방,873,838,20200509,1711
20200506,1,온양온천,3140,3206,20200509,6346
20200506,1,신창,1170,1213,20200509,2383
20200507,1,봉명,1167,1082,20200510,2249
20200507,1,쌍용,1732,1642,20200510,3374
20200507,1,아산,2109,1919,20200510,4028
20200507,1,배방,926,849,20200510,1775
20200507,1,온양온천,3092,3142,20200510,6234
20200507,1,신창,1220,1098,20200510,2318
20200508,1,봉명,1127,1047,20200511,2174
20200508,1,쌍용,1892,1701,20200511,3593
20200508,1,아산,2612,2435,20200511,5047
20200508,1,배방,1103,960,20200511,2063
20200508,1,온양온천,3327,3452,20200511,6779
20200508,1,신창,1654,1206,20200511,2860
20200509,1,신창,802,805,20200512,1607
20200509,1,온양온천,3296,3313,20200512,6609
20200509,1,배방,831,743,20200512,1574
20200509,1,아산,2023,1848,20200512,3871
20200509,1,쌍용,1225,1171,20200512,2396
20200509,1,봉명,628,605,20200512,1233
20200510,1,봉명,484,506,20200513,990
20200510,1,쌍용,1063,1062,20200513,2125
20200510,1,아산,2067,1561,20200513,3628
20200510,1,배방,668,759,20200513,1427
20200510,1,온양온천,2868,2817,20200513,5685
20200510,1,신창,742,1080,20200513,1822
20200511,1,신창,1267,1403,20200514,2670
20200511,1,온양온천,3206,3235,20200514,6441
20200511,1,배방,874,852,20200514,1726
20200511,1,아산,2345,1993,20200514,4338
20200511,1,쌍용,1948,1903,20200514,3851
20200511,1,봉명,1135,1104,20200514,2239
20200512,1,봉명,1125,1111,20200515,2236
20200512,1,쌍용,1911,1734,20200515,3645
20200512,1,아산,2086,1924,20200515,4010
20200512,1,배방,804,784,20200515,1588
20200512,1,온양온천,3047,3080,20200515,6127
20200512,1,신창,1289,1260,20200515,2549
20200513,1,봉명,1075,1024,20200516,2099
20200513,1,쌍용,1988,1735,20200516,3723
20200513,1,아산,2142,2021,20200516,4163
20200513,1,배방,844,819,20200516,1663
20200513,1,온양온천,3008,3097,20200516,6105
20200513,1,신창,1267,1195,20200516,2462
20200514,1,신창,1477,1300,20200517,2777
20200514,1,온양온천,3843,3916,20200517,7759
20200514,1,배방,900,876,20200517,1776
20200514,1,아산,2257,2070,20200517,4327
20200514,1,쌍용,2084,1872,20200517,3956
20200514,1,봉명,1166,1116,20200517,2282
20200515,1,봉명,1055,984,20200518,2039
20200515,1,쌍용,1874,1618,20200518,3492
20200515,1,아산,2530,2456,20200518,4986
20200515,1,배방,949,841,20200518,1790
20200515,1,온양온천,3121,3092,20200518,6213
20200515,1,신창,1774,1231,20200518,3005
20200516,1,아산,2167,2010,20200519,4177
20200516,1,쌍용,1390,1219,20200519,2609
20200516,1,봉명,728,651,20200519,1379
20200516,1,신창,969,891,20200519,1860
20200516,1,온양온천,3163,3208,20200519,6371
20200516,1,배방,933,808,20200519,1741
20200517,1,신창,870,1123,20200520,1993
20200517,1,온양온천,2898,2886,20200520,5784
20200517,1,배방,684,819,20200520,1503
20200517,1,아산,2188,1696,20200520,3884
20200517,1,쌍용,1027,1068,20200520,2095
20200517,1,봉명,467,472,20200520,939
20200518,1,봉명,1062,971,20200521,2033
20200518,1,쌍용,1712,1679,20200521,3391
20200518,1,아산,2140,1971,20200521,4111
20200518,1,배방,801,839,20200521,1640
20200518,1,온양온천,2878,2866,20200521,5744
20200518,1,신창,1188,1379,20200521,2567
20200519,1,봉명,1063,1016,20200522,2079
20200519,1,쌍용,1748,1656,20200522,3404
20200519,1,아산,2131,1935,20200522,4066
20200519,1,배방,776,751,20200522,1527
20200519,1,온양온천,3356,3448,20200522,6804
20200519,1,신창,1253,1279,20200522,2532
20200520,1,신창,1301,1230,20200523,2531
20200520,1,온양온천,3180,3265,20200523,6445
20200520,1,배방,825,823,20200523,1648
20200520,1,아산,2234,2039,20200523,4273
20200520,1,쌍용,1929,1759,20200523,3688
20200520,1,봉명,1091,1082,20200523,2173
20200521,1,신창,1446,1220,20200524,2666
20200521,1,온양온천,3082,3185,20200524,6267
20200521,1,배방,890,848,20200524,1738
20200521,1,아산,2260,2134,20200524,4394
20200521,1,쌍용,1908,1746,20200524,3654
20200521,1,봉명,1130,1053,20200524,2183
20200522,1,봉명,1175,1136,20200525,2311
20200522,1,쌍용,2137,1793,20200525,3930
20200522,1,아산,2898,2755,20200525,5653
20200522,1,배방,1005,945,20200525,1950
20200522,1,온양온천,3458,3463,20200525,6921
20200522,1,신창,1947,1351,20200525,3298
20200523,1,아산,2350,2246,20200526,4596
20200523,1,배방,1008,900,20200526,1908
20200523,1,온양온천,3616,3633,20200526,7249
20200523,1,신창,1021,963,20200526,1984
20200523,1,봉명,738,689,20200526,1427
20200523,1,쌍용,1508,1363,20200526,2871
20200524,1,신창,845,1217,20200527,2062
20200524,1,온양온천,3634,3699,20200527,7333
20200524,1,배방,653,772,20200527,1425
20200524,1,아산,2162,1687,20200527,3849
20200524,1,쌍용,1153,1179,20200527,2332
20200524,1,봉명,547,566,20200527,1113
20200525,1,신창,1345,1543,20200528,2888
20200525,1,온양온천,3350,3363,20200528,6713
20200525,1,배방,833,866,20200528,1699
20200525,1,아산,2433,2252,20200528,4685
20200525,1,쌍용,1887,1815,20200528,3702
20200525,1,봉명,1173,1094,20200528,2267
20200526,1,신창,1351,1387,20200529,2738
20200526,1,온양온천,3010,3065,20200529,6075
20200526,1,배방,887,871,20200529,1758
20200526,1,아산,2129,1974,20200529,4103
20200526,1,쌍용,1844,1753,20200529,3597
20200526,1,봉명,1110,1053,20200529,2163
20200527,1,봉명,1172,1132,20200530,2304
20200527,1,쌍용,1873,1697,20200530,3570
20200527,1,아산,2342,2149,20200530,4491
20200527,1,배방,937,884,20200530,1821
20200527,1,온양온천,3179,3194,20200530,6373
20200527,1,신창,1412,1303,20200530,2715
20200528,1,쌍용,1921,1714,20200531,3635
20200528,1,신창,1526,1307,20200531,2833
20200528,1,온양온천,3085,3198,20200531,6283
20200528,1,배방,901,882,20200531,1783
20200528,1,아산,2265,2141,20200531,4406
20200528,1,봉명,1123,1038,20200531,2161
20200529,1,봉명,1216,1139,20200601,2355
20200529,1,쌍용,2243,1959,20200601,4202
20200529,1,아산,2914,2823,20200601,5737
20200529,1,배방,1069,994,20200601,2063
20200529,1,온양온천,4425,4594,20200601,9019
20200529,1,신창,1987,1363,20200601,3350
20200530,1,봉명,653,659,20200602,1312
20200530,1,쌍용,1481,1325,20200602,2806
20200530,1,아산,2272,2170,20200602,4442
20200530,1,배방,981,841,20200602,1822
20200530,1,온양온천,3363,3431,20200602,6794
20200530,1,신창,1033,1006,20200602,2039
20200531,1,신창,882,1242,20200603,2124
20200531,1,온양온천,2942,2864,20200603,5806
20200531,1,배방,604,773,20200603,1377
20200531,1,아산,2293,1631,20200603,3924
20200531,1,쌍용,1054,1086,20200603,2140
20200531,1,봉명,577,600,20200603,1177
20200101,K,지평,32,21,20200104,53
20200101,K,용문,1583,1450,20200104,3033
20200101,K,원덕,241,205,20200104,446
20200101,K,양평,1838,1790,20200104,3628
20200101,K,오빈,189,170,20200104,359
20200101,K,아신,381,360,20200104,741
20200101,K,국수,394,388,20200104,782
20200101,K,신원,109,87,20200104,196
20200101,K,양수,1330,1424,20200104,2754
20200101,K,운길산,612,603,20200104,1215
20200101,K,팔당,697,660,20200104,1357
20200101,K,도심,1134,1029,20200104,2163
20200101,K,덕소,3140,3222,20200104,6362
20200101,K,양정,318,258,20200104,576
20200101,K,도농,4041,4104,20200104,8145
20200101,K,구리,6597,6908,20200104,13505
20200101,K,양원,661,705,20200104,1366
20200101,K,망우,4150,4220,20200104,8370
20200101,K,상봉,3355,3248,20200104,6603
20200101,K,중랑,2849,2865,20200104,5714
20200101,1,회기,13092,13633,20200104,26725
20200102,1,회기,27148,26682,20200105,53830
20200102,K,중랑,6028,5658,20200105,11686
20200102,K,상봉,6510,6109,20200105,12619
20200102,K,망우,8275,7983,20200105,16258
20200102,K,양원,1755,1823,20200105,3578
20200102,K,구리,14751,15062,20200105,29813
20200102,K,도농,10703,9471,20200105,20174
20200102,K,양정,830,711,20200105,1541
20200102,K,덕소,6401,6325,20200105,12726
20200102,K,도심,2833,2233,20200105,5066
20200102,K,팔당,723,725,20200105,1448
20200102,K,운길산,584,525,20200105,1109
20200102,K,양수,1836,1761,20200105,3597
20200102,K,신원,168,163,20200105,331
20200102,K,국수,718,695,20200105,1413
20200102,K,아신,562,573,20200105,1135
20200102,K,오빈,312,269,20200105,581
20200102,K,양평,3098,3021,20200105,6119
20200102,K,원덕,375,349,20200105,724
20200102,K,용문,1916,1839,20200105,3755
20200102,K,지평,62,48,20200105,110
20200103,1,회기,29042,27628,20200106,56670
20200103,K,중랑,6323,5901,20200106,12224
20200103,K,상봉,6808,6515,20200106,13323
20200103,K,망우,8819,8353,20200106,17172
20200103,K,양원,1651,1630,20200106,3281
20200103,K,구리,15691,16063,20200106,31754
20200103,K,도농,11161,9752,20200106,20913
20200103,K,양정,869,760,20200106,1629
20200103,K,덕소,6739,6686,20200106,13425
20200103,K,도심,2989,2343,20200106,5332
20200103,K,팔당,827,801,20200106,1628
20200103,K,운길산,651,589,20200106,1240
20200103,K,양수,1918,1905,20200106,3823
20200103,K,신원,186,163,20200106,349
20200103,K,국수,825,826,20200106,1651
20200103,K,아신,579,566,20200106,1145
20200103,K,오빈,313,309,20200106,622
20200103,K,양평,4166,4297,20200106,8463
20200103,K,원덕,383,389,20200106,772
20200103,K,용문,1978,2120,20200106,4098
20200103,K,지평,58,43,20200106,101
20200104,1,회기,23138,22031,20200107,45169
20200104,K,중랑,4855,4632,20200107,9487
20200104,K,상봉,5649,5496,20200107,11145
20200104,K,망우,7186,7029,20200107,14215
20200104,K,양원,1190,1214,20200107,2404
20200104,K,구리,12111,12387,20200107,24498
20200104,K,도농,7747,7132,20200107,14879
20200104,K,양정,607,499,20200107,1106
20200104,K,덕소,5548,5222,20200107,10770
20200104,K,도심,1904,1705,20200107,3609
20200104,K,팔당,1049,1083,20200107,2132
20200104,K,운길산,755,871,20200107,1626
20200104,K,양수,1891,1790,20200107,3681
20200104,K,신원,161,174,20200107,335
20200104,K,국수,625,641,20200107,1266
20200104,K,아신,527,542,20200107,1069
20200104,K,오빈,291,311,20200107,602
20200104,K,양평,2771,2970,20200107,5741
20200104,K,원덕,341,340,20200107,681
20200104,K,용문,2062,2119,20200107,4181
20200104,K,지평,40,49,20200107,89
20200105,1,회기,18248,18034,20200108,36282
20200105,K,중랑,3721,3642,20200108,7363
20200105,K,상봉,4499,4471,20200108,8970
20200105,K,망우,5605,5561,20200108,11166
20200105,K,양원,907,938,20200108,1845
20200105,K,구리,8578,8952,20200108,17530
20200105,K,도농,5651,5472,20200108,11123
20200105,K,양정,527,444,20200108,971
20200105,K,덕소,4066,4028,20200108,8094
20200105,K,도심,1565,1382,20200108,2947
20200105,K,팔당,1098,1038,20200108,2136
20200105,K,운길산,812,773,20200108,1585
20200105,K,양수,1503,1467,20200108,2970
20200105,K,신원,207,149,20200108,356
20200105,K,국수,668,640,20200108,1308
20200105,K,아신,505,473,20200108,978
20200105,K,오빈,203,217,20200108,420
20200105,K,양평,2456,2460,20200108,4916
20200105,K,원덕,370,331,20200108,701
20200105,K,용문,4171,3954,20200108,8125
20200105,K,지평,38,46,20200108,84
20200106,1,회기,27803,27062,20200109,54865
20200106,K,중랑,6146,5757,20200109,11903
20200106,K,상봉,6280,6243,20200109,12523
20200106,K,망우,8234,8102,20200109,16336
20200106,K,양원,1710,1722,20200109,3432
20200106,K,구리,15166,15332,20200109,30498
20200106,K,도농,11076,9806,20200109,20882
20200106,K,양정,852,731,20200109,1583
20200106,K,덕소,6467,6286,20200109,12753
20200106,K,도심,2898,2263,20200109,5161
20200106,K,팔당,745,699,20200109,1444
20200106,K,운길산,605,499,20200109,1104
20200106,K,양수,1855,1835,20200109,3690
20200106,K,신원,221,168,20200109,389
20200106,K,국수,822,761,20200109,1583
20200106,K,아신,565,549,20200109,1114
20200106,K,오빈,301,305,20200109,606
20200106,K,양평,3143,3035,20200109,6178
20200106,K,원덕,344,305,20200109,649
20200106,K,용문,1869,1802,20200109,3671
20200106,K,지평,63,49,20200109,112
20200107,1,회기,26823,26002,20200110,52825
20200107,K,중랑,5851,5631,20200110,11482
20200107,K,상봉,6025,6110,20200110,12135
20200107,K,망우,7898,7811,20200110,15709
20200107,K,양원,1543,1649,20200110,3192
20200107,K,구리,14580,14731,20200110,29311
20200107,K,도농,10550,9519,20200110,20069
20200107,K,양정,806,651,20200110,1457
20200107,K,덕소,6109,5990,20200110,12099
20200107,K,도심,2749,2154,20200110,4903
20200107,K,팔당,638,650,20200110,1288
20200107,K,운길산,491,444,20200110,935
20200107,K,양수,1504,1511,20200110,3015
20200107,K,신원,125,129,20200110,254
20200107,K,국수,663,632,20200110,1295
20200107,K,아신,561,511,20200110,1072
20200107,K,오빈,271,260,20200110,531
20200107,K,양평,2804,2811,20200110,5615
20200107,K,원덕,285,288,20200110,573
20200107,K,용문,1545,1542,20200110,3087
20200107,K,지평,44,35,20200110,79
20200108,1,회기,29103,28103,20200111,57206
20200108,K,중랑,6188,6121,20200111,12309
20200108,K,상봉,6448,6261,20200111,12709
20200108,K,망우,8529,8296,20200111,16825
20200108,K,양원,1675,1683,20200111,3358
20200108,K,구리,15438,15367,20200111,30805
20200108,K,도농,11051,9929,20200111,20980
20200108,K,양정,851,752,20200111,1603
20200108,K,덕소,6608,6569,20200111,13177
20200108,K,도심,2917,2268,20200111,5185
20200108,K,팔당,739,765,20200111,1504
20200108,K,운길산,550,520,20200111,1070
20200108,K,양수,1698,1738,20200111,3436
20200108,K,신원,185,177,20200111,362
20200108,K,국수,807,749,20200111,1556
20200108,K,아신,614,601,20200111,1215
20200108,K,오빈,325,302,20200111,627
20200108,K,양평,3562,3679,20200111,7241
20200108,K,원덕,391,390,20200111,781
20200108,K,용문,1719,1721,20200111,3440
20200108,K,지평,55,33,20200111,88
20200109,1,회기,28884,27661,20200112,56545
20200109,K,중랑,6233,5899,20200112,12132
20200109,K,상봉,6744,6382,20200112,13126
20200109,K,망우,8635,8493,20200112,17128
20200109,K,양원,1674,1802,20200112,3476
20200109,K,구리,15555,15724,20200112,31279
20200109,K,도농,11451,10094,20200112,21545
20200109,K,양정,894,718,20200112,1612
20200109,K,덕소,6777,6756,20200112,13533
20200109,K,도심,3084,2449,20200112,5533
20200109,K,팔당,787,759,20200112,1546
20200109,K,운길산,648,607,20200112,1255
20200109,K,양수,1903,1900,20200112,3803
20200109,K,신원,232,177,20200112,409
20200109,K,국수,926,918,20200112,1844
20200109,K,아신,534,562,20200112,1096
20200109,K,오빈,308,330,20200112,638
20200109,K,양평,3241,3242,20200112,6483
20200109,K,원덕,363,358,20200112,721
20200109,K,용문,1963,1974,20200112,3937
20200109,K,지평,49,51,20200112,100
20200110,1,회기,29991,28423,20200113,58414
20200110,K,중랑,6429,6141,20200113,12570
20200110,K,상봉,7047,6712,20200113,13759
20200110,K,망우,9078,8800,20200113,17878
20200110,K,양원,1741,1718,20200113,3459
20200110,K,구리,16162,16682,20200113,32844
20200110,K,도농,11592,10383,20200113,21975
20200110,K,양정,918,809,20200113,1727
20200110,K,덕소,7152,6909,20200113,14061
20200110,K,도심,3015,2385,20200113,5400
20200110,K,팔당,841,845,20200113,1686
20200110,K,운길산,590,558,20200113,1148
20200110,K,양수,1931,1922,20200113,3853
20200110,K,신원,179,151,20200113,330
20200110,K,국수,773,763,20200113,1536
20200110,K,아신,628,620,20200113,1248
20200110,K,오빈,336,318,20200113,654
20200110,K,양평,3354,3364,20200113,6718
20200110,K,원덕,389,414,20200113,803
20200110,K,용문,3425,3599,20200113,7024
20200110,K,지평,40,37,20200113,77
20200111,1,회기,27077,26119,20200114,53196
20200111,K,중랑,5128,4778,20200114,9906
20200111,K,상봉,5824,5712,20200114,11536
20200111,K,망우,7702,7589,20200114,15291
20200111,K,양원,1336,1331,20200114,2667
20200111,K,구리,12661,12973,20200114,25634
20200111,K,도농,8517,7681,20200114,16198
20200111,K,양정,725,583,20200114,1308
20200111,K,덕소,5794,5629,20200114,11423
20200111,K,도심,2008,1756,20200114,3764
20200111,K,팔당,1042,1043,20200114,2085
20200111,K,운길산,826,778,20200114,1604
20200111,K,양수,1955,1916,20200114,3871
20200111,K,신원,208,172,20200114,380
20200111,K,국수,658,673,20200114,1331
20200111,K,아신,551,581,20200114,1132
20200111,K,오빈,327,343,20200114,670
20200111,K,양평,3010,3214,20200114,6224
20200111,K,원덕,428,417,20200114,845
20200111,K,용문,2246,2365,20200114,4611
20200111,K,지평,33,39,20200114,72
20200112,1,회기,18547,18447,20200115,36994
20200112,K,중랑,3654,3618,20200115,7272
20200112,K,상봉,4479,4299,20200115,8778
20200112,K,망우,5662,5574,20200115,11236
20200112,K,양원,1003,1006,20200115,2009
20200112,K,구리,8792,9170,20200115,17962
20200112,K,도농,5800,5519,20200115,11319
20200112,K,양정,490,417,20200115,907
20200112,K,덕소,4136,4156,20200115,8292
20200112,K,도심,1533,1385,20200115,2918
20200112,K,팔당,1096,1129,20200115,2225
20200112,K,운길산,775,741,20200115,1516
20200112,K,양수,1542,1474,20200115,3016
20200112,K,신원,170,103,20200115,273
20200112,K,국수,689,673,20200115,1362
20200112,K,아신,464,488,20200115,952
20200112,K,오빈,193,201,20200115,394
20200112,K,양평,2418,2404,20200115,4822
20200112,K,원덕,349,288,20200115,637
20200112,K,용문,1986,1712,20200115,3698
20200112,K,지평,28,29,20200115,57
20200113,1,회기,28061,27089,20200116,55150
20200113,K,중랑,6199,5840,20200116,12039
20200113,K,상봉,6405,6269,20200116,12674
20200113,K,망우,8539,8367,20200116,16906
20200113,K,양원,1720,1787,20200116,3507
20200113,K,구리,15223,15315,20200116,30538
20200113,K,도농,11364,10139,20200116,21503
20200113,K,양정,904,751,20200116,1655
20200113,K,덕소,6697,6467,20200116,13164
20200113,K,도심,2980,2294,20200116,5274
20200113,K,팔당,767,729,20200116,1496
20200113,K,운길산,615,543,20200116,1158
20200113,K,양수,1907,1898,20200116,3805
20200113,K,신원,190,189,20200116,379
20200113,K,국수,805,868,20200116,1673
20200113,K,아신,641,587,20200116,1228
20200113,K,오빈,347,337,20200116,684
20200113,K,양평,4029,4059,20200116,8088
20200113,K,원덕,380,355,20200116,735
20200113,K,용문,1962,1976,20200116,3938
20200113,K,지평,48,31,20200116,79
20200114,K,지평,35,31,20200117,66
20200114,K,용문,1879,1816,20200117,3695
20200114,K,원덕,373,357,20200117,730
20200114,K,양평,3184,3129,20200117,6313
20200114,K,오빈,320,308,20200117,628
20200114,K,아신,575,631,20200117,1206
20200114,K,국수,722,729,20200117,1451
20200114,K,신원,167,153,20200117,320
20200114,K,양수,1871,1846,20200117,3717
20200114,K,운길산,604,567,20200117,1171
20200114,K,팔당,699,707,20200117,1406
20200114,K,도심,2979,2248,20200117,5227
20200114,K,덕소,6799,6651,20200117,13450
20200114,K,양정,887,768,20200117,1655
20200114,K,도농,11197,10004,20200117,21201
20200114,K,구리,15283,15513,20200117,30796
20200114,K,양원,1706,1716,20200117,3422
20200114,K,망우,8617,8304,20200117,16921
20200114,K,상봉,6455,6354,20200117,12809
20200114,K,중랑,6116,5955,20200117,12071
20200114,1,회기,28155,27149,20200117,55304
20200115,1,회기,28711,27691,20200118,56402
20200115,K,중랑,6167,5965,20200118,12132
20200115,K,상봉,6519,6278,20200118,12797
20200115,K,망우,8850,8455,20200118,17305
20200115,K,양원,1753,1743,20200118,3496
20200115,K,구리,15471,15786,20200118,31257
20200115,K,도농,11390,10175,20200118,21565
20200115,K,양정,909,777,20200118,1686
20200115,K,덕소,6770,6697,20200118,13467
20200115,K,도심,2960,2321,20200118,5281
20200115,K,팔당,745,710,20200118,1455
20200115,K,운길산,614,542,20200118,1156
20200115,K,양수,1931,1944,20200118,3875
20200115,K,신원,169,174,20200118,343
20200115,K,국수,778,737,20200118,1515
20200115,K,아신,632,631,20200118,1263
20200115,K,오빈,352,367,20200118,719
20200115,K,양평,3144,3072,20200118,6216
20200115,K,원덕,404,401,20200118,805
20200115,K,용문,3148,3175,20200118,6323
20200115,K,지평,49,32,20200118,81
20200116,K,지평,36,24,20200119,60
20200116,K,용문,1785,1856,20200119,3641
20200116,K,원덕,368,376,20200119,744
20200116,K,양평,3150,3052,20200119,6202
20200116,K,오빈,318,324,20200119,642
20200116,K,아신,571,560,20200119,1131
20200116,K,국수,739,738,20200119,1477
20200116,K,신원,211,147,20200119,358
20200116,K,양수,2072,2711,20200119,4783
20200116,K,운길산,604,574,20200119,1178
20200116,K,팔당,805,837,20200119,1642
20200116,K,도심,3051,2395,20200119,5446
20200116,K,덕소,6752,6541,20200119,13293
20200116,K,양정,914,767,20200119,1681
20200116,K,도농,11267,10101,20200119,21368
20200116,K,구리,15417,15585,20200119,31002
20200116,K,양원,1715,1786,20200119,3501
20200116,K,망우,8702,8525,20200119,17227
20200116,K,상봉,6592,6187,20200119,12779
20200116,K,중랑,6185,5822,20200119,12007
20200116,1,회기,28678,27604,20200119,56282
20200117,K,양평,3307,3487,20200120,6794
20200117,1,회기,29583,28353,20200120,57936
20200117,K,중랑,6540,6190,20200120,12730
20200117,K,상봉,7031,6599,20200120,13630
20200117,K,망우,9195,9031,20200120,18226
20200117,K,양원,1748,1697,20200120,3445
20200117,K,구리,16192,16517,20200120,32709
20200117,K,도농,11724,10212,20200120,21936
20200117,K,양정,908,771,20200120,1679
20200117,K,덕소,6858,6757,20200120,13615
20200117,K,도심,2968,2295,20200120,5263
20200117,K,팔당,796,759,20200120,1555
20200117,K,운길산,628,567,20200120,1195
20200117,K,양수,2263,2316,20200120,4579
20200117,K,신원,208,199,20200120,407
20200117,K,국수,779,802,20200120,1581
20200117,K,아신,669,670,20200120,1339
20200117,K,오빈,314,306,20200120,620
20200117,K,원덕,393,405,20200120,798
20200117,K,용문,1931,2084,20200120,4015
20200117,K,지평,60,54,20200120,114
20200118,1,회기,26997,25450,20200121,52447
20200118,K,중랑,4975,4821,20200121,9796
20200118,K,상봉,5715,5481,20200121,11196
20200118,K,망우,7859,7674,20200121,15533
20200118,K,양원,1316,1358,20200121,2674
20200118,K,구리,12490,12835,20200121,25325
20200118,K,도농,8352,7471,20200121,15823
20200118,K,양정,700,616,20200121,1316
20200118,K,덕소,5661,5494,20200121,11155
20200118,K,도심,2060,1858,20200121,3918
20200118,K,팔당,1168,1216,20200121,2384
20200118,K,운길산,837,785,20200121,1622
20200118,K,양수,2433,2512,20200121,4945
20200118,K,신원,230,220,20200121,450
20200118,K,국수,739,822,20200121,1561
20200118,K,아신,577,602,20200121,1179
20200118,K,오빈,308,318,20200121,626
20200118,K,양평,4329,4409,20200121,8738
20200118,K,원덕,444,407,20200121,851
20200118,K,용문,2095,2248,20200121,4343
20200118,K,지평,56,36,20200121,92
20200119,1,회기,19636,19357,20200122,38993
20200119,K,중랑,3757,3607,20200122,7364
20200119,K,상봉,4281,4193,20200122,8474
20200119,K,망우,5482,5672,20200122,11154
20200119,K,양원,979,980,20200122,1959
20200119,K,구리,8565,8969,20200122,17534
20200119,K,도농,5757,5541,20200122,11298
20200119,K,양정,474,400,20200122,874
20200119,K,덕소,4080,4042,20200122,8122
20200119,K,도심,1497,1372,20200122,2869
20200119,K,팔당,924,901,20200122,1825
20200119,K,운길산,682,654,20200122,1336
20200119,K,양수,1352,1373,20200122,2725
20200119,K,신원,172,101,20200122,273
20200119,K,국수,576,534,20200122,1110
20200119,K,아신,451,396,20200122,847
20200119,K,오빈,192,194,20200122,386
20200119,K,양평,2287,2237,20200122,4524
20200119,K,원덕,313,234,20200122,547
20200119,K,용문,1752,1584,20200122,3336
20200119,K,지평,27,35,20200122,62
20200120,K,지평,54,32,20200123,86
20200120,K,용문,2938,2965,20200123,5903
20200120,K,원덕,409,413,20200123,822
20200120,K,양평,3146,3056,20200123,6202
20200120,K,오빈,341,339,20200123,680
20200120,K,아신,626,632,20200123,1258
20200120,K,국수,800,804,20200123,1604
20200120,K,신원,192,152,20200123,344
20200120,K,양수,1937,1929,20200123,3866
20200120,K,운길산,602,540,20200123,1142
20200120,K,팔당,704,707,20200123,1411
20200120,K,도심,2906,2269,20200123,5175
20200120,K,덕소,6796,6583,20200123,13379
20200120,K,양정,866,748,20200123,1614
20200120,K,도농,11343,10033,20200123,21376
20200120,K,구리,15728,15604,20200123,31332
20200120,K,양원,1654,1685,20200123,3339
20200120,K,망우,8508,8340,20200123,16848
20200120,K,상봉,6530,6259,20200123,12789
20200120,K,중랑,6353,5941,20200123,12294
20200120,1,회기,28267,27175,20200123,55442
20200121,1,회기,28893,27285,20200124,56178
20200121,K,중랑,6248,5899,20200124,12147
20200121,K,상봉,6525,6560,20200124,13085
20200121,K,망우,8728,8372,20200124,17100
20200121,K,양원,1615,1644,20200124,3259
20200121,K,구리,15278,15412,20200124,30690
20200121,K,도농,11363,10166,20200124,21529
20200121,K,양정,870,743,20200124,1613
20200121,K,덕소,6661,6541,20200124,13202
20200121,K,도심,2975,2282,20200124,5257
20200121,K,팔당,717,714,20200124,1431
20200121,K,운길산,654,576,20200124,1230
20200121,K,양수,1973,1892,20200124,3865
20200121,K,신원,159,154,20200124,313
20200121,K,국수,685,703,20200124,1388
20200121,K,아신,597,619,20200124,1216
20200121,K,오빈,312,321,20200124,633
20200121,K,양평,2992,3010,20200124,6002
20200121,K,원덕,360,322,20200124,682
20200121,K,용문,1755,1756,20200124,3511
20200121,K,지평,49,38,20200124,87
20200122,1,회기,28507,25976,20200125,54483
20200122,K,중랑,6377,5981,20200125,12358
20200122,K,상봉,6611,6342,20200125,12953
20200122,K,망우,8768,8444,20200125,17212
20200122,K,양원,1684,1617,20200125,3301
20200122,K,구리,15337,15678,20200125,31015
20200122,K,도농,11221,9930,20200125,21151
20200122,K,양정,900,753,20200125,1653
20200122,K,덕소,6663,6525,20200125,13188
20200122,K,도심,2900,2219,20200125,5119
20200122,K,팔당,726,732,20200125,1458
20200122,K,운길산,561,504,20200125,1065
20200122,K,양수,1797,1766,20200125,3563
20200122,K,신원,181,144,20200125,325
20200122,K,국수,688,716,20200125,1404
20200122,K,아신,586,553,20200125,1139
20200122,K,오빈,335,311,20200125,646
20200122,K,양평,2896,2965,20200125,5861
20200122,K,원덕,325,322,20200125,647
20200122,K,용문,1645,1697,20200125,3342
20200122,K,지평,51,46,20200125,97
20200123,1,회기,27385,23508,20200126,50893
20200123,K,중랑,6279,5819,20200126,12098
20200123,K,상봉,6639,6441,20200126,13080
20200123,K,망우,8437,8399,20200126,16836
20200123,K,양원,1519,1459,20200126,2978
20200123,K,구리,14648,15468,20200126,30116
20200123,K,도농,10468,9331,20200126,19799
20200123,K,양정,754,678,20200126,1432
20200123,K,덕소,6365,6335,20200126,12700
20200123,K,도심,2763,2168,20200126,4931
20200123,K,팔당,760,756,20200126,1516
20200123,K,운길산,556,580,20200126,1136
20200123,K,양수,1796,1758,20200126,3554
20200123,K,신원,158,155,20200126,313
20200123,K,국수,727,785,20200126,1512
20200123,K,아신,527,595,20200126,1122
20200123,K,오빈,289,307,20200126,596
20200123,K,양평,3691,4143,20200126,7834
20200123,K,원덕,348,378,20200126,726
20200123,K,용문,1640,2254,20200126,3894
20200123,K,지평,48,42,20200126,90
20200124,K,지평,30,50,20200127,80
20200124,K,용문,1378,2796,20200127,4174
20200124,K,원덕,221,447,20200127,668
20200124,K,양평,1814,2949,20200127,4763
20200124,K,오빈,146,228,20200127,374
20200124,K,아신,354,528,20200127,882
20200124,K,국수,345,546,20200127,891
20200124,K,신원,91,128,20200127,219
20200124,K,양수,1043,1482,20200127,2525
20200124,K,운길산,449,487,20200127,936
20200124,K,팔당,715,724,20200127,1439
20200124,K,도심,1067,994,20200127,2061
20200124,K,덕소,3166,3347,20200127,6513
20200124,K,양정,349,352,20200127,701
20200124,K,도농,4286,4101,20200127,8387
20200124,K,구리,6798,6989,20200127,13787
20200124,K,양원,703,630,20200127,1333
20200124,K,망우,4711,4423,20200127,9134
20200124,K,상봉,3799,3559,20200127,7358
20200124,K,중랑,3261,2857,20200127,6118
20200124,1,회기,13260,10050,20200127,23310
20200125,1,회기,10574,10545,20200128,21119
20200125,K,중랑,2941,2973,20200128,5914
20200125,K,상봉,3797,3553,20200128,7350
20200125,K,망우,4270,4175,20200128,8445
20200125,K,양원,657,664,20200128,1321
20200125,K,구리,6302,6758,20200128,13060
20200125,K,도농,4212,3927,20200128,8139
20200125,K,양정,465,328,20200128,793
20200125,K,덕소,3196,3108,20200128,6304
20200125,K,도심,1092,994,20200128,2086
20200125,K,팔당,689,646,20200128,1335
20200125,K,운길산,592,509,20200128,1101
20200125,K,양수,1550,1536,20200128,3086
20200125,K,신원,193,135,20200128,328
20200125,K,국수,608,552,20200128,1160
20200125,K,아신,646,557,20200128,1203
20200125,K,오빈,257,247,20200128,504
20200125,K,양평,2661,2525,20200128,5186
20200125,K,원덕,478,368,20200128,846
20200125,K,용문,2704,2297,20200128,5001
20200125,K,지평,40,60,20200128,100
20200126,1,회기,12224,13484,20200129,25708
20200126,K,중랑,3188,3181,20200129,6369
20200126,K,상봉,4095,3964,20200129,8059
20200126,K,망우,4652,4823,20200129,9475
20200126,K,양원,799,851,20200129,1650
20200126,K,구리,7565,8097,20200129,15662
20200126,K,도농,4833,4390,20200129,9223
20200126,K,양정,429,356,20200129,785
20200126,K,덕소,3776,3609,20200129,7385
20200126,K,도심,1366,1222,20200129,2588
20200126,K,팔당,1104,1150,20200129,2254
20200126,K,운길산,777,642,20200129,1419
20200126,K,양수,1752,1563,20200129,3315
20200126,K,신원,213,168,20200129,381
20200126,K,국수,593,492,20200129,1085
20200126,K,아신,565,425,20200129,990
20200126,K,오빈,218,191,20200129,409
20200126,K,양평,2674,2201,20200129,4875
20200126,K,원덕,405,301,20200129,706
20200126,K,용문,2367,1647,20200129,4014
20200126,K,지평,51,47,20200129,98
20200127,1,회기,12665,14911,20200130,27576
20200127,K,중랑,3290,3338,20200130,6628
20200127,K,상봉,4092,3894,20200130,7986
20200127,K,망우,4917,4885,20200130,9802
20200127,K,양원,723,789,20200130,1512
20200127,K,구리,8127,8471,20200130,16598
20200127,K,도농,4946,4538,20200130,9484
20200127,K,양정,407,340,20200130,747
20200127,K,덕소,3706,3691,20200130,7397
20200127,K,도심,1315,1143,20200130,2458
20200127,K,팔당,1005,942,20200130,1947
20200127,K,운길산,608,637,20200130,1245
20200127,K,양수,1452,1235,20200130,2687
20200127,K,신원,176,133,20200130,309
20200127,K,국수,495,477,20200130,972
20200127,K,아신,461,407,20200130,868
20200127,K,오빈,187,184,20200130,371
20200127,K,양평,2340,2038,20200130,4378
20200127,K,원덕,346,229,20200130,575
20200127,K,용문,2032,1536,20200130,3568
20200127,K,지평,47,30,20200130,77
20200128,1,회기,23829,24327,20200131,48156
20200128,K,중랑,5736,5578,20200131,11314
20200128,K,상봉,6038,5837,20200131,11875
20200128,K,망우,7714,7462,20200131,15176
20200128,K,양원,1513,1547,20200131,3060
20200128,K,구리,14259,14538,20200131,28797
20200128,K,도농,10329,9356,20200131,19685
20200128,K,양정,828,704,20200131,1532
20200128,K,덕소,6283,6075,20200131,12358
20200128,K,도심,2717,2065,20200131,4782
20200128,K,팔당,723,723,20200131,1446
20200128,K,운길산,562,520,20200131,1082
20200128,K,양수,1722,1771,20200131,3493
20200128,K,신원,170,143,20200131,313
20200128,K,국수,666,663,20200131,1329
20200128,K,아신,572,543,20200131,1115
20200128,K,오빈,279,295,20200131,574
20200128,K,양평,3528,3306,20200131,6834
20200128,K,원덕,357,369,20200131,726
20200128,K,용문,1713,1576,20200131,3289
20200128,K,지평,44,25,20200131,69
20200129,1,회기,25227,24636,20200201,49863
20200129,K,중랑,6004,5778,20200201,11782
20200129,K,상봉,6207,6007,20200201,12214
20200129,K,망우,8264,8121,20200201,16385
20200129,K,양원,1552,1596,20200201,3148
20200129,K,구리,14632,14971,20200201,29603
20200129,K,도농,10682,9488,20200201,20170
20200129,K,양정,868,790,20200201,1658
20200129,K,덕소,6385,6134,20200201,12519
20200129,K,도심,2828,2161,20200201,4989
20200129,K,팔당,723,721,20200201,1444
20200129,K,운길산,587,511,20200201,1098
20200129,K,양수,1795,1707,20200201,3502
20200129,K,신원,160,168,20200201,328
20200129,K,국수,715,718,20200201,1433
20200129,K,아신,547,541,20200201,1088
20200129,K,오빈,273,272,20200201,545
20200129,K,양평,2912,2878,20200201,5790
20200129,K,원덕,317,307,20200201,624
20200129,K,용문,1641,1789,20200201,3430
20200129,K,지평,40,20,20200201,60
20200130,K,지평,42,43,20200202,85
20200130,K,용문,2803,2856,20200202,5659
20200130,K,원덕,345,344,20200202,689
20200130,K,양평,3048,3021,20200202,6069
20200130,K,오빈,309,322,20200202,631
20200130,K,아신,556,552,20200202,1108
20200130,K,국수,690,696,20200202,1386
20200130,K,신원,187,196,20200202,383
20200130,K,양수,1799,1774,20200202,3573
20200130,K,운길산,622,557,20200202,1179
20200130,K,팔당,763,794,20200202,1557
20200130,K,도심,2898,2309,20200202,5207
20200130,K,덕소,6339,6200,20200202,12539
20200130,K,양정,868,726,20200202,1594
20200130,K,도농,10681,9584,20200202,20265
20200130,K,구리,14542,14758,20200202,29300
20200130,K,양원,1646,1653,20200202,3299
20200130,K,망우,8196,7926,20200202,16122
20200130,K,상봉,6381,6210,20200202,12591
20200130,K,중랑,5992,5717,20200202,11709
20200130,1,회기,25431,24708,20200202,50139
20200131,1,회기,25620,24595,20200203,50215
20200131,K,중랑,5987,5622,20200203,11609
20200131,K,상봉,6384,6120,20200203,12504
20200131,K,망우,8336,8130,20200203,16466
20200131,K,양원,1510,1479,20200203,2989
20200131,K,구리,14829,15151,20200203,29980
20200131,K,도농,10556,9335,20200203,19891
20200131,K,양정,843,776,20200203,1619
20200131,K,덕소,6346,6305,20200203,12651
20200131,K,도심,2731,2105,20200203,4836
20200131,K,팔당,791,742,20200203,1533
20200131,K,운길산,600,576,20200203,1176
20200131,K,양수,1938,1879,20200203,3817
20200131,K,신원,183,195,20200203,378
20200131,K,국수,734,737,20200203,1471
20200131,K,아신,588,552,20200203,1140
20200131,K,오빈,266,292,20200203,558
20200131,K,양평,3031,3205,20200203,6236
20200131,K,원덕,319,330,20200203,649
20200131,K,용문,1858,1882,20200203,3740
20200131,K,지평,36,28,20200203,64
20200201,1,회기,19530,18877,20200204,38407
20200201,K,중랑,4252,4121,20200204,8373
20200201,K,상봉,4707,4598,20200204,9305
20200201,K,망우,6171,6084,20200204,12255
20200201,K,양원,1025,1009,20200204,2034
20200201,K,구리,10195,10619,20200204,20814
20200201,K,도농,6359,5830,20200204,12189
20200201,K,양정,513,451,20200204,964
20200201,K,덕소,4519,4367,20200204,8886
20200201,K,도심,1592,1419,20200204,3011
20200201,K,팔당,932,967,20200204,1899
20200201,K,운길산,688,652,20200204,1340
20200201,K,양수,1487,1598,20200204,3085
20200201,K,신원,146,177,20200204,323
20200201,K,국수,545,541,20200204,1086
20200201,K,아신,479,474,20200204,953
20200201,K,오빈,219,218,20200204,437
20200201,K,양평,2295,2418,20200204,4713
20200201,K,원덕,312,292,20200204,604
20200201,K,용문,1555,1739,20200204,3294
20200201,K,지평,37,27,20200204,64
20200202,1,회기,16945,16740,20200205,33685
20200202,K,중랑,3250,3116,20200205,6366
20200202,K,상봉,3697,3528,20200205,7225
20200202,K,망우,4589,4638,20200205,9227
20200202,K,양원,696,751,20200205,1447
20200202,K,구리,6942,7288,20200205,14230
20200202,K,도농,4422,4400,20200205,8822
20200202,K,양정,448,386,20200205,834
20200202,K,덕소,3394,3430,20200205,6824
20200202,K,도심,1248,1164,20200205,2412
20200202,K,팔당,975,908,20200205,1883
20200202,K,운길산,709,657,20200205,1366
20200202,K,양수,1214,1179,20200205,2393
20200202,K,신원,169,107,20200205,276
20200202,K,국수,461,454,20200205,915
20200202,K,아신,415,391,20200205,806
20200202,K,오빈,165,166,20200205,331
20200202,K,양평,1854,1801,20200205,3655
20200202,K,원덕,275,232,20200205,507
20200202,K,용문,1525,1377,20200205,2902
20200202,K,지평,23,20,20200205,43
20200203,1,회기,24508,23761,20200206,48269
20200203,K,중랑,5727,5406,20200206,11133
20200203,K,상봉,5980,5849,20200206,11829
20200203,K,망우,7557,7388,20200206,14945
20200203,K,양원,1793,1920,20200206,3713
20200203,K,구리,13943,14077,20200206,28020
20200203,K,도농,10192,9138,20200206,19330
20200203,K,양정,826,720,20200206,1546
20200203,K,덕소,6129,6012,20200206,12141
20200203,K,도심,2762,2041,20200206,4803
20200203,K,팔당,648,588,20200206,1236
20200203,K,운길산,543,478,20200206,1021
20200203,K,양수,1644,1652,20200206,3296
20200203,K,신원,171,167,20200206,338
20200203,K,국수,661,676,20200206,1337
20200203,K,아신,526,516,20200206,1042
20200203,K,오빈,291,282,20200206,573
20200203,K,양평,3176,3180,20200206,6356
20200203,K,원덕,317,273,20200206,590
20200203,K,용문,1492,1479,20200206,2971
20200203,K,지평,42,27,20200206,69
20200204,1,회기,24957,24142,20200207,49099
20200204,K,중랑,5637,5371,20200207,11008
20200204,K,상봉,5903,5674,20200207,11577
20200204,K,망우,7411,7316,20200207,14727
20200204,K,양원,1788,1872,20200207,3660
20200204,K,구리,13754,14029,20200207,27783
20200204,K,도농,9995,8972,20200207,18967
20200204,K,양정,814,682,20200207,1496
20200204,K,덕소,5958,5936,20200207,11894
20200204,K,도심,2678,2055,20200207,4733
20200204,K,팔당,609,602,20200207,1211
20200204,K,운길산,587,572,20200207,1159
20200204,K,양수,1600,1617,20200207,3217
20200204,K,신원,153,132,20200207,285
20200204,K,국수,624,605,20200207,1229
20200204,K,아신,525,517,20200207,1042
20200204,K,오빈,277,251,20200207,528
20200204,K,양평,2606,2625,20200207,5231
20200204,K,원덕,286,277,20200207,563
20200204,K,용문,1627,1630,20200207,3257
20200204,K,지평,42,28,20200207,70
20200205,1,회기,23930,22902,20200208,46832
20200205,K,중랑,5411,5135,20200208,10546
20200205,K,상봉,5604,5421,20200208,11025
20200205,K,망우,7177,7075,20200208,14252
20200205,K,양원,1623,1744,20200208,3367
20200205,K,구리,12535,12365,20200208,24900
20200205,K,도농,9429,8573,20200208,18002
20200205,K,양정,783,675,20200208,1458
20200205,K,덕소,5610,5494,20200208,11104
20200205,K,도심,2495,1969,20200208,4464
20200205,K,팔당,636,613,20200208,1249
20200205,K,운길산,448,402,20200208,850
20200205,K,양수,1376,1323,20200208,2699
20200205,K,신원,118,122,20200208,240
20200205,K,국수,597,559,20200208,1156
20200205,K,아신,422,408,20200208,830
20200205,K,오빈,230,250,20200208,480
20200205,K,양평,2288,2315,20200208,4603
20200205,K,원덕,261,257,20200208,518
20200205,K,용문,1819,1781,20200208,3600
20200205,K,지평,28,20,20200208,48
20200206,1,회기,24037,23010,20200209,47047
20200206,K,중랑,5323,5122,20200209,10445
20200206,K,상봉,5581,5214,20200209,10795
20200206,K,망우,6987,6876,20200209,13863
20200206,K,양원,1641,1766,20200209,3407
20200206,K,구리,11788,11638,20200209,23426
20200206,K,도농,9277,8352,20200209,17629
20200206,K,양정,726,619,20200209,1345
20200206,K,덕소,5494,5409,20200209,10903
20200206,K,도심,2450,1920,20200209,4370
20200206,K,팔당,595,582,20200209,1177
20200206,K,운길산,449,392,20200209,841
20200206,K,양수,1343,1419,20200209,2762
20200206,K,신원,127,123,20200209,250
20200206,K,국수,481,500,20200209,981
20200206,K,아신,444,441,20200209,885
20200206,K,오빈,245,246,20200209,491
20200206,K,양평,2216,2248,20200209,4464
20200206,K,원덕,243,225,20200209,468
20200206,K,용문,1210,1279,20200209,2489
20200206,K,지평,33,30,20200209,63
20200207,1,회기,24691,23645,20200210,48336
20200207,K,중랑,5625,5317,20200210,10942
20200207,K,상봉,6158,5894,20200210,12052
20200207,K,망우,7700,7519,20200210,15219
20200207,K,양원,1752,1803,20200210,3555
20200207,K,구리,12465,12642,20200210,25107
20200207,K,도농,9627,8705,20200210,18332
20200207,K,양정,741,645,20200210,1386
20200207,K,덕소,5637,5576,20200210,11213
20200207,K,도심,2516,1911,20200210,4427
20200207,K,팔당,649,619,20200210,1268
20200207,K,운길산,509,472,20200210,981
20200207,K,양수,1459,1472,20200210,2931
20200207,K,신원,157,122,20200210,279
20200207,K,국수,574,580,20200210,1154
20200207,K,아신,478,506,20200210,984
20200207,K,오빈,239,236,20200210,475
20200207,K,양평,2337,2495,20200210,4832
20200207,K,원덕,256,264,20200210,520
20200207,K,용문,1356,1592,20200210,2948
20200207,K,지평,42,31,20200210,73
20200208,1,회기,20995,20445,20200211,41440
20200208,K,중랑,4091,3962,20200211,8053
20200208,K,상봉,4478,4285,20200211,8763
20200208,K,망우,5780,5625,20200211,11405
20200208,K,양원,943,1010,20200211,1953
20200208,K,구리,8461,8574,20200211,17035
20200208,K,도농,5810,5375,20200211,11185
20200208,K,양정,545,459,20200211,1004
20200208,K,덕소,3850,3851,20200211,7701
20200208,K,도심,1418,1294,20200211,2712
20200208,K,팔당,907,937,20200211,1844
20200208,K,운길산,697,618,20200211,1315
20200208,K,양수,1395,1470,20200211,2865
20200208,K,신원,138,156,20200211,294
20200208,K,국수,498,547,20200211,1045
20200208,K,아신,428,453,20200211,881
20200208,K,오빈,243,244,20200211,487
20200208,K,양평,2541,2773,20200211,5314
20200208,K,원덕,252,262,20200211,514
20200208,K,용문,1423,1600,20200211,3023
20200208,K,지평,25,30,20200211,55
20200209,1,회기,14928,14659,20200212,29587
20200209,K,중랑,3031,2874,20200212,5905
20200209,K,상봉,3527,3403,20200212,6930
20200209,K,망우,4139,4148,20200212,8287
20200209,K,양원,691,766,20200212,1457
20200209,K,구리,6105,6433,20200212,12538
20200209,K,도농,4281,4197,20200212,8478
20200209,K,양정,355,318,20200212,673
20200209,K,덕소,3072,3034,20200212,6106
20200209,K,도심,1176,1035,20200212,2211
20200209,K,팔당,801,907,20200212,1708
20200209,K,운길산,809,695,20200212,1504
20200209,K,양수,1221,1137,20200212,2358
20200209,K,신원,176,138,20200212,314
20200209,K,국수,479,467,20200212,946
20200209,K,아신,365,299,20200212,664
20200209,K,오빈,133,149,20200212,282
20200209,K,양평,1707,1662,20200212,3369
20200209,K,원덕,232,204,20200212,436
20200209,K,용문,1295,1161,20200212,2456
20200209,K,지평,29,26,20200212,55
20200210,1,회기,24443,23762,20200213,48205
20200210,K,중랑,5551,5333,20200213,10884
20200210,K,상봉,5934,5711,20200213,11645
20200210,K,망우,7566,7401,20200213,14967
20200210,K,양원,1431,1418,20200213,2849
20200210,K,구리,12818,12733,20200213,25551
20200210,K,도농,9785,8725,20200213,18510
20200210,K,양정,806,700,20200213,1506
20200210,K,덕소,5818,5674,20200213,11492
20200210,K,도심,2552,1982,20200213,4534
20200210,K,팔당,690,651,20200213,1341
20200210,K,운길산,599,545,20200213,1144
20200210,K,양수,1602,1584,20200213,3186
20200210,K,신원,195,147,20200213,342
20200210,K,국수,650,685,20200213,1335
20200210,K,아신,473,436,20200213,909
20200210,K,오빈,260,257,20200213,517
20200210,K,양평,2568,2564,20200213,5132
20200210,K,원덕,319,324,20200213,643
20200210,K,용문,2330,2319,20200213,4649
20200210,K,지평,40,24,20200213,64
20200211,K,팔당,752,719,20200214,1471
20200211,1,회기,25360,24447,20200214,49807
20200211,K,중랑,5672,5455,20200214,11127
20200211,K,상봉,6104,5744,20200214,11848
20200211,K,망우,7696,7498,20200214,15194
20200211,K,양원,1497,1524,20200214,3021
20200211,K,구리,13428,13383,20200214,26811
20200211,K,도농,10061,9093,20200214,19154
20200211,K,양정,834,743,20200214,1577
20200211,K,덕소,6029,5845,20200214,11874
20200211,K,도심,2608,2030,20200214,4638
20200211,K,운길산,651,564,20200214,1215
20200211,K,양수,1748,1729,20200214,3477
20200211,K,신원,181,192,20200214,373
20200211,K,국수,598,615,20200214,1213
20200211,K,아신,497,485,20200214,982
20200211,K,오빈,258,251,20200214,509
20200211,K,양평,2578,2623,20200214,5201
20200211,K,원덕,292,307,20200214,599
20200211,K,용문,1660,1593,20200214,3253
20200211,K,지평,52,38,20200214,90
20200212,1,회기,24315,23465,20200215,47780
20200212,K,중랑,5493,5272,20200215,10765
20200212,K,상봉,5705,5605,20200215,11310
20200212,K,망우,7380,7155,20200215,14535
20200212,K,양원,1326,1345,20200215,2671
20200212,K,구리,12766,13017,20200215,25783
20200212,K,도농,9766,8635,20200215,18401
20200212,K,양정,771,621,20200215,1392
20200212,K,덕소,5505,5471,20200215,10976
20200212,K,도심,2511,2008,20200215,4519
20200212,K,팔당,586,601,20200215,1187
20200212,K,운길산,491,414,20200215,905
20200212,K,양수,1437,1453,20200215,2890
20200212,K,신원,128,135,20200215,263
20200212,K,국수,548,528,20200215,1076
20200212,K,아신,452,448,20200215,900
20200212,K,오빈,244,222,20200215,466
20200212,K,양평,2294,2313,20200215,4607
20200212,K,원덕,243,231,20200215,474
20200212,K,용문,1363,1381,20200215,2744
20200212,K,지평,36,28,20200215,64
20200213,1,회기,25637,24751,20200216,50388
20200213,K,중랑,5820,5556,20200216,11376
20200213,K,상봉,6271,5939,20200216,12210
20200213,K,망우,7923,7739,20200216,15662
20200213,K,양원,1533,1521,20200216,3054
20200213,K,구리,13632,13937,20200216,27569
20200213,K,도농,10393,9209,20200216,19602
20200213,K,양정,843,737,20200216,1580
20200213,K,덕소,6034,5963,20200216,11997
20200213,K,도심,2746,2064,20200216,4810
20200213,K,팔당,757,791,20200216,1548
20200213,K,운길산,626,530,20200216,1156
20200213,K,양수,1719,1742,20200216,3461
20200213,K,신원,181,171,20200216,352
20200213,K,국수,631,636,20200216,1267
20200213,K,아신,517,538,20200216,1055
20200213,K,오빈,294,298,20200216,592
20200213,K,양평,3410,3419,20200216,6829
20200213,K,원덕,331,314,20200216,645
20200213,K,용문,1568,1627,20200216,3195
20200213,K,지평,51,28,20200216,79
20200214,1,회기,26867,25283,20200217,52150
20200214,K,중랑,5989,5664,20200217,11653
20200214,K,상봉,6551,6396,20200217,12947
20200214,K,망우,8284,8122,20200217,16406
20200214,K,양원,1579,1488,20200217,3067
20200214,K,구리,14534,14698,20200217,29232
20200214,K,도농,10791,9483,20200217,20274
20200214,K,양정,953,846,20200217,1799
20200214,K,덕소,6413,6344,20200217,12757
20200214,K,도심,2765,2078,20200217,4843
20200214,K,팔당,841,807,20200217,1648
20200214,K,운길산,660,593,20200217,1253
20200214,K,양수,1757,1834,20200217,3591
20200214,K,신원,191,149,20200217,340
20200214,K,국수,691,733,20200217,1424
20200214,K,아신,553,571,20200217,1124
20200214,K,오빈,263,271,20200217,534
20200214,K,양평,2916,3018,20200217,5934
20200214,K,원덕,340,342,20200217,682
20200214,K,용문,1755,1911,20200217,3666
20200214,K,지평,45,38,20200217,83
20200215,K,망우,6726,6575,20200218,13301
20200215,1,회기,20999,19974,20200218,40973
20200215,K,중랑,4473,4275,20200218,8748
20200215,K,상봉,5163,4880,20200218,10043
20200215,K,양원,1143,1190,20200218,2333
20200215,K,구리,10488,10770,20200218,21258
20200215,K,도농,6877,6228,20200218,13105
20200215,K,양정,587,552,20200218,1139
20200215,K,덕소,4820,4643,20200218,9463
20200215,K,도심,1790,1573,20200218,3363
20200215,K,팔당,1117,1086,20200218,2203
20200215,K,운길산,868,830,20200218,1698
20200215,K,양수,1720,1825,20200218,3545
20200215,K,신원,238,164,20200218,402
20200215,K,국수,667,730,20200218,1397
20200215,K,아신,498,500,20200218,998
20200215,K,오빈,278,276,20200218,554
20200215,K,양평,2399,2546,20200218,4945
20200215,K,원덕,358,346,20200218,704
20200215,K,용문,3167,3335,20200218,6502
20200215,K,지평,38,40,20200218,78
20200216,1,회기,15182,14977,20200219,30159
20200216,K,중랑,3229,3105,20200219,6334
20200216,K,상봉,3756,3607,20200219,7363
20200216,K,망우,4656,4668,20200219,9324
20200216,K,양원,668,768,20200219,1436
20200216,K,구리,6792,7292,20200219,14084
20200216,K,도농,4744,4691,20200219,9435
20200216,K,양정,393,327,20200219,720
20200216,K,덕소,3283,3267,20200219,6550
20200216,K,도심,1183,1173,20200219,2356
20200216,K,팔당,867,817,20200219,1684
20200216,K,운길산,716,588,20200219,1304
20200216,K,양수,1295,1265,20200219,2560
20200216,K,신원,159,117,20200219,276
20200216,K,국수,447,418,20200219,865
20200216,K,아신,409,337,20200219,746
20200216,K,오빈,156,155,20200219,311
20200216,K,양평,1727,1679,20200219,3406
20200216,K,원덕,246,202,20200219,448
20200216,K,용문,1498,1307,20200219,2805
20200216,K,지평,32,25,20200219,57
20200217,1,회기,24409,23882,20200220,48291
20200217,K,중랑,5541,5390,20200220,10931
20200217,K,상봉,5884,5785,20200220,11669
20200217,K,망우,7605,7354,20200220,14959
20200217,K,양원,1424,1449,20200220,2873
20200217,K,구리,13692,13709,20200220,27401
20200217,K,도농,10394,9157,20200220,19551
20200217,K,양정,784,655,20200220,1439
20200217,K,덕소,5946,5782,20200220,11728
20200217,K,도심,2711,2060,20200220,4771
20200217,K,팔당,689,662,20200220,1351
20200217,K,운길산,607,526,20200220,1133
20200217,K,양수,1551,1559,20200220,3110
20200217,K,신원,160,126,20200220,286
20200217,K,국수,587,576,20200220,1163
20200217,K,아신,490,482,20200220,972
20200217,K,오빈,248,229,20200220,477
20200217,K,양평,2589,2584,20200220,5173
20200217,K,원덕,259,261,20200220,520
20200217,K,용문,1685,1675,20200220,3360
20200217,K,지평,47,39,20200220,86
20200218,1,회기,25101,24386,20200221,49487
20200218,K,중랑,5683,5381,20200221,11064
20200218,K,상봉,5939,5764,20200221,11703
20200218,K,망우,7437,7320,20200221,14757
20200218,K,양원,1372,1458,20200221,2830
20200218,K,구리,13760,13945,20200221,27705
20200218,K,도농,10117,9075,20200221,19192
20200218,K,양정,787,679,20200221,1466
20200218,K,덕소,6065,5995,20200221,12060
20200218,K,도심,2607,2036,20200221,4643
20200218,K,팔당,741,702,20200221,1443
20200218,K,운길산,578,541,20200221,1119
20200218,K,양수,1593,1585,20200221,3178
20200218,K,신원,172,142,20200221,314
20200218,K,국수,605,618,20200221,1223
20200218,K,아신,508,535,20200221,1043
20200218,K,오빈,273,249,20200221,522
20200218,K,양평,3134,3020,20200221,6154
20200218,K,원덕,274,257,20200221,531
20200218,K,용문,1447,1529,20200221,2976
20200218,K,지평,40,28,20200221,68
20200219,1,회기,26217,25419,20200222,51636
20200219,K,중랑,5788,5472,20200222,11260
20200219,K,상봉,6049,5948,20200222,11997
20200219,K,망우,7966,7811,20200222,15777
20200219,K,양원,1515,1550,20200222,3065
20200219,K,구리,13997,14211,20200222,28208
20200219,K,도농,10300,9137,20200222,19437
20200219,K,양정,819,746,20200222,1565
20200219,K,덕소,6006,5941,20200222,11947
20200219,K,도심,2753,2110,20200222,4863
20200219,K,팔당,732,722,20200222,1454
20200219,K,운길산,621,549,20200222,1170
20200219,K,양수,1694,1694,20200222,3388
20200219,K,신원,194,136,20200222,330
20200219,K,국수,644,639,20200222,1283
20200219,K,아신,500,534,20200222,1034
20200219,K,오빈,252,246,20200222,498
20200219,K,양평,2607,2594,20200222,5201
20200219,K,원덕,281,275,20200222,556
20200219,K,용문,1504,1509,20200222,3013
20200219,K,지평,39,25,20200222,64
20200220,1,회기,25077,24033,20200223,49110
20200220,K,중랑,5532,5248,20200223,10780
20200220,K,상봉,6153,6028,20200223,12181
20200220,K,망우,7798,7429,20200223,15227
20200220,K,양원,1459,1507,20200223,2966
20200220,K,구리,13816,13858,20200223,27674
20200220,K,도농,10241,9154,20200223,19395
20200220,K,양정,882,715,20200223,1597
20200220,K,덕소,6019,5923,20200223,11942
20200220,K,도심,2703,2115,20200223,4818
20200220,K,팔당,766,774,20200223,1540
20200220,K,운길산,595,543,20200223,1138
20200220,K,양수,1642,1637,20200223,3279
20200220,K,신원,179,153,20200223,332
20200220,K,국수,598,599,20200223,1197
20200220,K,아신,504,520,20200223,1024
20200220,K,오빈,273,271,20200223,544
20200220,K,양평,2584,2613,20200223,5197
20200220,K,원덕,311,328,20200223,639
20200220,K,용문,2503,2539,20200223,5042
20200220,K,지평,42,27,20200223,69
20200221,1,회기,25548,22849,20200224,48397
20200221,K,중랑,4108,6569,20200224,10677
20200221,K,상봉,6760,6565,20200224,13325
20200221,K,망우,6530,9550,20200224,16080
20200221,K,양원,1277,1361,20200224,2638
20200221,K,구리,11921,15525,20200224,27446
20200221,K,도농,9600,9525,20200224,19125
20200221,K,양정,791,974,20200224,1765
20200221,K,덕소,4443,5865,20200224,10308
20200221,K,도심,2356,1978,20200224,4334
20200221,K,팔당,659,767,20200224,1426
20200221,K,운길산,506,511,20200224,1017
20200221,K,양수,1417,1570,20200224,2987
20200221,K,신원,173,205,20200224,378
20200221,K,국수,492,628,20200224,1120
20200221,K,아신,496,518,20200224,1014
20200221,K,오빈,261,256,20200224,517
20200221,K,양평,2434,2513,20200224,4947
20200221,K,원덕,269,295,20200224,564
20200221,K,용문,1368,1509,20200224,2877
20200221,K,지평,37,25,20200224,62
20200222,1,회기,16951,16223,20200225,33174
20200222,K,중랑,3685,3569,20200225,7254
20200222,K,상봉,4070,3984,20200225,8054
20200222,K,망우,5034,4995,20200225,10029
20200222,K,양원,836,862,20200225,1698
20200222,K,구리,8254,8630,20200225,16884
20200222,K,도농,5339,4923,20200225,10262
20200222,K,양정,455,405,20200225,860
20200222,K,덕소,3578,3597,20200225,7175
20200222,K,도심,1343,1164,20200225,2507
20200222,K,팔당,715,772,20200225,1487
20200222,K,운길산,578,570,20200225,1148
20200222,K,양수,1309,1226,20200225,2535
20200222,K,신원,119,122,20200225,241
20200222,K,국수,386,470,20200225,856
20200222,K,아신,341,366,20200225,707
20200222,K,오빈,188,196,20200225,384
20200222,K,양평,1718,1921,20200225,3639
20200222,K,원덕,193,250,20200225,443
20200222,K,용문,1164,1316,20200225,2480
20200222,K,지평,36,35,20200225,71
20200223,1,회기,12172,12088,20200226,24260
20200223,K,중랑,2603,2511,20200226,5114
20200223,K,상봉,3059,2891,20200226,5950
20200223,K,망우,3477,3325,20200226,6802
20200223,K,양원,625,660,20200226,1285
20200223,K,구리,5585,5969,20200226,11554
20200223,K,도농,3605,3477,20200226,7082
20200223,K,양정,345,311,20200226,656
20200223,K,덕소,2721,2513,20200226,5234
20200223,K,도심,940,933,20200226,1873
20200223,K,팔당,795,817,20200226,1612
20200223,K,운길산,658,601,20200226,1259
20200223,K,양수,1105,935,20200226,2040
20200223,K,신원,153,145,20200226,298
20200223,K,국수,449,386,20200226,835
20200223,K,아신,337,335,20200226,672
20200223,K,오빈,131,154,20200226,285
20200223,K,양평,1779,1660,20200226,3439
20200223,K,원덕,203,174,20200226,377
20200223,K,용문,1102,971,20200226,2073
20200223,K,지평,28,25,20200226,53
20200224,1,회기,20383,19665,20200227,40048
20200224,K,중랑,5041,4724,20200227,9765
20200224,K,상봉,5178,5073,20200227,10251
20200224,K,망우,6522,6446,20200227,12968
20200224,K,양원,1195,1221,20200227,2416
20200224,K,구리,11800,11897,20200227,23697
20200224,K,도농,8541,7676,20200227,16217
20200224,K,양정,775,648,20200227,1423
20200224,K,덕소,5001,4903,20200227,9904
20200224,K,도심,2231,1684,20200227,3915
20200224,K,팔당,609,594,20200227,1203
20200224,K,운길산,513,475,20200227,988
20200224,K,양수,1219,1189,20200227,2408
20200224,K,신원,134,113,20200227,247
20200224,K,국수,475,512,20200227,987
20200224,K,아신,438,429,20200227,867
20200224,K,오빈,184,182,20200227,366
20200224,K,양평,1904,1897,20200227,3801
20200224,K,원덕,235,220,20200227,455
20200224,K,용문,1108,1094,20200227,2202
20200224,K,지평,37,23,20200227,60
20200225,1,회기,18813,18068,20200228,36881
20200225,K,중랑,4517,4327,20200228,8844
20200225,K,상봉,4722,4511,20200228,9233
20200225,K,망우,5820,5684,20200228,11504
20200225,K,양원,1039,1018,20200228,2057
20200225,K,구리,10618,10831,20200228,21449
20200225,K,도농,7959,7131,20200228,15090
20200225,K,양정,666,559,20200228,1225
20200225,K,덕소,4473,4372,20200228,8845
20200225,K,도심,2044,1557,20200228,3601
20200225,K,팔당,443,446,20200228,889
20200225,K,운길산,341,296,20200228,637
20200225,K,양수,885,904,20200228,1789
20200225,K,신원,91,91,20200228,182
20200225,K,국수,359,362,20200228,721
20200225,K,아신,320,305,20200228,625
20200225,K,오빈,177,189,20200228,366
20200225,K,양평,1508,1467,20200228,2975
20200225,K,원덕,186,181,20200228,367
20200225,K,용문,1019,1045,20200228,2064
20200225,K,지평,30,18,20200228,48
20200226,1,회기,19139,18152,20200229,37291
20200226,K,중랑,4734,4494,20200229,9228
20200226,K,상봉,4863,4758,20200229,9621
20200226,K,망우,6219,6056,20200229,12275
20200226,K,양원,1047,1101,20200229,2148
20200226,K,구리,10902,11009,20200229,21911
20200226,K,도농,7837,6924,20200229,14761
20200226,K,양정,719,639,20200229,1358
20200226,K,덕소,4563,4488,20200229,9051
20200226,K,도심,2039,1607,20200229,3646
20200226,K,팔당,540,532,20200229,1072
20200226,K,운길산,465,429,20200229,894
20200226,K,양수,1103,1141,20200229,2244
20200226,K,신원,132,109,20200229,241
20200226,K,국수,431,448,20200229,879
20200226,K,아신,359,391,20200229,750
20200226,K,오빈,167,167,20200229,334
20200226,K,양평,1628,1618,20200229,3246
20200226,K,원덕,208,224,20200229,432
20200226,K,용문,1032,1057,20200229,2089
20200226,K,지평,29,23,20200229,52
20200227,1,회기,18458,17518,20200301,35976
20200227,K,중랑,4535,4384,20200301,8919
20200227,K,상봉,4822,4643,20200301,9465
20200227,K,망우,6037,5892,20200301,11929
20200227,K,양원,1099,1075,20200301,2174
20200227,K,구리,10436,10600,20200301,21036
20200227,K,도농,7641,6929,20200301,14570
20200227,K,양정,727,647,20200301,1374
20200227,K,덕소,4499,4479,20200301,8978
20200227,K,도심,2035,1558,20200301,3593
20200227,K,팔당,587,573,20200301,1160
20200227,K,운길산,495,450,20200301,945
20200227,K,양수,1074,1104,20200301,2178
20200227,K,신원,126,105,20200301,231
20200227,K,국수,419,419,20200301,838
20200227,K,아신,383,377,20200301,760
20200227,K,오빈,178,179,20200301,357
20200227,K,양평,1746,1737,20200301,3483
20200227,K,원덕,215,214,20200301,429
20200227,K,용문,1028,1059,20200301,2087
20200227,K,지평,32,28,20200301,60
20200228,1,회기,17901,17075,20200302,34976
20200228,K,중랑,4414,4346,20200302,8760
20200228,K,상봉,4649,4452,20200302,9101
20200228,K,망우,5718,5684,20200302,11402
20200228,K,양원,983,993,20200302,1976
20200228,K,구리,10302,10468,20200302,20770
20200228,K,도농,7317,6655,20200302,13972
20200228,K,양정,657,551,20200302,1208
20200228,K,덕소,4278,4266,20200302,8544
20200228,K,도심,1933,1472,20200302,3405
20200228,K,팔당,499,486,20200302,985
20200228,K,운길산,366,355,20200302,721
20200228,K,양수,945,978,20200302,1923
20200228,K,신원,84,75,20200302,159
20200228,K,국수,369,385,20200302,754
20200228,K,아신,318,340,20200302,658
20200228,K,오빈,153,159,20200302,312
20200228,K,양평,1708,1771,20200302,3479
20200228,K,원덕,176,172,20200302,348
20200228,K,용문,922,1021,20200302,1943
20200228,K,지평,31,24,20200302,55
20200229,1,회기,11959,11350,20200303,23309
20200229,K,중랑,2949,2848,20200303,5797
20200229,K,상봉,3081,2871,20200303,5952
20200229,K,망우,3906,3741,20200303,7647
20200229,K,양원,651,698,20200303,1349
20200229,K,구리,6302,6606,20200303,12908
20200229,K,도농,3834,3561,20200303,7395
20200229,K,양정,436,371,20200303,807
20200229,K,덕소,2776,2817,20200303,5593
20200229,K,도심,1047,925,20200303,1972
20200229,K,팔당,777,865,20200303,1642
20200229,K,운길산,615,576,20200303,1191
20200229,K,양수,965,1012,20200303,1977
20200229,K,신원,135,99,20200303,234
20200229,K,국수,300,327,20200303,627
20200229,K,아신,311,298,20200303,609
20200229,K,오빈,149,160,20200303,309
20200229,K,양평,1218,1346,20200303,2564
20200229,K,원덕,152,177,20200303,329
20200229,K,용문,897,950,20200303,1847
20200229,K,지평,19,26,20200303,45
20200301,1,회기,8348,8131,20200304,16479
20200301,K,중랑,1996,1895,20200304,3891
20200301,K,상봉,2325,2272,20200304,4597
20200301,K,망우,2655,2562,20200304,5217
20200301,K,양원,463,512,20200304,975
20200301,K,구리,4165,4442,20200304,8607
20200301,K,도농,2446,2403,20200304,4849
20200301,K,양정,236,214,20200304,450
20200301,K,덕소,1988,1905,20200304,3893
20200301,K,도심,763,672,20200304,1435
20200301,K,팔당,781,880,20200304,1661
20200301,K,운길산,627,574,20200304,1201
20200301,K,양수,830,783,20200304,1613
20200301,K,신원,152,68,20200304,220
20200301,K,국수,305,316,20200304,621
20200301,K,아신,270,237,20200304,507
20200301,K,오빈,119,114,20200304,233
20200301,K,양평,998,930,20200304,1928
20200301,K,원덕,202,157,20200304,359
20200301,K,용문,896,761,20200304,1657
20200301,K,지평,29,12,20200304,41
20200302,1,회기,17146,16701,20200305,33847
20200302,K,중랑,4352,4200,20200305,8552
20200302,K,상봉,4560,4500,20200305,9060
20200302,K,망우,5837,5745,20200305,11582
20200302,K,양원,1091,1073,20200305,2164
20200302,K,구리,10376,10496,20200305,20872
20200302,K,도농,7605,6908,20200305,14513
20200302,K,양정,714,628,20200305,1342
20200302,K,덕소,4502,4475,20200305,8977
20200302,K,도심,1998,1551,20200305,3549
20200302,K,팔당,536,532,20200305,1068
20200302,K,운길산,478,426,20200305,904
20200302,K,양수,1117,1100,20200305,2217
20200302,K,신원,145,116,20200305,261
20200302,K,국수,465,479,20200305,944
20200302,K,아신,350,335,20200305,685
20200302,K,오빈,167,177,20200305,344
20200302,K,양평,1774,1735,20200305,3509
20200302,K,원덕,197,172,20200305,369
20200302,K,용문,1029,997,20200305,2026
20200302,K,지평,29,20,20200305,49
20200303,1,회기,17401,16835,20200306,34236
20200303,K,중랑,4386,4211,20200306,8597
20200303,K,상봉,4568,4431,20200306,8999
20200303,K,망우,5660,5558,20200306,11218
20200303,K,양원,1007,1024,20200306,2031
20200303,K,구리,10604,10615,20200306,21219
20200303,K,도농,7477,6758,20200306,14235
20200303,K,양정,705,618,20200306,1323
20200303,K,덕소,4369,4410,20200306,8779
20200303,K,도심,2025,1538,20200306,3563
20200303,K,팔당,552,542,20200306,1094
20200303,K,운길산,472,448,20200306,920
20200303,K,양수,1099,1109,20200306,2208
20200303,K,신원,132,112,20200306,244
20200303,K,국수,431,458,20200306,889
20200303,K,아신,357,356,20200306,713
20200303,K,오빈,185,181,20200306,366
20200303,K,양평,1971,1968,20200306,3939
20200303,K,원덕,215,200,20200306,415
20200303,K,용문,1009,1032,20200306,2041
20200303,K,지평,37,23,20200306,60
20200304,K,지평,29,17,20200307,46
20200304,1,회기,17181,16417,20200307,33598
20200304,K,중랑,4316,4098,20200307,8414
20200304,K,상봉,4460,4334,20200307,8794
20200304,K,망우,5636,5456,20200307,11092
20200304,K,양원,1017,1012,20200307,2029
20200304,K,구리,10358,10683,20200307,21041
20200304,K,도농,7296,6650,20200307,13946
20200304,K,양정,660,563,20200307,1223
20200304,K,덕소,4375,4379,20200307,8754
20200304,K,도심,1902,1489,20200307,3391
20200304,K,팔당,504,508,20200307,1012
20200304,K,운길산,411,388,20200307,799
20200304,K,양수,1027,1031,20200307,2058
20200304,K,신원,112,113,20200307,225
20200304,K,국수,388,391,20200307,779
20200304,K,아신,340,321,20200307,661
20200304,K,오빈,158,170,20200307,328
20200304,K,양평,1632,1593,20200307,3225
20200304,K,원덕,176,161,20200307,337
20200304,K,용문,984,978,20200307,1962
20200305,1,회기,16710,15750,20200308,32460
20200305,K,중랑,4308,4189,20200308,8497
20200305,K,상봉,4474,4426,20200308,8900
20200305,K,망우,5654,5546,20200308,11200
20200305,K,양원,1043,1005,20200308,2048
20200305,K,구리,10485,10664,20200308,21149
20200305,K,도농,7448,6734,20200308,14182
20200305,K,양정,689,619,20200308,1308
20200305,K,덕소,4327,4360,20200308,8687
20200305,K,도심,1987,1507,20200308,3494
20200305,K,팔당,574,541,20200308,1115
20200305,K,운길산,458,430,20200308,888
20200305,K,양수,1066,1030,20200308,2096
20200305,K,신원,113,107,20200308,220
20200305,K,국수,404,429,20200308,833
20200305,K,아신,357,381,20200308,738
20200305,K,오빈,177,180,20200308,357
20200305,K,양평,1670,1683,20200308,3353
20200305,K,원덕,206,221,20200308,427
20200305,K,용문,1375,1425,20200308,2800
20200305,K,지평,27,21,20200308,48
20200306,1,회기,17613,16540,20200309,34153
20200306,K,중랑,4413,4214,20200309,8627
20200306,K,상봉,4764,4666,20200309,9430
20200306,K,망우,5922,5756,20200309,11678
20200306,K,양원,1095,1024,20200309,2119
20200306,K,구리,10856,11126,20200309,21982
20200306,K,도농,7525,6878,20200309,14403
20200306,K,양정,740,597,20200309,1337
20200306,K,덕소,4593,4546,20200309,9139
20200306,K,도심,2002,1598,20200309,3600
20200306,K,팔당,604,629,20200309,1233
20200306,K,운길산,507,477,20200309,984
20200306,K,양수,1132,1188,20200309,2320
20200306,K,신원,145,128,20200309,273
20200306,K,국수,440,454,20200309,894
20200306,K,아신,407,397,20200309,804
20200306,K,오빈,184,195,20200309,379
20200306,K,양평,1817,1870,20200309,3687
20200306,K,원덕,200,229,20200309,429
20200306,K,용문,1039,1196,20200309,2235
20200306,K,지평,24,30,20200309,54
20200307,1,회기,12126,11278,20200310,23404
20200307,K,중랑,3108,2980,20200310,6088
20200307,K,상봉,3320,3134,20200310,6454
20200307,K,망우,3872,3874,20200310,7746
20200307,K,양원,712,744,20200310,1456
20200307,K,구리,6904,7116,20200310,14020
20200307,K,도농,4212,3835,20200310,8047
20200307,K,양정,461,416,20200310,877
20200307,K,덕소,3008,3149,20200310,6157
20200307,K,도심,1107,1000,20200310,2107
20200307,K,팔당,996,1042,20200310,2038
20200307,K,운길산,790,723,20200310,1513
20200307,K,양수,1136,1190,20200310,2326
20200307,K,신원,143,162,20200310,305
20200307,K,국수,376,408,20200310,784
20200307,K,아신,313,339,20200310,652
20200307,K,오빈,139,175,20200310,314
20200307,K,양평,1380,1516,20200310,2896
20200307,K,원덕,178,177,20200310,355
20200307,K,용문,1045,1161,20200310,2206
20200307,K,지평,21,33,20200310,54
20200308,1,회기,8833,8759,20200311,17592
20200308,K,중랑,2264,2196,20200311,4460
20200308,K,상봉,2558,2527,20200311,5085
20200308,K,망우,2821,2781,20200311,5602
20200308,K,양원,540,620,20200311,1160
20200308,K,구리,4961,5338,20200311,10299
20200308,K,도농,3009,2884,20200311,5893
20200308,K,양정,333,305,20200311,638
20200308,K,덕소,2429,2366,20200311,4795
20200308,K,도심,943,936,20200311,1879
20200308,K,팔당,1203,1245,20200311,2448
20200308,K,운길산,1049,895,20200311,1944
20200308,K,양수,1202,1039,20200311,2241
20200308,K,신원,266,187,20200311,453
20200308,K,국수,443,445,20200311,888
20200308,K,아신,356,272,20200311,628
20200308,K,오빈,143,144,20200311,287
20200308,K,양평,1637,1458,20200311,3095
20200308,K,원덕,238,244,20200311,482
20200308,K,용문,1079,995,20200311,2074
20200308,K,지평,34,30,20200311,64
20200309,1,회기,17437,16749,20200312,34186
20200309,K,중랑,4512,4291,20200312,8803
20200309,K,상봉,4840,4650,20200312,9490
20200309,K,망우,6105,5907,20200312,12012
20200309,K,양원,1154,1144,20200312,2298
20200309,K,구리,11271,11317,20200312,22588
20200309,K,도농,8002,7105,20200312,15107
20200309,K,양정,760,645,20200312,1405
20200309,K,덕소,4679,4618,20200312,9297
20200309,K,도심,2120,1545,20200312,3665
20200309,K,팔당,688,655,20200312,1343
20200309,K,운길산,580,538,20200312,1118
20200309,K,양수,1252,1266,20200312,2518
20200309,K,신원,143,137,20200312,280
20200309,K,국수,498,514,20200312,1012
20200309,K,아신,410,398,20200312,808
20200309,K,오빈,191,193,20200312,384
20200309,K,양평,1892,1870,20200312,3762
20200309,K,원덕,265,245,20200312,510
20200309,K,용문,1137,1080,20200312,2217
20200309,K,지평,30,16,20200312,46
20200310,1,회기,16471,16020,20200313,32491
20200310,K,중랑,4288,4213,20200313,8501
20200310,K,상봉,4378,4257,20200313,8635
20200310,K,망우,5595,5463,20200313,11058
20200310,K,양원,1032,990,20200313,2022
20200310,K,구리,10431,10631,20200313,21062
20200310,K,도농,7556,6831,20200313,14387
20200310,K,양정,642,554,20200313,1196
20200310,K,덕소,4310,4279,20200313,8589
20200310,K,도심,1996,1556,20200313,3552
20200310,K,팔당,461,455,20200313,916
20200310,K,운길산,354,325,20200313,679
20200310,K,양수,1018,1083,20200313,2101
20200310,K,신원,90,88,20200313,178
20200310,K,국수,397,393,20200313,790
20200310,K,아신,352,326,20200313,678
20200310,K,오빈,180,153,20200313,333
20200310,K,양평,1615,1581,20200313,3196
20200310,K,원덕,167,170,20200313,337
20200310,K,용문,1009,1055,20200313,2064
20200310,K,지평,31,17,20200313,48
20200311,1,회기,17322,16549,20200314,33871
20200311,K,중랑,4408,4268,20200314,8676
20200311,K,상봉,4726,4600,20200314,9326
20200311,K,망우,6065,5904,20200314,11969
20200311,K,양원,1094,1080,20200314,2174
20200311,K,구리,11035,11236,20200314,22271
20200311,K,도농,7745,7065,20200314,14810
20200311,K,양정,718,621,20200314,1339
20200311,K,덕소,4615,4565,20200314,9180
20200311,K,도심,2131,1605,20200314,3736
20200311,K,팔당,636,620,20200314,1256
20200311,K,운길산,574,534,20200314,1108
20200311,K,양수,1220,1265,20200314,2485
20200311,K,신원,145,134,20200314,279
20200311,K,국수,497,519,20200314,1016
20200311,K,아신,390,408,20200314,798
20200311,K,오빈,188,197,20200314,385
20200311,K,양평,1840,1855,20200314,3695
20200311,K,원덕,213,211,20200314,424
20200311,K,용문,1058,1088,20200314,2146
20200311,K,지평,29,26,20200314,55
20200312,1,회기,17190,16286,20200315,33476
20200312,K,중랑,4429,4207,20200315,8636
20200312,K,상봉,4698,4537,20200315,9235
20200312,K,망우,5884,5762,20200315,11646
20200312,K,양원,1081,1084,20200315,2165
20200312,K,구리,10781,10883,20200315,21664
20200312,K,도농,7641,6981,20200315,14622
20200312,K,양정,708,628,20200315,1336
20200312,K,덕소,4600,4535,20200315,9135
20200312,K,도심,2035,1594,20200315,3629
20200312,K,팔당,666,664,20200315,1330
20200312,K,운길산,561,557,20200315,1118
20200312,K,양수,1238,1222,20200315,2460
20200312,K,신원,157,126,20200315,283
20200312,K,국수,502,503,20200315,1005
20200312,K,아신,375,357,20200315,732
20200312,K,오빈,207,225,20200315,432
20200312,K,양평,1801,1834,20200315,3635
20200312,K,원덕,223,218,20200315,441
20200312,K,용문,1037,1022,20200315,2059
20200312,K,지평,34,26,20200315,60
20200313,1,회기,17493,16371,20200316,33864
20200313,K,중랑,4576,4284,20200316,8860
20200313,K,상봉,4836,4674,20200316,9510
20200313,K,망우,6029,5808,20200316,11837
20200313,K,양원,1076,1099,20200316,2175
20200313,K,구리,11108,11456,20200316,22564
20200313,K,도농,7699,6887,20200316,14586
20200313,K,양정,719,636,20200316,1355
20200313,K,덕소,4607,4504,20200316,9111
20200313,K,도심,2050,1571,20200316,3621
20200313,K,팔당,645,616,20200316,1261
20200313,K,운길산,498,520,20200316,1018
20200313,K,양수,1225,1250,20200316,2475
20200313,K,신원,152,147,20200316,299
20200313,K,국수,441,496,20200316,937
20200313,K,아신,382,418,20200316,800
20200313,K,오빈,208,207,20200316,415
20200313,K,양평,2093,2202,20200316,4295
20200313,K,원덕,217,236,20200316,453
20200313,K,용문,1043,1155,20200316,2198
20200313,K,지평,32,33,20200316,65
20200314,1,회기,11851,11227,20200317,23078
20200314,K,중랑,3124,3037,20200317,6161
20200314,K,상봉,3449,3360,20200317,6809
20200314,K,망우,4188,4095,20200317,8283
20200314,K,양원,715,748,20200317,1463
20200314,K,구리,7375,7748,20200317,15123
20200314,K,도농,4463,4068,20200317,8531
20200314,K,양정,472,418,20200317,890
20200314,K,덕소,3289,3329,20200317,6618
20200314,K,도심,1198,1136,20200317,2334
20200314,K,팔당,1076,1172,20200317,2248
20200314,K,운길산,804,792,20200317,1596
20200314,K,양수,1345,1281,20200317,2626
20200314,K,신원,200,170,20200317,370
20200314,K,국수,434,442,20200317,876
20200314,K,아신,444,392,20200317,836
20200314,K,오빈,192,161,20200317,353
20200314,K,양평,1534,1699,20200317,3233
20200314,K,원덕,233,244,20200317,477
20200314,K,용문,1113,1256,20200317,2369
20200314,K,지평,36,31,20200317,67
20200315,1,회기,8527,8638,20200318,17165
20200315,K,중랑,2201,2134,20200318,4335
20200315,K,상봉,2518,2512,20200318,5030
20200315,K,망우,2929,2855,20200318,5784
20200315,K,양원,451,518,20200318,969
20200315,K,구리,4963,5191,20200318,10154
20200315,K,도농,2988,2880,20200318,5868
20200315,K,양정,307,291,20200318,598
20200315,K,덕소,2319,2218,20200318,4537
20200315,K,도심,903,795,20200318,1698
20200315,K,팔당,997,1048,20200318,2045
20200315,K,운길산,921,850,20200318,1771
20200315,K,양수,1113,940,20200318,2053
20200315,K,신원,228,144,20200318,372
20200315,K,국수,393,387,20200318,780
20200315,K,아신,320,262,20200318,582
20200315,K,오빈,147,131,20200318,278
20200315,K,양평,1298,1127,20200318,2425
20200315,K,원덕,234,198,20200318,432
20200315,K,용문,1530,1401,20200318,2931
20200315,K,지평,29,19,20200318,48
20200316,1,회기,17172,16550,20200319,33722
20200316,K,중랑,4636,4350,20200319,8986
20200316,K,상봉,4732,4494,20200319,9226
20200316,K,망우,5916,5832,20200319,11748
20200316,K,양원,1110,1122,20200319,2232
20200316,K,구리,11211,11303,20200319,22514
20200316,K,도농,7694,7098,20200319,14792
20200316,K,양정,732,641,20200319,1373
20200316,K,덕소,4678,4537,20200319,9215
20200316,K,도심,2061,1557,20200319,3618
20200316,K,팔당,536,547,20200319,1083
20200316,K,운길산,555,478,20200319,1033
20200316,K,양수,1286,1280,20200319,2566
20200316,K,신원,153,122,20200319,275
20200316,K,국수,522,522,20200319,1044
20200316,K,아신,371,381,20200319,752
20200316,K,오빈,198,174,20200319,372
20200316,K,양평,1890,1880,20200319,3770
20200316,K,원덕,245,208,20200319,453
20200316,K,용문,1181,1114,20200319,2295
20200316,K,지평,32,21,20200319,53
20200317,1,회기,17218,16523,20200320,33741
20200317,K,중랑,4443,4203,20200320,8646
20200317,K,상봉,4632,4579,20200320,9211
20200317,K,망우,5809,5625,20200320,11434
20200317,K,양원,1063,1029,20200320,2092
20200317,K,구리,10980,11194,20200320,22174
20200317,K,도농,7575,6912,20200320,14487
20200317,K,양정,674,571,20200320,1245
20200317,K,덕소,4495,4396,20200320,8891
20200317,K,도심,2043,1568,20200320,3611
20200317,K,팔당,533,530,20200320,1063
20200317,K,운길산,505,445,20200320,950
20200317,K,양수,1115,1162,20200320,2277
20200317,K,신원,119,114,20200320,233
20200317,K,국수,442,447,20200320,889
20200317,K,아신,367,354,20200320,721
20200317,K,오빈,201,202,20200320,403
20200317,K,양평,1823,1844,20200320,3667
20200317,K,원덕,196,196,20200320,392
20200317,K,용문,1039,1056,20200320,2095
20200317,K,지평,32,19,20200320,51
20200318,1,회기,17862,17025,20200321,34887
20200318,K,중랑,4654,4488,20200321,9142
20200318,K,상봉,4889,4804,20200321,9693
20200318,K,망우,6258,5971,20200321,12229
20200318,K,양원,1110,1106,20200321,2216
20200318,K,구리,11302,11395,20200321,22697
20200318,K,도농,7856,7088,20200321,14944
20200318,K,양정,780,675,20200321,1455
20200318,K,덕소,4661,4695,20200321,9356
20200318,K,도심,2183,1670,20200321,3853
20200318,K,팔당,700,724,20200321,1424
20200318,K,운길산,608,587,20200321,1195
20200318,K,양수,1337,1342,20200321,2679
20200318,K,신원,209,170,20200321,379
20200318,K,국수,588,566,20200321,1154
20200318,K,아신,440,429,20200321,869
20200318,K,오빈,206,220,20200321,426
20200318,K,양평,2157,2152,20200321,4309
20200318,K,원덕,268,244,20200321,512
20200318,K,용문,1188,1208,20200321,2396
20200318,K,지평,35,30,20200321,65
20200319,1,회기,16954,15944,20200322,32898
20200319,K,중랑,4330,4047,20200322,8377
20200319,K,상봉,4470,4366,20200322,8836
20200319,K,망우,5687,5553,20200322,11240
20200319,K,양원,1044,956,20200322,2000
20200319,K,구리,10365,10534,20200322,20899
20200319,K,도농,7288,6626,20200322,13914
20200319,K,양정,667,592,20200322,1259
20200319,K,덕소,4390,4322,20200322,8712
20200319,K,도심,1951,1528,20200322,3479
20200319,K,팔당,499,494,20200322,993
20200319,K,운길산,367,366,20200322,733
20200319,K,양수,986,1027,20200322,2013
20200319,K,신원,103,92,20200322,195
20200319,K,국수,398,409,20200322,807
20200319,K,아신,339,333,20200322,672
20200319,K,오빈,204,203,20200322,407
20200319,K,양평,1646,1655,20200322,3301
20200319,K,원덕,182,183,20200322,365
20200319,K,용문,918,961,20200322,1879
20200319,K,지평,33,20,20200322,53
20200320,1,회기,18926,17606,20200323,36532
20200320,K,중랑,4761,4478,20200323,9239
20200320,K,상봉,5191,4887,20200323,10078
20200320,K,망우,6356,6237,20200323,12593
20200320,K,양원,1183,1119,20200323,2302
20200320,K,구리,11556,11992,20200323,23548
20200320,K,도농,7973,7286,20200323,15259
20200320,K,양정,803,717,20200323,1520
20200320,K,덕소,4928,4733,20200323,9661
20200320,K,도심,2087,1605,20200323,3692
20200320,K,팔당,681,699,20200323,1380
20200320,K,운길산,650,589,20200323,1239
20200320,K,양수,1325,1384,20200323,2709
20200320,K,신원,167,161,20200323,328
20200320,K,국수,558,572,20200323,1130
20200320,K,아신,430,465,20200323,895
20200320,K,오빈,218,215,20200323,433
20200320,K,양평,1998,2098,20200323,4096
20200320,K,원덕,260,298,20200323,558
20200320,K,용문,1542,1733,20200323,3275
20200320,K,지평,40,31,20200323,71
20200321,1,회기,12994,12174,20200324,25168
20200321,K,중랑,3309,3121,20200324,6430
20200321,K,상봉,3704,3572,20200324,7276
20200321,K,망우,4242,4183,20200324,8425
20200321,K,양원,754,872,20200324,1626
20200321,K,구리,7529,7726,20200324,15255
20200321,K,도농,4607,4220,20200324,8827
20200321,K,양정,511,478,20200324,989
20200321,K,덕소,3340,3410,20200324,6750
20200321,K,도심,1290,1177,20200324,2467
20200321,K,팔당,1276,1394,20200324,2670
20200321,K,운길산,1150,1030,20200324,2180
20200321,K,양수,1410,1488,20200324,2898
20200321,K,신원,221,207,20200324,428
20200321,K,국수,515,524,20200324,1039
20200321,K,아신,406,441,20200324,847
20200321,K,오빈,197,207,20200324,404
20200321,K,양평,1810,1892,20200324,3702
20200321,K,원덕,322,360,20200324,682
20200321,K,용문,1299,1400,20200324,2699
20200321,K,지평,35,33,20200324,68
20200322,1,회기,9575,9666,20200325,19241
20200322,K,중랑,2321,2350,20200325,4671
20200322,K,상봉,2870,2673,20200325,5543
20200322,K,망우,3016,3011,20200325,6027
20200322,K,양원,556,672,20200325,1228
20200322,K,구리,5334,5587,20200325,10921
20200322,K,도농,3076,3057,20200325,6133
20200322,K,양정,446,391,20200325,837
20200322,K,덕소,2473,2497,20200325,4970
20200322,K,도심,920,889,20200325,1809
20200322,K,팔당,1426,1572,20200325,2998
20200322,K,운길산,1281,1089,20200325,2370
20200322,K,양수,1541,1323,20200325,2864
20200322,K,신원,316,198,20200325,514
20200322,K,국수,503,494,20200325,997
20200322,K,아신,402,371,20200325,773
20200322,K,오빈,170,156,20200325,326
20200322,K,양평,1611,1348,20200325,2959
20200322,K,원덕,346,281,20200325,627
20200322,K,용문,1307,1115,20200325,2422
20200322,K,지평,27,23,20200325,50
20200323,1,회기,17793,17282,20200326,35075
20200323,K,중랑,4615,4477,20200326,9092
20200323,K,상봉,4866,4748,20200326,9614
20200323,K,망우,6206,6036,20200326,12242
20200323,K,양원,1121,1143,20200326,2264
20200323,K,구리,11273,11448,20200326,22721
20200323,K,도농,7777,7138,20200326,14915
20200323,K,양정,783,679,20200326,1462
20200323,K,덕소,4779,4686,20200326,9465
20200323,K,도심,2197,1669,20200326,3866
20200323,K,팔당,739,686,20200326,1425
20200323,K,운길산,680,644,20200326,1324
20200323,K,양수,1397,1350,20200326,2747
20200323,K,신원,190,176,20200326,366
20200323,K,국수,522,515,20200326,1037
20200323,K,아신,444,435,20200326,879
20200323,K,오빈,249,239,20200326,488
20200323,K,양평,2262,2220,20200326,4482
20200323,K,원덕,262,242,20200326,504
20200323,K,용문,1219,1200,20200326,2419
20200323,K,지평,38,27,20200326,65
20200324,K,구리,11204,11239,20200327,22443
20200324,1,회기,18133,17314,20200327,35447
20200324,K,중랑,4588,4433,20200327,9021
20200324,K,상봉,4796,4747,20200327,9543
20200324,K,망우,6170,5926,20200327,12096
20200324,K,양원,1168,1187,20200327,2355
20200324,K,도농,7846,7205,20200327,15051
20200324,K,양정,834,730,20200327,1564
20200324,K,덕소,4722,4645,20200327,9367
20200324,K,도심,2123,1737,20200327,3860
20200324,K,팔당,729,732,20200327,1461
20200324,K,운길산,734,723,20200327,1457
20200324,K,양수,1321,1344,20200327,2665
20200324,K,신원,200,188,20200327,388
20200324,K,국수,559,566,20200327,1125
20200324,K,아신,420,403,20200327,823
20200324,K,오빈,225,223,20200327,448
20200324,K,양평,1971,1978,20200327,3949
20200324,K,원덕,332,295,20200327,627
20200324,K,용문,1232,1277,20200327,2509
20200324,K,지평,38,31,20200327,69
20200325,1,회기,18444,17515,20200328,35959
20200325,K,중랑,4745,4485,20200328,9230
20200325,K,상봉,4933,4921,20200328,9854
20200325,K,망우,6269,6089,20200328,12358
20200325,K,양원,1140,1160,20200328,2300
20200325,K,구리,11430,11618,20200328,23048
20200325,K,도농,7785,7117,20200328,14902
20200325,K,양정,816,731,20200328,1547
20200325,K,덕소,4801,4708,20200328,9509
20200325,K,도심,2182,1745,20200328,3927
20200325,K,팔당,756,731,20200328,1487
20200325,K,운길산,768,679,20200328,1447
20200325,K,양수,1382,1405,20200328,2787
20200325,K,신원,218,177,20200328,395
20200325,K,국수,532,563,20200328,1095
20200325,K,아신,410,418,20200328,828
20200325,K,오빈,245,252,20200328,497
20200325,K,양평,2005,1991,20200328,3996
20200325,K,원덕,315,334,20200328,649
20200325,K,용문,1723,1731,20200328,3454
20200325,K,지평,50,32,20200328,82
20200326,1,회기,17802,17005,20200329,34807
20200326,K,중랑,4598,4320,20200329,8918
20200326,K,상봉,4887,4576,20200329,9463
20200326,K,망우,5996,5899,20200329,11895
20200326,K,양원,1154,1145,20200329,2299
20200326,K,구리,11033,11207,20200329,22240
20200326,K,도농,7571,7057,20200329,14628
20200326,K,양정,748,644,20200329,1392
20200326,K,덕소,4597,4572,20200329,9169
20200326,K,도심,2105,1626,20200329,3731
20200326,K,팔당,626,663,20200329,1289
20200326,K,운길산,570,562,20200329,1132
20200326,K,양수,1281,1262,20200329,2543
20200326,K,신원,181,149,20200329,330
20200326,K,국수,529,487,20200329,1016
20200326,K,아신,391,409,20200329,800
20200326,K,오빈,233,241,20200329,474
20200326,K,양평,1899,1905,20200329,3804
20200326,K,원덕,266,263,20200329,529
20200326,K,용문,1120,1157,20200329,2277
20200326,K,지평,43,27,20200329,70
20200327,1,회기,19050,18043,20200330,37093
20200327,K,중랑,4721,4489,20200330,9210
20200327,K,상봉,5102,4878,20200330,9980
20200327,K,망우,6185,6032,20200330,12217
20200327,K,양원,1134,1073,20200330,2207
20200327,K,구리,11419,11753,20200330,23172
20200327,K,도농,7840,7085,20200330,14925
20200327,K,양정,764,658,20200330,1422
20200327,K,덕소,4721,4724,20200330,9445
20200327,K,도심,2085,1561,20200330,3646
20200327,K,팔당,658,685,20200330,1343
20200327,K,운길산,585,539,20200330,1124
20200327,K,양수,1237,1331,20200330,2568
20200327,K,신원,171,155,20200330,326
20200327,K,국수,486,514,20200330,1000
20200327,K,아신,390,414,20200330,804
20200327,K,오빈,219,211,20200330,430
20200327,K,양평,1894,2034,20200330,3928
20200327,K,원덕,253,263,20200330,516
20200327,K,용문,1156,1318,20200330,2474
20200327,K,지평,29,18,20200330,47
20200328,1,회기,13436,12408,20200331,25844
20200328,K,중랑,3310,3158,20200331,6468
20200328,K,상봉,3761,3584,20200331,7345
20200328,K,망우,4581,4394,20200331,8975
20200328,K,양원,808,896,20200331,1704
20200328,K,구리,7850,8164,20200331,16014
20200328,K,도농,4670,4279,20200331,8949
20200328,K,양정,603,529,20200331,1132
20200328,K,덕소,3527,3612,20200331,7139
20200328,K,도심,1322,1259,20200331,2581
20200328,K,팔당,1423,1546,20200331,2969
20200328,K,운길산,1239,1087,20200331,2326
20200328,K,양수,1618,1560,20200331,3178
20200328,K,신원,279,238,20200331,517
20200328,K,국수,565,587,20200331,1152
20200328,K,아신,469,452,20200331,921
20200328,K,오빈,236,259,20200331,495
20200328,K,양평,2168,2321,20200331,4489
20200328,K,원덕,404,457,20200331,861
20200328,K,용문,1426,1485,20200331,2911
20200328,K,지평,30,45,20200331,75
20200329,1,회기,9720,9831,20200401,19551
20200329,K,중랑,2472,2423,20200401,4895
20200329,K,상봉,2990,2763,20200401,5753
20200329,K,망우,3212,3239,20200401,6451
20200329,K,양원,606,628,20200401,1234
20200329,K,구리,5498,5716,20200401,11214
20200329,K,도농,3275,3204,20200401,6479
20200329,K,양정,398,367,20200401,765
20200329,K,덕소,2497,2514,20200401,5011
20200329,K,도심,1013,917,20200401,1930
20200329,K,팔당,1439,1603,20200401,3042
20200329,K,운길산,1420,1208,20200401,2628
20200329,K,양수,1457,1301,20200401,2758
20200329,K,신원,380,203,20200401,583
20200329,K,국수,496,468,20200401,964
20200329,K,아신,429,382,20200401,811
20200329,K,오빈,177,169,20200401,346
20200329,K,양평,1616,1383,20200401,2999
20200329,K,원덕,394,366,20200401,760
20200329,K,용문,1437,1240,20200401,2677
20200329,K,지평,34,27,20200401,61
20200330,1,회기,18243,17736,20200402,35979
20200330,K,중랑,4735,4540,20200402,9275
20200330,K,상봉,4982,4879,20200402,9861
20200330,K,망우,6293,6184,20200402,12477
20200330,K,양원,1187,1205,20200402,2392
20200330,K,구리,11488,11554,20200402,23042
20200330,K,도농,7890,7124,20200402,15014
20200330,K,양정,790,745,20200402,1535
20200330,K,덕소,4799,4698,20200402,9497
20200330,K,도심,2204,1746,20200402,3950
20200330,K,팔당,765,719,20200402,1484
20200330,K,운길산,716,700,20200402,1416
20200330,K,양수,1489,1433,20200402,2922
20200330,K,신원,172,162,20200402,334
20200330,K,국수,554,541,20200402,1095
20200330,K,아신,450,459,20200402,909
20200330,K,오빈,254,248,20200402,502
20200330,K,양평,2039,2047,20200402,4086
20200330,K,원덕,327,287,20200402,614
20200330,K,용문,1683,1647,20200402,3330
20200330,K,지평,46,30,20200402,76
20200331,1,회기,18492,17814,20200403,36306
20200331,K,중랑,4768,4540,20200403,9308
20200331,K,상봉,5066,4872,20200403,9938
20200331,K,망우,6184,6044,20200403,12228
20200331,K,양원,1171,1192,20200403,2363
20200331,K,구리,11279,11480,20200403,22759
20200331,K,도농,8016,7294,20200403,15310
20200331,K,양정,838,735,20200403,1573
20200331,K,덕소,4786,4718,20200403,9504
20200331,K,도심,2247,1717,20200403,3964
20200331,K,팔당,653,719,20200403,1372
20200331,K,운길산,779,758,20200403,1537
20200331,K,양수,1367,1429,20200403,2796
20200331,K,신원,214,176,20200403,390
20200331,K,국수,523,542,20200403,1065
20200331,K,아신,425,445,20200403,870
20200331,K,오빈,257,247,20200403,504
20200331,K,양평,1983,1969,20200403,3952
20200331,K,원덕,321,304,20200403,625
20200331,K,용문,1376,1391,20200403,2767
20200331,K,지평,37,35,20200403,72
20200401,1,회기,18558,17784,20200404,36342
20200401,K,중랑,4688,4459,20200404,9147
20200401,K,상봉,4909,4865,20200404,9774
20200401,K,망우,6377,6199,20200404,12576
20200401,K,양원,1179,1205,20200404,2384
20200401,K,구리,11221,11443,20200404,22664
20200401,K,도농,7873,7286,20200404,15159
20200401,K,양정,790,717,20200404,1507
20200401,K,덕소,4742,4683,20200404,9425
20200401,K,도심,2214,1684,20200404,3898
20200401,K,팔당,724,754,20200404,1478
20200401,K,운길산,688,675,20200404,1363
20200401,K,양수,1413,1428,20200404,2841
20200401,K,신원,190,149,20200404,339
20200401,K,국수,560,546,20200404,1106
20200401,K,아신,419,412,20200404,831
20200401,K,오빈,268,261,20200404,529
20200401,K,양평,1909,1920,20200404,3829
20200401,K,원덕,305,302,20200404,607
20200401,K,용문,1263,1297,20200404,2560
20200401,K,지평,33,38,20200404,71
20200402,1,회기,18611,17875,20200405,36486
20200402,K,중랑,4632,4493,20200405,9125
20200402,K,상봉,5016,4917,20200405,9933
20200402,K,망우,6264,6114,20200405,12378
20200402,K,양원,1216,1231,20200405,2447
20200402,K,구리,11275,11408,20200405,22683
20200402,K,도농,8007,7204,20200405,15211
20200402,K,양정,766,694,20200405,1460
20200402,K,덕소,4713,4702,20200405,9415
20200402,K,도심,2167,1635,20200405,3802
20200402,K,팔당,754,756,20200405,1510
20200402,K,운길산,722,699,20200405,1421
20200402,K,양수,1414,1413,20200405,2827
20200402,K,신원,241,175,20200405,416
20200402,K,국수,593,613,20200405,1206
20200402,K,아신,465,437,20200405,902
20200402,K,오빈,219,248,20200405,467
20200402,K,양평,2037,2057,20200405,4094
20200402,K,원덕,279,294,20200405,573
20200402,K,용문,1286,1369,20200405,2655
20200402,K,지평,36,26,20200405,62
20200403,1,회기,19774,18493,20200406,38267
20200403,K,중랑,4793,4593,20200406,9386
20200403,K,상봉,5230,5123,20200406,10353
20200403,K,망우,6484,6249,20200406,12733
20200403,K,양원,1212,1203,20200406,2415
20200403,K,구리,11754,12211,20200406,23965
20200403,K,도농,8030,7298,20200406,15328
20200403,K,양정,822,710,20200406,1532
20200403,K,덕소,4857,4867,20200406,9724
20200403,K,도심,2180,1646,20200406,3826
20200403,K,팔당,781,835,20200406,1616
20200403,K,운길산,770,740,20200406,1510
20200403,K,양수,1447,1494,20200406,2941
20200403,K,신원,200,163,20200406,363
20200403,K,국수,599,633,20200406,1232
20200403,K,아신,452,470,20200406,922
20200403,K,오빈,243,236,20200406,479
20200403,K,양평,2449,2595,20200406,5044
20200403,K,원덕,310,321,20200406,631
20200403,K,용문,1371,1529,20200406,2900
20200403,K,지평,29,43,20200406,72
20200404,1,회기,13782,13088,20200407,26870
20200404,K,중랑,3436,3374,20200407,6810
20200404,K,상봉,3798,3612,20200407,7410
20200404,K,망우,4559,4433,20200407,8992
20200404,K,양원,877,889,20200407,1766
20200404,K,구리,7738,7998,20200407,15736
20200404,K,도농,4833,4522,20200407,9355
20200404,K,양정,607,525,20200407,1132
20200404,K,덕소,3482,3583,20200407,7065
20200404,K,도심,1302,1236,20200407,2538
20200404,K,팔당,1496,1678,20200407,3174
20200404,K,운길산,1284,1197,20200407,2481
20200404,K,양수,1753,1715,20200407,3468
20200404,K,신원,276,203,20200407,479
20200404,K,국수,599,619,20200407,1218
20200404,K,아신,469,517,20200407,986
20200404,K,오빈,209,237,20200407,446
20200404,K,양평,1981,2087,20200407,4068
20200404,K,원덕,477,428,20200407,905
20200404,K,용문,1412,1644,20200407,3056
20200404,K,지평,53,51,20200407,104
20200405,1,회기,10209,10305,20200408,20514
20200405,K,중랑,2523,2528,20200408,5051
20200405,K,상봉,2968,2744,20200408,5712
20200405,K,망우,3308,3358,20200408,6666
20200405,K,양원,637,699,20200408,1336
20200405,K,구리,5561,5751,20200408,11312
20200405,K,도농,3249,3146,20200408,6395
20200405,K,양정,378,396,20200408,774
20200405,K,덕소,2523,2554,20200408,5077
20200405,K,도심,1014,956,20200408,1970
20200405,K,팔당,1585,1616,20200408,3201
20200405,K,운길산,1443,1286,20200408,2729
20200405,K,양수,1477,1417,20200408,2894
20200405,K,신원,305,191,20200408,496
20200405,K,국수,593,539,20200408,1132
20200405,K,아신,473,423,20200408,896
20200405,K,오빈,194,189,20200408,383
20200405,K,양평,1829,1519,20200408,3348
20200405,K,원덕,433,329,20200408,762
20200405,K,용문,1986,1719,20200408,3705
20200405,K,지평,62,38,20200408,100
20200406,1,회기,18908,18532,20200409,37440
20200406,K,중랑,4818,4574,20200409,9392
20200406,K,상봉,4974,4979,20200409,9953
20200406,K,망우,6447,6436,20200409,12883
20200406,K,양원,1311,1260,20200409,2571
20200406,K,구리,11656,11833,20200409,23489
20200406,K,도농,8233,7446,20200409,15679
20200406,K,양정,834,738,20200409,1572
20200406,K,덕소,4817,4795,20200409,9612
20200406,K,도심,2242,1686,20200409,3928
20200406,K,팔당,688,689,20200409,1377
20200406,K,운길산,764,690,20200409,1454
20200406,K,양수,1545,1484,20200409,3029
20200406,K,신원,206,176,20200409,382
20200406,K,국수,606,595,20200409,1201
20200406,K,아신,418,420,20200409,838
20200406,K,오빈,245,219,20200409,464
20200406,K,양평,2084,2035,20200409,4119
20200406,K,원덕,331,307,20200409,638
20200406,K,용문,1306,1282,20200409,2588
20200406,K,지평,50,31,20200409,81
20200407,1,회기,19085,18473,20200410,37558
20200407,K,중랑,4821,4517,20200410,9338
20200407,K,상봉,5008,4859,20200410,9867
20200407,K,망우,6346,6232,20200410,12578
20200407,K,양원,1242,1250,20200410,2492
20200407,K,구리,11722,12007,20200410,23729
20200407,K,도농,8394,7659,20200410,16053
20200407,K,양정,808,702,20200410,1510
20200407,K,덕소,4887,4831,20200410,9718
20200407,K,도심,2245,1727,20200410,3972
20200407,K,팔당,720,720,20200410,1440
20200407,K,운길산,829,841,20200410,1670
20200407,K,양수,1435,1493,20200410,2928
20200407,K,신원,217,165,20200410,382
20200407,K,국수,565,559,20200410,1124
20200407,K,아신,465,459,20200410,924
20200407,K,오빈,249,244,20200410,493
20200407,K,양평,2076,2090,20200410,4166
20200407,K,원덕,327,276,20200410,603
20200407,K,용문,1361,1377,20200410,2738
20200407,K,지평,36,37,20200410,73
20200408,1,회기,19361,18655,20200411,38016
20200408,K,중랑,4867,4670,20200411,9537
20200408,K,상봉,5056,5036,20200411,10092
20200408,K,망우,6555,6355,20200411,12910
20200408,K,양원,1293,1278,20200411,2571
20200408,K,구리,11894,11947,20200411,23841
20200408,K,도농,8235,7534,20200411,15769
20200408,K,양정,810,728,20200411,1538
20200408,K,덕소,4815,4800,20200411,9615
20200408,K,도심,2226,1746,20200411,3972
20200408,K,팔당,821,800,20200411,1621
20200408,K,운길산,788,748,20200411,1536
20200408,K,양수,1486,1480,20200411,2966
20200408,K,신원,188,191,20200411,379
20200408,K,국수,621,647,20200411,1268
20200408,K,아신,464,453,20200411,917
20200408,K,오빈,260,255,20200411,515
20200408,K,양평,2420,2484,20200411,4904
20200408,K,원덕,347,304,20200411,651
20200408,K,용문,1377,1407,20200411,2784
20200408,K,지평,34,30,20200411,64
20200409,1,회기,19206,18662,20200412,37868
20200409,K,중랑,4857,4590,20200412,9447
20200409,K,상봉,5133,5027,20200412,10160
20200409,K,망우,6455,6243,20200412,12698
20200409,K,양원,1243,1255,20200412,2498
20200409,K,구리,11508,11751,20200412,23259
20200409,K,도농,8235,7464,20200412,15699
20200409,K,양정,797,689,20200412,1486
20200409,K,덕소,4910,4877,20200412,9787
20200409,K,도심,2234,1755,20200412,3989
20200409,K,팔당,827,802,20200412,1629
20200409,K,운길산,763,706,20200412,1469
20200409,K,양수,1474,1540,20200412,3014
20200409,K,신원,260,165,20200412,425
20200409,K,국수,614,626,20200412,1240
20200409,K,아신,483,479,20200412,962
20200409,K,오빈,243,234,20200412,477
20200409,K,양평,1952,1997,20200412,3949
20200409,K,원덕,280,274,20200412,554
20200409,K,용문,1302,1339,20200412,2641
20200409,K,지평,44,32,20200412,76
20200410,1,회기,20548,19358,20200413,39906
20200410,K,중랑,5032,4666,20200413,9698
20200410,K,상봉,5322,5296,20200413,10618
20200410,K,망우,6723,6499,20200413,13222
20200410,K,양원,1255,1207,20200413,2462
20200410,K,구리,12117,12328,20200413,24445
20200410,K,도농,8421,7607,20200413,16028
20200410,K,양정,817,719,20200413,1536
20200410,K,덕소,4963,5005,20200413,9968
20200410,K,도심,2289,1754,20200413,4043
20200410,K,팔당,806,837,20200413,1643
20200410,K,운길산,804,743,20200413,1547
20200410,K,양수,1551,1599,20200413,3150
20200410,K,신원,211,198,20200413,409
20200410,K,국수,612,645,20200413,1257
20200410,K,아신,464,468,20200413,932
20200410,K,오빈,255,226,20200413,481
20200410,K,양평,2074,2222,20200413,4296
20200410,K,원덕,307,342,20200413,649
20200410,K,용문,1757,1943,20200413,3700
20200410,K,지평,49,43,20200413,92
20200411,K,도농,4919,4577,20200414,9496
20200411,1,회기,14762,13783,20200414,28545
20200411,K,중랑,3569,3471,20200414,7040
20200411,K,상봉,4063,4009,20200414,8072
20200411,K,망우,4750,4634,20200414,9384
20200411,K,양원,832,958,20200414,1790
20200411,K,구리,8058,8382,20200414,16440
20200411,K,양정,618,557,20200414,1175
20200411,K,덕소,3628,3626,20200414,7254
20200411,K,도심,1375,1254,20200414,2629
20200411,K,팔당,1601,1809,20200414,3410
20200411,K,운길산,1465,1322,20200414,2787
20200411,K,양수,1858,1901,20200414,3759
20200411,K,신원,316,229,20200414,545
20200411,K,국수,569,604,20200414,1173
20200411,K,아신,502,492,20200414,994
20200411,K,오빈,244,240,20200414,484
20200411,K,양평,2046,2121,20200414,4167
20200411,K,원덕,384,429,20200414,813
20200411,K,용문,1562,1737,20200414,3299
20200411,K,지평,47,36,20200414,83
20200412,1,회기,10456,10700,20200415,21156
20200412,K,중랑,2639,2589,20200415,5228
20200412,K,상봉,3019,3018,20200415,6037
20200412,K,망우,3332,3363,20200415,6695
20200412,K,양원,695,759,20200415,1454
20200412,K,구리,5744,5852,20200415,11596
20200412,K,도농,3462,3498,20200415,6960
20200412,K,양정,412,384,20200415,796
20200412,K,덕소,2681,2709,20200415,5390
20200412,K,도심,1097,980,20200415,2077
20200412,K,팔당,1586,1735,20200415,3321
20200412,K,운길산,1503,1344,20200415,2847
20200412,K,양수,1537,1407,20200415,2944
20200412,K,신원,352,304,20200415,656
20200412,K,국수,586,544,20200415,1130
20200412,K,아신,487,409,20200415,896
20200412,K,오빈,206,181,20200415,387
20200412,K,양평,1651,1552,20200415,3203
20200412,K,원덕,383,342,20200415,725
20200412,K,용문,1656,1372,20200415,3028
20200412,K,지평,44,47,20200415,91
20200413,1,회기,19397,18831,20200416,38228
20200413,K,중랑,4973,4720,20200416,9693
20200413,K,상봉,5226,5059,20200416,10285
20200413,K,망우,6618,6426,20200416,13044
20200413,K,양원,1233,1285,20200416,2518
20200413,K,구리,12122,12248,20200416,24370
20200413,K,도농,8509,7764,20200416,16273
20200413,K,양정,819,716,20200416,1535
20200413,K,덕소,5133,5056,20200416,10189
20200413,K,도심,2347,1763,20200416,4110
20200413,K,팔당,710,753,20200416,1463
20200413,K,운길산,755,725,20200416,1480
20200413,K,양수,1600,1559,20200416,3159
20200413,K,신원,244,190,20200416,434
20200413,K,국수,693,684,20200416,1377
20200413,K,아신,475,458,20200416,933
20200413,K,오빈,277,262,20200416,539
20200413,K,양평,2433,2466,20200416,4899
20200413,K,원덕,313,292,20200416,605
20200413,K,용문,1402,1391,20200416,2793
20200413,K,지평,43,44,20200416,87
20200414,1,회기,19842,19537,20200417,39379
20200414,K,중랑,5077,4778,20200417,9855
20200414,K,상봉,5399,5262,20200417,10661
20200414,K,망우,6781,6505,20200417,13286
20200414,K,양원,1245,1266,20200417,2511
20200414,K,구리,12386,12465,20200417,24851
20200414,K,도농,8754,7740,20200417,16494
20200414,K,양정,830,723,20200417,1553
20200414,K,덕소,5186,5003,20200417,10189
20200414,K,도심,2365,1800,20200417,4165
20200414,K,팔당,804,817,20200417,1621
20200414,K,운길산,944,914,20200417,1858
20200414,K,양수,1650,1665,20200417,3315
20200414,K,신원,222,194,20200417,416
20200414,K,국수,619,637,20200417,1256
20200414,K,아신,466,476,20200417,942
20200414,K,오빈,247,236,20200417,483
20200414,K,양평,2214,2277,20200417,4491
20200414,K,원덕,319,351,20200417,670
20200414,K,용문,1585,1651,20200417,3236
20200414,K,지평,41,38,20200417,79
20200415,1,회기,12558,12139,20200418,24697
20200415,K,중랑,3235,3115,20200418,6350
20200415,K,상봉,3497,3480,20200418,6977
20200415,K,망우,4372,4244,20200418,8616
20200415,K,양원,817,859,20200418,1676
20200415,K,구리,7201,7396,20200418,14597
20200415,K,도농,4606,4389,20200418,8995
20200415,K,양정,641,569,20200418,1210
20200415,K,덕소,3400,3460,20200418,6860
20200415,K,도심,1260,1189,20200418,2449
20200415,K,팔당,1560,1601,20200418,3161
20200415,K,운길산,1361,1258,20200418,2619
20200415,K,양수,1734,1654,20200418,3388
20200415,K,신원,261,203,20200418,464
20200415,K,국수,572,560,20200418,1132
20200415,K,아신,526,504,20200418,1030
20200415,K,오빈,218,219,20200418,437
20200415,K,양평,1843,1763,20200418,3606
20200415,K,원덕,336,343,20200418,679
20200415,K,용문,2180,2160,20200418,4340
20200415,K,지평,64,54,20200418,118
20200416,1,회기,19826,19094,20200419,38920
20200416,K,중랑,4922,4739,20200419,9661
20200416,K,상봉,5356,5291,20200419,10647
20200416,K,망우,6752,6343,20200419,13095
20200416,K,양원,1257,1259,20200419,2516
20200416,K,구리,12147,12273,20200419,24420
20200416,K,도농,8552,7785,20200419,16337
20200416,K,양정,823,727,20200419,1550
20200416,K,덕소,5112,5023,20200419,10135
20200416,K,도심,2349,1847,20200419,4196
20200416,K,팔당,796,790,20200419,1586
20200416,K,운길산,861,814,20200419,1675
20200416,K,양수,1602,1595,20200419,3197
20200416,K,신원,199,185,20200419,384
20200416,K,국수,669,660,20200419,1329
20200416,K,아신,522,484,20200419,1006
20200416,K,오빈,259,243,20200419,502
20200416,K,양평,2120,2095,20200419,4215
20200416,K,원덕,359,348,20200419,707
20200416,K,용문,1498,1517,20200419,3015
20200416,K,지평,41,33,20200419,74
20200417,1,회기,19933,18921,20200420,38854
20200417,K,중랑,4750,4617,20200420,9367
20200417,K,상봉,5290,5197,20200420,10487
20200417,K,망우,6313,6044,20200420,12357
20200417,K,양원,1134,1112,20200420,2246
20200417,K,구리,11665,12006,20200420,23671
20200417,K,도농,8249,7432,20200420,15681
20200417,K,양정,716,622,20200420,1338
20200417,K,덕소,4812,4674,20200420,9486
20200417,K,도심,2134,1558,20200420,3692
20200417,K,팔당,551,550,20200420,1101
20200417,K,운길산,434,417,20200420,851
20200417,K,양수,1169,1236,20200420,2405
20200417,K,신원,126,109,20200420,235
20200417,K,국수,516,533,20200420,1049
20200417,K,아신,419,430,20200420,849
20200417,K,오빈,189,191,20200420,380
20200417,K,양평,1933,2038,20200420,3971
20200417,K,원덕,237,252,20200420,489
20200417,K,용문,1167,1353,20200420,2520
20200417,K,지평,33,26,20200420,59
20200418,1,회기,15150,14374,20200421,29524
20200418,K,중랑,3867,3679,20200421,7546
20200418,K,상봉,4439,4238,20200421,8677
20200418,K,망우,5348,5261,20200421,10609
20200418,K,양원,1019,1060,20200421,2079
20200418,K,구리,8873,9056,20200421,17929
20200418,K,도농,5482,5191,20200421,10673
20200418,K,양정,688,618,20200421,1306
20200418,K,덕소,4162,4144,20200421,8306
20200418,K,도심,1602,1515,20200421,3117
20200418,K,팔당,1766,2010,20200421,3776
20200418,K,운길산,1855,1647,20200421,3502
20200418,K,양수,2028,2216,20200421,4244
20200418,K,신원,422,292,20200421,714
20200418,K,국수,824,826,20200421,1650
20200418,K,아신,583,581,20200421,1164
20200418,K,오빈,285,295,20200421,580
20200418,K,양평,2804,2875,20200421,5679
20200418,K,원덕,480,541,20200421,1021
20200418,K,용문,1973,2203,20200421,4176
20200418,K,지평,37,63,20200421,100
20200419,1,회기,10243,10334,20200422,20577
20200419,K,중랑,2550,2481,20200422,5031
20200419,K,상봉,3265,3136,20200422,6401
20200419,K,망우,3472,3509,20200422,6981
20200419,K,양원,636,731,20200422,1367
20200419,K,구리,5684,5978,20200422,11662
20200419,K,도농,3551,3478,20200422,7029
20200419,K,양정,447,413,20200422,860
20200419,K,덕소,2662,2566,20200422,5228
20200419,K,도심,1006,935,20200422,1941
20200419,K,팔당,1257,1410,20200422,2667
20200419,K,운길산,1278,1130,20200422,2408
20200419,K,양수,1460,1295,20200422,2755
20200419,K,신원,373,275,20200422,648
20200419,K,국수,598,516,20200422,1114
20200419,K,아신,496,455,20200422,951
20200419,K,오빈,154,155,20200422,309
20200419,K,양평,1601,1481,20200422,3082
20200419,K,원덕,369,258,20200422,627
20200419,K,용문,1621,1409,20200422,3030
20200419,K,지평,43,36,20200422,79
20200420,1,회기,19703,19379,20200423,39082
20200420,K,중랑,4841,4728,20200423,9569
20200420,K,상봉,5276,5176,20200423,10452
20200420,K,망우,6640,6543,20200423,13183
20200420,K,양원,1298,1311,20200423,2609
20200420,K,구리,12088,12232,20200423,24320
20200420,K,도농,8569,7840,20200423,16409
20200420,K,양정,835,723,20200423,1558
20200420,K,덕소,5104,5039,20200423,10143
20200420,K,도심,2370,1756,20200423,4126
20200420,K,팔당,662,658,20200423,1320
20200420,K,운길산,658,586,20200423,1244
20200420,K,양수,1537,1442,20200423,2979
20200420,K,신원,176,165,20200423,341
20200420,K,국수,605,617,20200423,1222
20200420,K,아신,497,482,20200423,979
20200420,K,오빈,249,245,20200423,494
20200420,K,양평,2280,2248,20200423,4528
20200420,K,원덕,279,265,20200423,544
20200420,K,용문,1945,1920,20200423,3865
20200420,K,지평,43,40,20200423,83
20200421,1,회기,20219,19785,20200424,40004
20200421,K,중랑,5002,4861,20200424,9863
20200421,K,상봉,5419,5197,20200424,10616
20200421,K,망우,6817,6586,20200424,13403
20200421,K,양원,1323,1337,20200424,2660
20200421,K,구리,12082,12412,20200424,24494
20200421,K,도농,8799,7885,20200424,16684
20200421,K,양정,841,721,20200424,1562
20200421,K,덕소,5158,5046,20200424,10204
20200421,K,도심,2284,1827,20200424,4111
20200421,K,팔당,760,766,20200424,1526
20200421,K,운길산,823,761,20200424,1584
20200421,K,양수,1548,1589,20200424,3137
20200421,K,신원,246,235,20200424,481
20200421,K,국수,629,628,20200424,1257
20200421,K,아신,447,468,20200424,915
20200421,K,오빈,248,223,20200424,471
20200421,K,양평,2076,2135,20200424,4211
20200421,K,원덕,313,318,20200424,631
20200421,K,용문,1501,1528,20200424,3029
20200421,K,지평,45,38,20200424,83
20200422,1,회기,20289,19654,20200425,39943
20200422,K,중랑,4917,4651,20200425,9568
20200422,K,상봉,5175,5046,20200425,10221
20200422,K,망우,6646,6570,20200425,13216
20200422,K,양원,1255,1231,20200425,2486
20200422,K,구리,12152,12390,20200425,24542
20200422,K,도농,8605,7766,20200425,16371
20200422,K,양정,773,674,20200425,1447
20200422,K,덕소,4879,4856,20200425,9735
20200422,K,도심,2304,1789,20200425,4093
20200422,K,팔당,646,639,20200425,1285
20200422,K,운길산,611,588,20200425,1199
20200422,K,양수,1457,1416,20200425,2873
20200422,K,신원,156,139,20200425,295
20200422,K,국수,543,564,20200425,1107
20200422,K,아신,443,453,20200425,896
20200422,K,오빈,245,231,20200425,476
20200422,K,양평,1962,1969,20200425,3931
20200422,K,원덕,294,273,20200425,567
20200422,K,용문,1286,1287,20200425,2573
20200422,K,지평,32,29,20200425,61
20200423,1,회기,20659,20024,20200426,40683
20200423,K,중랑,5044,4881,20200426,9925
20200423,K,상봉,5502,5276,20200426,10778
20200423,K,망우,6807,6636,20200426,13443
20200423,K,양원,1352,1338,20200426,2690
20200423,K,구리,12121,12362,20200426,24483
20200423,K,도농,8834,8010,20200426,16844
20200423,K,양정,862,764,20200426,1626
20200423,K,덕소,5219,5207,20200426,10426
20200423,K,도심,2380,1803,20200426,4183
20200423,K,팔당,747,744,20200426,1491
20200423,K,운길산,733,697,20200426,1430
20200423,K,양수,1543,1525,20200426,3068
20200423,K,신원,194,195,20200426,389
20200423,K,국수,667,627,20200426,1294
20200423,K,아신,493,487,20200426,980
20200423,K,오빈,292,281,20200426,573
20200423,K,양평,2698,2765,20200426,5463
20200423,K,원덕,308,305,20200426,613
20200423,K,용문,1497,1502,20200426,2999
20200423,K,지평,49,47,20200426,96
20200424,1,회기,22252,20999,20200427,43251
20200424,K,중랑,5207,5028,20200427,10235
20200424,K,상봉,5780,5609,20200427,11389
20200424,K,망우,7093,6856,20200427,13949
20200424,K,양원,1378,1413,20200427,2791
20200424,K,구리,12913,13233,20200427,26146
20200424,K,도농,9120,8125,20200427,17245
20200424,K,양정,842,761,20200427,1603
20200424,K,덕소,5349,5317,20200427,10666
20200424,K,도심,2402,1900,20200427,4302
20200424,K,팔당,828,815,20200427,1643
20200424,K,운길산,752,685,20200427,1437
20200424,K,양수,1584,1593,20200427,3177
20200424,K,신원,181,171,20200427,352
20200424,K,국수,633,683,20200427,1316
20200424,K,아신,574,585,20200427,1159
20200424,K,오빈,251,246,20200427,497
20200424,K,양평,2347,2448,20200427,4795
20200424,K,원덕,323,354,20200427,677
20200424,K,용문,1528,1735,20200427,3263
20200424,K,지평,35,36,20200427,71
20200425,1,회기,16234,15454,20200428,31688
20200425,K,중랑,3926,3771,20200428,7697
20200425,K,상봉,4576,4370,20200428,8946
20200425,K,망우,5442,5307,20200428,10749
20200425,K,양원,982,1000,20200428,1982
20200425,K,구리,9456,9627,20200428,19083
20200425,K,도농,5808,5245,20200428,11053
20200425,K,양정,618,596,20200428,1214
20200425,K,덕소,4156,4128,20200428,8284
20200425,K,도심,1640,1398,20200428,3038
20200425,K,팔당,1592,1849,20200428,3441
20200425,K,운길산,1544,1365,20200428,2909
20200425,K,양수,2042,2069,20200428,4111
20200425,K,신원,374,291,20200428,665
20200425,K,국수,739,716,20200428,1455
20200425,K,아신,591,585,20200428,1176
20200425,K,오빈,273,276,20200428,549
20200425,K,양평,2339,2395,20200428,4734
20200425,K,원덕,461,537,20200428,998
20200425,K,용문,3249,3384,20200428,6633
20200425,K,지평,35,54,20200428,89
20200426,1,회기,12118,12126,20200429,24244
20200426,K,중랑,2983,2934,20200429,5917
20200426,K,상봉,3698,3548,20200429,7246
20200426,K,망우,4105,4152,20200429,8257
20200426,K,양원,795,854,20200429,1649
20200426,K,구리,6600,6889,20200429,13489
20200426,K,도농,4192,4076,20200429,8268
20200426,K,양정,529,439,20200429,968
20200426,K,덕소,3238,3283,20200429,6521
20200426,K,도심,1291,1153,20200429,2444
20200426,K,팔당,1716,1915,20200429,3631
20200426,K,운길산,1744,1554,20200429,3298
20200426,K,양수,2075,1822,20200429,3897
20200426,K,신원,507,262,20200429,769
20200426,K,국수,692,641,20200429,1333
20200426,K,아신,529,510,20200429,1039
20200426,K,오빈,235,201,20200429,436
20200426,K,양평,2058,1809,20200429,3867
20200426,K,원덕,466,389,20200429,855
20200426,K,용문,2105,1836,20200429,3941
20200426,K,지평,57,60,20200429,117
20200427,1,회기,20718,20165,20200430,40883
20200427,K,중랑,5247,4957,20200430,10204
20200427,K,상봉,5600,5371,20200430,10971
20200427,K,망우,7081,6902,20200430,13983
20200427,K,양원,1376,1414,20200430,2790
20200427,K,구리,12991,12925,20200430,25916
20200427,K,도농,9207,8309,20200430,17516
20200427,K,양정,894,781,20200430,1675
20200427,K,덕소,5437,5250,20200430,10687
20200427,K,도심,2463,1989,20200430,4452
20200427,K,팔당,772,759,20200430,1531
20200427,K,운길산,884,799,20200430,1683
20200427,K,양수,1662,1659,20200430,3321
20200427,K,신원,238,199,20200430,437
20200427,K,국수,698,703,20200430,1401
20200427,K,아신,511,502,20200430,1013
20200427,K,오빈,295,246,20200430,541
20200427,K,양평,2399,2414,20200430,4813
20200427,K,원덕,382,328,20200430,710
20200427,K,용문,1669,1654,20200430,3323
20200427,K,지평,46,44,20200430,90
20200428,1,회기,21284,20575,20200501,41859
20200428,K,중랑,5219,5099,20200501,10318
20200428,K,상봉,5741,5606,20200501,11347
20200428,K,망우,7247,6942,20200501,14189
20200428,K,양원,1409,1433,20200501,2842
20200428,K,구리,13109,13371,20200501,26480
20200428,K,도농,9376,8367,20200501,17743
20200428,K,양정,883,770,20200501,1653
20200428,K,덕소,5678,5595,20200501,11273
20200428,K,도심,2498,1982,20200501,4480
20200428,K,팔당,894,882,20200501,1776
20200428,K,운길산,898,875,20200501,1773
20200428,K,양수,1796,1819,20200501,3615
20200428,K,신원,223,259,20200501,482
20200428,K,국수,710,747,20200501,1457
20200428,K,아신,550,505,20200501,1055
20200428,K,오빈,346,342,20200501,688
20200428,K,양평,3267,3253,20200501,6520
20200428,K,원덕,407,368,20200501,775
20200428,K,용문,1958,2005,20200501,3963
20200428,K,지평,41,52,20200501,93
20200429,1,회기,22619,21175,20200502,43794
20200429,K,중랑,5526,5078,20200502,10604
20200429,K,상봉,6041,5823,20200502,11864
20200429,K,망우,7412,7094,20200502,14506
20200429,K,양원,1442,1449,20200502,2891
20200429,K,구리,13192,13617,20200502,26809
20200429,K,도농,9533,8590,20200502,18123
20200429,K,양정,880,745,20200502,1625
20200429,K,덕소,5630,5437,20200502,11067
20200429,K,도심,2566,1990,20200502,4556
20200429,K,팔당,953,886,20200502,1839
20200429,K,운길산,916,916,20200502,1832
20200429,K,양수,1757,1850,20200502,3607
20200429,K,신원,271,219,20200502,490
20200429,K,국수,701,717,20200502,1418
20200429,K,아신,530,551,20200502,1081
20200429,K,오빈,326,322,20200502,648
20200429,K,양평,2454,2739,20200502,5193
20200429,K,원덕,378,386,20200502,764
20200429,K,용문,1678,1930,20200502,3608
20200429,K,지평,55,55,20200502,110
20200430,1,회기,14971,13611,20200503,28582
20200430,K,중랑,3849,3676,20200503,7525
20200430,K,상봉,4550,4196,20200503,8746
20200430,K,망우,5440,5145,20200503,10585
20200430,K,양원,1072,1063,20200503,2135
20200430,K,구리,8800,8805,20200503,17605
20200430,K,도농,5950,5449,20200503,11399
20200430,K,양정,784,692,20200503,1476
20200430,K,덕소,3998,4210,20200503,8208
20200430,K,도심,1780,1526,20200503,3306
20200430,K,팔당,2019,2313,20200503,4332
20200430,K,운길산,1996,1994,20200503,3990
20200430,K,양수,2387,2311,20200503,4698
20200430,K,신원,399,278,20200503,677
20200430,K,국수,725,791,20200503,1516
20200430,K,아신,630,684,20200503,1314
20200430,K,오빈,319,340,20200503,659
20200430,K,양평,2316,2768,20200503,5084
20200430,K,원덕,427,512,20200503,939
20200430,K,용문,4064,4543,20200503,8607
20200430,K,지평,33,53,20200503,86
20200501,K,운길산,1349,1358,20200504,2707
20200501,K,팔당,1492,1712,20200504,3204
20200501,K,도심,1691,1462,20200504,3153
20200501,K,덕소,4303,4233,20200504,8536
20200501,K,양정,645,599,20200504,1244
20200501,K,도농,6006,5562,20200504,11568
20200501,K,구리,9135,9495,20200504,18630
20200501,K,양원,967,992,20200504,1959
20200501,K,망우,5584,5317,20200504,10901
20200501,K,상봉,4606,4431,20200504,9037
20200501,K,중랑,4007,3673,20200504,7680
20200501,1,회기,15569,14448,20200504,30017
20200501,K,지평,62,71,20200504,133
20200501,K,용문,2404,2603,20200504,5007
20200501,K,원덕,452,421,20200504,873
20200501,K,양평,2490,2548,20200504,5038
20200501,K,오빈,280,271,20200504,551
20200501,K,아신,621,611,20200504,1232
20200501,K,국수,766,721,20200504,1487
20200501,K,신원,376,249,20200504,625
20200501,K,양수,2346,2269,20200504,4615
20200502,K,지평,54,42,20200505,96
20200502,K,용문,2366,2496,20200505,4862
20200502,K,원덕,439,399,20200505,838
20200502,K,양평,2504,2569,20200505,5073
20200502,K,오빈,276,302,20200505,578
20200502,K,아신,615,613,20200505,1228
20200502,K,국수,721,747,20200505,1468
20200502,K,신원,283,218,20200505,501
20200502,K,양수,2218,2019,20200505,4237
20200502,K,운길산,1467,1554,20200505,3021
20200502,K,팔당,1710,1818,20200505,3528
20200502,K,도심,1507,1316,20200505,2823
20200502,K,덕소,4096,4108,20200505,8204
20200502,K,양정,614,543,20200505,1157
20200502,K,도농,5418,5142,20200505,10560
20200502,K,구리,8720,8973,20200505,17693
20200502,K,양원,845,940,20200505,1785
20200502,K,망우,5186,5121,20200505,10307
20200502,K,상봉,4426,4183,20200505,8609
20200502,K,중랑,3851,3655,20200505,7506
20200502,1,회기,15230,14299,20200505,29529
20200503,K,지평,59,48,20200506,107
20200503,K,용문,2498,1900,20200506,4398
20200503,K,원덕,396,327,20200506,723
20200503,K,양평,3625,3120,20200506,6745
20200503,K,오빈,253,215,20200506,468
20200503,K,아신,612,488,20200506,1100
20200503,K,국수,662,628,20200506,1290
20200503,K,신원,323,211,20200506,534
20200503,K,양수,1882,1613,20200506,3495
20200503,K,운길산,1369,1345,20200506,2714
20200503,K,팔당,1683,1686,20200506,3369
20200503,K,도심,1225,1187,20200506,2412
20200503,K,덕소,3178,3162,20200506,6340
20200503,K,양정,464,442,20200506,906
20200503,K,도농,4324,4287,20200506,8611
20200503,K,구리,6737,7101,20200506,13838
20200503,K,양원,741,771,20200506,1512
20200503,K,망우,4259,4237,20200506,8496
20200503,K,상봉,3876,3613,20200506,7489
20200503,K,중랑,3012,3062,20200506,6074
20200503,1,회기,12301,12941,20200506,25242
20200504,K,지평,52,50,20200507,102
20200504,K,용문,1958,1987,20200507,3945
20200504,K,원덕,407,384,20200507,791
20200504,K,양평,2522,2538,20200507,5060
20200504,K,오빈,294,300,20200507,594
20200504,K,아신,590,562,20200507,1152
20200504,K,국수,734,747,20200507,1481
20200504,K,신원,259,192,20200507,451
20200504,K,양수,1964,1943,20200507,3907
20200504,K,운길산,928,885,20200507,1813
20200504,K,팔당,980,1019,20200507,1999
20200504,K,도심,2210,1701,20200507,3911
20200504,K,덕소,5134,5085,20200507,10219
20200504,K,양정,797,671,20200507,1468
20200504,K,도농,7959,7263,20200507,15222
20200504,K,구리,12078,12337,20200507,24415
20200504,K,양원,1288,1279,20200507,2567
20200504,K,망우,6795,6543,20200507,13338
20200504,K,상봉,5498,5158,20200507,10656
20200504,K,중랑,4936,4723,20200507,9659
20200504,1,회기,20454,19860,20200507,40314
20200505,K,지평,60,50,20200508,110
20200505,K,용문,3961,3834,20200508,7795
20200505,K,원덕,388,337,20200508,725
20200505,K,양평,2245,2040,20200508,4285
20200505,K,오빈,263,271,20200508,534
20200505,K,아신,613,503,20200508,1116
20200505,K,국수,688,613,20200508,1301
20200505,K,신원,282,295,20200508,577
20200505,K,양수,1996,1876,20200508,3872
20200505,K,운길산,1338,1241,20200508,2579
20200505,K,팔당,1614,1695,20200508,3309
20200505,K,도심,1514,1346,20200508,2860
20200505,K,덕소,3634,3680,20200508,7314
20200505,K,양정,588,527,20200508,1115
20200505,K,도농,4837,4557,20200508,9394
20200505,K,구리,7754,8105,20200508,15859
20200505,K,양원,813,898,20200508,1711
20200505,K,망우,4628,4746,20200508,9374
20200505,K,상봉,4128,3824,20200508,7952
20200505,K,중랑,3288,3244,20200508,6532
20200505,1,회기,13088,12902,20200508,25990
20200506,1,회기,22215,21684,20200509,43899
20200506,K,중랑,5451,5216,20200509,10667
20200506,K,상봉,5905,5739,20200509,11644
20200506,K,망우,7426,7198,20200509,14624
20200506,K,양원,1419,1449,20200509,2868
20200506,K,구리,13433,13556,20200509,26989
20200506,K,도농,9740,8699,20200509,18439
20200506,K,양정,872,787,20200509,1659
20200506,K,덕소,5729,5566,20200509,11295
20200506,K,도심,2631,2032,20200509,4663
20200506,K,팔당,888,854,20200509,1742
20200506,K,운길산,834,790,20200509,1624
20200506,K,양수,1846,1820,20200509,3666
20200506,K,신원,204,188,20200509,392
20200506,K,국수,692,719,20200509,1411
20200506,K,아신,586,578,20200509,1164
20200506,K,오빈,315,284,20200509,599
20200506,K,양평,2549,2576,20200509,5125
20200506,K,원덕,386,363,20200509,749
20200506,K,용문,1985,1997,20200509,3982
20200506,K,지평,49,36,20200509,85
20200507,1,회기,22675,21592,20200510,44267
20200507,K,중랑,5395,5218,20200510,10613
20200507,K,상봉,6063,5842,20200510,11905
20200507,K,망우,7407,7246,20200510,14653
20200507,K,양원,1477,1433,20200510,2910
20200507,K,구리,13558,13677,20200510,27235
20200507,K,도농,9892,8691,20200510,18583
20200507,K,양정,896,774,20200510,1670
20200507,K,덕소,5737,5596,20200510,11333
20200507,K,도심,2600,1976,20200510,4576
20200507,K,팔당,873,910,20200510,1783
20200507,K,운길산,974,914,20200510,1888
20200507,K,양수,1806,1845,20200510,3651
20200507,K,신원,231,211,20200510,442
20200507,K,국수,713,698,20200510,1411
20200507,K,아신,640,649,20200510,1289
20200507,K,오빈,315,307,20200510,622
20200507,K,양평,2616,2619,20200510,5235
20200507,K,원덕,358,370,20200510,728
20200507,K,용문,2035,2076,20200510,4111
20200507,K,지평,40,40,20200510,80
20200508,1,회기,23381,21766,20200511,45147
20200508,K,중랑,5563,5420,20200511,10983
20200508,K,상봉,6044,5940,20200511,11984
20200508,K,망우,7547,7471,20200511,15018
20200508,K,양원,1465,1447,20200511,2912
20200508,K,구리,13630,14277,20200511,27907
20200508,K,도농,9825,9084,20200511,18909
20200508,K,양정,866,796,20200511,1662
20200508,K,덕소,5801,5842,20200511,11643
20200508,K,도심,2631,1985,20200511,4616
20200508,K,팔당,912,889,20200511,1801
20200508,K,운길산,822,807,20200511,1629
20200508,K,양수,1817,1915,20200511,3732
20200508,K,신원,218,202,20200511,420
20200508,K,국수,730,766,20200511,1496
20200508,K,아신,661,610,20200511,1271
20200508,K,오빈,287,269,20200511,556
20200508,K,양평,3463,3675,20200511,7138
20200508,K,원덕,331,379,20200511,710
20200508,K,용문,1741,1952,20200511,3693
20200508,K,지평,43,47,20200511,90
20200509,K,지평,21,32,20200512,53
20200509,K,용문,1219,1401,20200512,2620
20200509,K,원덕,268,241,20200512,509
20200509,K,양평,1691,1880,20200512,3571
20200509,K,오빈,182,174,20200512,356
20200509,K,아신,348,382,20200512,730
20200509,K,국수,456,463,20200512,919
20200509,K,신원,112,78,20200512,190
20200509,K,양수,1257,1434,20200512,2691
20200509,K,운길산,556,592,20200512,1148
20200509,K,팔당,795,713,20200512,1508
20200509,K,도심,1274,1153,20200512,2427
20200509,K,덕소,3566,3530,20200512,7096
20200509,K,양정,485,438,20200512,923
20200509,K,도농,5200,4592,20200512,9792
20200509,K,구리,8061,8344,20200512,16405
20200509,K,양원,707,727,20200512,1434
20200509,K,망우,4915,4659,20200512,9574
20200509,K,상봉,3991,3699,20200512,7690
20200509,K,중랑,3591,3458,20200512,7049
20200509,1,회기,15146,14964,20200512,30110
20200510,1,회기,12730,13001,20200513,25731
20200510,K,중랑,3190,3078,20200513,6268
20200510,K,상봉,3779,3532,20200513,7311
20200510,K,망우,4066,4125,20200513,8191
20200510,K,양원,801,816,20200513,1617
20200510,K,구리,6732,7049,20200513,13781
20200510,K,도농,4163,4110,20200513,8273
20200510,K,양정,512,441,20200513,953
20200510,K,덕소,3164,3185,20200513,6349
20200510,K,도심,1296,1211,20200513,2507
20200510,K,팔당,1501,1640,20200513,3141
20200510,K,운길산,1268,1214,20200513,2482
20200510,K,양수,1587,1402,20200513,2989
20200510,K,신원,316,250,20200513,566
20200510,K,국수,607,582,20200513,1189
20200510,K,아신,530,481,20200513,1011
20200510,K,오빈,209,197,20200513,406
20200510,K,양평,2007,1760,20200513,3767
20200510,K,원덕,418,309,20200513,727
20200510,K,용문,3182,2891,20200513,6073
20200510,K,지평,50,49,20200513,99
20200511,K,지평,55,54,20200514,109
20200511,K,용문,1689,1642,20200514,3331
20200511,K,원덕,386,365,20200514,751
20200511,K,양평,2454,2536,20200514,4990
20200511,K,오빈,281,276,20200514,557
20200511,K,아신,566,560,20200514,1126
20200511,K,국수,703,685,20200514,1388
20200511,K,신원,218,190,20200514,408
20200511,K,양수,1879,1812,20200514,3691
20200511,K,운길산,815,789,20200514,1604
20200511,K,팔당,809,764,20200514,1573
20200511,K,도심,2536,1952,20200514,4488
20200511,K,덕소,5767,5554,20200514,11321
20200511,K,양정,874,755,20200514,1629
20200511,K,도농,9629,8582,20200514,18211
20200511,K,구리,13363,13247,20200514,26610
20200511,K,양원,1452,1503,20200514,2955
20200511,K,망우,7260,7035,20200514,14295
20200511,K,상봉,5860,5562,20200514,11422
20200511,K,중랑,5491,5197,20200514,10688
20200511,1,회기,22051,21663,20200514,43714
20200512,K,신원,219,229,20200515,448
20200512,K,국수,660,681,20200515,1341
20200512,K,아신,526,508,20200515,1034
20200512,K,오빈,341,324,20200515,665
20200512,K,양평,2305,2328,20200515,4633
20200512,K,원덕,376,323,20200515,699
20200512,K,용문,1641,1662,20200515,3303
20200512,K,지평,45,40,20200515,85
20200512,1,회기,21829,21230,20200515,43059
20200512,K,중랑,5370,5116,20200515,10486
20200512,K,상봉,5756,5542,20200515,11298
20200512,K,망우,7199,7071,20200515,14270
20200512,K,양원,1402,1412,20200515,2814
20200512,K,구리,13093,13116,20200515,26209
20200512,K,도농,9333,8500,20200515,17833
20200512,K,양정,889,781,20200515,1670
20200512,K,덕소,5533,5444,20200515,10977
20200512,K,도심,2518,1931,20200515,4449
20200512,K,팔당,780,803,20200515,1583
20200512,K,운길산,770,733,20200515,1503
20200512,K,양수,1695,1663,20200515,3358
20200513,1,회기,21893,21219,20200516,43112
20200513,K,중랑,5352,5190,20200516,10542
20200513,K,상봉,5829,5642,20200516,11471
20200513,K,망우,7308,7181,20200516,14489
20200513,K,양원,1408,1394,20200516,2802
20200513,K,구리,13136,13450,20200516,26586
20200513,K,도농,9360,8295,20200516,17655
20200513,K,양정,861,788,20200516,1649
20200513,K,덕소,5599,5521,20200516,11120
20200513,K,도심,2559,1990,20200516,4549
20200513,K,팔당,866,864,20200516,1730
20200513,K,운길산,941,884,20200516,1825
20200513,K,양수,1860,1846,20200516,3706
20200513,K,신원,227,230,20200516,457
20200513,K,국수,768,739,20200516,1507
20200513,K,아신,547,590,20200516,1137
20200513,K,오빈,291,286,20200516,577
20200513,K,양평,3227,3139,20200516,6366
20200513,K,원덕,359,350,20200516,709
20200513,K,용문,1694,1649,20200516,3343
20200513,K,지평,56,57,20200516,113
20200514,K,지평,69,61,20200517,130
20200514,K,용문,1748,1800,20200517,3548
20200514,K,원덕,325,321,20200517,646
20200514,K,양평,2354,2418,20200517,4772
20200514,K,오빈,291,273,20200517,564
20200514,K,아신,536,530,20200517,1066
20200514,K,국수,681,718,20200517,1399
20200514,K,신원,217,211,20200517,428
20200514,K,양수,1801,1756,20200517,3557
20200514,K,운길산,817,809,20200517,1626
20200514,K,팔당,862,880,20200517,1742
20200514,K,도심,2479,1974,20200517,4453
20200514,K,덕소,5603,5509,20200517,11112
20200514,K,양정,881,737,20200517,1618
20200514,K,도농,9507,8587,20200517,18094
20200514,K,구리,13099,13300,20200517,26399
20200514,K,양원,1380,1408,20200517,2788
20200514,K,망우,7192,6901,20200517,14093
20200514,K,상봉,5727,5609,20200517,11336
20200514,K,중랑,5275,5056,20200517,10331
20200514,1,회기,21735,20795,20200517,42530
20200515,1,회기,21541,20854,20200518,42395
20200515,K,중랑,5137,4932,20200518,10069
20200515,K,상봉,5533,5323,20200518,10856
20200515,K,망우,6755,6686,20200518,13441
20200515,K,양원,1207,1221,20200518,2428
20200515,K,구리,12568,13203,20200518,25771
20200515,K,도농,9128,8180,20200518,17308
20200515,K,양정,785,674,20200518,1459
20200515,K,덕소,5248,5097,20200518,10345
20200515,K,도심,2381,1788,20200518,4169
20200515,K,팔당,653,616,20200518,1269
20200515,K,운길산,506,508,20200518,1014
20200515,K,양수,1316,1333,20200518,2649
20200515,K,신원,126,113,20200518,239
20200515,K,국수,528,544,20200518,1072
20200515,K,아신,458,452,20200518,910
20200515,K,오빈,263,233,20200518,496
20200515,K,양평,2080,2223,20200518,4303
20200515,K,원덕,259,273,20200518,532
20200515,K,용문,1620,1793,20200518,3413
20200515,K,지평,34,29,20200518,63
20200516,K,지평,45,43,20200519,88
20200516,K,용문,1636,2028,20200519,3664
20200516,K,원덕,360,335,20200519,695
20200516,K,양평,2117,2323,20200519,4440
20200516,K,오빈,213,219,20200519,432
20200516,K,아신,475,549,20200519,1024
20200516,K,국수,620,638,20200519,1258
20200516,K,신원,209,190,20200519,399
20200516,K,양수,1781,1923,20200519,3704
20200516,K,운길산,1145,1090,20200519,2235
20200516,K,팔당,1217,1380,20200519,2597
20200516,K,도심,1551,1341,20200519,2892
20200516,K,덕소,4137,4138,20200519,8275
20200516,K,양정,606,546,20200519,1152
20200516,K,도농,5751,5457,20200519,11208
20200516,K,구리,9180,9527,20200519,18707
20200516,K,양원,876,938,20200519,1814
20200516,K,망우,5724,5438,20200519,11162
20200516,K,상봉,4522,4309,20200519,8831
20200516,K,중랑,3930,3786,20200519,7716
20200516,1,회기,16592,15804,20200519,32396
20200517,K,지평,65,37,20200520,102
20200517,K,용문,2188,1911,20200520,4099
20200517,K,원덕,404,302,20200520,706
20200517,K,양평,2137,1839,20200520,3976
20200517,K,오빈,269,246,20200520,515
20200517,K,아신,546,481,20200520,1027
20200517,K,국수,753,711,20200520,1464
20200517,K,신원,413,312,20200520,725
20200517,K,양수,1897,1725,20200520,3622
20200517,K,운길산,1651,1498,20200520,3149
20200517,K,팔당,1705,1893,20200520,3598
20200517,K,도심,1301,1257,20200520,2558
20200517,K,덕소,3408,3374,20200520,6782
20200517,K,양정,522,482,20200520,1004
20200517,K,도농,4336,4158,20200520,8494
20200517,K,구리,6739,6936,20200520,13675
20200517,K,양원,817,837,20200520,1654
20200517,K,망우,4300,4380,20200520,8680
20200517,K,상봉,3824,3707,20200520,7531
20200517,K,중랑,3132,3042,20200520,6174
20200517,1,회기,13131,13100,20200520,26231
20200518,K,지평,45,33,20200521,78
20200518,1,회기,20632,20514,20200521,41146
20200518,K,중랑,5270,5176,20200521,10446
20200518,K,상봉,5290,5237,20200521,10527
20200518,K,망우,6782,6757,20200521,13539
20200518,K,양원,1317,1355,20200521,2672
20200518,K,구리,12619,12725,20200521,25344
20200518,K,도농,9072,8281,20200521,17353
20200518,K,양정,821,685,20200521,1506
20200518,K,덕소,5359,5232,20200521,10591
20200518,K,도심,2382,1834,20200521,4216
20200518,K,팔당,726,696,20200521,1422
20200518,K,운길산,608,558,20200521,1166
20200518,K,양수,1600,1574,20200521,3174
20200518,K,신원,146,137,20200521,283
20200518,K,국수,620,624,20200521,1244
20200518,K,아신,486,512,20200521,998
20200518,K,오빈,261,240,20200521,501
20200518,K,양평,2640,2613,20200521,5253
20200518,K,원덕,309,305,20200521,614
20200518,K,용문,1519,1452,20200521,2971
20200519,1,회기,21225,20968,20200522,42193
20200519,K,중랑,5213,4912,20200522,10125
20200519,K,상봉,5314,5260,20200522,10574
20200519,K,망우,6771,6546,20200522,13317
20200519,K,양원,1274,1283,20200522,2557
20200519,K,구리,12523,12664,20200522,25187
20200519,K,도농,9129,8121,20200522,17250
20200519,K,양정,793,660,20200522,1453
20200519,K,덕소,5349,5272,20200522,10621
20200519,K,도심,2346,1784,20200522,4130
20200519,K,팔당,598,595,20200522,1193
20200519,K,운길산,483,465,20200522,948
20200519,K,양수,1393,1446,20200522,2839
20200519,K,신원,122,117,20200522,239
20200519,K,국수,562,543,20200522,1105
20200519,K,아신,421,448,20200522,869
20200519,K,오빈,240,247,20200522,487
20200519,K,양평,2061,2085,20200522,4146
20200519,K,원덕,295,296,20200522,591
20200519,K,용문,1249,1236,20200522,2485
20200519,K,지평,41,34,20200522,75
20200520,K,지평,63,60,20200523,123
20200520,K,용문,2827,2906,20200523,5733
20200520,K,원덕,372,370,20200523,742
20200520,K,양평,2527,2556,20200523,5083
20200520,K,오빈,303,274,20200523,577
20200520,K,아신,541,530,20200523,1071
20200520,K,국수,768,735,20200523,1503
20200520,K,신원,278,229,20200523,507
20200520,K,양수,1935,1916,20200523,3851
20200520,K,운길산,1002,941,20200523,1943
20200520,K,팔당,867,895,20200523,1762
20200520,K,도심,2622,2063,20200523,4685
20200520,K,덕소,5948,5901,20200523,11849
20200520,K,양정,924,799,20200523,1723
20200520,K,도농,9754,8811,20200523,18565
20200520,K,구리,13683,13733,20200523,27416
20200520,K,양원,1640,1695,20200523,3335
20200520,K,망우,7494,7438,20200523,14932
20200520,K,상봉,5811,5609,20200523,11420
20200520,K,중랑,5613,5438,20200523,11051
20200520,1,회기,22791,22171,20200523,44962
20200521,K,지평,62,64,20200524,126
20200521,K,원덕,383,380,20200524,763
20200521,K,양평,2571,2535,20200524,5106
20200521,K,오빈,293,313,20200524,606
20200521,K,아신,560,533,20200524,1093
20200521,K,국수,753,740,20200524,1493
20200521,K,신원,216,207,20200524,423
20200521,K,양수,1895,1942,20200524,3837
20200521,K,운길산,978,923,20200524,1901
20200521,K,팔당,925,935,20200524,1860
20200521,K,도심,2547,2065,20200524,4612
20200521,K,덕소,5762,5664,20200524,11426
20200521,K,양정,907,806,20200524,1713
20200521,K,도농,9729,8882,20200524,18611
20200521,K,구리,13405,13520,20200524,26925
20200521,K,양원,1564,1586,20200524,3150
20200521,K,망우,7547,7303,20200524,14850
20200521,K,상봉,6043,5749,20200524,11792
20200521,K,중랑,5575,5246,20200524,10821
20200521,1,회기,22470,21800,20200524,44270
20200521,K,용문,1898,1978,20200524,3876
20200522,1,회기,23525,22182,20200525,45707
20200522,K,중랑,5695,5428,20200525,11123
20200522,K,상봉,6158,6025,20200525,12183
20200522,K,망우,7663,7436,20200525,15099
20200522,K,양원,1551,1523,20200525,3074
20200522,K,구리,13667,14005,20200525,27672
20200522,K,도농,9859,8844,20200525,18703
20200522,K,양정,841,781,20200525,1622
20200522,K,덕소,5822,5841,20200525,11663
20200522,K,도심,2597,1971,20200525,4568
20200522,K,양수,1783,1894,20200525,3677
20200522,K,운길산,876,866,20200525,1742
20200522,K,팔당,941,920,20200525,1861
20200522,K,지평,55,51,20200525,106
20200522,K,용문,1716,1898,20200525,3614
20200522,K,원덕,341,371,20200525,712
20200522,K,양평,2597,2808,20200525,5405
20200522,K,오빈,267,252,20200525,519
20200522,K,아신,598,616,20200525,1214
20200522,K,국수,741,723,20200525,1464
20200522,K,신원,226,189,20200525,415
20200523,1,회기,18612,17705,20200526,36317
20200523,K,중랑,4354,4170,20200526,8524
20200523,K,상봉,5096,4753,20200526,9849
20200523,K,망우,6150,5904,20200526,12054
20200523,K,양원,1223,1222,20200526,2445
20200523,K,구리,10241,10612,20200526,20853
20200523,K,도농,6449,6022,20200526,12471
20200523,K,양정,718,620,20200526,1338
20200523,K,덕소,4636,4620,20200526,9256
20200523,K,도심,1686,1502,20200526,3188
20200523,K,팔당,1850,2118,20200526,3968
20200523,K,운길산,1774,1665,20200526,3439
20200523,K,양수,2403,2301,20200526,4704
20200523,K,신원,365,241,20200526,606
20200523,K,국수,797,830,20200526,1627
20200523,K,아신,652,624,20200526,1276
20200523,K,오빈,291,295,20200526,586
20200523,K,양평,3538,3645,20200526,7183
20200523,K,원덕,438,441,20200526,879
20200523,K,용문,2262,2587,20200526,4849
20200523,K,지평,74,49,20200526,123
20200524,K,국수,533,499,20200527,1032
20200524,K,신원,220,188,20200527,408
20200524,K,양수,1486,1295,20200527,2781
20200524,K,운길산,1115,1061,20200527,2176
20200524,K,팔당,1055,1076,20200527,2131
20200524,K,도심,1136,1013,20200527,2149
20200524,K,덕소,2932,2928,20200527,5860
20200524,K,양정,438,362,20200527,800
20200524,K,도농,4051,4094,20200527,8145
20200524,K,구리,6343,6675,20200527,13018
20200524,K,양원,733,792,20200527,1525
20200524,K,망우,3879,3910,20200527,7789
20200524,K,상봉,3410,3288,20200527,6698
20200524,K,중랑,2981,2905,20200527,5886
20200524,1,회기,12625,12942,20200527,25567
20200524,K,아신,441,413,20200527,854
20200524,K,오빈,200,171,20200527,371
20200524,K,양평,1855,1606,20200527,3461
20200524,K,원덕,298,223,20200527,521
20200524,K,용문,1630,1336,20200527,2966
20200524,K,지평,40,29,20200527,69
20200525,K,지평,43,45,20200528,88
20200525,K,용문,2885,2891,20200528,5776
20200525,K,원덕,356,316,20200528,672
20200525,K,양평,2589,2603,20200528,5192
20200525,K,오빈,286,295,20200528,581
20200525,K,아신,582,567,20200528,1149
20200525,K,국수,746,723,20200528,1469
20200525,K,신원,215,209,20200528,424
20200525,K,양수,1896,1858,20200528,3754
20200525,K,운길산,853,812,20200528,1665
20200525,K,팔당,858,809,20200528,1667
20200525,K,도심,2614,2053,20200528,4667
20200525,K,덕소,5981,5747,20200528,11728
20200525,K,양정,916,794,20200528,1710
20200525,K,도농,9961,8864,20200528,18825
20200525,K,구리,13593,13585,20200528,27178
20200525,K,양원,1525,1547,20200528,3072
20200525,K,망우,7439,7291,20200528,14730
20200525,K,상봉,5900,5734,20200528,11634
20200525,K,중랑,5537,5278,20200528,10815
20200525,1,회기,22578,22083,20200528,44661
20200526,K,지평,52,41,20200529,93
20200526,K,용문,1655,1679,20200529,3334
20200526,K,원덕,320,323,20200529,643
20200526,K,양평,2461,2433,20200529,4894
20200526,K,오빈,290,303,20200529,593
20200526,K,아신,546,526,20200529,1072
20200526,K,국수,675,643,20200529,1318
20200526,K,신원,191,172,20200529,363
20200526,K,양수,1773,1781,20200529,3554
20200526,K,운길산,860,844,20200529,1704
20200526,K,팔당,790,786,20200529,1576
20200526,K,도심,2637,2026,20200529,4663
20200526,K,덕소,5738,5668,20200529,11406
20200526,K,양정,907,771,20200529,1678
20200526,K,도농,9825,8836,20200529,18661
20200526,K,구리,13286,13572,20200529,26858
20200526,K,양원,1631,1678,20200529,3309
20200526,K,망우,7401,7289,20200529,14690
20200526,K,상봉,5717,5626,20200529,11343
20200526,K,중랑,5558,5300,20200529,10858
20200526,1,회기,22540,21979,20200529,44519
20200527,1,회기,23097,22423,20200530,45520
20200527,K,중랑,5593,5392,20200530,10985
20200527,K,상봉,5986,5738,20200530,11724
20200527,K,망우,7416,7237,20200530,14653
20200527,K,양원,1849,1922,20200530,3771
20200527,K,구리,13509,13661,20200530,27170
20200527,K,도농,10048,9046,20200530,19094
20200527,K,양정,892,799,20200530,1691
20200527,K,덕소,5793,5756,20200530,11549
20200527,K,도심,2634,2067,20200530,4701
20200527,K,팔당,849,897,20200530,1746
20200527,K,운길산,941,941,20200530,1882
20200527,K,양수,1868,1886,20200530,3754
20200527,K,신원,204,171,20200530,375
20200527,K,국수,847,778,20200530,1625
20200527,K,아신,546,582,20200530,1128
20200527,K,오빈,305,316,20200530,621
20200527,K,양평,2622,2642,20200530,5264
20200527,K,원덕,354,336,20200530,690
20200527,K,용문,1793,1782,20200530,3575
20200527,K,지평,56,50,20200530,106
20200528,K,지평,75,60,20200531,135
20200528,K,용문,1814,1879,20200531,3693
20200528,K,원덕,361,360,20200531,721
20200528,K,양평,3458,3556,20200531,7014
20200528,K,오빈,318,319,20200531,637
20200528,K,아신,553,512,20200531,1065
20200528,K,국수,780,756,20200531,1536
20200528,K,신원,232,207,20200531,439
20200528,K,양수,1945,1994,20200531,3939
20200528,K,운길산,993,929,20200531,1922
20200528,K,팔당,872,888,20200531,1760
20200528,K,도심,2633,2002,20200531,4635
20200528,K,덕소,5712,5707,20200531,11419
20200528,K,양정,880,783,20200531,1663
20200528,K,도농,9827,8806,20200531,18633
20200528,K,구리,13103,13376,20200531,26479
20200528,K,양원,1790,1802,20200531,3592
20200528,K,망우,7541,7253,20200531,14794
20200528,K,상봉,5916,5585,20200531,11501
20200528,K,중랑,5554,5239,20200531,10793
20200528,1,회기,23404,22555,20200531,45959
20200529,K,지평,77,47,20200601,124
20200529,1,회기,23625,22477,20200601,46102
20200529,K,중랑,5603,5225,20200601,10828
20200529,K,상봉,6228,5832,20200601,12060
20200529,K,망우,7511,7338,20200601,14849
20200529,K,양원,1713,1799,20200601,3512
20200529,K,구리,13352,13689,20200601,27041
20200529,K,도농,9942,8929,20200601,18871
20200529,K,양정,844,792,20200601,1636
20200529,K,덕소,5810,5841,20200601,11651
20200529,K,도심,2559,1936,20200601,4495
20200529,K,팔당,872,890,20200601,1762
20200529,K,운길산,893,892,20200601,1785
20200529,K,양수,1850,1930,20200601,3780
20200529,K,신원,216,188,20200601,404
20200529,K,국수,799,774,20200601,1573
20200529,K,아신,575,547,20200601,1122
20200529,K,오빈,295,287,20200601,582
20200529,K,양평,2601,2788,20200601,5389
20200529,K,원덕,371,410,20200601,781
20200529,K,용문,1849,2058,20200601,3907
20200530,1,회기,17716,16928,20200602,34644
20200530,K,중랑,4250,4078,20200602,8328
20200530,K,상봉,4696,4485,20200602,9181
20200530,K,망우,5870,5729,20200602,11599
20200530,K,양원,1152,1124,20200602,2276
20200530,K,구리,9511,9834,20200602,19345
20200530,K,도농,6220,5704,20200602,11924
20200530,K,양정,705,604,20200602,1309
20200530,K,덕소,4597,4619,20200602,9216
20200530,K,도심,1734,1562,20200602,3296
20200530,K,팔당,1754,1811,20200602,3565
20200530,K,운길산,1738,1710,20200602,3448
20200530,K,양수,2234,2374,20200602,4608
20200530,K,신원,271,230,20200602,501
20200530,K,국수,752,708,20200602,1460
20200530,K,아신,628,666,20200602,1294
20200530,K,오빈,265,286,20200602,551
20200530,K,양평,2425,2546,20200602,4971
20200530,K,원덕,417,436,20200602,853
20200530,K,용문,3453,3690,20200602,7143
20200530,K,지평,72,56,20200602,128
20200531,K,지평,49,45,20200603,94
20200531,K,용문,2088,1785,20200603,3873
20200531,K,원덕,386,310,20200603,696
20200531,K,양평,2101,1731,20200603,3832
20200531,K,오빈,212,205,20200603,417
20200531,K,아신,551,460,20200603,1011
20200531,K,국수,622,556,20200603,1178
20200531,K,신원,332,256,20200603,588
20200531,K,양수,1911,1577,20200603,3488
20200531,K,운길산,1645,1508,20200603,3153
20200531,K,팔당,1528,1632,20200603,3160
20200531,K,도심,1238,1188,20200603,2426
20200531,K,덕소,3189,3246,20200603,6435
20200531,K,양정,473,421,20200603,894
20200531,K,도농,4222,4024,20200603,8246
20200531,K,구리,6390,6802,20200603,13192
20200531,K,양원,801,894,20200603,1695
20200531,K,망우,4128,4151,20200603,8279
20200531,K,상봉,3640,3613,20200603,7253
20200531,K,중랑,3129,3055,20200603,6184
20200531,1,회기,13178,13179,20200603,26357
